Code géographique;Libellé géographique;Foyers fiscaux en 2011;Revenu net déclaré foyers fiscaux en  2011 (€);Impôt total foyers fiscaux en 2011 (€);Foyers fiscaux imposables en 2011;Rev net déclaré foy fiscaux imposables en 2011 (€);Foyers fiscaux non imposables en 2011;Rev net déclaré foy fisc non imposables en 2011 (€);Revenu;rang
97356;Camopi;571;1886486;56696;40;1154735;531;731751;3304;1
97361;Awala-Yalimapo;477;2198159;4592;32;884155;445;1314004;4608;2
97362;Papaichton;461;2729611;62655;42;1408424;419;1321187;5921;3
11291;Plavilla;129;869639;27426;17;661638;112;208001;6741;4
97357;Grand-Santi;620;4179843;122475;75;2441479;545;1738364;6742;5
97353;Maripasoula;1303;9736511;216880;172;5245098;1131;4491413;7472;6
97360;Apatou;839;6278200;88406;121;3948215;718;2329985;7483;7
97219;Le Prêcheur;1030;8799044;57306;157;3771941;873;5027103;8543;8
97303;Iracoubo;708;6163341;59217;101;2986216;607;3177125;8705;9
97301;Régina;278;2489472;15260;42;1147679;236;1341793;8955;10
97306;Mana;2462;22191989;482564;385;13185675;2077;9006314;9014;11
01310;Prémeyzel;185;1681375;42966;41;1154245;144;527130;9089;12
11191;Laroque-de-Fa;102;932869;-3819;17;442861;85;490008;9146;13
11384;Soulatgé;69;631569;777;12;294528;57;337041;9153;14
97215;Macouba;786;7207367;40130;161;3661731;625;3545636;9170;15
97126;Saint-Louis;1680;15608100;182776;269;7572527;1411;8035573;9291;16
48084;Laval-Atger;154;1435240;-45200;18;483524;136;951716;9320;17
97308;Saint-Georges;1376;12920601;504914;242;8665165;1134;4255436;9390;18
24406;Sainte-Foy-de-Belvès;83;784583;37326;17;578804;66;205779;9453;19
11310;Rennes-les-Bains;150;1423057;36673;34;879407;116;543650;9487;20
97421;Salazie;4017;38126462;294212;577;17849356;3440;20277106;9491;21
07081;Dompnac;59;563390;2487;16;317004;43;246386;9549;22
97211;Grand'Rivière;449;4505311;23802;85;1973510;364;2531801;10034;23
2A331;Urbalacone;39;392031;5488;11;267084;28;124947;10052;24
07202;Sablières;79;795315;5962;17;430903;62;364412;10067;25
97110;La Désirade;925;9317015;113866;158;4463095;767;4853920;10072;26
09011;Antras;48;489672;6231;13;271879;35;217793;10202;27
26142;Glandage;69;706721;17176;18;415900;51;290821;10242;28
97108;Capesterre-de-Marie-Galante;2096;21468705;380894;384;11706609;1712;9762096;10243;29
48174;Saint-Paul-le-Froid;91;933767;-3721;15;350291;76;583476;10261;30
26047;Bellegarde-en-Diois;56;576058;4167;12;280859;44;295199;10287;31
11381;Sougraigne;50;515665;4407;13;308528;37;207137;10313;32
70472;Saint-Remy;449;4638986;186931;119;3332040;330;1306946;10332;33
97417;Saint-Philippe;2886;29991122;92881;465;13406757;2421;16584365;10392;34
97419;Sainte-Rose;3630;37729357;489846;565;18504498;3065;19224859;10394;35
64215;Espiute;93;972409;-5004;19;513679;74;458730;10456;36
09063;Le Bosc;77;809453;27849;21;515317;56;294136;10512;37
97424;Cilaos;3249;34191674;736764;558;17742476;2691;16449198;10524;38
97214;Le Lorrain;4893;51610203;476727;990;26930135;3903;24680068;10548;39
2B287;Sorio;69;727978;11464;17;445153;52;282825;10550;40
11346;Saint-Jean-de-Paracol;69;729366;16925;18;432760;51;296606;10571;41
09231;Le Port;104;1099473;31075;27;684884;77;414589;10572;42
97121;Pointe-Noire;4135;43861429;866918;802;23888304;3333;19973125;10607;43
97407;Le Port;19670;209703823;2979324;3935;111851218;15735;97852605;10661;44
2A258;Renno;47;501918;6248;11;235128;36;266790;10679;45
97311;Saint-Laurent-du-Maroni;12178;130484957;4257165;2299;85890386;9879;44594571;10715;46
12017;Ayssènes;137;1468453;782;28;644398;109;824055;10719;47
64543;Urepel;161;1734216;19596;39;898381;122;835835;10772;48
43029;La Besseyre-Saint-Mary;77;832144;-2345;13;280074;64;552070;10807;49
97228;Sainte-Marie;11609;126156699;2159859;2448;69674305;9161;56482394;10867;50
97130;Terre-de-Bas;554;6020649;83018;87;2960242;467;3060407;10868;51
15173;Saint-Bonnet-de-Condat;78;849756;-835;21;410332;57;439424;10894;52
66068;Escaro;77;842695;7375;22;476119;55;366576;10944;53
97208;Fonds-Saint-Denis;534;5883180;63158;135;3220548;399;2662632;11017;54
48110;Paulhac-en-Margeride;62;683654;-7609;13;267243;49;416411;11027;55
03125;La Guillermie;99;1095065;19393;23;561622;76;533443;11061;56
11117;Davejean;77;853544;2921;19;464485;58;389059;11085;57
11260;Mouthoumet;63;700461;9331;18;430539;45;269922;11118;58
11142;Festes-et-Saint-André;120;1335841;9184;27;757161;93;578680;11132;59
09271;Saint-Michel;53;590352;7495;15;329692;38;260660;11139;60
07163;Montselgues;55;613149;1551;11;278957;44;334192;11148;61
97203;Basse-Pointe;2445;27456713;262740;512;13927428;1933;13529285;11230;62
76331;Grugny;669;7563280;212110;157;4913634;512;2649646;11305;63
11143;Feuilla;63;714118;13302;14;373313;49;340805;11335;64
15240;Trémouille;116;1320755;9936;34;712090;82;608665;11386;65
34158;Minerve;82;935428;9523;21;480587;61;454841;11408;66
43094;Ferrussac;60;686142;-1706;11;252572;49;433570;11436;67
97134;Vieux-Habitants;4864;56030858;1052404;1038;31972333;3826;24058525;11520;68
71532;Taizé;57;656748;15045;11;261516;46;395232;11522;69
34040;Brenas;38;437935;10719;12;301036;26;136899;11525;70
81167;Miolles;56;650302;7373;15;361051;41;289251;11613;71
66092;Lansac;49;570817;1961;13;297324;36;273493;11649;72
06133;Sauze;47;548336;1343;12;273745;35;274591;11667;73
63006;Anzat-le-Luguet;138;1610808;564;38;789132;100;821676;11673;74
16249;Oradour-Fanais;197;2305377;18396;53;1315481;144;989896;11702;75
97107;Capesterre-Belle-Eau;11727;137327651;2435151;2568;78109240;9159;59218411;11710;76
09078;Carcanières;42;491882;12237;14;347359;28;144523;11711;77
11075;Castans;72;846098;13214;18;455845;54;390253;11751;78
34233;Roqueredonde;123;1446945;36334;32;858533;91;588412;11764;79
43245;Thoras;121;1424531;-1576;22;550953;99;873578;11773;80
07147;Malarce-sur-la-Thines;156;1836964;43215;41;1085990;115;750974;11775;81
23171;Sermur;80;942159;15789;25;572391;55;369768;11777;82
66013;Baillestavy;49;579262;7544;11;323364;38;255898;11822;83
38469;La Salette-Fallavaux;44;521890;18120;17;374292;27;147598;11861;84
15149;Paulhenc;188;2238334;104138;46;1522537;142;715797;11906;85
19215;Saint-Julien-le-Pèlerin;81;964533;-3891;18;414430;63;550103;11908;86
48171;Saint-Martin-de-Lansuscle;91;1083989;15419;22;598196;69;485793;11912;87
12147;Montagnol;96;1144332;10505;28;601908;68;542424;11920;88
63087;La Chapelle-Marcousse;45;536638;-5026;16;285625;29;251013;11925;89
97122;Port-Louis;3202;38185592;826618;694;21489624;2508;16695968;11926;90
02619;Prémontré;557;6652045;337740;176;5431910;381;1220135;11943;91
97216;Le Marigot;2278;27214733;553963;509;15585281;1769;11629452;11947;92
30132;La Grand-Combe;3073;36782641;655160;760;18862897;2313;17919744;11970;93
43104;Grèzes;146;1749729;-11779;36;852602;110;897127;11984;94
63339;Saint-Étienne-des-Champs;85;1021196;4761;21;537222;64;483974;12014;95
09118;Esplas-de-Sérou;106;1273583;12682;27;677157;79;596426;12015;96
09033;Bagert;32;386539;6571;13;288583;19;97956;12079;97
09097;Clermont;57;689970;11205;17;431537;40;258433;12105;98
63153;Espinchal;67;811595;4064;17;404890;50;406705;12113;99
43097;Freycenet-la-Cuche;76;921699;-2764;19;400728;57;520971;12128;100
97105;Basse-Terre;7361;89316808;2373579;1877;56757246;5484;32559562;12134;101
58125;Gien-sur-Cure;67;815119;6378;16;407614;51;407505;12166;102
07006;Albon-d'Ardèche;98;1193145;29517;31;764281;67;428864;12175;103
97412;Saint-Joseph;20353;247964918;4293512;4022;139462508;16331;108502410;12183;104
09291;Sentenac-d'Oust;63;767865;-4310;23;469676;40;298189;12188;105
36076;Fontgombault;179;2185409;66344;52;1483346;127;702063;12209;106
97225;Saint-Pierre;2773;33879076;853421;553;19132961;2220;14746115;12217;107
63410;Sauvagnat;90;1100158;-9760;20;469273;70;630885;12224;108
63101;Château-sur-Cher;63;770254;13478;16;415762;47;354492;12226;109
48108;La Panouse;54;660628;-1455;12;271097;42;389531;12234;110
66039;Caramany;80;979219;14191;19;461660;61;517559;12240;111
97106;Bouillante;4346;53201265;1217386;979;31191415;3367;22009850;12241;112
15171;Sainte-Anastasie;95;1162990;-6147;29;548639;66;614351;12242;113
15151;Peyrusse;105;1288884;380;25;597493;80;691391;12275;114
88416;Saint-Genest;106;1302665;16453;26;656206;80;646459;12289;115
15158;Rageade;68;836093;-1662;14;340676;54;495417;12295;116
97312;Sinnamary;1208;14864734;337278;266;8650581;942;6214153;12305;117
09008;Alos;75;923788;33979;24;602878;51;320910;12317;118
97423;Les Trois-Bassins;4000;49319048;893027;836;27620569;3164;21698479;12330;119
97201;L'Ajoupa-Bouillon;1105;13640496;181942;247;7076342;858;6564154;12344;120
66152;Prugnanes;62;765441;15496;17;423151;45;342290;12346;121
66201;Tarerach;31;382831;1952;11;232391;20;150440;12349;122
2A014;Ambiegna;38;469418;247;14;319311;24;150107;12353;123
23218;Saint-Maurice-près-Crocq;74;914331;2676;16;436044;58;478287;12356;124
2A132;Guargualé;53;655883;28897;19;466552;34;189331;12375;125
43082;Cronce;51;631678;-9873;12;232947;39;398731;12386;126
63134;Dauzat-sur-Vodable;60;744207;1391;20;455822;40;288385;12403;127
03003;Ainay-le-Château;980;12170121;417676;287;8380856;693;3789265;12418;128
24163;Étouars;81;1006309;10660;26;509802;55;496507;12424;129
97352;Saül;50;621636;12724;15;389145;35;232491;12433;130
97220;Rivière-Pilote;7848;97659803;1854171;1956;56571555;5892;41088248;12444;131
2B161;Moïta;37;460463;11972;12;272527;25;187936;12445;132
15199;Saint-Martial;46;572634;3825;11;267396;35;305238;12449;133
43060;Charraix;52;647399;-5716;14;334987;38;312412;12450;134
59361;Lourches;1997;24875234;310191;495;12678232;1502;12197002;12456;135
19103;Lamazière-Haute;50;622838;5399;15;325388;35;297450;12457;136
23152;Pierrefitte;47;586239;-3569;13;294141;34;292098;12473;137
2A322;Tasso;68;848281;27039;17;436341;51;411940;12475;138
54220;Gémonville;53;661413;10771;15;350809;38;310604;12479;139
09059;Bonac-Irazein;91;1139596;36267;31;753150;60;386446;12523;140
22153;Moncontour;601;7532403;201686;158;4625536;443;2906867;12533;141
07206;Saint-Alban-en-Montagne;34;426143;-1622;13;254046;21;172097;12534;142
23178;Saint-Agnant-près-Crocq;128;1606937;16219;36;817839;92;789098;12554;143
2A200;Palneca;80;1004508;28665;27;655991;53;348517;12556;144
66155;Py;49;616022;15022;15;370815;34;245207;12572;145
65416;Seich;39;491454;477;12;245342;27;246112;12601;146
48058;La Fage-Montivernoux;89;1122321;-9452;22;508769;67;613552;12610;147
97414;Saint-Louis;27149;342508969;6428261;5548;187228382;21601;155280587;12616;148
97112;Grand-Bourg;3445;43504079;1125695;776;26188656;2669;17315423;12628;149
09120;Fabas;220;2779018;48625;61;1533614;159;1245404;12632;150
2B365;San-Gavino-di-Fiumorbo;82;1037397;24368;28;640476;54;396921;12651;151
33402;Sainte-Foy-la-Grande;1706;21589689;646607;458;12397318;1248;9192371;12655;152
48136;Saint-André-de-Lancize;69;873946;2417;17;435223;52;438723;12666;153
64092;Banca;142;1800446;34076;39;897510;103;902936;12679;154
88394;Romain-aux-Bois;31;393100;17;11;207256;20;185844;12681;155
2B225;Pietra-di-Verde;77;977538;39925;23;658854;54;318684;12695;156
63377;Saint-Maurice-près-Pionsat;234;2971822;41299;66;1499565;168;1472257;12700;157
16357;Saint-Vallier;88;1117647;-8182;22;478754;66;638893;12701;158
86172;Mouterre-sur-Blourde;97;1232224;20125;24;600394;73;631830;12703;159
11066;Camurac;68;864201;17097;22;531279;46;332922;12709;160
15015;Auzers;123;1564035;16239;30;697935;93;866100;12716;161
48079;Lajo;72;915935;16257;18;455425;54;460510;12721;162
2A066;Cargiaca;29;368974;20280;11;284931;18;84043;12723;163
63256;Novacelles;90;1146434;6119;24;617666;66;528768;12738;164
36105;Lureuil;143;1821670;22003;50;1196275;93;625395;12739;165
48045;Chaudeyrac;174;2217119;44302;55;1550167;119;666952;12742;166
12064;Le Cayrol;173;2206823;32940;49;1288906;124;917917;12756;167
26350;Teyssières;53;676970;15239;18;482142;35;194828;12773;168
59172;Denain;10737;137316795;3472816;2883;79650801;7854;57665994;12789;169
26189;Montauban-sur-l'Ouvèze;68;869782;13604;22;581182;46;288600;12791;170
08172;Fligny;104;1330799;32576;26;730980;78;599819;12796;171
04179;Saint-Geniez;56;716931;13303;15;456648;41;260283;12802;172
11317;Rodome;78;998752;11832;18;493958;60;504794;12805;173
07120;Lachamp-Raphaël;45;576254;6308;15;351632;30;224622;12806;174
63450;Verneugheol;160;2050216;23680;42;1033939;118;1016277;12814;175
2A089;Ciamannacce;47;603046;23938;14;363522;33;239524;12831;176
61326;Perrou;180;2311254;54040;58;1670304;122;640950;12840;177
2B101;Croce;54;693715;21179;17;436922;37;256793;12847;178
15130;Montchamp;79;1015401;-2256;21;533416;58;481985;12853;179
12075;Connac;67;861342;15242;15;428253;52;433089;12856;180
09018;Arrout;48;617255;8679;12;304968;36;312287;12859;181
15051;Clavières;155;1994420;32549;41;1011491;114;982929;12867;182
2B176;Nocario;34;437707;11912;11;266721;23;170986;12874;183
97119;Petit-Canal;4499;57942867;1121589;1070;34130573;3429;23812294;12879;184
07226;Saint-Clément;62;798913;28013;16;465080;46;333833;12886;185
64045;Arhansus;35;451137;1627;11;283749;24;167388;12890;186
66111;Montalba-le-Château;93;1199266;7358;25;515982;68;683284;12895;187
65431;Sost;62;799886;20684;25;535665;37;264221;12901;188
50357;Morigny;53;683822;324;15;331220;38;352602;12902;189
15018;Barriac-les-Bosquets;82;1058841;4642;26;642203;56;416638;12913;190
66040;Casefabre;28;361622;6127;11;257684;17;103938;12915;191
63191;Lastic;77;994564;12780;24;547233;53;447331;12916;192
32217;Louslitges;48;621246;6425;12;360186;36;261060;12943;193
22365;Trémargat;105;1359504;-13012;31;754910;74;604594;12948;194
11163;Gincla;31;401387;17249;11;315403;20;85984;12948;195
15112;Malbo;65;842433;-3107;16;439734;49;402699;12961;196
64258;Haux;50;648712;11167;13;320853;37;327859;12974;197
63060;Bussières;63;818195;-3977;17;417256;46;400939;12987;198
43149;Pébrac;60;779346;868;16;408378;44;370968;12989;199
58234;Saint-Bonnot;39;506723;14596;11;292664;28;214059;12993;200
23084;La Forêt-du-Temple;90;1170312;9348;29;657428;61;512884;13003;201
30171;Molières-sur-Cèze;880;11444722;198199;225;5750226;655;5694496;13005;202
12019;Balaguier-sur-Rance;58;755089;2156;13;352201;45;402888;13019;203
97212;Gros-Morne;6364;82865733;1608226;1591;48225083;4773;34640650;13021;204
15218;Saint-Vincent-de-Salers;48;626791;3285;11;304501;37;322290;13058;205
2B023;Asco;63;822821;20845;25;547521;38;275300;13061;206
30153;Malons-et-Elze;76;992756;25846;24;696117;52;296639;13063;207
52232;Guindrecourt-sur-Blaise;29;378816;2676;11;217574;18;161242;13063;208
71041;Bois-Sainte-Marie;129;1686738;16889;23;660457;106;1026281;13075;209
2B280;Silvareccio;77;1007167;33641;25;673020;52;334147;13080;210
09129;Galey;75;981244;15989;22;566744;53;414500;13083;211
19133;Mercoeur;167;2185241;19161;53;1153511;114;1031730;13085;212
11321;Roquefort-de-Sault;71;929978;26274;23;526727;48;403251;13098;213
2A203;Partinello;57;747227;17736;25;523448;32;223779;13109;214
03202;Noyant-d'Allier;428;5614487;86917;136;3426808;292;2187679;13118;215
2B102;Crocicchia;37;485607;25865;14;371260;23;114347;13125;216
15082;Junhac;187;2454392;15170;45;1127116;142;1327276;13125;217
2A133;Guitera-les-Bains;74;971305;29264;29;718417;45;252888;13126;218
09182;Massat;433;5683496;159181;125;3356918;308;2326578;13126;219
64016;Aldudes;168;2207189;55577;44;1271712;124;935477;13138;220
97101;Les Abymes;34596;455268566;12761825;9726;304291493;24870;150977073;13160;221
15190;Saint-Hippolyte;64;842924;-3317;16;407473;48;435451;13171;222
09073;Camarade;114;1502807;28261;29;847974;85;654833;13183;223
2B192;Olmo;88;1160229;17387;33;749536;55;410693;13184;224
11373;Salvezines;51;672595;11411;19;419802;32;252793;13188;225
31398;Nizan-Gesse;50;659445;22315;14;419708;36;239737;13189;226
63292;Puy-Saint-Gulmier;86;1135365;4470;26;633267;60;502098;13202;227
09057;Biert;184;2429171;55458;55;1460482;129;968689;13202;228
11326;Rouffiac-des-Corbières;49;647189;13029;12;379844;37;267345;13208;229
07121;Lachapelle-Graillouse;146;1928608;16744;39;928634;107;999974;13210;230
32175;Ladevèze-Ville;165;2179878;68061;53;1679962;112;499916;13211;231
43222;Saint-Privat-du-Dragon;110;1453435;11356;30;755966;80;697469;13213;232
23234;Saint-Priest;120;1586135;13287;39;930443;81;655692;13218;233
11436;Villesèque-des-Corbières;231;3053372;67785;72;1762169;159;1291203;13218;234
43006;Ally;94;1243295;13762;20;595322;74;647973;13227;235
31365;Montbrun-Bocage;284;3757973;64301;81;2144748;203;1613225;13232;236
04171;Rougon;46;608814;11081;15;388714;31;220100;13235;237
42008;Arcon;73;966169;-111;28;569845;45;396324;13235;238
63041;Biollet;186;2462511;29192;66;1584889;120;877622;13239;239
32226;Manas-Bastanous;56;741658;11216;19;462361;37;279297;13244;240
63313;Saint-Alyre-ès-Montagne;95;1259207;19796;27;699476;68;559731;13255;241
48060;Fau-de-Peyre;118;1564099;15174;29;787169;89;776930;13255;242
02641;Renneval;77;1020835;13033;24;653847;53;366988;13258;243
15097;Lastic;69;914887;-3298;18;422599;51;492288;13259;244
07262;Saint-Laurent-les-Bains;79;1047558;13608;18;527907;61;519651;13260;245
97202;Les Anses-d'Arlet;2200;29180935;639398;527;17337172;1673;11843763;13264;246
48193;Vebron;145;1925048;43257;47;1193474;98;731574;13276;247
97410;Saint-Benoît;19095;253636068;5033637;3998;144799942;15097;108836126;13283;248
58159;Marigny-sur-Yonne;145;1928623;44767;42;1274079;103;654544;13301;249
11044;Bouisse;59;784819;13770;21;479548;38;305271;13302;250
07075;Cros-de-Géorand;96;1278960;25706;27;762395;69;516565;13323;251
48145;Saint-Denis-en-Margeride;117;1559041;39511;27;688864;90;870177;13325;252
24367;Saint-André-de-Double;114;1519262;20717;40;929305;74;589957;13327;253
97102;Anse-Bertrand;2618;34898758;608467;634;19848648;1984;15050110;13330;254
86266;Surin;70;933224;9496;18;432051;52;501173;13332;255
11200;Lespinassière;70;933352;11092;25;575892;45;357460;13334;256
64012;Ainharp;68;906848;-5304;21;486689;47;420159;13336;257
08499;Wasigny;193;2573935;19992;53;1334538;140;1239397;13336;258
19111;Laval-sur-Luzège;58;773885;15535;18;423739;40;350146;13343;259
04129;Montjustin;35;467018;7022;11;273203;24;193815;13343;260
07166;Nozières;156;2081644;30607;40;1010220;116;1071424;13344;261
26190;Montaulieu;48;640848;19631;12;379175;36;261673;13351;262
07106;Issarlès;98;1310165;13561;29;765070;69;545095;13369;263
23204;Saint-Julien-le-Châtel;93;1243386;15649;32;775844;61;467542;13370;264
97116;Morne-à-l'Eau;9990;133588885;2979354;2673;84974394;7317;48614491;13372;265
11376;La Serpent;52;695626;21908;14;413182;38;282444;13377;266
43220;Saint-Préjet-d'Allier;118;1578857;21360;39;877101;79;701756;13380;267
63076;Chambon-sur-Dolore;105;1405033;20963;27;709105;78;695928;13381;268
81221;Rayssac;134;1793745;10314;36;948639;98;845106;13386;269
81086;Espérausses;85;1137845;13800;27;672962;58;464883;13386;270
48046;Chaulhac;45;602848;11556;14;341963;31;260885;13397;271
19261;Sornac;583;7816900;178091;198;5282122;385;2534778;13408;272
15126;Molèdes;58;777930;-3817;14;282207;44;495723;13413;273
11092;Citou;60;805219;19090;20;490900;40;314319;13420;274
66043;Casteil;87;1170307;28321;29;809726;58;360581;13452;275
12128;Lescure-Jaoul;163;2192693;15914;47;1230399;116;962294;13452;276
2A363;Zoza;32;430612;10026;11;234991;21;195621;13457;277
07282;Saint-Pierre-de-Colombier;267;3592943;109265;82;2239968;185;1352975;13457;278
81246;Sainte-Cécile-du-Cayrou;71;955650;13777;20;514699;51;440951;13460;279
48093;Mas-d'Orcières;76;1023062;-1797;24;578049;52;445013;13461;280
15172;Saint-Antoine;71;955937;5935;23;562602;48;393335;13464;281
39002;Abergement-le-Grand;38;512134;7252;12;308810;26;203324;13477;282
32466;Viozan;69;930049;13787;16;490072;53;439977;13479;283
07329;Valgorge;273;3680274;79188;91;2435584;182;1244690;13481;284
34257;Saint-Geniès-de-Varensal;104;1402282;17327;34;894757;70;507525;13483;285
48112;Pierrefiche;100;1348606;35058;35;926988;65;421618;13486;286
97120;Pointe-à-Pitre;10067;135804041;5217648;2779;94879920;7288;40924121;13490;287
07026;Le Béage;159;2145586;2724;49;1228993;110;916593;13494;288
2A204;Pastricciola;58;782667;27023;20;502056;38;280611;13494;289
2B356;Zalana;84;1133649;36781;31;805184;53;328465;13496;290
81121;Lacabarède;184;2484006;21557;58;1372675;126;1111331;13500;291
11131;Fa;205;2768115;28188;56;1456379;149;1311736;13503;292
32271;Monguilhem;252;3403559;45245;80;2209139;172;1194420;13506;293
58230;Saint-Aubin-des-Chaumes;52;702893;-3648;16;310862;36;392031;13517;294
48004;Altier;122;1649673;17386;33;710402;89;939271;13522;295
48028;Les Bondons;94;1271279;15104;30;739304;64;531975;13524;296
97131;Terre-de-Haut;971;13132067;231376;223;7426791;748;5705276;13524;297
64025;Angous;56;757577;6;16;388597;40;368980;13528;298
48170;Saint-Martin-de-Boubaux;110;1488249;34603;34;1051933;76;436316;13530;299
97218;Le Morne-Rouge;3046;41211267;1098590;719;23309139;2327;17902128;13530;300
04214;Tartonne;84;1137315;15146;23;687327;61;449988;13539;301
43004;Alleyrac;67;907746;-6793;17;389793;50;517953;13548;302
66123;Nyer;69;935487;31737;22;603401;47;332086;13558;303
06132;Saorge;303;4111872;125860;112;2860870;191;1251002;13571;304
66143;Planèzes;69;936714;12375;19;524717;50;411997;13576;305
05014;Barret-sur-Méouge;150;2037235;71828;53;1435400;97;601835;13582;306
15058;Cros-de-Ronesque;86;1168056;12671;29;673604;57;494452;13582;307
11037;Berriac;484;6578103;249012;165;4894992;319;1683111;13591;308
26153;Laborel;57;774724;16931;13;381923;44;392801;13592;309
82097;Lavit;998;13577381;403992;321;9328376;677;4249005;13605;310
97104;Baillif;3587;48802919;1429901;983;31858363;2604;16944556;13605;311
88404;Rozières-sur-Mouzon;46;626204;3390;15;323777;31;302427;13613;312
11431;Villeneuve-les-Corbières;144;1961128;39563;46;1148018;98;813110;13619;313
47200;Parranquet;77;1048743;14713;29;665221;48;383522;13620;314
43133;Mercoeur;86;1171578;6779;24;603153;62;568425;13623;315
31431;Portet-d'Aspet;51;694774;21041;18;400247;33;294527;13623;316
11179;Labastide-en-Val;57;776549;5372;20;451213;37;325336;13624;317
15066;Le Falgoux;96;1308020;17982;24;649900;72;658120;13625;318
05126;Rosans;348;4743457;109996;118;3210838;230;1532619;13631;319
23091;Gioux;99;1349679;13277;31;778191;68;571488;13633;320
23127;Mautes;143;1949645;45200;39;1120617;104;829028;13634;321
2B201;Pancheraccia;108;1472692;41076;36;963957;72;508735;13636;322
48020;Bassurels;27;368414;6880;11;245142;16;123272;13645;323
89208;Joux-la-Ville;566;7725985;214838;180;5226056;386;2499929;13650;324
23260;Vidaillat;111;1515416;28512;39;921892;72;593524;13652;325
2B334;Valle-d'Alesani;62;847241;20217;22;530269;40;316972;13665;326
11244;Montfort-sur-Boulzane;44;601440;7979;14;331248;30;270192;13669;327
2B340;Velone-Orneto;80;1094076;31207;28;690703;52;403373;13676;328
11311;Ribaute;158;2162022;27193;55;1428161;103;733861;13684;329
11036;Belvis;117;1602477;17211;39;975603;78;626874;13696;330
15139;Narnhac;53;726160;-3560;14;363012;39;363148;13701;331
82133;Mouillac;51;698760;7076;13;355800;38;342960;13701;332
26060;Bouvières;86;1178334;4759;25;714561;61;463773;13702;333
11110;Coustouge;63;863236;14869;19;573569;44;289667;13702;334
24515;Salagnac;482;6607963;121100;176;4395399;306;2212564;13709;335
16389;Turgon;54;740783;7181;21;484713;33;256070;13718;336
03006;Arfeuilles;448;6150659;130514;140;3439321;308;2711338;13729;337
64267;Ibarrolle;47;645427;15967;15;355502;32;289925;13732;338
2B054;Campile;119;1634964;36872;45;1078591;74;556373;13739;339
15229;Soulages;57;783405;14168;14;447342;43;336063;13744;340
23090;Gentioux-Pigerolles;262;3601761;72211;93;2285985;169;1315776;13747;341
12179;Peux-et-Couffouleux;61;838759;610;17;486073;44;352686;13750;342
11205;Limousis;72;990022;19092;19;516409;53;473613;13750;343
2B126;Giuncaggio;36;495039;4140;12;257174;24;237865;13751;344
88179;Fouchécourt;35;481300;-4531;13;269590;22;211710;13751;345
2A144;Lopigna;72;990547;31351;29;696003;43;294544;13758;346
81122;Lacapelle-Pinet;39;536565;5609;11;242136;28;294429;13758;347
15256;Vèze;58;797990;26371;21;485175;37;312815;13758;348
64162;Camou-Cihigue;47;646733;-2130;20;406215;27;240518;13760;349
09322;Ustou;191;2628311;31790;69;1657540;122;970771;13761;350
04007;Angles;45;619332;8400;14;353761;31;265571;13763;351
21244;Éguilly;28;385371;3132;12;250170;16;135201;13763;352
11184;Lafage;57;784743;3246;21;527201;36;257542;13767;353
97409;Saint-André;27779;382627244;6199607;6127;216677942;21652;165949302;13774;354
30037;Bessèges;1997;27519206;766854;586;15644215;1411;11874991;13780;355
15068;Faverolles;203;2797866;37615;50;1407885;153;1389981;13783;356
2B226;Pietraserena;52;717016;19587;21;517227;31;199789;13789;357
64528;Suhescun;89;1227362;23244;33;810554;56;416808;13791;358
23221;Saint-Merd-la-Breuille;136;1875691;17675;41;1062969;95;812722;13792;359
19157;Palisse;131;1806754;16071;30;801070;101;1005684;13792;360
09028;Aulos;35;482758;2026;12;287061;23;195697;13793;361
32081;Castelnavet;81;1117626;11186;25;647962;56;469664;13798;362
17478;Vinax;43;593836;482;17;373522;26;220314;13810;363
30283;Saint-Martial;123;1699115;41753;39;1046137;84;652978;13814;364
43128;Malvières;74;1022420;9791;26;631426;48;390994;13816;365
11194;Lastours;96;1326919;15240;35;779895;61;547024;13822;366
57236;Frémery;39;539105;4430;12;274140;27;264965;13823;367
32367;Saint-Christaud;42;580627;6045;16;383303;26;197324;13824;368
11180;Labastide-Esparbairenque;49;677456;7979;16;355878;33;321578;13826;369
57613;Saint-Jean-de-Bassel;256;3543424;45230;68;1743767;188;1799657;13842;370
66061;Coustouges;75;1038182;20724;23;512729;52;525453;13842;371
2A359;Zicavo;161;2230555;131402;49;1522376;112;708179;13854;372
48010;Auroux;235;3257238;84308;80;2236036;155;1021202;13861;373
07105;Issanlas;63;874032;11784;15;454869;48;419163;13874;374
16065;Brillac;371;5147361;118978;113;2961105;258;2186256;13874;375
2B073;Casamaccioli;76;1054525;28622;33;738794;43;315731;13875;376
24402;Sainte-Eulalie-d'Eymet;44;610575;3690;13;321493;31;289082;13877;377
23060;Chavanat;89;1235565;25256;32;781911;57;453654;13883;378
65427;Siradan;197;2736501;65489;63;1778954;134;957547;13891;379
24061;Bourrou;78;1083706;11381;26;634859;52;448847;13894;380
15225;Ségur-les-Villas;133;1848082;8917;44;970304;89;877778;13895;381
09153;Lapenne;70;972790;16378;18;523066;52;449724;13897;382
57058;Behren-lès-Forbach;3965;55106110;930080;1073;28026944;2892;27079166;13898;383
17092;Chartuzac;98;1362450;21898;31;773520;67;588930;13903;384
66223;Villefranche-de-Conflent;146;2030238;25850;48;1239944;98;790294;13906;385
09005;Aleu;93;1293940;32309;29;806254;64;487686;13913;386
19258;Servières-le-Château;437;6080920;174761;149;4186268;288;1894652;13915;387
07154;Mazan-l'Abbaye;87;1210844;33568;19;566776;68;644068;13918;388
48119;Prévenchères;153;2130814;54380;47;1383671;106;747143;13927;389
43171;Saint-Bérain;51;710811;-2736;15;324026;36;386785;13937;390
63359;Saint-Hilaire-les-Monges;60;836361;4264;23;521675;37;314686;13939;391
15043;Charmensac;57;794726;5736;16;390671;41;404055;13943;392
26036;Beaumont-en-Diois;63;878403;44119;20;545967;43;332436;13943;393
60200;Domfront;183;2552413;46165;49;1339913;134;1212500;13948;394
48007;Arzenc-d'Apcher;29;404606;-440;12;254838;17;149768;13952;395
70436;Raincourt;67;934987;1927;22;439547;45;495440;13955;396
2B051;Cambia;30;418872;13975;12;310010;18;108862;13962;397
30159;Le Martinet;524;7316786;133398;169;4216730;355;3100056;13963;398
62771;Sallaumines;5439;75952425;1548008;1658;43378357;3781;32574068;13964;399
2A266;Salice;51;712576;18798;20;503305;31;209271;13972;400
62361;Frévent;2127;29737671;786841;634;17531029;1493;12206642;13981;401
81071;Courris;54;755135;20500;16;454906;38;300229;13984;402
87132;Saint-Amand-le-Petit;63;881299;10805;22;488230;41;393069;13989;403
15107;Lorcières;132;1846599;29626;36;966028;96;880571;13989;404
48044;Chauchailles;62;867381;23388;20;550848;42;316533;13990;405
2A259;Rezza;29;405757;367;12;259991;17;145766;13992;406
11055;Bugarach;112;1567821;35033;40;1041943;72;525878;13998;407
63081;Champétières;170;2379952;90874;65;1778807;105;601145;14000;408
23005;Arfeuille-Châtain;119;1666170;36507;41;1075006;78;591164;14001;409
70217;Esmoulières;68;952202;23957;23;566068;45;386134;14003;410
46096;Espeyroux;68;953155;22279;26;659899;42;293256;14017;411
23044;Chambon-Sainte-Croix;57;799134;9412;21;487806;36;311328;14020;412
23104;Lavaufranche;159;2230521;34491;50;1207439;109;1023082;14028;413
24569;Vendoire;89;1248654;20462;28;696034;61;552620;14030;414
03050;La Chabanne;113;1585589;33246;34;912344;79;673245;14032;415
23147;Nouzerolles;65;912238;8071;21;474185;44;438053;14034;416
66103;Marquixanes;306;4295778;126071;98;2889507;208;1406271;14038;417
48144;Sainte-Croix-Vallée-Française;190;2667433;56392;58;1783468;132;883965;14039;418
64218;Estérençuby;146;2049732;30969;41;1098079;105;951653;14039;419
63360;Saint-Hilaire;121;1699078;23693;40;989675;81;709403;14042;420
63336;Saint-Donat;149;2092943;23690;55;1351069;94;741874;14047;421
64345;Lohitzun-Oyhercq;99;1390739;-3701;29;712055;70;678684;14048;422
11329;Rouvenac;130;1827981;51179;45;1178721;85;649260;14061;423
23252;Tercillat;108;1519349;18241;35;842155;73;677194;14068;424
02275;Effry;197;2771465;27969;61;1492659;136;1278806;14068;425
55469;Sassey-sur-Meuse;64;900541;2121;26;541359;38;359182;14071;426
2A018;Arbellara;80;1125892;8600;27;683113;53;442779;14074;427
43156;Présailles;93;1309056;12154;31;768674;62;540382;14076;428
65041;Asque;65;914951;12141;20;551577;45;363374;14076;429
2B055;Campitello;59;830623;31176;21;550889;38;279734;14078;430
65463;Viella;63;886972;8298;28;563403;35;323569;14079;431
59365;Louvroil;3460;48728153;1383169;1051;29934601;2409;18793552;14083;432
15206;Saint-Pierre;87;1226342;28324;29;724719;58;501623;14096;433
50368;Nay;44;620373;-6895;11;288016;33;332357;14099;434
70582;Vy-lès-Rupt;53;747354;1779;20;406428;33;340926;14101;435
2B135;Isolaccio-di-Fiumorbo;177;2495945;77179;59;1522272;118;973673;14101;436
2B178;Nonza;48;677133;27832;15;399663;33;277470;14107;437
23062;Chéniers;360;5079472;96781;126;3085003;234;1994469;14110;438
87136;Saint-Barbant;214;3019622;43427;70;1726993;144;1292629;14110;439
50179;Ferrières;32;451593;12326;11;286235;21;165358;14112;440
15208;Saint-Projet-de-Salers;81;1143143;27751;25;635950;56;507193;14113;441
48023;Belvezet;48;677868;-2652;16;366117;32;311751;14122;442
07232;Saint-Étienne-de-Lugdarès;239;3376162;101114;80;2216917;159;1159245;14126;443
43050;Chambezon;67;946509;29168;26;656906;41;289603;14127;444
23017;Basville;111;1568310;28509;36;925305;75;643005;14129;445
33103;Castelmoron-d'Albret;36;508746;16957;16;384336;20;124410;14132;446
83142;Trigance;103;1455725;33584;37;902342;66;553383;14133;447
62555;Marles-les-Mines;3163;44720028;631346;973;24469236;2190;20250792;14138;448
31376;Montgaillard-de-Salies;73;1032165;13787;32;722628;41;309537;14139;449
32141;Gaujan;77;1089136;40654;27;720073;50;369063;14145;450
09146;Justiniac;28;396104;7034;13;260267;15;135837;14147;451
18106;Grossouvre;175;2476308;44521;57;1425374;118;1050934;14150;452
70369;Mont-Saint-Léger;38;537725;667;14;295086;24;242639;14151;453
81272;Saint-Urcisse;137;1938741;32046;45;1188681;92;750060;14151;454
58221;Rémilly;105;1486077;20455;35;880659;70;605418;14153;455
26253;Poyols;38;538098;8865;16;364971;22;173127;14160;456
88478;Tranqueville-Graux;50;708249;6109;17;400302;33;307947;14165;457
12192;Mounes-Prohencoux;112;1586711;-2240;31;788530;81;798181;14167;458
24542;Soulaures;45;637559;10683;11;312290;34;325269;14168;459
11412;Villardebelle;34;481849;9723;12;293223;22;188626;14172;460
43037;Le Bouchet-Saint-Nicolas;146;2069237;29265;47;1173404;99;895833;14173;461
81158;Le Masnau-Massuguiès;171;2423561;11993;52;1316448;119;1107113;14173;462
2B138;Lavatoggio;96;1360776;32572;32;850060;64;510716;14175;463
26279;La Rochette-du-Buis;50;708792;14659;16;408051;34;300741;14176;464
64223;Etsaut;52;737570;11975;20;468927;32;268643;14184;465
11342;Saint-Frichoux;139;1971685;-3478;45;1113821;94;857864;14185;466
43125;Lubilhac;75;1063886;9964;27;636808;48;427078;14185;467
84107;Saint-Christol;794;11263336;152665;360;7424319;434;3839017;14186;468
31337;Melles;67;950663;21971;28;628742;39;321921;14189;469
24464;Saint-Mesmin;172;2440745;39874;62;1531760;110;908985;14190;470
23158;Poussanges;80;1135250;8224;28;691632;52;443618;14191;471
87195;Tersannes;86;1220600;18662;28;722097;58;498503;14193;472
05160;Salérans;47;667128;7293;15;388791;32;278337;14194;473
15113;Mandailles-Saint-Julien;137;1944771;32005;50;1213887;87;730884;14195;474
23108;Leyrat;88;1249436;22952;22;703071;66;546365;14198;475
81009;Amarens;39;553950;14383;16;403110;23;150840;14204;476
24313;Orliac;38;539774;5039;14;325790;24;213984;14205;477
80060;Béalcourt;68;966220;9044;30;646191;38;320029;14209;478
86138;Luchapt;171;2430211;47794;52;1466612;119;963599;14212;479
15214;Saint-Saury;111;1577771;-3997;35;814791;76;762980;14214;480
36099;Lourdoueix-Saint-Michel;217;3084525;76157;70;1845925;147;1238600;14214;481
34190;Oupia;170;2416451;41809;52;1425968;118;990483;14214;482
05024;Bruis;43;611225;6512;12;324510;31;286715;14215;483
19198;Saint-Éloy-les-Tuileries;78;1108776;21826;27;701530;51;407246;14215;484
16255;Parzac;86;1223143;12395;29;799788;57;423355;14223;485
08146;Draize;59;839142;12907;21;518939;38;320203;14223;486
63277;Peslières;41;583189;4506;17;392940;24;190249;14224;487
66193;Serdinya;141;2005871;34076;54;1245269;87;760602;14226;488
52122;Chaumont-la-Ville;72;1024331;7077;26;577203;46;447128;14227;489
87123;Rempnat;88;1251968;32945;26;718472;62;533496;14227;490
58274;Savigny-Poil-Fol;66;939450;8545;20;500755;46;438695;14234;491
81285;Sérénac;276;3930379;64649;93;2350221;183;1580158;14241;492
64475;Sainte-Engrâce;88;1253555;38127;31;805904;57;447651;14245;493
63220;Mazoires;67;954482;6012;20;555725;47;398757;14246;494
65329;Nistos;148;2108467;32444;44;1212353;104;896114;14246;495
15017;Badailhac;86;1225372;4148;32;704548;54;520824;14249;496
31532;Sarremezan;50;712428;15558;19;476054;31;236374;14249;497
02304;La Fère;1753;24986808;1000565;559;15999833;1194;8986975;14254;498
08176;Fossé;39;555968;-4636;17;385415;22;170553;14256;499
16048;Boisbreteau;82;1169174;4860;25;654340;57;514834;14258;500
09190;Mérigon;73;1041189;1495;22;577120;51;464069;14263;501
2A108;Évisa;119;1698042;45445;48;1126675;71;571367;14269;502
11157;Fraissé-des-Corbières;140;1997916;22366;44;1124274;96;873642;14271;503
07212;Saint-André-en-Vivarais;147;2098023;15770;43;1068112;104;1029911;14272;504
62601;Nédonchel;146;2084029;27660;36;1023267;110;1060762;14274;505
43168;Saint-Arcons-de-Barges;79;1127956;23640;22;559575;57;568381;14278;506
63117;Compains;90;1285507;22484;36;829312;54;456195;14283;507
34279;Saint-Nazaire-de-Ladarez;202;2885468;39191;64;1595617;138;1289851;14284;508
18238;Saint-Vitte;84;1199956;13409;29;680421;55;519535;14285;509
36227;Urciers;153;2185717;28329;53;1186652;100;999065;14286;510
09090;Cazaux;27;385920;10077;11;273821;16;112099;14293;511
16170;Juignac;255;3645943;97537;86;2470440;169;1175503;14298;512
43250;Vals-le-Chastel;34;486187;9697;12;273378;22;212809;14300;513
07239;Saint-Genest-Lachamp;66;943812;2937;24;589497;42;354315;14300;514
87091;Maisonnais-sur-Tardoire;265;3792007;70129;88;2265946;177;1526061;14309;515
16403;Le Vieux-Cérier;77;1102373;16784;26;676118;51;426255;14317;516
24378;Saint-Avit-Rivière;51;730171;9408;13;434882;38;295289;14317;517
23012;Auriat;75;1073944;29084;23;675652;52;398292;14319;518
09200;Montbel;70;1003054;28348;18;609751;52;393303;14329;519
46161;Lauresses;167;2393040;-5525;56;1297564;111;1095476;14330;520
2B122;Gavignano;34;487254;11772;18;384920;16;102334;14331;521
48120;Prinsuéjols;91;1304121;1643;25;651326;66;652795;14331;522
23139;Moutier-Malcard;324;4643772;104190;106;2724991;218;1918781;14333;523
23162;Roches;252;3612675;88533;80;2133830;172;1478845;14336;524
2A094;Corrano;49;702575;19029;24;520878;25;181697;14338;525
19228;Saint-Pantaléon-de-Lapleau;39;559237;12401;14;358669;25;200568;14339;526
26361;Valdrôme;81;1161588;12469;27;725768;54;435820;14341;527
50193;Le Fresne-Poret;125;1792733;-8379;39;897457;86;895276;14342;528
81028;Berlats;77;1104443;13094;27;644293;50;460150;14343;529
42241;Saint-Jodard;271;3887322;92439;93;2659623;178;1227699;14344;530
11107;Courtauly;36;516447;7565;12;331091;24;185356;14346;531
12015;Auriac-Lagast;144;2065914;-3609;40;1084230;104;981684;14347;532
29012;Bolazec;132;1894279;43258;46;1146617;86;747662;14351;533
61333;Pontchardon;115;1651125;19597;35;825935;80;825190;14358;534
66146;Porta;70;1005060;15719;30;640116;40;364944;14358;535
15269;Besse;88;1263604;6031;30;727100;58;536504;14359;536
48100;Montbel;83;1192273;18569;31;691088;52;501185;14365;537
33108;Castillon-la-Bataille;2016;28962781;1007479;633;17483262;1383;11479519;14366;538
02660;Rouvroy-sur-Serre;28;402263;879;13;258868;15;143395;14367;539
15131;Le Monteil;167;2399616;4722;53;1347448;114;1052168;14369;540
63337;Saint-Éloy-la-Glacière;39;560416;5271;13;316795;26;243621;14370;541
63328;Sainte-Catherine;39;560488;6395;11;264246;28;296242;14371;542
11007;Albières;50;718706;-2543;19;479451;31;239255;14374;543
12035;Brasc;94;1351435;-6909;24;698559;70;652876;14377;544
11123;Duilhac-sous-Peyrepertuse;84;1207761;11703;32;798388;52;409373;14378;545
24025;Bars;137;1970238;39004;37;1112929;100;857309;14381;546
15207;Saint-Poncy;197;2833722;18678;52;1428823;145;1404899;14384;547
24046;Boisseuilh;77;1107767;13842;21;542066;56;565701;14387;548
57207;Farébersviller;2847;40958851;551140;834;21042939;2013;19915912;14387;549
52464;Saulles;40;575573;11920;13;359182;27;216391;14389;550
23115;Magnat-l'Étrange;126;1813071;49486;45;1176614;81;636457;14389;551
17038;Bedenac;324;4662553;78519;97;2724153;227;1938400;14391;552
48073;Les Hermaux;71;1022075;5929;23;524704;48;497371;14395;553
48155;Saint-Germain-de-Calberte;253;3642854;69645;91;2319427;162;1323427;14399;554
15013;Auriac-l'Église;117;1685099;21814;39;926088;78;759011;14403;555
02642;Résigny;110;1584707;35356;41;976423;69;608284;14406;556
43090;Esplantas;51;734731;-2342;19;397555;32;337176;14406;557
46146;Ladirat;73;1051687;17617;24;592738;49;458949;14407;558
32445;Tieste-Uragnoux;90;1296656;23437;35;866823;55;429833;14407;559
56099;Langoëlan;231;3329363;49322;74;1809541;157;1519822;14413;560
43109;Lafarre;46;663005;15555;16;394676;30;268329;14413;561
15078;Jabrun;94;1355027;17534;30;756736;64;598291;14415;562
23216;Saint-Martin-Château;94;1355949;27581;35;881200;59;474749;14425;563
09341;Viviès;62;895373;5578;18;465068;44;430305;14442;564
2B084;Cateri;119;1719074;28160;42;1119227;77;599847;14446;565
55297;Lissey;68;982470;12750;20;526629;48;455841;14448;566
65114;Buzon;60;866946;6570;17;502197;43;364749;14449;567
82078;Labastide-de-Penne;74;1069243;21614;28;707528;46;361715;14449;568
30198;Les Plantiers;158;2283382;53630;44;1308708;114;974674;14452;569
11154;Fournes-Cabardès;31;448022;2854;11;265920;20;182102;14452;570
06051;La Croix-sur-Roudoule;54;780759;14259;18;428893;36;351866;14459;571
02038;Les Autels;40;578368;6311;11;235927;29;342441;14459;572
36028;La Buxerette;75;1084544;2725;23;524065;52;560479;14461;573
86037;Brigueil-le-Chantre;307;4439488;79539;105;2661455;202;1778033;14461;574
15167;Rouziers;67;968905;4511;20;550763;47;418142;14461;575
09141;Illartein;47;679767;20008;19;499585;28;180182;14463;576
23254;Toulx-Sainte-Croix;209;3023351;57458;71;1842324;138;1181027;14466;577
2B354;Vivario;244;3530209;132733;111;2737983;133;792226;14468;578
43256;Venteuges;216;3125260;30742;63;1771532;153;1353728;14469;579
65475;Villemur;39;564865;16278;17;390844;22;174021;14484;580
34071;Ceilhes-et-Rocozels;169;2448044;40499;62;1611238;107;836806;14485;581
23050;La Chapelle-Baloue;101;1463082;55573;36;981691;65;481391;14486;582
2A022;Arro;57;825754;27090;23;566690;34;259064;14487;583
87026;Bussière-Boffy;192;2782160;81790;66;1759740;126;1022420;14490;584
87206;Villefavard;108;1565253;21155;42;989763;66;575490;14493;585
43065;Chastel;97;1405935;27087;28;766551;69;639384;14494;586
11235;Missègre;44;637793;20538;15;407013;29;230780;14495;587
11377;Serres;37;536392;12452;11;347480;26;188912;14497;588
97117;Le Moule;12719;184393773;5730843;3452;117477106;9267;66916667;14498;589
12074;Condom-d'Aubrac;185;2682156;46665;55;1500738;130;1181418;14498;590
12184;Pomayrols;88;1276929;31344;26;738541;62;538388;14511;591
23187;Saint-Dizier-la-Tour;122;1770425;14415;44;1024059;78;746366;14512;592
48164;Saint-Julien-du-Tournel;72;1045207;2668;21;489650;51;555557;14517;593
93027;La Courneuve;20427;296601110;7152655;7247;187588658;13180;109012452;14520;594
66151;Prats-de-Sournia;45;653488;25573;13;397308;32;256180;14522;595
59512;Roubaix;48426;703242832;22965484;15560;456217942;32866;247024890;14522;596
11424;Villefort;57;828060;2587;20;407233;37;420827;14527;597
15026;Brezons;118;1714361;35120;35;970753;83;743608;14528;598
15243;Trizac;337;4896883;57193;106;2734117;231;2162766;14531;599
23105;Lavaveix-les-Mines;450;6542420;191652;161;4235214;289;2307206;14539;600
63158;Fayet-Ronaye;71;1032322;20823;23;631068;48;401254;14540;601
15093;Lapeyrugue;63;916578;29445;20;561381;43;355197;14549;602
32449;Toujouse;140;2037146;42488;45;1117133;95;920013;14551;603
11400;Tréziers;53;771723;20119;19;540316;34;231407;14561;604
32350;Roquepine;27;393144;665;11;241887;16;151257;14561;605
07192;Rochepaule;195;2839529;57824;73;1747686;122;1091843;14562;606
70554;Villars-le-Pautel;114;1660043;12077;42;973874;72;686169;14562;607
23054;Charron;135;1966670;28082;40;1152144;95;814526;14568;608
15180;Saint-Clément;47;684961;17226;11;379564;36;305397;14574;609
2B317;Santa-Reparata-di-Moriani;37;539561;19832;15;398916;22;140645;14583;610
03192;Nades;76;1108323;16302;24;683847;52;424476;14583;611
56256;Tréhorenteuc;84;1225267;27710;31;769779;53;455488;14587;612
2B007;Albertacce;146;2129721;80628;58;1521180;88;608541;14587;613
86063;Chatain;160;2333988;49034;54;1450031;106;883957;14587;614
42072;La Côte-en-Couzan;48;700264;6529;21;485482;27;214782;14589;615
11019;Aunat;33;481455;5735;12;281487;21;199968;14590;616
59036;Avesnes-sur-Helpe;2790;40711734;1807459;919;27621199;1871;13090535;14592;617
81023;Barre;119;1736478;3645;36;875255;83;861223;14592;618
46255;Saint-Cirgues;221;3225269;21535;80;2006032;141;1219237;14594;619
54540;Val-et-Châtillon;366;5342754;45095;121;2955211;245;2387543;14598;620
31218;Gensac-de-Boulogne;65;949229;1956;19;502159;46;447070;14604;621
02069;Berlise;62;905490;10691;22;522600;40;382890;14605;622
46243;Rueyres;134;1957278;26582;46;1192369;88;764909;14607;623
15098;Laurie;59;861885;18142;20;526180;39;335705;14608;624
15091;Landeyrat;42;613654;9609;13;359245;29;254409;14611;625
19024;Beyssac;446;6517221;200189;173;4870104;273;1647117;14613;626
62386;Grenay;3663;53533840;960699;1212;30564845;2451;22968995;14615;627
2B143;Linguizzetta;550;8040229;218582;162;4687728;388;3352501;14619;628
19095;Lacelle;78;1140321;22151;33;807183;45;333138;14620;629
16001;Abzac;293;4283640;66237;88;2484291;205;1799349;14620;630
36156;Pérassay;237;3464963;75673;77;2177698;160;1287265;14620;631
79165;Maisontiers;103;1505930;17986;34;995738;69;510192;14621;632
65404;Sariac-Magnoac;92;1345107;25723;34;855575;58;489532;14621;633
09065;Boussenac;140;2047576;94905;39;1341528;101;706048;14626;634
70381;Neurey-lès-la-Demie;230;3364375;94444;72;1933689;158;1430686;14628;635
24109;La Chapelle-Grésignac;72;1053237;17386;23;639307;49;413930;14628;636
48192;Trélans;62;907415;3544;19;475580;43;431835;14636;637
65018;Arbéost;57;834522;27088;20;545807;37;288715;14641;638
11372;Salsigne;225;3294250;52880;75;1897643;150;1396607;14641;639
62447;Hesdin;1543;22596564;849244;497;14393817;1046;8202747;14645;640
15069;Ferrières-Saint-Mary;160;2343734;50420;53;1432367;107;911367;14648;641
55448;Rupt-devant-Saint-Mihiel;34;498136;-185;11;258216;23;239920;14651;642
26154;Lachau;113;1655674;39743;37;1023705;76;631969;14652;643
66158;Rasiguères;88;1289392;29386;30;826822;58;462570;14652;644
86206;Raslay;71;1040773;-241;26;560080;45;480693;14659;645
2B145;Loreto-di-Casinca;131;1920343;53499;46;1272124;85;648219;14659;646
58206;Parigny-la-Rose;24;351827;6159;13;291217;11;60610;14659;647
19074;L'Église-aux-Bois;34;498435;9637;13;355023;21;143412;14660;648
11309;Rennes-le-Château;49;718364;-2110;13;332754;36;385610;14660;649
34168;Montesquieu;46;674526;14883;18;465247;28;209279;14664;650
02181;Chéry-lès-Rozoy;52;762576;16860;17;436261;35;326315;14665;651
63376;Saint-Martin-d'Ollières;95;1393304;9560;34;739241;61;654063;14666;652
36238;Vigoulant;65;953436;15066;21;553276;44;400160;14668;653
15211;Saint-Santin-Cantalès;184;2700127;-2439;51;1255761;133;1444366;14675;654
34334;Vieussan;161;2363138;98715;46;1559819;115;803319;14678;655
15161;Rézentières;64;939475;-629;20;489583;44;449892;14679;656
08440;Tarzy;73;1071863;8538;26;710758;47;361105;14683;657
17374;Sainte-Même;141;2070379;29086;45;1166338;96;904041;14684;658
18278;Vesdun;384;5638730;97973;129;3559114;255;2079616;14684;659
16118;Deviat;95;1395233;20598;25;785580;70;609653;14687;660
49122;Dénezé-sous-le-Lude;156;2291195;22981;55;1303552;101;987643;14687;661
30307;Les Salles-du-Gardon;1532;22501185;450315;491;12628608;1041;9872577;14687;662
63053;Briffons;175;2571010;38150;59;1530998;116;1040012;14691;663
87145;Saint-Georges-les-Landes;151;2218755;43684;51;1326336;100;892419;14694;664
17392;Saint-Romain-sur-Gironde;31;455643;6866;11;276878;20;178765;14698;665
2B002;Aghione;151;2219515;42712;45;1253256;106;966259;14699;666
19205;Saint-Geniez-ô-Merle;62;911335;18753;25;586656;37;324679;14699;667
34228;Rieussec;51;749774;12908;21;506329;30;243445;14701;668
65066;Barrancoueu;26;382297;10320;11;268606;15;113691;14704;669
12235;Saint-Just-sur-Viaur;133;1955656;17694;43;1094686;90;860970;14704;670
97111;Deshaies;2475;36398911;1123253;670;22777944;1805;13620967;14707;671
57281;Haboudange;149;2191570;18000;47;1238236;102;953334;14709;672
24039;Besse;100;1470934;21584;32;858559;68;612375;14709;673
22373;Tréogan;64;941589;16844;24;592330;40;349259;14712;674
24465;Saint-Michel-de-Double;156;2295327;63776;55;1483700;101;811627;14714;675
66169;Saint-Arnac;69;1015246;10327;21;546685;48;468561;14714;676
52229;Grenant;103;1515534;34961;45;1039809;58;475725;14714;677
22138;Maël-Pestivien;233;3429092;71576;65;1937419;168;1491673;14717;678
23087;Fresselines;375;5520100;96433;123;3224984;252;2295116;14720;679
39148;Chisséria;46;677182;10064;18;393685;28;283497;14721;680
59014;Anzin;7665;112842510;3030251;2691;72246667;4974;40595843;14722;681
19088;Grandsaigne;28;412367;2815;11;254707;17;157660;14727;682
23223;Saint-Moreil;153;2253349;57698;54;1444233;99;809116;14728;683
32052;Bezolles;87;1281385;35329;25;736448;62;544937;14729;684
2B210;Pero-Casevecchie;75;1104684;40720;33;831092;42;273592;14729;685
66006;Ansignan;104;1532235;33087;31;904923;73;627312;14733;686
2B306;Santa-Lucia-di-Mercurio;60;884251;27861;23;633574;37;250677;14738;687
11411;Villanière;89;1312087;28192;34;759466;55;552621;14743;688
2A358;Zévaco;33;486683;18710;16;363407;17;123276;14748;689
07160;Monestier;36;530966;11708;16;355190;20;175776;14749;690
26238;Les Pilles;155;2286341;20988;50;1235302;105;1051039;14751;691
04236;Vergons;49;722780;15087;20;469391;29;253389;14751;692
39575;Le Villey;50;737685;11815;20;475101;30;262584;14754;693
12190;Prévinquières;179;2641192;-319;57;1503771;122;1137421;14755;694
23205;Saint-Junien-la-Bregère;96;1416948;25121;27;694569;69;722379;14760;695
22037;La Chapelle-Neuve;237;3498666;31938;80;2124965;157;1373701;14762;696
30220;Roquedur;130;1919357;121210;38;1414438;92;504919;14764;697
34286;Saint-Privat;237;3500074;99159;76;2195870;161;1304204;14768;698
64351;Lourdios-Ichère;67;990040;21197;24;634985;43;355055;14777;699
64047;Arnéguy;116;1714344;20676;37;1016079;79;698265;14779;700
11137;Félines-Termenès;75;1108599;20007;25;664253;50;444346;14781;701
42298;Sauvain;234;3459726;54511;74;1873139;160;1586587;14785;702
11336;Sainte-Colombe-sur-l'Hers;264;3903467;97196;96;2485495;168;1417972;14786;703
65130;Castelnau-Rivière-Basse;425;6285689;225752;144;4384496;281;1901193;14790;704
34250;Saint-Étienne-d'Albagnan;185;2736796;68708;66;1797106;119;939690;14793;705
23136;Mortroux;180;2662874;43497;64;1635380;116;1027494;14794;706
33428;Saint-Laurent-du-Plan;55;813982;2871;17;460194;38;353788;14800;707
43180;Saint-Étienne-du-Vigan;59;873282;-741;16;395077;43;478205;14801;708
16161;Guizengeard;99;1465769;44778;30;911019;69;554750;14806;709
66156;Rabouillet;63;932923;19916;25;684149;38;248774;14808;710
23010;Augères;89;1317971;40762;25;750553;64;567418;14809;711
15009;Apchon;150;2221598;44295;56;1357786;94;863812;14811;712
24399;Saint-Étienne-de-Puycorbier;68;1007128;9787;18;457025;50;550103;14811;713
43196;Saint-Jean-d'Aubrigoux;120;1777490;40235;38;993422;82;784068;14812;714
42247;Saint-Just-en-Bas;184;2726075;40080;67;1565889;117;1160186;14816;715
12078;Les Costes-Gozon;107;1585285;17439;37;837513;70;747772;14816;716
26200;Montfroc;45;666775;20153;15;427208;30;239567;14817;717
81072;Crespin;77;1141224;10313;22;582138;55;559086;14821;718
2B245;Porri;40;592870;21526;18;430482;22;162388;14822;719
95268;Garges-lès-Gonesse;20873;309461945;7036229;7380;192466533;13493;116995412;14826;720
32144;Gazax-et-Baccarisse;44;652709;2310;16;363223;28;289486;14834;721
89446;Vézelay;299;4435825;206267;93;3147740;206;1288085;14836;722
09330;Vernaux;26;385736;10763;12;260315;14;125421;14836;723
07290;Saint-Prix;152;2255781;37183;46;1220765;106;1035016;14841;724
58285;Tamnay-en-Bazois;119;1766076;32570;42;1099839;77;666237;14841;725
15129;Montboudif;107;1588411;23714;37;903234;70;685177;14845;726
42321;La Valla-sur-Rochefort;86;1276838;66216;27;841619;59;435219;14847;727
71046;La Boulaye;65;965082;46042;23;689610;42;275472;14847;728
32415;Sarraguzan;58;861192;16004;15;482923;43;378269;14848;729
65382;Sacoué;46;683063;16850;21;501386;25;181677;14849;730
32363;Sainte-Aurence-Cazaux;64;950369;16833;22;561845;42;388524;14850;731
55438;Romagne-sous-Montfaucon;89;1321666;19974;30;778720;59;542946;14850;732
64011;Aincille;45;668315;8057;12;396941;33;271374;14851;733
97129;Sainte-Rose;11009;163512430;4484114;2977;104803665;8032;58708765;14853;734
48187;Les Salces;57;846803;2589;22;532347;35;314456;14856;735
12082;La Couvertoirade;103;1530383;23105;33;916447;70;613936;14858;736
97217;Le Marin;5213;77460389;2404693;1493;49135843;3720;28324546;14859;737
11251;Montlaur;305;4532067;83432;99;2735308;206;1796759;14859;738
06096;Pierlas;29;430919;5359;11;291916;18;139003;14859;739
10201;La Loge-Pomblin;33;490377;8569;11;280189;22;210188;14860;740
24490;Saint-Privat-des-Prés;329;4889307;151579;117;3386025;212;1503282;14861;741
15047;Chavagnac;58;861969;4893;20;465714;38;396255;14862;742
05152;Saint-Maurice-en-Valgodemard;75;1114846;30006;32;758772;43;356074;14865;743
30280;Saint-Laurent-le-Minier;213;3166385;64641;71;2073573;142;1092812;14866;744
46269;Saint-Hilaire;49;728471;21273;14;407106;35;321365;14867;745
31191;Fougaron;59;877336;26305;28;656687;31;220649;14870;746
12037;Broquiès;327;4862933;54061;99;2815377;228;2047556;14871;747
50508;Sainte-Marie-du-Bois;35;520755;6444;11;306366;24;214389;14879;748
43210;Saint-Martin-de-Fugères;130;1934250;4706;45;1116280;85;817970;14879;749
71098;Charbonnat;146;2172941;19951;52;1234312;94;938629;14883;750
19017;Bassignac-le-Bas;55;818610;12728;18;526543;37;292067;14884;751
86084;Coulonges;153;2277354;52909;51;1320035;102;957319;14885;752
48148;Saint-Étienne-Vallée-Française;277;4123269;97263;93;2647347;184;1475922;14885;753
07095;Gilhoc-sur-Ormèze;250;3722940;38978;87;2214300;163;1508640;14892;754
72037;Blèves;62;923326;5937;26;610658;36;312668;14892;755
52288;Lezéville;69;1027611;6082;28;643019;41;384592;14893;756
12023;La Bastide-Solages;73;1087264;8366;28;706658;45;380606;14894;757
19253;Segonzac;139;2070292;29241;44;1142625;95;927667;14894;758
81094;Fraissines;51;759658;9128;16;423025;35;336633;14895;759
23190;Saint-Domet;112;1668310;44404;39;1055415;73;612895;14896;760
09219;Orgibet;114;1698457;52668;38;1064110;76;634347;14899;761
46329;Vaylats;161;2399161;24780;60;1507935;101;891226;14902;762
48048;Cheylard-l'Évêque;39;581184;13693;14;376707;25;204477;14902;763
16073;Chalais;1203;17929884;432284;411;11420160;792;6509724;14904;764
07103;Intres;91;1356426;13894;37;821637;54;534789;14906;765
11341;Saint-Ferriol;88;1311970;31079;30;819988;58;491982;14909;766
26291;Saint-Andéol;34;506945;4311;14;300426;20;206519;14910;767
93001;Aubervilliers;41275;615570628;20196673;15187;409078111;26088;206492517;14914;768
46125;Gorses;201;2997764;39483;65;1802906;136;1194858;14914;769
65316;Monlong;65;969594;2514;20;522056;45;447538;14917;770
11226;Mayreville;42;626630;10347;15;414694;27;211936;14920;771
17167;Le Fouilloux;432;6446156;116307;148;3961169;284;2484987;14922;772
34100;Ferrières-Poussarou;49;731297;13808;16;433245;33;298052;14924;773
55064;Bouquemont;67;1000078;8647;29;714155;38;285923;14927;774
02095;Bohain-en-Vermandois;3302;49290906;1460836;1089;30678557;2213;18612349;14928;775
19208;Saint-Hilaire-Foissac;134;2000453;25760;48;1197763;86;802690;14929;776
66187;Saint-Paul-de-Fenouillet;1145;17093984;378335;356;9895120;789;7198864;14929;777
16203;Mainzac;65;970475;12775;24;629943;41;340532;14930;778
15217;Saint-Victor;56;836287;5628;14;428919;42;407368;14934;779
34291;Saint-Vincent-d'Olargues;212;3168133;73852;79;2071671;133;1096462;14944;780
65253;Lamarque-Rustaing;35;523099;11496;16;361539;19;161560;14946;781
88176;Fontenoy-le-Château;356;5320676;127309;119;3210553;237;2110123;14946;782
16188;Le Lindois;190;2840235;22481;75;1768721;115;1071514;14949;783
12125;Laval-Roquecezière;187;2795861;56593;63;1754216;124;1041645;14951;784
15203;Saint-Mary-le-Plain;100;1495164;33226;29;824178;71;670986;14952;785
33081;Cadillac;1670;24976167;849704;622;17484223;1048;7491944;14956;786
15114;Marcenat;371;5549986;146494;130;3588382;241;1961604;14960;787
12141;Martrin;124;1855019;17153;34;954330;90;900689;14960;788
40039;Betbezer-d'Armagnac;78;1166948;5199;24;637664;54;529284;14961;789
15080;Joursac;90;1346861;13718;30;775325;60;571536;14965;790
97223;Saint-Esprit;5306;79440778;1911183;1564;50532216;3742;28908562;14972;791
2B328;Tox;75;1123015;27110;26;728634;49;394381;14974;792
97226;Sainte-Anne;2904;43486624;1252596;835;26890238;2069;16596386;14975;793
66198;Sournia;293;4387729;75268;97;2735177;196;1652552;14975;794
81265;Saint-Michel-de-Vax;33;494224;8458;12;301558;21;192666;14976;795
46234;Rampoux;62;928658;8048;21;509639;41;419019;14978;796
52318;Melay;177;2651280;75718;57;1536961;120;1114319;14979;797
23026;Bord-Saint-Georges;224;3356048;55649;92;2274897;132;1081151;14982;798
50428;Reffuveille;282;4226174;35811;86;2296704;196;1929470;14986;799
07128;Lalouvesc;283;4241468;114777;101;2743336;182;1498132;14988;800
23009;Auge;59;884265;9302;16;453990;43;430275;14988;801
86011;Asnières-sur-Blour;99;1483904;25748;32;845331;67;638573;14989;802
04224;Ubraye;45;674580;13752;18;444146;27;230434;14991;803
03181;Montcombroux-les-Mines;212;3178094;43174;80;1902300;132;1275794;14991;804
48154;Saint-Georges-de-Lévéjac;151;2263788;27575;56;1469753;95;794035;14992;805
82143;Poupas;43;644800;8437;13;360558;30;284242;14995;806
15253;Vernols;45;674811;1177;15;369120;30;305691;14996;807
11290;Plaigne;70;1049714;14839;28;634877;42;414837;14996;808
24260;Mauzac-et-Grand-Castang;468;7018453;297287;166;5107329;302;1911124;14997;809
34111;Ganges;2565;38468741;1233088;909;24492169;1656;13976572;14998;810
64199;Diusse;95;1424953;26692;32;928330;63;496623;15000;811
34075;Cesseras;237;3554976;74653;75;2399129;162;1155847;15000;812
32287;Monties;52;780211;12471;18;513139;34;267072;15004;813
81303;Trébas;247;3706218;125478;73;2322330;174;1383888;15005;814
03196;Neuilly-en-Donjon;137;2056422;20762;46;1205383;91;851039;15010;815
62048;Auchel;5973;89659672;2566164;1962;55326043;4011;34333629;15011;816
22294;Saint-Gilles-Pligeaux;178;2672480;60350;62;1535868;116;1136612;15014;817
08372;Rubigny;43;645677;12257;13;353091;30;292586;15016;818
47177;Monheurt;132;1982452;25411;44;1104004;88;878448;15019;819
43057;La Chapelle-Bertin;38;570710;4497;13;337680;25;233030;15019;820
23148;Nouziers;146;2192808;64026;45;1294937;101;897871;15019;821
97232;Le Vauclin;6055;90964425;3051636;1579;59463920;4476;31500505;15023;822
63028;Bagnols;281;4222430;115888;88;2537666;193;1684764;15026;823
26306;Sainte-Jalle;187;2809945;107778;56;1738227;131;1071718;15026;824
2B304;San-Lorenzo;71;1066888;32922;27;743510;44;323378;15027;825
18017;Augy-sur-Aubois;191;2870194;44484;66;1733439;125;1136755;15027;826
91286;Grigny;13526;203285294;5115758;4825;127196143;8701;76089151;15029;827
15191;Saint-Illide;384;5771863;107982;134;3826446;250;1945417;15031;828
43219;Saint-Préjet-Armandon;58;871851;12410;23;573707;35;298144;15032;829
64316;Larrau;92;1382984;43028;31;852728;61;530256;15032;830
04020;Barles;68;1022251;14092;17;514291;51;507960;15033;831
16034;Bazac;96;1443554;44729;31;956853;65;486701;15037;832
36160;Pommiers;179;2691739;68440;65;1609347;114;1082392;15038;833
23113;Lupersat;221;3323931;74520;82;2228110;139;1095821;15040;834
63293;Le Quartier;130;1955849;28878;51;1120554;79;835295;15045;835
23109;Linard;95;1429494;23087;35;869629;60;559865;15047;836
64196;Crouseilles;81;1219085;13275;32;793064;49;426021;15050;837
07149;Marcols-les-Eaux;179;2694741;54506;54;1515426;125;1179315;15054;838
19086;Goulles;194;2920711;38466;68;1693847;126;1226864;15055;839
15260;Vieillevie;61;918391;8464;20;493391;41;425000;15056;840
66125;Olette;227;3418306;96321;83;2244682;144;1173624;15059;841
87109;Oradour-Saint-Genest;226;3403773;115533;79;2089998;147;1313775;15061;842
04051;Châteauneuf-Miravail;40;602535;15312;12;372122;28;230413;15063;843
11303;Puivert;293;4414080;70007;100;2798055;193;1616025;15065;844
64206;Escot;61;919017;13306;21;518679;40;400338;15066;845
2A284;Sollacaro;252;3796687;126971;98;2512085;154;1284602;15066;846
2A131;Guagno;76;1145117;43618;33;840409;43;304708;15067;847
15072;Freix-Anglards;130;1958797;35100;49;1231933;81;726864;15068;848
47192;Monviel;45;678111;8515;12;390988;33;287123;15069;849
22009;Le Bodéo;104;1567240;17853;37;883513;67;683727;15070;850
42217;Saint-Didier-sur-Rochefort;241;3631894;49892;85;2152241;156;1479653;15070;851
11006;Albas;60;904209;14765;21;543938;39;360271;15070;852
08323;La Neuville-lès-Wasigny;105;1582374;32077;35;971938;70;610436;15070;853
07252;Saint-Julien-Boutières;121;1823612;25555;42;993267;79;830345;15071;854
80353;Fresnes-Mazancourt;68;1024886;14430;23;573698;45;451188;15072;855
48184;Saint-Symphorien;156;2351252;28450;55;1444906;101;906346;15072;856
11047;Le Bousquet;30;452206;12339;13;327479;17;124727;15074;857
12268;Sénergues;284;4282030;70613;101;2635303;183;1646727;15078;858
12187;Prades-d'Aubrac;212;3196610;61429;62;1778578;150;1418032;15078;859
15100;Laveissenet;65;980180;10777;27;617116;38;363064;15080;860
66080;Fontpédrouse;99;1493206;34998;39;916305;60;576901;15083;861
23182;Saint-Avit-de-Tardes;107;1613930;15547;39;1017747;68;596183;15083;862
15033;Cézens;141;2126786;9934;50;1235557;91;891229;15084;863
36240;Vijon;203;3062410;59226;81;2006436;122;1055974;15086;864
15228;Siran;333;5024183;96100;110;2970042;223;2054141;15088;865
62246;Coupelle-Neuve;92;1388378;23285;34;911766;58;476612;15091;866
16009;Ambernac;219;3305150;35945;73;1809964;146;1495186;15092;867
23041;La Cellette;172;2596198;55411;58;1585069;114;1011129;15094;868
31528;Saman;81;1222721;26371;26;800303;55;422418;15095;869
21006;Aisey-sur-Seine;122;1841677;66074;37;1064086;85;777591;15096;870
46073;Concots;257;3879764;83076;89;2428549;168;1451215;15096;871
81154;Marnaves;36;543688;8989;15;368323;21;175365;15102;872
15110;Lugarde;101;1525492;16276;38;921817;63;603675;15104;873
49234;Parçay-les-Pins;536;8096422;147784;182;4792053;354;3304369;15105;874
16182;Lesterps;278;4199841;100143;85;2421678;193;1778163;15107;875
09247;Rivèrenert;114;1722339;47013;42;1183043;72;539296;15108;876
46315;Teyssieu;111;1678024;33922;38;960650;73;717374;15117;877
03017;Barrais-Bussolles;124;1874666;25116;49;1143317;75;731349;15118;878
07249;Saint-Jeure-d'Andaure;59;891999;25110;21;548887;38;343112;15119;879
43247;Torsiac;44;665227;7991;15;400192;29;265035;15119;880
82189;Vazerac;410;6198781;92889;132;3632544;278;2566237;15119;881
34271;Saint-Julien;139;2101630;55901;57;1526285;82;575345;15120;882
26181;Mévouillon;134;2026078;7263;44;1217440;90;808638;15120;883
09189;Mérens-les-Vals;85;1285233;24690;31;812490;54;472743;15120;884
79312;Séligné;68;1028375;13812;29;696779;39;331596;15123;885
26022;Ballons;50;756217;16247;20;530174;30;226043;15124;886
66183;Saint-Marsal;61;922649;19882;22;619130;39;303519;15125;887
63173;Grandrif;103;1558032;22267;40;1013191;63;544841;15127;888
59205;Escaudain;4773;72208517;1945692;1568;43882695;3205;28325822;15129;889
81309;Vaour;186;2813913;58108;57;1792895;129;1021018;15129;890
43005;Alleyras;120;1815555;32964;44;1066755;76;748800;15130;891
19034;Camps-Saint-Mathurin-Léobazel;140;2118342;8376;41;1120632;99;997710;15131;892
09244;Rieucros;370;5598692;62177;130;3400296;240;2198396;15132;893
43198;Saint-Jean-Lachalm;173;2618041;13451;54;1537028;119;1081013;15133;894
70454;Rosières-sur-Mance;46;696196;10657;14;322969;32;373227;15135;895
30253;Saint-Florent-sur-Auzonnet;713;10791683;209714;269;6915429;444;3876254;15136;896
15049;Cheylade;155;2346187;25602;54;1367020;101;979167;15137;897
11071;Cascastel-des-Corbières;107;1619830;14898;33;903637;74;716193;15139;898
97402;Bras-Panon;6442;97527772;1457024;1647;56250241;4795;41277531;15139;899
50144;Coulouvray-Boisbenâtre;283;4285996;58620;92;2347323;191;1938673;15145;900
06110;Roubion;72;1090464;20644;25;622154;47;468310;15145;901
23159;Puy-Malsignat;91;1378238;21011;30;821119;61;557119;15145;902
43034;Boisset;174;2635531;18171;68;1609032;106;1026499;15147;903
08366;Rocquigny;412;6241141;84108;146;3876030;266;2365111;15148;904
87080;Jouac;127;1923900;35545;43;1094940;84;828960;15149;905
11101;Coudons;27;409064;11212;13;273478;14;135586;15151;906
17177;Le Gicq;84;1272683;16914;26;695482;58;577201;15151;907
02381;Hirson;5532;83822855;2774962;1918;55612198;3614;28210657;15152;908
62628;Noyelles-sous-Lens;3999;60596895;1103995;1439;35990026;2560;24606869;15153;909
11127;Escouloubre;49;742663;20917;12;391059;37;351604;15156;910
36061;Crozon-sur-Vauvre;222;3365803;43580;72;1943121;150;1422682;15161;911
48152;Saint-Frézal-de-Ventalon;86;1303975;30413;19;725722;67;578253;15163;912
11045;Bouriège;78;1182736;29075;30;835785;48;346951;15163;913
09113;Ercé;286;4337022;191354;96;2826879;190;1510143;15164;914
15024;Brageac;38;576255;295;13;307949;25;268306;15165;915
43178;Saint-Didier-sur-Doulon;126;1910824;37392;39;1113861;87;796963;15165;916
48019;Barre-des-Cévennes;149;2259694;43087;59;1522984;90;736710;15166;917
43027;Berbezit;37;561159;12651;11;306093;26;255066;15166;918
03139;Laprugne;212;3215552;30961;75;1812223;137;1403329;15168;919
03024;Bert;154;2336295;34836;57;1434815;97;901480;15171;920
62565;Mencas;45;682722;9390;18;437498;27;245224;15172;921
02021;Archon;52;788938;7728;16;515205;36;273733;15172;922
2B095;Corscia;113;1714533;60371;45;1182946;68;531587;15173;923
81053;Cambounès;205;3110549;36838;67;1721182;138;1389367;15173;924
48082;Laubert;65;986311;18184;25;698005;40;288306;15174;925
11314;Rieux-en-Val;51;773875;13593;15;427118;36;346757;15174;926
15104;Leynhac;215;3262776;46070;63;1791523;152;1471253;15176;927
32211;Lias-d'Armagnac;132;2003495;34834;54;1381151;78;622344;15178;928
59654;Waziers;3809;57825287;1169294;1325;34792316;2484;23032971;15181;929
07114;Labatie-d'Andaure;123;1867321;28735;45;1113403;78;753918;15181;930
12149;Montclar;80;1214555;20686;28;729277;52;485278;15182;931
06053;Daluis;83;1260173;22986;32;781907;51;478266;15183;932
19132;Ménoire;53;804913;15394;20;499799;33;305114;15187;933
2B039;Bisinchi;114;1731737;21779;46;1179468;68;552269;15191;934
88064;Bois-de-Champ;61;926649;2694;23;572632;38;354017;15191;935
2A142;Levie;457;6942316;182961;183;4823169;274;2119147;15191;936
59153;Condé-sur-l'Escaut;5545;84258647;3312293;1856;54005285;3689;30253362;15195;937
87160;Saint-Léger-Magnazeix;290;4407215;76169;103;2752641;187;1654574;15197;938
04030;Blieux;38;577506;9161;14;337415;24;240091;15198;939
23181;Saint-Amand-Jartoudeix;123;1869398;31930;46;1181010;77;688388;15198;940
58211;Poil;90;1367906;5612;30;789330;60;578576;15199;941
05076;Méreuil;49;744993;2367;12;328253;37;416740;15204;942
15213;Saint-Saturnin;129;1961467;21739;48;1274216;81;687251;15205;943
12233;Saint-Juéry;134;2037647;31916;43;1202328;91;835319;15206;944
16087;Chassiecq;103;1566432;47648;34;939114;69;627318;15208;945
17213;Lozay;92;1399408;20848;30;838317;62;561091;15211;946
06052;Cuébris;70;1064904;33934;28;690715;42;374189;15213;947
12022;La Bastide-Pradines;66;1004092;13012;30;656688;36;347404;15214;948
43253;Les Vastres;115;1749568;19280;28;874580;87;874988;15214;949
62266;Denier;32;486863;2613;14;299839;18;187024;15214;950
47299;Sérignac-Péboudou;82;1247631;26033;25;708100;57;539531;15215;951
64487;Saint-Just-Ibarre;128;1947862;28748;40;1008775;88;939087;15218;952
43001;Agnat;127;1932861;47471;51;1234636;76;698225;15219;953
60175;Creil;17766;270438907;8060687;6719;175691968;11047;94746939;15222;954
32378;Saint-Germé;306;4658463;180469;113;3391673;193;1266790;15224;955
16205;Manot;312;4749922;76195;111;2980166;201;1769756;15224;956
63437;Trémouille-Saint-Loup;81;1233208;11625;23;602980;58;630228;15225;957
24216;La Jemaye;67;1020379;11390;26;628176;41;392203;15230;958
65089;Betpouey;63;959463;16046;21;510681;42;448782;15230;959
16404;Vieux-Ruffec;73;1111767;30859;20;642825;53;468942;15230;960
34007;Aigues-Vives;266;4051743;76384;93;2554894;173;1496849;15232;961
43204;Saint-Julien-Molhesabate;111;1690973;14848;40;1022635;71;668338;15234;962
52051;Bize;37;563671;24937;11;396147;26;167524;15234;963
09224;Pailhès;258;3931045;105438;93;2540365;165;1390680;15237;964
21327;Jours-en-Vaux;62;944689;27932;24;673609;38;271080;15237;965
23156;Pontcharraud;56;853405;50517;16;548515;40;304890;15239;966
38428;Saint-Michel-en-Beaumont;28;426744;11308;15;311450;13;115294;15241;967
34284;Saint-Pons-de-Thomières;1211;18457428;605721;422;12145307;789;6312121;15241;968
11125;Embres-et-Castelmaure;115;1753182;82338;36;1160677;79;592505;15245;969
16256;Passirac;134;2043271;17132;48;1152277;86;890994;15248;970
55253;Les Islettes;544;8298085;254562;201;5730186;343;2567899;15254;971
46099;Fargues;95;1449315;26675;30;834408;65;614907;15256;972
46071;Comiac;142;2166371;49984;48;1302786;94;863585;15256;973
55571;Vilosnes-Haraumont;131;1998794;35668;43;1144234;88;854560;15258;974
2B025;Avapessa;56;854491;25440;22;585191;34;269300;15259;975
24290;Montferrand-du-Périgord;90;1373534;37356;28;824455;62;549079;15261;976
16157;Le Grand-Madieu;94;1434903;20998;33;848103;61;586800;15265;977
65058;Azet;94;1435007;20011;39;940383;55;494624;15266;978
70127;Chantes;82;1251891;26783;33;831124;49;420767;15267;979
48134;Saint-Andéol-de-Clerguemort;52;793899;19123;17;567521;35;226378;15267;980
18232;Saint-Priest-la-Marche;145;2214003;50038;50;1385799;95;828204;15269;981
15035;Chalinargues;241;3680436;65466;88;2265846;153;1414590;15272;982
65166;Espèche;30;458186;10881;13;336466;17;121720;15273;983
25104;By;46;702575;3391;14;397238;32;305337;15273;984
21447;Musigny;41;626217;12376;16;391493;25;234724;15274;985
2B352;Ville-di-Paraso;124;1894033;35371;48;1216540;76;677493;15274;986
55192;Fontaines-Saint-Clair;31;473577;11032;13;309128;18;164449;15277;987
19216;Saint-Julien-le-Vendômois;170;2597073;38012;70;1715024;100;882049;15277;988
23262;Vigeville;88;1344853;27682;35;853922;53;490931;15282;989
55563;Villers-lès-Mangiennes;42;642001;-2171;13;279676;29;362325;15286;990
16128;Épenède;122;1865310;31022;37;981910;85;883400;15289;991
07098;Gourdon;56;856224;19374;24;619397;32;236827;15290;992
15011;Arnac;109;1666664;44561;37;1041360;72;625304;15290;993
22024;Calanhel;130;1987809;24297;39;1021719;91;966090;15291;994
05146;Saint-Julien-en-Beauchêne;68;1039926;23641;24;651110;44;388816;15293;995
2A310;Santa-Maria-Figaniella;43;657651;14963;17;470712;26;186939;15294;996
48071;Grandvals;39;596539;1374;16;367723;23;228816;15296;997
2A027;Azzana;32;489629;16524;13;343032;19;146597;15301;998
15103;Leucamp;142;2173335;39642;53;1323959;89;849376;15305;999
82022;Bourg-de-Visa;244;3734960;100210;78;2260133;166;1474827;15307;1000
24118;Chenaud;201;3077427;56474;76;1938405;125;1139022;15311;1001
30009;Alzon;122;1867917;43675;41;1154448;81;713469;15311;1002
11302;Puilaurens;153;2343684;46554;55;1514361;98;829323;15318;1003
09100;Couflens;47;719962;17769;17;496130;30;223832;15318;1004
24363;Saint-Amand-de-Belvès;67;1026455;15882;24;607607;43;418848;15320;1005
54419;Parux;44;674125;13090;15;397861;29;276264;15321;1006
80737;Sorel;99;1517037;18487;34;869968;65;647069;15324;1007
36038;Champillet;94;1440425;42113;37;998040;57;442385;15324;1008
87087;Lussac-les-Églises;313;4796437;128337;104;2872904;209;1923533;15324;1009
63356;Saint-Gervazy;185;2835034;62406;75;2079544;110;755490;15325;1010
63137;Doranges;98;1501914;32903;39;1036706;59;465208;15326;1011
65419;Sentous;50;766289;17912;18;512486;32;253803;15326;1012
47168;Miramont-de-Guyenne;2048;31394494;808440;706;19390429;1342;12004065;15329;1013
16394;Vaux-Lavalette;66;1011839;6541;21;625140;45;386699;15331;1014
97302;Cayenne;30425;466548043;17576837;8793;325570534;21632;140977509;15334;1015
59291;Hautmont;8003;122779872;3944711;2728;78652234;5275;44127638;15342;1016
02031;Aubenton;386;5922259;107052;140;3685056;246;2237203;15343;1017
23255;Trois-Fonds;72;1105052;18044;27;699880;45;405172;15348;1018
23083;Fontanières;138;2118049;16045;56;1334568;82;783481;15348;1019
70308;La Longine;145;2225689;23367;41;1191242;104;1034447;15350;1020
34107;Fraisse-sur-Agout;181;2778303;63284;72;1868670;109;909633;15350;1021
81019;Assac;78;1197299;5297;23;659027;55;538272;15350;1022
16096;Cherves-Châtelars;242;3714748;61053;95;2349285;147;1365463;15350;1023
50525;Saint-Michel-de-Montjoie;202;3100858;43102;82;1981637;120;1119221;15351;1024
24208;Grun-Bordas;120;1842210;18418;49;1145831;71;696379;15352;1025
03317;Viplaix;207;3177945;61413;71;1945876;136;1232069;15352;1026
11050;Brenac;142;2180058;63308;54;1503362;88;676696;15353;1027
39347;Montagna-le-Templier;62;951874;23476;22;612773;40;339101;15353;1028
70512;La Vaivre;135;2072783;11537;55;1250789;80;821994;15354;1029
04032;Braux;70;1074823;9987;22;540973;48;533850;15355;1030
36133;Mouhers;154;2365066;30733;65;1545406;89;819660;15358;1031
15050;Le Claux;130;1996661;36709;52;1361758;78;634903;15359;1032
09327;Ventenac;136;2088973;49220;47;1363720;89;725253;15360;1033
11301;Puichéric;655;10062266;238380;228;6357319;427;3704947;15362;1034
64079;Aurions-Idernes;60;921914;-694;20;494051;40;427863;15365;1035
81183;Mont-Roc;119;1828694;26422;44;1124291;75;704403;15367;1036
88355;Portieux;779;11972876;299338;278;8085512;501;3887364;15370;1037
54092;Bouzanville;42;645689;13409;18;449924;24;195765;15374;1038
09061;Les Bordes-sur-Arize;292;4490181;141088;110;2990660;182;1499521;15377;1039
09127;Gabre;59;907440;11133;19;509185;40;398255;15380;1040
09098;Contrazy;48;738320;17011;16;453035;32;285285;15382;1041
65288;Lubret-Saint-Luc;47;722941;27196;16;464008;31;258933;15382;1042
34064;Le Caylar;283;4353586;78864;110;2869917;173;1483669;15384;1043
11016;Arquettes-en-Val;54;830863;12042;18;490242;36;340621;15386;1044
24123;Clermont-de-Beauregard;70;1077062;35578;22;709941;48;367121;15387;1045
47317;Verteuil-d'Agenais;341;5247356;145936;104;3179992;237;2067364;15388;1046
57248;Givrycourt;56;861749;5188;18;510794;38;350955;15388;1047
2B333;Vallecalle;81;1246545;39046;37;927502;44;319043;15389;1048
87101;Mortemart;74;1138880;27397;30;760841;44;378039;15390;1049
04104;Limans;189;2908844;131496;67;2080011;122;828833;15391;1050
22146;Mellionnec;257;3955734;70918;93;2530580;164;1425154;15392;1051
86068;Chaunay;761;11714069;237796;276;7333374;485;4380695;15393;1052
02265;Dohis;63;969920;14226;28;617433;35;352487;15396;1053
87121;Rancon;315;4850310;106202;105;3049494;210;1800816;15398;1054
24199;Gout-Rossignol;248;3819062;136560;85;2453942;163;1365120;15399;1055
07119;Le Lac-d'Issarlès;159;2448803;82321;55;1586000;104;862803;15401;1056
2A028;Balogna;79;1216823;23721;30;733444;49;483379;15403;1057
62562;Matringhem;111;1709770;49355;41;1083648;70;626122;15403;1058
63156;Esteil;48;739382;16955;20;473664;28;265718;15404;1059
87055;Darnac;253;3897194;92320;91;2387990;162;1509204;15404;1060
48195;Les Vignes;60;924292;7339;20;511054;40;413238;15405;1061
2B314;Santo-Pietro-di-Tenda;235;3620428;113261;86;2505897;149;1114531;15406;1062
62194;Calonne-Ricouart;3072;47334113;1129099;1057;28709811;2015;18624302;15408;1063
11415;Villar-Saint-Anselme;62;955365;14083;25;625991;37;329374;15409;1064
2A186;Olivese;186;2866232;48263;71;1937560;115;928672;15410;1065
81017;Arifat;86;1325366;39353;27;793177;59;532189;15411;1066
06005;Ascros;99;1525786;53239;40;1082107;59;443679;15412;1067
63129;Cros;111;1710967;20563;39;917036;72;793931;15414;1068
43173;Saint-Christophe-d'Allier;64;986506;5810;23;603511;41;382995;15414;1069
48165;Saint-Laurent-de-Muret;106;1633968;19674;45;1079433;61;554535;15415;1070
2A099;Cozzano;131;2019491;56132;41;1218148;90;801343;15416;1071
23046;Chambonchard;46;709246;6215;18;458778;28;250468;15418;1072
66107;Maury;492;7586552;231341;154;4480042;338;3106510;15420;1073
52066;Brachay;40;616858;8472;16;342322;24;274536;15421;1074
29084;Île-Molène;132;2035751;64904;48;1229280;84;806471;15422;1075
15128;La Monselie;69;1064223;19973;26;638679;43;425544;15424;1076
43052;Champagnac-le-Vieux;138;2128508;38748;42;1245209;96;883299;15424;1077
15059;Cussac;82;1264799;7075;28;731646;54;533153;15424;1078
05088;Montmorin;38;586206;9602;14;363086;24;223120;15426;1079
43072;La Chomette;86;1326752;9533;31;753940;55;572812;15427;1080
15155;Pradiers;53;817710;16930;23;587048;30;230662;15428;1081
19173;Rilhac-Xaintrie;208;3210013;107877;75;2211850;133;998163;15433;1082
61171;Fontaine-les-Bassets;65;1003158;14126;23;580638;42;422520;15433;1083
09313;Tourtouse;89;1373637;16253;26;688843;63;684794;15434;1084
25181;Cubrial;84;1296536;33830;36;1004939;48;291597;15435;1085
43214;Saint-Pal-de-Senouire;68;1049632;26898;25;645540;43;404092;15436;1086
43145;Ouides;36;555718;15827;12;344655;24;211063;15437;1087
34030;Berlou;110;1698099;28081;37;1072080;73;626019;15437;1088
07079;Désaignes;675;10420706;195329;260;6801577;415;3619129;15438;1089
65155;Devèze;40;617553;7910;15;419873;25;197680;15439;1090
11276;Paziols;270;4168899;101391;101;2821645;169;1347254;15440;1091
36223;Tilly;99;1528722;41602;34;958164;65;570558;15442;1092
23213;Saint-Marien;127;1961493;41298;53;1236637;74;724856;15445;1093
12014;Aurelle-Verlac;107;1652627;47941;37;1030612;70;622015;15445;1094
42109;L'Hôpital-sous-Rochefort;75;1158444;15901;26;641468;49;516976;15446;1095
14224;Deux-Jumeaux;38;586971;10776;14;381009;24;205962;15447;1096
64506;Sarrance;111;1714596;74293;37;1170353;74;544243;15447;1097
26026;Barret-de-Lioure;48;741652;31043;16;487991;32;253661;15451;1098
70443;La Grande-Résie;61;942659;14274;28;658673;33;283986;15453;1099
03066;Châtel-Montagne;249;3848006;77652;86;2359715;163;1488291;15454;1100
87137;Saint-Bazile;82;1267232;17660;28;743568;54;523664;15454;1101
87090;Mailhac-sur-Benaize;179;2766419;72048;58;1661915;121;1104504;15455;1102
23027;Bosmoreau-les-Mines;153;2364647;50011;59;1563498;94;801149;15455;1103
52370;Osne-le-Val;176;2720134;53422;77;1764110;99;956024;15455;1104
16318;Saint-Front;217;3353893;75349;67;1935159;150;1418734;15456;1105
16396;Ventouse;73;1128322;11576;27;649774;46;478548;15456;1106
39466;Rosay;87;1344826;21443;34;793093;53;551733;15458;1107
15076;Glénat;127;1963213;31333;41;1232470;86;730743;15458;1108
04101;Lardiers;66;1020258;17424;22;575410;44;444848;15458;1109
62710;Rimboval;81;1252149;27375;28;791248;53;460901;15459;1110
11064;Camplong-d'Aude;183;2829478;42097;78;1898864;105;930614;15462;1111
30345;La Vernarède;236;3649316;112088;87;2312980;149;1336336;15463;1112
79105;Coutières;97;1499949;13233;31;822521;66;677428;15463;1113
04023;Bayons;114;1762839;44109;38;1095648;76;667191;15464;1114
14654;Saint-Pierre-sur-Dives;2210;34174822;862137;828;21388193;1382;12786629;15464;1115
11042;Blomac;113;1747734;25204;44;1140814;69;606920;15467;1116
16264;Pleuville;195;3016485;27771;64;1606555;131;1409930;15469;1117
21345;Léry;126;1949397;26157;52;1269782;74;679615;15471;1118
24238;Lempzours;87;1346096;20201;30;785247;57;560849;15472;1119
59207;Escautpont;2191;33902880;727767;746;20389853;1445;13513027;15474;1120
02683;Saint-Martin-Rivière;71;1098949;20295;26;686639;45;412310;15478;1121
52513;Velles;49;758454;5920;15;429586;34;328868;15479;1122
65095;Bonnefont;195;3018539;99720;67;2099310;128;919229;15480;1123
19225;Saint-Merd-de-Lapleau;106;1640884;16707;30;844523;76;796361;15480;1124
43107;Josat;56;866988;19305;21;580157;35;286831;15482;1125
32168;Labarrère;127;1966211;35869;39;1092436;88;873775;15482;1126
32456;Tudelle;37;572836;19993;16;420403;21;152433;15482;1127
05081;Montclus;33;510911;-1831;12;331366;21;179545;15482;1128
09149;Lacourt;143;2214070;54460;61;1502316;82;711754;15483;1129
87200;Verneuil-Moustiers;82;1269993;30241;34;871424;48;398569;15488;1130
52512;Vecqueville;343;5312328;76355;142;3393800;201;1918528;15488;1131
86167;Monts-sur-Guesnes;435;6737382;176852;144;4038230;291;2699152;15488;1132
36214;Sazeray;192;2974100;51043;73;1871271;119;1102829;15490;1133
21116;Bure-les-Templiers;84;1301211;18351;25;739865;59;561346;15491;1134
09126;Freychenet;54;836529;16814;21;524477;33;312052;15491;1135
44200;Soulvache;219;3392641;68402;79;2035237;140;1357404;15492;1136
15176;Saint-Chamant;145;2246842;42018;49;1384577;96;862265;15495;1137
21008;Alise-Sainte-Reine;431;6679104;391029;154;5130352;277;1548752;15497;1138
52286;Leurville;58;898824;28598;23;625145;35;273679;15497;1139
04093;Gigors;34;526959;5922;13;317121;21;209838;15499;1140
16068;Cellefrouin;318;4928912;90966;122;3008488;196;1920424;15500;1141
63348;Saint-Genès-la-Tourette;113;1751633;24061;48;1211899;65;539734;15501;1142
50474;Saint-Georges-de-Rouelley;318;4930222;62360;111;2873166;207;2057056;15504;1143
2B302;San-Giovanni-di-Moriani;59;914783;35814;20;599892;39;314891;15505;1144
66078;Fillols;102;1581690;43225;38;1027261;64;554429;15507;1145
12189;Pradinas;228;3535824;41757;72;2053646;156;1482178;15508;1146
87196;Thiat;105;1628504;37435;38;1020724;67;607780;15510;1147
70183;Courtesoult-et-Gatey;45;697957;10111;23;496704;22;201253;15510;1148
66137;Le Perthus;374;5800966;177848;115;3533961;259;2267005;15511;1149
43059;La Chapelle-Geneste;80;1241029;28911;24;634841;56;606188;15513;1150
15046;Chaussenac;141;2187570;41449;58;1446719;83;740851;15515;1151
64113;Bergouey-Viellenave;68;1055087;17163;25;620492;43;434595;15516;1152
58019;Avrée;58;899967;15847;23;563704;35;336263;15517;1153
15034;Chaliers;113;1753464;22633;37;1061105;76;692359;15517;1154
15136;Mourjou;196;3041460;104341;60;1800096;136;1241364;15518;1155
63159;Fernoël;84;1303733;26176;31;806429;53;497304;15521;1156
18234;Saint-Saturnin;289;4486495;106819;101;2694521;188;1791974;15524;1157
24343;Puymangou;44;683088;19511;17;456124;27;226964;15525;1158
32028;Barcugnan;76;1179893;36935;24;773524;52;406369;15525;1159
24070;Busserolles;298;4627526;84194;105;2897727;193;1729799;15529;1160
08424;Sommauthe;69;1071517;8822;26;641936;43;429581;15529;1161
86211;Romagne;528;8199670;239562;199;5503832;329;2695838;15530;1162
07256;Saint-Julien-Labrousse;217;3370180;48984;92;2225264;125;1144916;15531;1163
17199;Jussas;76;1180348;35930;24;685624;52;494724;15531;1164
47302;Sos;430;6678455;194337;134;3961190;296;2717265;15531;1165
08049;Bar-lès-Buzancy;76;1180521;23123;28;745619;48;434902;15533;1166
59484;Quiévrechain;3302;51290790;1429065;1139;31440418;2163;19850372;15533;1167
19219;Sainte-Marie-Lapanouze;37;574741;14336;16;414262;21;160479;15534;1168
65105;Bourg-de-Bigorre;126;1957231;40258;44;1183120;82;774111;15534;1169
27701;Val-de-Reuil;6186;96126323;2253386;2354;63415257;3832;32711066;15539;1170
48031;Brion;58;901323;45832;19;581848;39;319475;15540;1171
63024;Avèze;123;1911602;15939;45;1163872;78;747730;15541;1172
70569;Vilory;47;730497;7825;19;488462;28;242035;15542;1173
31350;Mondilhan;47;730509;13751;14;455240;33;275269;15543;1174
80055;Barly;107;1663220;49821;42;1137486;65;525734;15544;1175
82046;Coutures;61;948393;14033;21;548037;40;400356;15547;1176
97405;Petite-Île;6852;106536108;2452107;1814;66804189;5038;39731919;15548;1177
16103;Combiers;71;1104025;19304;25;647293;46;456732;15550;1178
09232;Prades;30;466516;12636;11;327039;19;139477;15551;1179
23215;Saint-Martial-le-Vieux;85;1321832;39627;33;856709;52;465123;15551;1180
04219;Thorame-Haute;155;2410550;63990;70;1716740;85;693810;15552;1181
15148;Paulhac;256;3982128;17733;94;2304293;162;1677835;15555;1182
11035;Belvianes-et-Cavirac;169;2628881;49278;62;1628215;107;1000666;15556;1183
34319;Vailhan;96;1493349;22654;30;788492;66;704857;15556;1184
14662;Saint-Vigor-des-Mézerets;141;2193386;30216;63;1525791;78;667595;15556;1185
23037;Bussière-Nouvelle;58;902352;11962;19;566595;39;335757;15558;1186
2B078;Castellare-di-Mercurio;27;420061;12153;11;305010;16;115051;15558;1187
23134;Le Monteil-au-Vicomte;132;2053702;44635;48;1230867;84;822835;15558;1188
93014;Clichy-sous-Bois;12864;200159459;5535586;4561;129865929;8303;70293530;15560;1189
03147;Loddes;97;1509514;40890;35;990571;62;518943;15562;1190
58026;Beaulieu;23;357946;6132;11;243732;12;114214;15563;1191
50462;Saint-Cyr-du-Bailleul;232;3610659;26485;86;2137562;146;1473097;15563;1192
97403;Entre-Deux;3541;55112476;1197677;943;33484443;2598;21628033;15564;1193
09206;Montferrier;374;5821303;74764;155;3795900;219;2025403;15565;1194
79018;Aubigné;130;2023452;32772;42;1115196;88;908256;15565;1195
2B199;Palasca;91;1416553;22659;31;797974;60;618579;15567;1196
24585;Villefranche-du-Périgord;441;6866420;153982;136;4342386;305;2524034;15570;1197
11129;Espéraza;1277;19886817;559124;449;12122542;828;7764275;15573;1198
26321;Saint-Nazaire-le-Désert;92;1432794;50036;33;992670;59;440124;15574;1199
16214;Mazières;52;810057;6621;21;503241;31;306816;15578;1200
86055;La Chapelle-Bâton;222;3458403;81218;82;2273897;140;1184506;15578;1201
38522;Valjouffrey;79;1230797;28425;30;783188;49;447609;15580;1202
02107;Bourguignon-sous-Coucy;57;888088;12814;25;616319;32;271769;15580;1203
81199;Padiès;109;1698368;23073;43;1082364;66;616004;15581;1204
23056;Châtelus-le-Marcheix;195;3038502;71129;65;1807255;130;1231247;15582;1205
11316;Rivel;133;2073097;65819;47;1309706;86;763391;15587;1206
81014;Anglès;323;5034876;71278;118;3187249;205;1847627;15588;1207
24247;Lusignac;107;1668049;41367;31;884949;76;783100;15589;1208
59292;Haveluy;1632;25444267;555300;569;15501219;1063;9943048;15591;1209
24428;Saint-Jory-de-Chalais;345;5379074;91683;140;3681505;205;1697569;15592;1210
16092;Chavenat;115;1793092;27211;42;1083594;73;709498;15592;1211
61031;Beauchêne;134;2089630;21433;48;1275204;86;814426;15594;1212
65135;Castillon;57;888999;19262;24;591172;33;297827;15596;1213
26013;Arpavon;51;795668;29317;15;482120;36;313548;15601;1214
2A064;Cardo-Torgia;28;436841;11921;11;267422;17;169419;15601;1215
31047;Bax;54;842518;9385;19;566461;35;276057;15602;1216
57501;Neufvillage;26;405667;5068;11;279675;15;125992;15603;1217
43197;Saint-Jean-de-Nay;213;3323403;25990;71;1802824;142;1520579;15603;1218
36146;Orsennes;457;7131021;169564;162;4324296;295;2806725;15604;1219
23167;Sannat;209;3262216;58286;77;1927765;132;1334451;15609;1220
03224;Saint-Clément;199;3106192;34053;70;1855796;129;1250396;15609;1221
05131;Saint-Auban-d'Oze;45;702445;210;16;390942;29;311503;15610;1222
30105;Dourbies;105;1639052;64044;36;1011570;69;627482;15610;1223
43215;Saint-Paul-de-Tartas;123;1920297;16512;39;1063838;84;856459;15612;1224
70467;Saint-Loup-sur-Semouse;1961;30619298;797260;711;19152697;1250;11466601;15614;1225
32185;Lalanne-Arqué;86;1342924;19205;31;854232;55;488692;15615;1226
62065;Avion;9653;150741926;3594436;3649;96686862;6004;54055064;15616;1227
07153;Mayres;160;2498637;60765;55;1415771;105;1082866;15616;1228
64081;Aussurucq;118;1842815;53275;44;1157561;74;685254;15617;1229
30246;Sainte-Croix-de-Caderle;65;1015299;21794;20;617647;45;397652;15620;1230
22316;Saint-Mayeux;282;4404900;94845;97;2725449;185;1679451;15620;1231
32278;Montaut;66;1030980;26370;21;686189;45;344791;15621;1232
81233;Roumégoux;136;2124448;5013;47;1262230;89;862218;15621;1233
43154;Pradelles;355;5545705;208276;130;3756352;225;1789353;15622;1234
52015;Arbigny-sous-Varennes;53;828070;19160;15;440961;38;387109;15624;1235
31078;Boudrac;83;1296928;26890;36;843280;47;453648;15626;1236
03259;Saint-Sauvier;229;3578953;72766;92;2361902;137;1217051;15629;1237
04091;Ganagobie;53;828545;18231;22;617892;31;210653;15633;1238
15106;Lieutadès;113;1766868;77393;36;1156963;77;609905;15636;1239
32392;Saint-Martin-Gimois;52;813151;30069;18;552061;34;261090;15638;1240
58050;Challement;45;703690;16756;15;415830;30;287860;15638;1241
86023;Berthegon;170;2658422;11097;61;1486578;109;1171844;15638;1242
34193;Pardailhan;111;1735941;83115;37;1287244;74;448697;15639;1243
2A232;Pila-Canale;170;2659167;110710;61;1782461;109;876706;15642;1244
23038;Bussière-Saint-Georges;141;2206331;33625;52;1442893;89;763438;15648;1245
04062;La Condamine-Châtelard;112;1752900;36197;50;1207545;62;545355;15651;1246
12006;Alrance;218;3412292;18227;77;2097954;141;1314338;15653;1247
89170;Foissy-lès-Vézelay;90;1408923;40348;36;957288;54;451635;15655;1248
10044;Bétignicourt;24;375724;10122;11;259630;13;116094;15655;1249
97132;Trois-Rivières;5516;86358956;2715705;1553;56206519;3963;30152437;15656;1250
09074;Camon;83;1299455;26717;33;851053;50;448402;15656;1251
10081;La Chapelle-Saint-Luc;6783;106200625;3238168;2716;72405718;4067;33794907;15657;1252
63094;Charensat;330;5167031;124878;124;3317348;206;1849683;15658;1253
04043;Val-de-Chalvagne;48;751631;17369;19;519965;29;231666;15659;1254
23058;Le Chauchet;52;814370;519;20;540079;32;274291;15661;1255
34234;Roquessels;69;1080644;60333;21;665086;48;415558;15662;1256
06086;Moulinet;131;2051878;88888;46;1329704;85;722174;15663;1257
07258;Saint-Julien-Vocance;169;2647100;124864;61;1813985;108;833115;15663;1258
43193;Saint-Hilaire;102;1597793;27289;36;1038234;66;559559;15665;1259
48083;Les Laubies;103;1613516;27347;36;1027586;67;585930;15665;1260
15246;Valette;148;2318605;42312;55;1393531;93;925074;15666;1261
87043;Cheissoux;117;1833135;40886;50;1320021;67;513114;15668;1262
26141;Gigors-et-Lozeron;110;1723465;26115;46;1147344;64;576121;15668;1263
87115;Pensol;112;1754907;44129;42;1078693;70;676214;15669;1264
34238;Saint-André-de-Buèges;30;470088;18762;11;313985;19;156103;15670;1265
23250;Saint-Yrieix-les-Bois;186;2914762;28941;86;1981904;100;932858;15671;1266
43228;Saint-Victor-sur-Arlanc;58;909004;12531;22;633970;36;275034;15672;1267
87069;Gajoubert;93;1457671;28752;30;905828;63;551843;15674;1268
22231;Plourac'h;204;3198144;70103;76;2019847;128;1178297;15677;1269
36126;Montchevrier;317;4969852;127993;106;2904428;211;2065424;15678;1270
65318;Montastruc;153;2398788;54187;62;1760237;91;638551;15678;1271
07251;Saint-Joseph-des-Bancs;93;1458152;18389;36;903073;57;555079;15679;1272
56103;Lantillac;184;2885191;44850;72;1723191;112;1162000;15680;1273
50400;Picauville;1212;19009214;510107;460;12749778;752;6259436;15684;1274
02331;Franqueville;73;1144999;19259;31;692595;42;452404;15685;1275
63312;Saint-Alyre-d'Arlanc;119;1866581;40481;49;1258862;70;607719;15686;1276
40189;Monget;45;705857;7443;20;483611;25;222246;15686;1277
11126;Escales;246;3858689;81627;83;2338043;163;1520646;15686;1278
35232;Princé;219;3435358;6552;90;2059815;129;1375543;15687;1279
46244;Sabadel-Latronquière;57;894139;18252;22;591180;35;302959;15687;1280
16372;Souffrignac;84;1317794;24504;27;711853;57;605941;15688;1281
97234;Bellefontaine;903;14166422;310442;302;9019875;601;5146547;15688;1282
07139;Laviolle;79;1239382;46241;30;803643;49;435739;15688;1283
07257;Saint-Julien-le-Roux;59;925841;11792;19;549754;40;376087;15692;1284
17325;Saint-Dizant-du-Gua;327;5131422;106753;121;3278136;206;1853286;15692;1285
19112;Lestards;60;941550;23322;22;616381;38;325169;15693;1286
59456;Pecquencourt;3254;51076199;1006412;1162;31939058;2092;19137141;15696;1287
23243;Saint-Silvain-sous-Toulx;98;1538261;28484;39;1052978;59;485283;15697;1288
59249;Fourmies;7056;110769923;4269299;2528;75216604;4528;35553319;15699;1289
39060;Bois-de-Gand;37;580907;2975;14;298158;23;282749;15700;1290
46338;Bessonies;48;753653;-11162;13;406733;35;346920;15701;1291
55148;Delouze-Rosières;77;1209068;28063;37;859934;40;349134;15702;1292
59136;Le Cateau-Cambrésis;3946;61983059;2148879;1375;40910281;2571;21072778;15708;1293
03172;Mesples;81;1272462;34777;33;874138;48;398324;15709;1294
36084;Gournay;182;2859459;55007;75;2026173;107;833286;15711;1295
03260;Saint-Sornin;139;2184022;45647;54;1408016;85;776006;15712;1296
12039;Brusque;190;2985397;63430;70;1771814;120;1213583;15713;1297
14264;La Ferrière-Harang;166;2608316;6192;62;1575417;104;1032899;15713;1298
23023;Blaudeix;59;927140;17372;22;563277;37;363863;15714;1299
02361;Guise;3052;47966816;1867565;1130;32461143;1922;15505673;15717;1300
04102;Le Lauzet-Ubaye;155;2436372;40457;68;1576441;87;859931;15719;1301
23144;La Nouaille;128;2011987;33460;45;1206198;83;805789;15719;1302
33326;Pleine-Selve;123;1933555;32145;39;1207488;84;726067;15720;1303
76635;Saint-Pierre-des-Jonquières;61;958969;27201;19;521296;42;437673;15721;1304
81245;Saint-Christophe;76;1194845;11310;26;754538;50;440307;15722;1305
50208;Gonfreville;90;1415183;11410;33;801481;57;613702;15724;1306
59170;Dechy;2850;44817036;1032594;1087;29018440;1763;15798596;15725;1307
15263;Virargues;78;1226631;3621;29;711014;49;515617;15726;1308
65176;Ferrières;59;927853;26941;23;586838;36;341015;15726;1309
33289;Monségur;954;15003430;547360;313;9754107;641;5249323;15727;1310
88382;Remicourt;34;534831;-86;11;289139;23;245692;15730;1311
16059;Brettes;105;1651763;27231;31;955666;74;696097;15731;1312
14718;Truttemer-le-Petit;67;1054047;18899;32;708555;35;345492;15732;1313
50529;Saint-Nicolas-des-Bois;53;833901;15586;23;518933;30;314968;15734;1314
62563;Mazingarbe;4222;66430489;1503468;1584;42718722;2638;23711767;15734;1315
61290;Montreuil-au-Houlme;78;1227387;20813;28;709000;50;518387;15736;1316
88021;Autrey;148;2329011;36519;56;1489609;92;839402;15737;1317
80418;Hardecourt-aux-Bois;56;881257;16888;20;552034;36;329223;15737;1318
50254;Husson;130;2045809;12818;54;1306759;76;739050;15737;1319
07085;Empurany;319;5020833;72360;109;3068507;210;1952326;15739;1320
63398;Saint-Sauveur-la-Sagne;73;1148980;22881;24;653155;49;495825;15739;1321
2B105;Erbajolo;74;1164828;48793;31;895376;43;269452;15741;1322
58167;Michaugues;37;582427;11270;15;393399;22;189028;15741;1323
63118;Condat-en-Combraille;270;4250491;94928;86;2652948;184;1597543;15743;1324
24209;Hautefaye;76;1196469;9935;30;787825;46;408644;15743;1325
21159;La Chaume;77;1212309;21386;28;716269;49;496040;15744;1326
58111;Fâchin;82;1291081;45513;30;838238;52;452843;15745;1327
79212;Pliboux;114;1795110;21498;40;1113065;74;682045;15747;1328
43073;Cistrières;103;1622098;21873;37;907777;66;714321;15749;1329
15057;Cros-de-Montvert;131;2063070;35158;52;1262804;79;800266;15749;1330
63176;Heume-l'Église;65;1023724;11566;26;696415;39;327309;15750;1331
12269;La Serre;70;1102573;34204;18;621761;52;480812;15751;1332
63338;Saint-Éloy-les-Mines;2402;37837213;995886;963;25311771;1439;12525442;15752;1333
30175;Montclus;105;1654163;52085;38;1129003;67;525160;15754;1334
58199;Onlay;100;1575459;38519;46;1099617;54;475842;15755;1335
16227;Montignac-le-Coq;90;1418093;26914;35;959575;55;458518;15757;1336
88254;Jorxey;50;787856;5784;20;515658;30;272198;15757;1337
11435;Villerouge-Termenès;93;1465458;66995;28;888024;65;577434;15758;1338
61343;Randonnai;438;6902559;164240;156;4535273;282;2367286;15759;1339
46302;Sénaillac-Latronquière;86;1355516;12876;37;909895;49;445621;15762;1340
09267;Saint-Lary;78;1229442;62645;29;919231;49;310211;15762;1341
64392;Moncla;56;882851;18953;22;495246;34;387605;15765;1342
47312;Tournon-d'Agenais;458;7220737;333857;164;4833822;294;2386915;15766;1343
19110;Latronche;90;1418989;17722;37;969881;53;449108;15767;1344
58008;Anthien;109;1718809;19335;50;1207455;59;511354;15769;1345
16322;Saint-Germain-de-Confolens;52;820059;34937;22;600610;30;219449;15770;1346
61460;Le Sap;580;9147454;310656;195;5879887;385;3267567;15771;1347
02391;Jeantes;120;1892788;28423;53;1352551;67;540237;15773;1348
87149;Saint-Hilaire-la-Treille;238;3754135;88502;86;2326063;152;1428072;15774;1349
46026;Belmont-Sainte-Foi;62;977989;19590;26;646871;36;331118;15774;1350
76553;Sainte-Agathe-d'Aliermont;162;2555496;8170;62;1477716;100;1077780;15775;1351
19120;Louignac;128;2019386;24032;50;1303558;78;715828;15776;1352
61248;Mantilly;327;5159028;66293;116;2956371;211;2202657;15777;1353
46328;Varaire;179;2824077;56568;68;1921601;111;902476;15777;1354
11169;Greffeil;51;804692;16940;19;507663;32;297029;15778;1355
17231;Messac;61;962683;32800;18;560993;43;401690;15782;1356
43221;Saint-Privat-d'Allier;245;3866863;72675;84;2297909;161;1568954;15783;1357
56073;Guémené-sur-Scorff;762;12027517;401588;292;8037723;470;3989794;15784;1358
62133;Billy-Montigny;4493;70943540;1711878;1709;45749291;2784;25194249;15790;1359
11306;Quirbajou;27;426357;23313;11;360822;16;65535;15791;1360
47311;Tourliac;64;1010784;7186;25;644327;39;366457;15794;1361
55004;Aincreville;49;773924;1958;24;514181;25;259743;15794;1362
82116;Montagudet;116;1832313;19163;39;1126928;77;705385;15796;1363
12249;Saint-Sever-du-Moustier;130;2053743;50966;46;1260016;84;793727;15798;1364
2B320;Tallone;235;3712536;167707;64;2315755;171;1396781;15798;1365
23261;Viersat;193;3049335;79274;76;2041614;117;1007721;15800;1366
19083;Feyt;76;1200931;19674;33;843765;43;357166;15802;1367
81203;Paulinet;315;4977845;115219;105;3085408;210;1892437;15803;1368
89321;Ravières;562;8881595;260770;206;5564346;356;3317249;15804;1369
09009;Alzen;101;1596394;51051;28;910677;73;685717;15806;1370
05144;Saint-Jacques-en-Valgodemard;83;1311912;22399;25;709101;58;602811;15806;1371
11056;Cabrespine;95;1501654;63743;32;1033512;63;468142;15807;1372
62724;Rouvroy;4744;74996125;1823474;1752;47949365;2992;27046760;15809;1373
63299;Rentières;69;1090886;18069;30;727941;39;362945;15810;1374
52439;Rouvres-sur-Aube;65;1027687;31619;31;750201;34;277486;15811;1375
23068;Cressat;366;5786995;115626;143;3707137;223;2079858;15811;1376
11347;Saint-Julia-de-Bec;65;1027760;25925;22;602350;43;425410;15812;1377
2B058;Canari;172;2719921;133744;64;1823404;108;896517;15813;1378
36166;Préaux;110;1739662;37726;40;1088065;70;651597;15815;1379
50026;Azeville;50;790814;1899;15;430480;35;360334;15816;1380
63025;Ayat-sur-Sioule;81;1281136;7068;25;713108;56;568028;15816;1381
23053;Chard;100;1581792;65485;36;1046376;64;535416;15818;1382
62270;Divion;3835;60669769;1506680;1402;38180794;2433;22488975;15820;1383
58014;Arzembouy;45;711935;30745;16;443227;29;268708;15821;1384
85237;Saint-Laurent-de-la-Salle;212;3354042;13178;78;1849665;134;1504377;15821;1385
42238;Saint-Jean-la-Vêtre;214;3386267;27246;78;2081372;136;1304895;15824;1386
56170;Plouray;721;11410696;238274;256;7128301;465;4282395;15826;1387
19027;Bonnefond;69;1092036;19581;27;687433;42;404603;15827;1388
31159;Le Cuing;272;4305164;105351;99;3055612;173;1249552;15828;1389
63370;Saint-Julien-Puy-Lavèze;220;3482372;39356;85;2124690;135;1357682;15829;1390
16310;Saint-Coutant;129;2042317;29761;50;1326303;79;716014;15832;1391
15052;Collandres;114;1805035;33810;49;1210069;65;594966;15834;1392
50271;Lingeard;29;459273;5895;14;331034;15;128239;15837;1393
22167;Perret;127;2011498;48770;42;1273693;85;737805;15839;1394
63408;Sauret-Besserve;107;1694727;29617;50;1161924;57;532803;15839;1395
66119;Mosset;187;2961989;109058;65;1970671;122;991318;15840;1396
14296;Le Gast;123;1948434;12221;40;986301;83;962133;15841;1397
32338;Ramouzens;107;1695007;61161;44;1251471;63;443536;15841;1398
07235;Sainte-Eulalie;126;1996025;3633;45;1232639;81;763386;15841;1399
29261;Saint-Rivoal;110;1742609;32292;44;1211666;66;530943;15842;1400
48012;Les Monts-Verts;197;3121511;41890;75;1842959;122;1278552;15845;1401
09035;Balaguères;119;1885791;53952;47;1292881;72;592910;15847;1402
52038;Bassoncourt;45;713224;9277;19;427670;26;285554;15849;1403
17054;Boresse-et-Martron;122;1933658;36254;48;1221728;74;711930;15850;1404
48189;Servières;95;1505873;25662;37;947098;58;558775;15851;1405
76278;Foucarmont;592;9384403;351925;238;6467424;354;2916979;15852;1406
48076;Javols;168;2663554;34166;60;1538175;108;1125379;15854;1407
09202;Montégut-Plantaurel;200;3170915;22520;71;2065193;129;1105722;15855;1408
39180;Cressia;154;2441809;59492;66;1728839;88;712970;15856;1409
66166;Sahorre;214;3393215;90621;79;2201690;135;1191525;15856;1410
15178;Saint-Cirgues-de-Jordanne;85;1347904;22132;26;779845;59;568059;15858;1411
59392;Maubeuge;17213;272983207;10695421;6387;186399833;10826;86583374;15859;1412
42281;Saint-Rirand;83;1316321;9108;31;798223;52;518098;15859;1413
50250;Houtteville;47;745467;11888;17;446913;30;298554;15861;1414
06160;Villeneuve-d'Entraunes;39;618586;15629;17;391433;22;227153;15861;1415
23111;Lizières;166;2633122;51727;60;1548294;106;1084828;15862;1416
04181;Saint-Jeannet;42;666274;19669;18;453545;24;212729;15864;1417
43019;Barges;47;745790;21260;17;471594;30;274196;15868;1418
25556;Tallans;27;428460;-474;12;252790;15;175670;15869;1419
86202;La Puye;350;5554460;138338;127;3590215;223;1964245;15870;1420
07112;Labastide-sur-Bésorgues;142;2253782;30418;55;1350233;87;903549;15872;1421
34331;Verreries-de-Moussans;56;888871;15931;25;553311;31;335560;15873;1422
81137;Lasfaillades;48;761914;14255;18;452923;30;308991;15873;1423
62178;Bruay-la-Buissière;13185;209326163;6544081;4814;135009862;8371;74316301;15876;1424
52019;Arnancourt;64;1016080;15726;26;616136;38;399944;15876;1425
33112;Caumont;85;1349509;28534;27;856025;58;493484;15877;1426
48086;Luc;144;2286450;39720;54;1424048;90;862402;15878;1427
42188;Roche;146;2318360;1899;55;1263617;91;1054743;15879;1428
62268;Desvres;2887;45843658;1129764;1090;29828485;1797;16015173;15879;1429
62364;Fruges;1456;23122529;622220;489;14836350;967;8286179;15881;1430
64379;Mendive;91;1445263;51690;33;902048;58;543215;15882;1431
16007;Alloue;314;4986979;107691;118;3146676;196;1840303;15882;1432
03035;Le Bouchaud;110;1747190;9372;35;1011635;75;735555;15884;1433
32246;Maupas;107;1699553;26179;44;1086519;63;613034;15884;1434
08463;Vaux-en-Dieulet;38;603602;8729;13;319434;25;284168;15884;1435
89481;Vireaux;78;1238975;27949;32;783885;46;455090;15884;1436
08252;Létanne;71;1127986;7518;26;617112;45;510874;15887;1437
54030;Autrepierre;56;889686;10533;19;494168;37;395518;15887;1438
62828;Tramecourt;32;508490;2637;13;309792;19;198698;15890;1439
19206;Saint-Germain-Lavolps;46;730968;653;19;437684;27;293284;15891;1440
80501;Maison-Ponthieu;159;2526682;41541;61;1705384;98;821298;15891;1441
23160;Reterre;183;2908126;55526;71;1822990;112;1085136;15891;1442
54284;Joudreville;679;10791277;153466;178;4900227;501;5891050;15893;1443
15209;Saint-Rémy-de-Chaudes-Aigues;59;937710;4316;17;505501;42;432209;15893;1444
26048;Bénivay-Ollon;34;540389;3433;12;327959;22;212430;15894;1445
04163;Revest-du-Bion;372;5912493;129894;136;3814764;236;2097729;15894;1446
43053;Champclause;125;1986821;32973;46;1254479;79;732342;15895;1447
12083;Cransac;1013;16102287;401414;393;10312308;620;5789979;15896;1448
43064;Chassignolles;47;747157;19305;17;481028;30;266129;15897;1449
64433;Osse-en-Aspe;180;2861557;77088;58;1750852;122;1110705;15898;1450
09046;Bédeille;53;842611;33222;17;457038;36;385573;15898;1451
30120;Gagnières;611;9714282;205214;234;6171437;377;3542845;15899;1452
11367;Saissac;583;9269558;183395;198;5557642;385;3711916;15900;1453
2A071;Casalabriva;123;1956224;64179;48;1214478;75;741746;15904;1454
07213;Saint-André-Lachamp;84;1336040;43925;30;892345;54;443695;15905;1455
87120;La Porcherie;345;5488564;127062;128;3541672;217;1946892;15909;1456
16005;Aigre;710;11296327;385804;267;7548115;443;3748212;15910;1457
32109;Couloumé-Mondebat;127;2020638;40009;52;1390122;75;630516;15911;1458
93008;Bobigny;25834;411046522;12265333;10266;276818874;15568;134227648;15911;1459
15157;Quézac;189;3007438;60548;70;1856422;119;1151016;15912;1460
06162;La Brigue;395;6285388;274137;170;4671936;225;1613452;15912;1461
08029;Auflance;48;763818;13030;16;455804;32;308014;15913;1462
11320;Roquefeuil;165;2625645;73374;58;1580359;107;1045286;15913;1463
53114;Hardanges;130;2068757;32941;54;1322397;76;746360;15914;1464
65026;Aries-Espénan;35;557006;7342;12;356983;23;200023;15914;1465
08296;Montcheutin;79;1257299;21344;31;785230;48;472069;15915;1466
15064;Escorailles;42;668447;11901;17;393023;25;275424;15915;1467
32303;Pallanne;36;572971;11583;16;388984;20;183987;15916;1468
09294;Sieuras;44;700413;11762;19;526812;25;173601;15918;1469
65355;Paréac;47;748179;12840;19;454308;28;293871;15919;1470
29249;Saint-Goazec;459;7307133;131205;192;4741114;267;2566019;15920;1471
09014;Argein;130;2069748;57197;51;1416819;79;652929;15921;1472
08409;Sedan;10849;172736714;6971977;4198;119926133;6651;52810581;15922;1473
70222;Étrelles-et-la-Montbleuse;49;780215;10000;22;505094;27;275121;15923;1474
63097;Chassagne;45;716525;13556;15;404794;30;311731;15923;1475
23164;Rougnat;323;5143307;126624;120;3080350;203;2062957;15924;1476
76231;Elbeuf;9939;158300906;5740850;4109;112204465;5830;46096441;15927;1477
32403;Saint-Pierre-d'Aubézies;44;700827;11752;13;415332;31;285495;15928;1478
81016;Arfons;120;1911648;83886;50;1368192;70;543456;15930;1479
05042;La Cluse;34;541767;14040;12;325824;22;215943;15934;1480
06100;Revest-les-Roches;128;2039733;61566;49;1377576;79;662157;15935;1481
48065;Fraissinet-de-Fourques;48;764917;8585;20;470774;28;294143;15936;1482
82166;Saint-Michel;141;2247100;43957;59;1528489;82;718611;15937;1483
50341;Montebourg;1275;20320937;364972;444;12197274;831;8123663;15938;1484
62510;Liévin;16647;265327024;7721927;6177;175052537;10470;90274487;15938;1485
23229;Saint-Pardoux-les-Cards;205;3267648;82177;84;2206881;121;1060767;15940;1486
58161;Maux;89;1418663;28601;39;998239;50;420424;15940;1487
09216;Nescus;33;526128;10938;14;353478;19;172650;15943;1488
62907;Libercourt;4530;72223526;1893034;1720;46294627;2810;25928899;15943;1489
18203;Saint-Christophe-le-Chaudry;61;972613;29731;20;584583;41;388030;15944;1490
63009;Ardes;376;5995551;204158;131;3627701;245;2367850;15946;1491
09114;Erp;75;1195933;40375;32;868490;43;327443;15946;1492
63115;Combrailles;115;1833814;21332;42;1133867;73;699947;15946;1493
42205;Saint-Bonnet-le-Courreau;423;6745422;91988;151;3873630;272;2871792;15947;1494
33352;La Réole;2674;42645401;1681078;948;29177631;1726;13467770;15948;1495
88227;Hagnéville-et-Roncourt;52;829307;1562;24;527204;28;302103;15948;1496
15205;Saint-Paul-de-Salers;73;1164284;28335;27;724785;46;439499;15949;1497
97413;Saint-Leu;18353;292826043;8094042;4863;186403770;13490;106422273;15955;1498
47103;Fréchou;162;2584962;100298;61;1914679;101;670283;15957;1499
11319;Roquefère;39;622309;-650;14;386058;25;236251;15957;1500
30310;Saumane;201;3207328;90831;71;2239119;130;968209;15957;1501
12266;Ségur;319;5090309;43777;105;3114210;214;1976099;15957;1502
32022;Avéron-Bergelle;92;1468052;44940;36;984271;56;483781;15957;1503
22289;Saint-Fiacre;140;2234375;51325;56;1393155;84;841220;15960;1504
33450;Saint-Michel-de-Castelnau;139;2218574;62642;49;1368852;90;849722;15961;1505
15021;Boisset;362;5778361;113839;139;3685805;223;2092556;15962;1506
59253;Fresnes-sur-Escaut;4025;64248982;1643863;1559;42114523;2466;22134459;15962;1507
24100;Champniers-et-Reilhac;291;4645211;84602;111;3032161;180;1613050;15963;1508
19186;Saint-Bonnet-Elvert;125;1995367;48519;47;1247739;78;747628;15963;1509
88527;Xaffévillers;94;1500618;24060;29;734884;65;765734;15964;1510
43106;Jax;71;1133645;12043;19;510985;52;622660;15967;1511
66118;Montner;180;2874151;76310;65;1907994;115;966157;15968;1512
58141;Lavault-de-Frétoy;43;686603;14816;17;428453;26;258150;15968;1513
52352;Ninville;49;782449;9853;19;511507;30;270942;15968;1514
87165;Saint-Martin-le-Mault;75;1197653;24824;27;695970;48;501683;15969;1515
11270;Padern;91;1453223;40485;31;836072;60;617151;15969;1516
17366;Saint-Martin-de-Coux;245;3912925;92555;92;2450102;153;1462823;15971;1517
11242;Montclar;98;1565172;24039;36;996077;62;569095;15971;1518
66205;Tautavel;512;8177599;232896;191;5382913;321;2794686;15972;1519
35311;Saint-Séglin;302;4823669;38863;131;3052350;171;1771319;15972;1520
63190;Larodde;151;2412159;43835;60;1514306;91;897853;15975;1521
12069;Combret;145;2316322;22696;47;1417026;98;899296;15975;1522
26104;Cornillac;46;734853;12787;17;464688;29;270165;15975;1523
30332;Trèves;51;814867;42460;18;536073;33;278794;15978;1524
32205;Laveraët;71;1134557;21843;28;836479;43;298078;15980;1525
02519;Montloué;98;1566059;12635;34;875904;64;690155;15980;1526
43011;Aubazat;103;1646135;32532;37;1110083;66;536052;15982;1527
82034;Castéra-Bouzet;64;1022888;34135;26;728536;38;294352;15983;1528
34117;Graissessac;412;6584884;140359;181;4445409;231;2139475;15983;1529
64291;Labastide-Villefranche;188;3005041;46561;68;1889199;120;1115842;15984;1530
19259;Sexcles;146;2333705;33215;53;1492485;93;841220;15984;1531
87204;Videix;128;2046185;54716;43;1246733;85;799452;15986;1532
50405;Le Plessis-Lastelle;145;2318168;43334;50;1361457;95;956711;15987;1533
2A160;Moca-Croce;141;2254302;107519;59;1684407;82;569895;15988;1534
32163;Jû-Belloc;202;3229905;69420;77;2136793;125;1093112;15990;1535
03312;Vieure;158;2526433;21828;63;1578502;95;947931;15990;1536
70281;Greucourt;40;639725;3459;14;335664;26;304061;15993;1537
12294;Vézins-de-Lévézou;366;5853566;34662;113;3256400;253;2597166;15993;1538
03198;Neure;106;1695372;51642;41;1222469;65;472903;15994;1539
36094;Lignac;318;5086122;107067;115;3191527;203;1894595;15994;1540
23207;Saint-Léger-Bridereix;119;1903684;28118;45;1172382;74;731302;15997;1541
70373;La Roche-Morey;161;2575592;57056;54;1431225;107;1144367;15997;1542
88124;Darney;722;11550438;344120;254;7341945;468;4208493;15998;1543
52185;Enfonvelle;51;815934;11649;20;559290;31;256644;15999;1544
19080;Eygurande;468;7487635;161567;191;5220915;277;2266720;15999;1545
62667;Le Portel;5471;87547362;1983211;2189;57476326;3282;30071036;16002;1546
61021;Avrilly;74;1184201;5535;30;739299;44;444902;16003;1547
62345;Fontaine-l'Étalon;69;1104272;20754;28;672965;41;431307;16004;1548
55177;Érize-la-Petite;36;576234;10525;16;429298;20;146936;16007;1549
48151;Saint-Frézal-d'Albuges;30;480197;2801;11;281311;19;198886;16007;1550
65076;Bazus-Neste;35;560266;14104;15;382749;20;177517;16008;1551
97233;Le Morne-Vert;1198;19177759;598848;384;13019432;814;6158327;16008;1552
12038;Brousse-le-Château;106;1696905;31415;40;1073059;66;623846;16009;1553
58190;Neuffontaines;75;1200738;53178;26;770510;49;430228;16010;1554
40225;Philondenx;111;1777131;19511;40;1073341;71;703790;16010;1555
32001;Aignan;468;7493186;193234;169;4770347;299;2722839;16011;1556
80417;Harbonnières;885;14170317;404666;353;9694485;532;4475832;16012;1557
47160;Masquières;113;1809537;39589;35;1082982;78;726555;16014;1558
11168;Granès;70;1120960;26011;27;756432;43;364528;16014;1559
62587;Montigny-en-Gohelle;5324;85278367;1962410;2085;56077564;3239;29200803;16018;1560
62498;Lens;20044;321064312;12991524;7716;219357731;12328;101706581;16018;1561
63027;Baffie;80;1281555;19532;33;807940;47;473615;16019;1562
87163;Saint-Martial-sur-Isop;75;1201475;47669;27;714404;48;487071;16020;1563
02488;Molain;95;1522223;32507;36;987952;59;534271;16023;1564
58219;Préporché;137;2195208;53320;56;1458636;81;736572;16023;1565
24195;Gaugeac;69;1105707;15607;26;673764;43;431943;16025;1566
16054;Le Bouchage;106;1698787;35534;37;1019825;69;678962;16026;1567
07187;Prunet;87;1394314;36118;31;889302;56;505012;16027;1568
23066;Le Compas;135;2164131;40597;39;1159025;96;1005106;16031;1569
80531;Méricourt-en-Vimeu;74;1186453;12633;29;739355;45;447098;16033;1570
23077;Faux-la-Montagne;239;3832021;104391;101;2488035;138;1343986;16034;1571
23183;Saint-Avit-le-Pauvre;44;705575;19938;12;439914;32;265661;16036;1572
65039;Aspin-Aure;33;529199;8457;11;269435;22;259764;16036;1573
81047;Cadix;119;1908511;43904;42;1205833;77;702678;16038;1574
2B231;Pigna;58;930314;34713;18;527016;40;403298;16040;1575
59008;Aniche;5354;85878081;2136635;2066;56089679;3288;29788402;16040;1576
59028;Auby;3914;62783117;1272746;1529;39834876;2385;22948241;16041;1577
70072;Beveuge;47;754183;8901;22;508537;25;245646;16046;1578
43075;Collat;46;738224;6076;12;407079;34;331145;16048;1579
46279;Saint-Maurice-en-Quercy;138;2214812;22904;49;1346325;89;868487;16049;1580
08437;Tailly;112;1797546;32562;43;1152106;69;645440;16050;1581
11287;Peyrolles;46;738362;354;20;396634;26;341728;16051;1582
70287;Hurecourt;34;545751;8864;16;355362;18;190389;16052;1583
70066;Betaucourt;98;1573063;26353;31;872192;67;700871;16052;1584
80646;Punchy;49;786535;12211;17;403701;32;382834;16052;1585
18065;Chezal-Benoît;566;9085570;296852;265;6937299;301;2148271;16052;1586
89032;Beauvilliers;46;738407;6128;18;513678;28;224729;16052;1587
34260;Saint-Gervais-sur-Mare;547;8780673;197292;177;5122240;370;3658433;16052;1588
31397;Nénigan;33;529747;17646;11;367300;22;162447;16053;1589
36207;Saint-Plantaire;317;5089028;125514;121;3317039;196;1771989;16054;1590
23112;Lourdoueix-Saint-Pierre;514;8251970;187571;206;5381244;308;2870726;16054;1591
50131;Chérencé-le-Roussel;177;2841839;43959;71;1821363;106;1020476;16056;1592
22064;Gouarec;518;8317133;250273;181;5165185;337;3151948;16056;1593
2A154;Marignana;62;995613;28227;25;667298;37;328315;16058;1594
16181;Lessac;317;5090550;108266;128;3323675;189;1766875;16059;1595
59659;Wignehies;1690;27139205;787622;650;18550109;1040;8589096;16059;1596
65383;Sadournin;116;1863044;37841;45;1177067;71;685977;16061;1597
46198;Montbrun;56;899437;13349;23;624577;33;274860;16061;1598
24263;Mazeyrolles;192;3083880;86380;63;1880008;129;1203872;16062;1599
65374;Puydarrieux;135;2168534;41934;48;1334407;87;834127;16063;1600
52350;Neuvelle-lès-Voisey;51;819284;-6143;18;384159;33;435125;16064;1601
86242;Saint-Romain;230;3694880;64432;81;2299275;149;1395605;16065;1602
23217;Saint-Martin-Sainte-Catherine;205;3293267;73054;76;2049246;129;1244021;16065;1603
08185;Fumay;2156;34636863;1024818;836;22557588;1320;12079275;16065;1604
15061;Dienne;182;2924323;49776;72;1881468;110;1042855;16068;1605
47188;Montignac-de-Lauzun;162;2603170;62164;53;1547139;109;1056031;16069;1606
12267;La Selve;374;6010419;56079;135;3704080;239;2306339;16071;1607
26304;Saint-Ferréol-Trente-Pas;139;2233834;63289;45;1375307;94;858527;16071;1608
48097;Moissac-Vallée-Française;115;1848387;55798;44;1256864;71;591523;16073;1609
59179;Douchy-les-Mines;5512;88598679;1847433;2067;57488201;3445;31110478;16074;1610
22031;Carnoët;418;6718841;139949;168;4356170;250;2362671;16074;1611
11406;Véraza;25;401872;11504;12;305836;13;96036;16075;1612
23073;Dontreix;257;4131264;105252;94;2722882;163;1408382;16075;1613
89183;Fresnes;43;691280;19108;20;464480;23;226800;16076;1614
48116;Le Pont-de-Montvert;180;2893961;73606;69;1949216;111;944745;16078;1615
43183;Sainte-Eugénie-de-Villeneuve;58;932543;22356;27;637817;31;294726;16078;1616
70364;Montjustin-et-Velotte;67;1077445;-16855;24;603784;43;473661;16081;1617
50323;Le Mesnil-Tôve;126;2026300;20657;54;1278377;72;747923;16082;1618
03142;Lenax;155;2492984;69744;48;1426998;107;1065986;16084;1619
54129;Cirey-sur-Vezouze;995;16003640;362770;390;10622394;605;5381246;16084;1620
70176;Corravillers;132;2123106;45969;48;1314216;84;808890;16084;1621
70337;Melin;38;611247;17457;15;399888;23;211359;16085;1622
09105;Daumazan-sur-Arize;426;6852504;250403;157;4478184;269;2374320;16086;1623
11198;Laure-Minervois;601;9669415;191064;222;6252240;379;3417175;16089;1624
43136;Monistrol-d'Allier;140;2252553;31974;45;1206138;95;1046415;16090;1625
81110;Jouqueviel;50;804611;6863;15;423119;35;381492;16092;1626
04180;Saint-Jacques;33;531126;19432;14;380595;19;150531;16095;1627
31390;Montréjeau;1851;29794015;1134156;711;20499027;1140;9294988;16096;1628
38255;Montfalcon;67;1078468;7163;27;680016;40;398452;16097;1629
50318;Le Mesnil-Rainfray;129;2076524;41410;54;1307120;75;769404;16097;1630
62160;Boulogne-sur-Mer;24992;402313566;15693482;10003;282840351;14989;119473215;16098;1631
04158;Quinson;290;4668344;142421;127;3338716;163;1329628;16098;1632
47235;Saint-Colomb-de-Lauzun;273;4394902;83811;96;2605710;177;1789192;16099;1633
88234;Harsault;217;3493432;47905;82;2056655;135;1436777;16099;1634
30077;Cendras;1115;17950220;426230;405;11262505;710;6687715;16099;1635
19131;Meilhards;311;5007449;117809;121;3287252;190;1720197;16101;1636
52161;Daillecourt;51;821220;24138;20;565800;31;255420;16102;1637
23028;Bosroger;62;998352;18712;27;687735;35;310617;16102;1638
21160;Chaume-lès-Baigneux;59;950079;14343;26;617317;33;332762;16103;1639
02759;La Vallée-au-Blé;210;3382910;65655;74;2042133;136;1340777;16109;1640
47242;Saint-Front-sur-Lémance;331;5332201;92156;116;3233703;215;2098498;16109;1641
50192;Fourneaux;55;886116;7131;22;597214;33;288902;16111;1642
06111;Roure;58;934497;31842;23;596709;35;337788;16112;1643
48107;Palhers;146;2352550;47457;57;1715437;89;637113;16113;1644
40200;Moustey;405;6526262;193203;158;4403576;247;2122686;16114;1645
62886;Wicquinghem;130;2095134;23740;47;1222119;83;873015;16116;1646
15135;Montvert;74;1192669;15042;26;821217;48;371452;16117;1647
26269;Rochebrune;36;580226;27605;12;394450;24;185776;16117;1648
26027;Barsac;88;1418497;27445;33;857737;55;560760;16119;1649
70279;Gray;3507;56530486;2019084;1296;37541227;2211;18989259;16119;1650
03183;Le Montet;315;5077841;149737;118;3353348;197;1724493;16120;1651
23151;Peyrat-la-Nonière;264;4255739;76048;95;2610114;169;1645625;16120;1652
39204;Dramelay;24;386922;12526;12;279647;12;107275;16122;1653
50637;Villebaudon;173;2789076;14068;74;1793279;99;995797;16122;1654
97128;Sainte-Anne;13759;221846433;7092727;4164;148502770;9595;73343663;16124;1655
34015;Assignan;93;1499536;30826;39;1041384;54;458152;16124;1656
81223;Le Rialet;37;596600;13379;14;398296;23;198304;16124;1657
32343;Riguepeu;125;2015602;42907;46;1350213;79;665389;16125;1658
46324;Uzech;134;2160796;36539;47;1394885;87;765911;16125;1659
30031;La Bastide-d'Engras;129;2080356;60732;51;1426802;78;653554;16127;1660
23014;Azat-Châtenet;71;1145073;34671;25;687595;46;457478;16128;1661
53181;Pontmain;544;8773612;164654;185;5402921;359;3370691;16128;1662
84079;Monieux;166;2677940;71991;67;1925104;99;752836;16132;1663
23149;Parsac;382;6162773;200884;152;4196148;230;1966625;16133;1664
24221;Rudeau-Ladosse;80;1290715;34702;32;852441;48;438274;16134;1665
59079;Beuvrages;3395;54779178;1229529;1300;35849459;2095;18929719;16135;1666
39583;Vosbles;69;1113352;18877;30;749514;39;363838;16136;1667
19108;Laroche-près-Feyt;44;710004;15431;18;514052;26;195952;16136;1668
17135;Cressé;152;2452881;63275;51;1525320;101;927561;16137;1669
88214;Grandrupt-de-Bains;39;629439;3719;12;353326;27;276113;16139;1670
12099;Fayet;155;2501702;68487;58;1582154;97;919548;16140;1671
09256;Saint-Bauzeil;35;565040;3689;17;373778;18;191262;16144;1672
03238;Saint-Hilaire;316;5101729;127080;124;3353141;192;1748588;16145;1673
88290;Martigny-les-Gerbonvaux;70;1130150;21098;30;762959;40;367191;16145;1674
11263;Nébias;136;2195746;55042;48;1440025;88;755721;16145;1675
17294;Puyrolland;115;1856821;34655;45;1182594;70;674227;16146;1676
16071;Chabrac;335;5409134;100451;142;3597389;193;1811745;16147;1677
26046;Bellecombe-Tarendol;59;952752;21495;22;594739;37;358013;16148;1678
03309;Le Veurdre;324;5232477;243072;109;3448976;215;1783501;16150;1679
48043;Châteauneuf-de-Randon;316;5103842;206989;135;3841388;181;1262454;16151;1680
23185;Saint-Chabrais;180;2907318;47098;65;1727191;115;1180127;16152;1681
18264;Thou;52;839936;38738;23;658175;29;181761;16153;1682
71043;Les Bordes;61;985331;33851;30;684224;31;301107;16153;1683
32174;Ladevèze-Rivière;140;2261432;48307;62;1594136;78;667296;16153;1684
23035;Budelière;489;7898978;205421;188;5152612;301;2746366;16153;1685
2B179;Novale;38;613879;23961;17;416534;21;197345;16155;1686
2B346;Vescovato;1403;22665102;629907;547;15420315;856;7244787;16155;1687
33478;Saint-Seurin-sur-l'Isle;1859;30032015;655846;721;19016152;1138;11015863;16155;1688
32039;Beccas;59;953195;14516;28;701899;31;251296;16156;1689
63462;Virlet;147;2374954;62332;60;1593538;87;781416;16156;1690
63460;Villosanges;210;3393337;57738;72;1982531;138;1410806;16159;1691
19265;Tarnac;221;3571171;110947;81;2179000;140;1392171;16159;1692
2B350;Vignale;118;1906804;94059;47;1344986;71;561818;16159;1693
63132;Cunlhat;805;13009157;431466;310;9111766;495;3897391;16160;1694
02059;Beautor;1565;25291553;754766;645;17338250;920;7953303;16161;1695
65194;Générest;65;1050466;28791;36;826381;29;224085;16161;1696
03087;Couleuvre;371;5996035;139407;146;3916064;225;2079971;16162;1697
11022;Azille;671;10844773;318633;244;7210963;427;3633810;16162;1698
59271;Grande-Synthe;10372;167641596;3729874;3971;105539620;6401;62101976;16163;1699
07132;Largentière;1003;16211810;573946;374;10864833;629;5346977;16163;1700
81263;Saint-Martin-Laguépie;231;3733947;91194;86;2376404;145;1357543;16164;1701
79106;Couture-d'Argenson;250;4041639;110668;84;2513780;166;1527859;16167;1702
10426;Ville-sous-la-Ferté;640;10347790;173234;268;6814088;372;3533702;16168;1703
25299;Guillon-les-Bains;63;1018824;10181;31;733333;32;285491;16172;1704
11182;Lacombe;98;1584882;42720;34;1008090;64;576792;16172;1705
87012;Berneuil;264;4269731;94662;101;2778651;163;1491080;16173;1706
81240;Saint-André;57;922041;31583;17;556881;40;365160;16176;1707
11109;Coustaussa;36;582420;7432;13;309353;23;273067;16178;1708
12245;Saint-Salvadou;232;3753479;85464;73;2311659;159;1441820;16179;1709
06045;Collongues;44;711884;40221;21;566521;23;145363;16179;1710
14686;Le Theil-Bocage;138;2232774;39246;55;1401535;83;831239;16180;1711
2B355;Volpajola;235;3802201;70445;85;2290771;150;1511430;16180;1712
93072;Stains;17577;284394169;8803383;7102;194677815;10475;89716354;16180;1713
2A295;Sant'Andréa-d'Orcino;52;841389;14694;21;526571;31;314818;16181;1714
23088;Gartempe;81;1310673;28000;31;822517;50;488156;16181;1715
69256;Vaulx-en-Velin;21955;355258647;8065640;8853;232264768;13102;122993879;16181;1716
33492;Saint-Yzan-de-Soudiac;1224;19806409;304487;474;12593659;750;7212750;16182;1717
12186;Pousthomy;124;2006757;44526;44;1312693;80;694064;16184;1718
52301;Maisoncelles;34;550244;10173;17;415762;17;134482;16184;1719
24386;Saint-Cernin-de-l'Herm;136;2201086;40633;48;1312014;88;889072;16184;1720
52433;Romain-sur-Meuse;72;1165403;28025;30;794619;42;370784;16186;1721
58066;Châtin;71;1149353;32019;29;796039;42;353314;16188;1722
03308;Vernusse;98;1586445;41226;36;952230;62;634215;16188;1723
48001;Albaret-le-Comtal;114;1845556;53004;42;1154939;72;690617;16189;1724
56238;Saint-Tugdual;246;3982635;62101;96;2522918;150;1459717;16190;1725
81082;Le Dourn;61;987676;13530;21;650292;40;337384;16191;1726
17454;Tugéras-Saint-Maurice;226;3659326;71341;89;2372572;137;1286754;16192;1727
54280;Joeuf;4014;64995067;1462993;1547;39523707;2467;25471360;16192;1728
02678;Sainte-Geneviève;38;615324;2780;17;348893;21;266431;16193;1729
2B263;Rospigliani;51;825841;16999;22;528898;29;296943;16193;1730
54423;Pexonne;231;3740604;46859;96;2376406;135;1364198;16193;1731
31510;Saint-Pé-Delbosc;80;1295474;38521;27;774971;53;520503;16193;1732
09301;Soulan;229;3708408;138837;95;2622741;134;1085667;16194;1733
16332;Saint-Léger;76;1230771;22778;26;738062;50;492709;16194;1734
43182;Saint-Étienne-sur-Blesle;40;647785;11453;17;410250;23;237535;16195;1735
43131;Mazerat-Aurouze;120;1943401;1830;46;1156782;74;786619;16195;1736
97416;Saint-Pierre;44839;726226368;25116585;12244;477180752;32595;249045616;16196;1737
80014;Aizecourt-le-Bas;30;485966;1664;12;313454;18;172512;16199;1738
24080;Capdrot;296;4794949;156267;100;3170937;196;1624012;16199;1739
30268;Saint-Jean-de-Valériscle;374;6059119;138790;138;3812946;236;2246173;16201;1740
70065;Besnans;43;696659;2459;24;503454;19;193205;16201;1741
30227;Saint-Ambroix;2132;34542354;1089642;791;23002789;1341;11539565;16202;1742
21642;Toutry;260;4212545;47356;109;2610070;151;1602475;16202;1743
15238;Tournemire;90;1458294;41816;33;937223;57;521071;16203;1744
33154;Les Églisottes-et-Chalaures;1144;18536588;512569;436;12095131;708;6441457;16203;1745
15108;Loubaresse;251;4067296;56070;94;2571576;157;1495720;16204;1746
02684;Saint-Michel;1936;31372467;972037;739;21100229;1197;10272238;16205;1747
32438;Tachoires;49;794049;20997;17;519657;32;274392;16205;1748
04177;Hautes-Duyes;24;388955;1537;11;276273;13;112682;16206;1749
59112;Bruay-sur-l'Escaut;6223;100857459;2732926;2426;67022664;3797;33834795;16207;1750
87006;Azat-le-Ris;155;2512229;52089;60;1636142;95;876087;16208;1751
10403;Vernonvilliers;45;729382;21453;17;435891;28;293491;16208;1752
2A174;Murzo;65;1053654;26107;37;800017;28;253637;16210;1753
42282;Saint-Romain-d'Urfé;161;2610045;38237;61;1673900;100;936145;16211;1754
58076;Chougny;37;599832;7305;14;401345;23;198487;16212;1755
26329;Saint-Sauveur-Gouvernet;118;1912979;49519;43;1212800;75;700179;16212;1756
36015;Beaulieu;45;729539;43115;11;429497;34;300042;16212;1757
52284;Leschères-sur-le-Blaiseron;55;891687;524;24;594045;31;297642;16212;1758
12092;Durenque;316;5123470;86915;104;3060147;212;2063323;16214;1759
70098;Brotte-lès-Luxeuil;125;2026900;19423;49;1177112;76;849788;16215;1760
26103;Condorcet;276;4475680;121379;106;3061571;170;1414109;16216;1761
03282;Theneuille;251;4070505;105318;104;2792465;147;1278040;16217;1762
12303;Vimenet;147;2384202;25680;61;1609767;86;774435;16219;1763
34252;Saint-Étienne-Estréchoux;179;2903375;72333;71;1901459;108;1001916;16220;1764
14521;Presles;152;2465450;38857;62;1600593;90;864857;16220;1765
30229;Saint-André-de-Majencoules;380;6164488;167820;150;4220403;230;1944085;16222;1766
46078;Couzou;58;940918;26314;23;614650;35;326268;16223;1767
31404;Oô;66;1070778;20654;31;724699;35;346079;16224;1768
88025;Avranville;43;697630;16212;18;452583;25;245047;16224;1769
39142;Chevreaux;93;1508896;46266;44;1175097;49;333799;16225;1770
97422;Le Tampon;39389;639074319;20126415;10614;410235311;28775;228839008;16225;1771
32099;Cazaux-Villecomtal;59;957282;34001;26;680413;33;276869;16225;1772
88287;Marey;45;730133;10733;19;458957;26;271176;16225;1773
52544;Voisey;207;3358729;55494;82;2075097;125;1283632;16226;1774
63289;Prondines;154;2498853;26383;58;1571616;96;927237;16226;1775
2B159;Meria;70;1135931;40759;22;790818;48;345113;16228;1776
23070;Crozant;330;5355526;171321;116;3415261;214;1940265;16229;1777
2A026;Azilone-Ampaza;88;1428251;34482;36;930816;52;497435;16230;1778
24095;Chalais;246;3992806;61840;105;2548776;141;1444030;16231;1779
65170;Estampures;47;762883;11431;21;507316;26;255567;16232;1780
39168;Courbette;30;487000;6260;14;295861;16;191139;16233;1781
86001;Adriers;466;7564734;247378;158;4850505;308;2714229;16233;1782
43083;Cubelles;75;1217630;32923;26;725328;49;492302;16235;1783
26214;Mornans;42;681900;17750;15;378042;27;303858;16236;1784
34277;Saint-Maurice-Navacelles;105;1704755;58075;43;1139507;62;565248;16236;1785
81115;Labastide-Rouairoux;933;15148073;333802;313;8623280;620;6524793;16236;1786
15195;Saint-Just;123;1997089;36436;46;1195875;77;801214;16236;1787
05039;Chauffayer;235;3816424;76292;92;2492805;143;1323619;16240;1788
32032;Bassoues;201;3264330;58434;71;2084552;130;1179778;16240;1789
87194;Sussac;202;3280608;75454;76;2083266;126;1197342;16241;1790
55116;Le Claon;38;617145;10809;21;464876;17;152269;16241;1791
03004;Andelaroche;151;2452392;35468;62;1553697;89;898695;16241;1792
24517;Salles-de-Belvès;49;795825;19265;22;552426;27;243399;16241;1793
14442;Montchamp;332;5392691;105296;127;3336926;205;2055765;16243;1794
66046;Caudiès-de-Fenouillèdes;367;5961290;149258;134;3915748;233;2045542;16243;1795
43063;Chassagnes;101;1640615;11089;39;1005183;62;635432;16244;1796
2B183;Ogliastro;61;990887;56977;23;656601;38;334286;16244;1797
87028;Bussière-Poitevine;553;8983168;199290;190;5491511;363;3491657;16244;1798
54497;Saxon-Sion;44;714796;25082;19;541357;25;173439;16245;1799
70051;La Basse-Vaivre;26;422418;4317;11;272182;15;150236;16247;1800
70244;Fouchécourt;72;1169870;17382;31;724427;41;445443;16248;1801
70016;Amont-et-Effreney;103;1673567;24581;44;1090499;59;583068;16248;1802
53256;Saint-Thomas-de-Courceriers;130;2112393;20711;49;1215365;81;897028;16249;1803
62083;Barlin;4165;67681436;1616460;1601;43432411;2564;24249025;16250;1804
80057;Bayencourt;42;682546;4655;16;425647;26;256899;16251;1805
44208;Treffieux;452;7345766;65430;186;4748977;266;2596789;16252;1806
07326;Usclades-et-Rieutord;61;991367;9432;26;604668;35;386699;16252;1807
50183;Fierville-les-Mines;178;2893071;39296;71;1848602;107;1044469;16253;1808
23188;Saint-Dizier-les-Domaines;122;1983155;44411;53;1311323;69;671832;16255;1809
17055;Boscamnant;180;2925969;73268;56;1720704;124;1205265;16255;1810
22124;Lescouët-Gouarec;117;1901949;23516;47;1274596;70;627353;16256;1811
79271;Saint-Marc-la-Lande;215;3495249;93625;78;2239261;137;1255988;16257;1812
34269;Saint-Jean-de-Minervois;93;1512014;54497;31;1053207;62;458807;16258;1813
63416;Savennes;64;1040550;21854;27;638653;37;401897;16259;1814
33502;Saugon;224;3642140;64067;87;2436663;137;1205477;16260;1815
11241;Montbrun-des-Corbières;162;2634507;113252;54;1745110;108;889397;16262;1816
53261;Soucé;87;1415368;4333;31;750799;56;664569;16269;1817
31235;Guran;30;488096;6995;13;325308;17;162788;16270;1818
89216;Lainsecq;205;3335710;128886;72;2127536;133;1208174;16272;1819
42183;La Ricamarie;4240;68994513;1516467;1627;43544744;2613;25449769;16272;1820
46207;Montredon;164;2668748;56905;52;1551499;112;1117249;16273;1821
15116;Marchastel;93;1513420;36073;34;1039740;59;473680;16273;1822
02150;Cerny-en-Laonnois;41;667219;8858;21;487340;20;179879;16274;1823
86189;Payroux;284;4621743;154140;94;3219076;190;1402667;16274;1824
62080;Bapaume;2112;34376909;1507899;758;23673631;1354;10703278;16277;1825
71116;Châtenay;103;1676616;25716;46;1137348;57;539268;16278;1826
16239;Mouzon;75;1220941;21653;32;790382;43;430559;16279;1827
09169;Limbrassac;67;1090781;35198;28;750750;39;340031;16280;1828
16076;Champagne-Mouton;621;10110305;287022;223;6428731;398;3681574;16281;1829
19164;Peyrelevade;436;7098428;242998;190;5257434;246;1840994;16281;1830
43186;Saint-Front;261;4249298;87792;106;2816614;155;1432684;16281;1831
46081;Crégols;35;569909;24019;12;424719;23;145190;16283;1832
04194;Saint-Pierre;64;1042228;34063;23;672945;41;369283;16285;1833
24389;Saint-Cirq;69;1123685;18661;22;597403;47;526282;16285;1834
16229;Montjean;147;2393991;49145;46;1363102;101;1030889;16286;1835
31301;Lilhac;69;1123765;27925;25;672667;44;451098;16286;1836
65274;Libaros;89;1449555;35372;37;1015544;52;434011;16287;1837
29036;Collorec;371;6042840;102670;140;3654797;231;2388043;16288;1838
43239;Siaugues-Sainte-Marie;473;7704652;119783;171;4799017;302;2905635;16289;1839
87153;Saint-Julien-le-Petit;197;3209046;78102;83;2218510;114;990536;16290;1840
31443;Puymaurin;181;2948437;100654;69;1894535;112;1053902;16290;1841
64285;Juxue;84;1368433;-5650;26;680333;58;688100;16291;1842
15201;Saint-Martin-sous-Vigouroux;132;2150583;20523;43;1283447;89;867136;16292;1843
52393;Poinsenot;30;488772;4709;14;306806;16;181966;16292;1844
15174;Saint-Bonnet-de-Salers;187;3047157;42861;66;1825851;121;1221306;16295;1845
22320;Saint-Nicodème;102;1662191;82213;33;1058840;69;603351;16296;1846
30016;Arre;184;2998480;54067;78;2023544;106;974936;16296;1847
02204;Coingt;43;700777;14225;18;422410;25;278367;16297;1848
81295;Teillet;267;4351409;118887;81;2503387;186;1848022;16297;1849
97420;Sainte-Suzanne;11633;189597689;5172028;3128;118779527;8505;70818162;16298;1850
08246;Landres-et-Saint-Georges;54;880126;13680;18;557237;36;322889;16299;1851
12296;Viala-du-Tarn;271;4417401;105918;98;2786563;173;1630838;16300;1852
47298;Sénestis;113;1841943;32517;38;1114613;75;727330;16300;1853
17229;Mérignac;133;2167991;76039;50;1389717;83;778274;16301;1854
65154;Créchets;30;489024;1135;12;315861;18;173163;16301;1855
03153;Louroux-Hodement;156;2542955;41012;71;1814623;85;728332;16301;1856
23249;Saint-Yrieix-la-Montagne;132;2151744;46648;49;1354804;83;796940;16301;1857
09043;La Bastide-sur-l'Hers;431;7026440;120788;164;4185060;267;2841380;16303;1858
81224;Le Riols;75;1222757;29989;25;749152;50;473605;16303;1859
88421;Saint-Julien;74;1206537;15957;23;635727;51;570810;16305;1860
63357;Saint-Hérent;61;994595;7377;21;622622;40;371973;16305;1861
19210;Saint-Hilaire-Luc;47;766332;12350;17;463408;30;302924;16305;1862
47173;Monclar;493;8038377;236037;192;5470939;301;2567438;16305;1863
61017;Les Authieux-du-Puits;39;635917;9476;15;372344;24;263573;16306;1864
26236;Pierrelongue;123;2005882;49142;44;1240783;79;765099;16308;1865
03222;Saint-Caprais;56;913288;8680;24;585622;32;327666;16309;1866
36035;Chaillac;655;10682264;221443;247;6647455;408;4034809;16309;1867
51423;Pargny-sur-Saulx;1089;17760464;348129;421;10850956;668;6909508;16309;1868
18059;Le Châtelet;644;10503003;236579;260;6895149;384;3607854;16309;1869
12307;Curan;183;2984596;47709;63;1771523;120;1213073;16309;1870
56199;Roudouallec;437;7127206;111778;192;4726006;245;2401200;16309;1871
12304;Vitrac-en-Viadène;63;1027570;27963;18;578086;45;449484;16311;1872
15084;Labesserette;165;2691277;35176;65;1744658;100;946619;16311;1873
82122;Montbarla;86;1402835;36673;28;864134;58;538701;16312;1874
89177;Fontenay-sous-Fouronnes;46;750368;16778;23;518710;23;231658;16312;1875
31591;Escoulis;55;897222;26610;29;685010;26;212212;16313;1876
29141;Loqueffret;235;3833676;101019;91;2659176;144;1174500;16314;1877
15002;Alleuze;122;1990287;35236;47;1267225;75;723062;16314;1878
21311;Grosbois-lès-Tichey;40;652567;-3129;14;354991;26;297576;16314;1879
2A019;Arbori;42;685230;22931;19;541129;23;144101;16315;1880
48131;Le Rozier;90;1468449;38962;39;1037136;51;431313;16316;1881
43242;Tailhac;37;603822;19422;16;461017;21;142805;16320;1882
70086;Bourbévelle;48;783421;15056;20;501094;28;282327;16321;1883
23172;La Serre-Bussière-Vieille;67;1093575;28777;21;573377;46;520198;16322;1884
81062;Castelnau-de-Brassac;471;7687838;105617;185;4782059;286;2905779;16322;1885
48158;Saint-Hilaire-de-Lavit;60;979438;15572;18;468490;42;510948;16324;1886
95680;Villiers-le-Bel;14652;239184928;6984667;6084;163942345;8568;75242583;16324;1887
79225;Reffannes;204;3330223;60963;81;2105427;123;1224796;16325;1888
88139;Dombasle-en-Xaintois;90;1469269;39800;37;966061;53;503208;16325;1889
58301;Vandenesse;230;3755035;87172;100;2632263;130;1122772;16326;1890
15089;Ladinhac;279;4555258;39712;89;2611892;190;1943366;16327;1891
70548;Vernois-sur-Mance;105;1714388;51418;41;1121945;64;592443;16328;1892
49325;La Salle-de-Vihiers;609;9944389;108396;206;6091508;403;3852881;16329;1893
48168;Saint-Léger-de-Peyre;115;1877878;22625;48;1189308;67;688570;16329;1894
09082;Castelnau-Durban;286;4670455;131024;115;3229478;171;1440977;16330;1895
79140;Hanc;154;2515337;72960;49;1566744;105;948593;16333;1896
30216;Robiac-Rochessadoule;488;7970884;152745;192;5332339;296;2638545;16334;1897
32214;Loubédat;69;1127043;15363;23;648183;46;478860;16334;1898
25359;Malans;89;1453744;11332;43;983000;46;470744;16334;1899
23131;Mérinchal;448;7318165;168710;159;4514052;289;2804113;16335;1900
03228;Saint-Éloy-d'Allier;29;473762;10399;11;331661;18;142101;16337;1901
62519;Lisbourg;323;5277295;134087;116;3459953;207;1817342;16338;1902
23251;Tardes;77;1258117;14528;28;730616;49;527501;16339;1903
01433;Vernoux;152;2483636;25994;63;1705092;89;778544;16340;1904
47266;Saint-Pé-Saint-Simon;121;1977173;31545;40;1196474;81;780699;16340;1905
31222;Gouaux-de-Luchon;34;555570;23227;14;400017;20;155553;16340;1906
25595;Vellerot-lès-Belvoir;63;1029458;18008;25;642932;38;386526;16341;1907
17243;Montlieu-la-Garde;782;12779206;403336;276;8288679;506;4490527;16342;1908
93079;Villetaneuse;6102;99720530;2696363;2539;66629848;3563;33090682;16342;1909
65169;Estaing;50;817151;12505;17;524083;33;293068;16343;1910
32260;Monbardon;44;719109;28524;17;524116;27;194993;16343;1911
66003;Amélie-les-Bains-Palalda;2615;42738634;1633859;1058;29284096;1557;13454538;16344;1912
50548;Saint-Sauveur-de-Pierrepont;72;1176743;-2632;27;650582;45;526161;16344;1913
05048;L'Épine;122;1993946;75011;43;1308368;79;685578;16344;1914
24554;La Tour-Blanche;277;4527448;203201;89;2835176;188;1692272;16345;1915
81180;Montirat;160;2615270;78168;51;1628327;109;986943;16345;1916
19065;Courteix;36;588467;4851;18;431377;18;157090;16346;1917
49059;Les Cerqueux-sous-Passavant;244;3988715;-16460;80;2136786;164;1851929;16347;1918
57597;Rosselange;1609;26302680;624407;611;16583137;998;9719543;16347;1919
39112;La Chassagne;78;1275136;29148;31;845548;47;429588;16348;1920
34235;Rosis;168;2746951;60557;71;1848050;97;898901;16351;1921
62783;Saulchoy;179;2926888;65170;75;1954938;104;971950;16351;1922
54226;Gibeaumeix;77;1259246;17502;23;688085;54;571161;16354;1923
30350;Le Vigan;2476;40494750;1258042;936;26931361;1540;13563389;16355;1924
2A268;Sampolo;36;588864;29299;12;381068;24;207796;16357;1925
32010;Arrouède;46;752441;16507;22;554887;24;197554;16357;1926
36212;Saulnay;115;1881213;38907;56;1413571;59;467642;16358;1927
16038;Benest;195;3190341;59740;69;1846856;126;1343485;16361;1928
62183;Buire-le-Sec;430;7035280;150239;152;4059440;278;2975840;16361;1929
89246;Massangis;246;4024958;160989;95;2900854;151;1124104;16362;1930
16183;Lésignac-Durand;108;1767067;15779;40;1026045;68;741022;16362;1931
61313;Notre-Dame-du-Rocher;39;638161;23184;18;467771;21;170390;16363;1932
19190;Saint-Bonnet-près-Bort;106;1734536;28608;42;1050275;64;684261;16364;1933
79198;Paizay-le-Chapt;137;2242199;13464;48;1237067;89;1005132;16366;1934
64532;Tadousse-Ussau;38;622010;17237;12;367592;26;254418;16369;1935
54530;Tramont-Lassus;49;802104;12016;22;512064;27;290040;16369;1936
32430;Sère;45;736629;20721;19;543577;26;193052;16370;1937
16191;Lonnes;101;1653514;11809;43;1094669;58;558845;16371;1938
24373;Saint-Aubin-de-Cadelech;187;3061493;73948;71;1982040;116;1079453;16372;1939
80356;Fresnoy-Andainville;55;900470;8785;24;558017;31;342453;16372;1940
22043;Coëtlogon;135;2210286;43108;45;1317680;90;892606;16372;1941
36017;La Berthenoux;278;4552521;109348;111;3037940;167;1514581;16376;1942
02502;Montcornet;798;13068642;437377;292;8630868;506;4437774;16377;1943
56191;Réminiac;207;3390437;45499;81;2097573;126;1292864;16379;1944
32401;Saint-Ost;51;835331;6573;24;553937;27;281394;16379;1945
48088;La Malène;102;1670766;34193;40;1019983;62;650783;16380;1946
31593;Cazac;49;802634;7778;17;491906;32;310728;16380;1947
2B171;Muracciole;26;425955;17459;12;324822;14;101133;16383;1948
79253;Saint-Georges-de-Noisné;401;6569718;62178;165;4096017;236;2473701;16383;1949
70135;Charmes-Saint-Valbert;29;475122;10115;14;333796;15;141326;16384;1950
09025;Aucazein;43;704502;16308;20;464260;23;240242;16384;1951
82111;Miramont-de-Quercy;177;2899941;68977;67;1846627;110;1053314;16384;1952
2A062;Carbuccia;229;3751984;106136;98;2646893;131;1105091;16384;1953
62351;Fouquières-lès-Lens;3339;54708127;1393378;1308;35892527;2031;18815600;16385;1954
53079;Couesmes-Vaucé;208;3408038;13476;83;2186318;125;1221720;16385;1955
23209;Saint-Loup;118;1933457;29377;49;1211231;69;722226;16385;1956
33249;Lormont;11270;184677887;5344522;4825;127440427;6445;57237460;16387;1957
88451;Senones;1555;25484355;842247;596;16450123;959;9034232;16389;1958
22115;Lanrivain;258;4228469;75966;92;2600038;166;1628431;16389;1959
37039;Bridoré;318;5212048;80596;127;3333718;191;1878330;16390;1960
86059;Chapelle-Viviers;277;4540289;64115;103;2950646;174;1589643;16391;1961
09166;Leychert;65;1065430;14076;26;716400;39;349030;16391;1962
81077;Curvalle;275;4508056;115312;94;2845441;181;1662615;16393;1963
24485;Saint-Pierre-de-Côle;265;4344316;91890;100;2804416;165;1539900;16394;1964
50557;Saint-Symphorien-des-Monts;82;1344427;8843;38;890217;44;454210;16395;1965
88314;Morizécourt;85;1393709;33385;42;986870;43;406839;16397;1966
24034;Beleymas;145;2377579;55808;50;1641189;95;736390;16397;1967
86270;Thollet;104;1705336;59094;42;1132967;62;572369;16397;1968
32125;Espas;72;1180696;32718;28;783241;44;397455;16399;1969
97406;La Plaine-des-Palmistes;2866;46999970;752142;753;26308630;2113;20691340;16399;1970
54237;Grimonviller;59;967604;20074;28;670117;31;297487;16400;1971
52217;Germainvilliers;59;967606;27846;29;719918;30;247688;16400;1972
33351;Reignac;862;14137261;389582;316;9174352;546;4962909;16401;1973
63274;Perpezat;220;3608528;-6136;77;2068680;143;1539848;16402;1974
12210;Saint-André-de-Najac;241;3953106;73494;73;2308780;168;1644326;16403;1975
17471;La Villedieu;138;2263862;53942;57;1533412;81;730450;16405;1976
52520;Vicq;100;1640813;25366;38;966741;62;674072;16408;1977
01416;Tenay;644;10566864;265309;292;7398609;352;3168255;16408;1978
07158;Mézilhac;67;1099480;25027;26;669798;41;429682;16410;1979
59324;Jeumont;5480;89932225;3344034;2184;62148280;3296;27783945;16411;1980
50261;Lamberville;93;1526235;-246;40;999576;53;526659;16411;1981
81123;Lacapelle-Ségalar;53;869911;10270;24;626249;29;243662;16413;1982
07047;Cellier-du-Luc;46;755019;28205;21;530209;25;224810;16413;1983
31342;Milhas;109;1789070;51833;48;1246789;61;542281;16413;1984
15170;Saint-Amandin;150;2462148;50130;62;1627140;88;835008;16414;1985
54555;Vaxainville;47;771509;4746;23;587811;24;183698;16415;1986
15022;Bonnac;109;1789342;33760;44;1230565;65;558777;16416;1987
46286;Saint-Paul-de-Vern;113;1855106;32452;43;1198462;70;656644;16417;1988
36175;Rouvres-les-Bois;189;3102836;48887;79;1969229;110;1133607;16417;1989
30134;Issirac;134;2199950;57544;46;1449679;88;750271;16418;1990
23098;Jalesches;64;1050743;59025;22;662348;42;388395;16418;1991
2B248;Prato-di-Giovellina;23;377626;5271;11;232646;12;144980;16419;1992
11078;Castelreng;116;1904626;46140;47;1392715;69;511911;16419;1993
2A146;Loreto-di-Tallano;43;706129;35973;18;536964;25;169165;16422;1994
24099;Champeaux-et-la-Chapelle-Pommier;108;1773557;76691;39;1235593;69;537964;16422;1995
23266;La Villetelle;102;1675039;56680;41;1145918;61;529121;16422;1996
21214;Crugey;115;1888586;27910;59;1337842;56;550744;16422;1997
25247;Fontenelle-Montby;53;870393;5914;19;454525;34;415868;16423;1998
14440;Montamy;44;722598;13734;16;462689;28;259909;16423;1999
97114;Goyave;4075;66926421;2043654;1201;43819754;2874;23106667;16424;2000
61464;Sées;2619;43016176;1234970;990;28734427;1629;14281749;16425;2001
08420;Signy-le-Petit;740;12154506;373063;260;7644232;480;4510274;16425;2002
03178;Montaiguët-en-Forez;167;2742998;34561;63;1651617;104;1091381;16425;2003
63440;Valbeleix;86;1412562;24620;35;918408;51;494154;16425;2004
24424;Saint-Jean-d'Ataux;77;1264788;34749;35;870237;42;394551;16426;2005
50195;Gathemo;136;2233940;8770;58;1406849;78;827091;16426;2006
08277;Marlemont;68;1117000;-5922;24;592391;44;524609;16426;2007
39394;Onoz;52;854221;22090;22;558571;30;295650;16427;2008
63142;Échandelys;149;2447699;59242;64;1582701;85;864998;16428;2009
63468;Vollore-Montagne;196;3219824;48265;78;2023591;118;1196233;16428;2010
17464;Vergné;88;1446017;32777;35;981617;53;464400;16432;2011
34142;Lodève;4509;74098849;2580128;1666;49690235;2843;24408614;16434;2012
11409;Vignevieille;50;821779;4578;18;524232;32;297547;16436;2013
63174;Grandval;73;1199897;44191;33;848202;40;351695;16437;2014
16364;Sauvagnac;38;624720;22105;15;415989;23;208731;16440;2015
58027;Beaumont-la-Ferrière;68;1117932;28834;24;705447;44;412485;16440;2016
58296;Tresnay;90;1479668;19998;28;904469;62;575199;16441;2017
08094;Cernion;26;427470;2331;12;273824;14;153646;16441;2018
09257;Sainte-Croix-Volvestre;421;6922851;248663;157;4549409;264;2373442;16444;2019
15123;Méallet;113;1858387;33241;41;1142086;72;716301;16446;2020
55363;Moulotte;55;904778;572;19;440686;36;464092;16451;2021
63434;Tours-sur-Meymont;334;5494846;107212;138;3525726;196;1969120;16452;2022
53080;Couptrain;86;1414844;29850;29;768427;57;646417;16452;2023
24021;Badefols-d'Ans;280;4606655;146796;108;3059755;172;1546900;16452;2024
46141;Lacam-d'Ourcet;62;1020057;14616;20;658388;42;361669;16453;2025
16373;Souvigné;123;2023693;39198;42;1225321;81;798372;16453;2026
55076;Bréhéville;100;1645295;19073;36;1006881;64;638414;16453;2027
15145;Oradour;167;2747649;41972;61;1652876;106;1094773;16453;2028
88520;Les Voivres;168;2764752;14799;66;1652430;102;1112322;16457;2029
29127;Loc-Eguiner-Saint-Thégonnec;184;3028471;28650;72;1889175;112;1139296;16459;2030
08037;Auvillers-les-Forges;465;7653657;156077;201;5243712;264;2409945;16459;2031
30080;Chamborigaud;445;7324487;256433;173;5032996;272;2291491;16460;2032
88310;Monthureux-sur-Saône;560;9217691;277860;202;6022950;358;3194741;16460;2033
07012;Arcens;236;3884944;61426;103;2542029;133;1342915;16462;2034
88346;La Petite-Raon;469;7720690;183989;185;4871739;284;2848951;16462;2035
17116;Consac;136;2238847;40744;55;1469216;81;769631;16462;2036
65144;Cheust;56;921928;18035;27;662244;29;259684;16463;2037
12112;Graissac;118;1942733;55328;47;1325518;71;617215;16464;2038
04150;Piégut;83;1366696;11804;35;902980;48;463716;16466;2039
07088;Faugères;61;1004469;38174;22;668811;39;335658;16467;2040
43095;Fix-Saint-Geneys;84;1383204;20337;34;857913;50;525291;16467;2041
12068;Colombiès;545;8974441;154069;205;5756683;340;3217758;16467;2042
82041;Cazals;131;2157177;68087;48;1354840;83;802337;16467;2043
47296;Ségalas;97;1597332;39023;39;1095969;58;501363;16467;2044
82077;Labarthe;195;3211269;90920;59;1946310;136;1264959;16468;2045
59390;Masny;2325;38288695;956735;878;25199659;1447;13089036;16468;2046
15040;Chanterelle;79;1300995;38628;26;849925;53;451070;16468;2047
08255;Linay;123;2025635;34662;45;1235009;78;790626;16469;2048
04099;Lambruisse;54;889354;22115;22;593627;32;295727;16470;2049
50312;Le Mesnil-Gilbert;89;1465814;25401;35;948428;54;517386;16470;2050
12065;Centrès;321;5287197;98290;116;3416723;205;1870474;16471;2051
09075;Campagne-sur-Arize;185;3047925;124613;69;2101264;116;946661;16475;2052
26364;Vassieux-en-Vercors;188;3097448;64314;78;2071310;110;1026138;16476;2053
33155;Escaudes;104;1713484;64319;44;1272426;60;441058;16476;2054
2B155;Matra;34;560228;52702;13;453420;21;106808;16477;2055
22216;Plougonver;429;7068940;146673;154;4454291;275;2614649;16478;2056
62109;Bergueneuse;128;2109166;57842;55;1468043;73;641123;16478;2057
15006;Anglards-de-Salers;475;7827257;164355;186;4828068;289;2999189;16478;2058
21090;Boudreville;41;675698;12452;15;371409;26;304289;16480;2059
58142;Limanton;154;2538175;72411;60;1630578;94;907597;16482;2060
46212;Orniac;45;741692;16368;19;465700;26;275992;16482;2061
15147;Parlan;209;3444960;100447;91;2471511;118;973449;16483;2062
03175;Monestier;159;2621126;44147;65;1688629;94;932497;16485;2063
11068;Capendu;911;15018675;328905;345;9401876;566;5616799;16486;2064
11150;Fontiers-Cabardès;219;3610587;39185;78;2113703;141;1496884;16487;2065
26135;Ferrassières;74;1220044;30979;32;828958;42;391086;16487;2066
19142;Monestier-Port-Dieu;77;1269506;14651;32;769892;45;499614;16487;2067
70400;Ouge;66;1088157;11863;29;744662;37;343495;16487;2068
61137;Craménil;86;1418008;34978;39;999355;47;418653;16488;2069
17173;La Genétouze;138;2275557;65899;52;1527533;86;748024;16490;2070
58107;Dun-sur-Grandry;100;1649101;42220;42;1109832;58;539269;16491;2071
62437;Herly;186;3067452;62435;57;1732228;129;1335224;16492;2072
31236;Herran;39;643182;25857;16;462756;23;180426;16492;2073
2A163;Monacia-d'Aullène;278;4585380;156981;113;3077859;165;1507521;16494;2074
31522;Salerm;33;544309;16315;12;355715;21;188594;16494;2075
09160;Lavelanet;3863;63719512;2041087;1432;40889753;2431;22829759;16495;2076
24050;Borrèze;195;3216644;58580;79;2100443;116;1116201;16496;2077
11428;Villemagne;165;2721817;63553;69;1953637;96;768180;16496;2078
09290;Sentein;99;1633105;79955;42;1139394;57;493711;16496;2079
51361;Le Meix-Tiercelin;104;1715724;30300;39;1251928;65;463796;16497;2080
88010;Aouze;106;1748927;20211;40;964609;66;784318;16499;2081
65210;Grust;27;445504;4106;12;269712;15;175792;16500;2082
63264;Orcival;163;2689717;74329;77;1945209;86;744508;16501;2083
55411;Rambluzin-et-Benoite-Vaux;52;858071;32990;20;562561;32;295510;16501;2084
05117;Ribeyret;67;1105595;20579;25;711139;42;394456;16501;2085
63225;Messeix;739;12195045;237141;318;7631953;421;4563092;16502;2086
16242;Nanteuil-en-Vallée;827;13647855;380305;321;9113550;506;4534305;16503;2087
66029;Caixas;74;1221223;42003;26;838823;48;382400;16503;2088
49095;Chenillé-Changé;88;1452282;61720;21;797157;67;655125;16503;2089
14710;Tréprel;58;957255;6408;27;633566;31;323689;16504;2090
79063;Cersay;559;9226167;105868;215;5805273;344;3420894;16505;2091
14138;Cartigny-l'Épinay;161;2657273;19704;66;1677476;95;979797;16505;2092
65337;Orieux;65;1072883;37558;28;779185;37;293698;16506;2093
15165;Rouffiac;121;1997448;68955;48;1387634;73;609814;16508;2094
81012;Andillac;71;1172059;20262;23;720822;48;451237;16508;2095
47292;Sauveterre-la-Lémance;322;5315554;132995;122;3332813;200;1982741;16508;2096
89248;Menades;31;511757;8368;15;409873;16;101884;16508;2097
08069;Blanchefosse-et-Bay;92;1518771;26362;34;929780;58;588991;16508;2098
21554;Saint-Jean-de-Losne;725;11968837;447427;260;7841875;465;4126962;16509;2099
24541;Soudat;47;775924;8258;17;504237;30;271687;16509;2100
09108;Durban-sur-Arize;105;1733549;33031;50;1287809;55;445740;16510;2101
36145;Obterre;130;2146395;58488;48;1409070;82;737325;16511;2102
09218;Orgeix;49;809053;19723;24;601149;25;207904;16511;2103
56182;Priziac;605;9990177;215232;250;6523169;355;3467008;16513;2104
11021;Axat;336;5548366;167352;132;3836389;204;1711977;16513;2105
50024;Auxais;99;1634883;10014;40;1056176;59;578707;16514;2106
59261;Glageon;985;16266770;456467;419;11250142;566;5016628;16514;2107
64355;Louvigny;59;974404;-16364;17;506462;42;467942;16515;2108
26248;Pontaix;98;1618549;31270;41;1066862;57;551687;16516;2109
59491;Raismes;7272;120104872;4030182;2886;81318085;4386;38786787;16516;2110
79349;Villemain;102;1684683;48153;37;1101096;65;583587;16517;2111
07170;Pailharès;177;2923463;66441;69;1959129;108;964334;16517;2112
12285;Vabre-Tizac;235;3881852;26644;94;2401154;141;1480698;16519;2113
30108;L'Estréchure;100;1651876;21955;43;1122383;57;529493;16519;2114
63383;Saint-Pierre-Colamine;156;2577027;60168;75;1909406;81;667621;16519;2115
32166;Justian;54;892050;19904;21;626596;33;265454;16519;2116
62590;Monts-en-Ternois;35;578220;5651;18;461023;17;117197;16521;2117
16391;Tuzie;84;1387739;18763;31;877593;53;510146;16521;2118
73230;Saint-Colomban-des-Villards;108;1784268;64184;55;1333189;53;451079;16521;2119
58272;Sardy-lès-Épiry;77;1272125;21363;29;709526;48;562599;16521;2120
69199;Saint-Fons;8969;148192632;3671405;3893;99413940;5076;48778692;16523;2121
21454;Nicey;88;1454130;51075;39;1054486;49;399644;16524;2122
36134;Mouhet;292;4825376;132631;108;3060372;184;1765004;16525;2123
89176;Fontenay-près-Vézelay;88;1454225;40828;41;1004436;47;449789;16525;2124
2B219;Piedicroce;64;1057698;37253;27;753806;37;303892;16527;2125
2B267;Saliceto;33;545395;17297;14;353504;19;191891;16527;2126
43093;Félines;177;2925446;58940;71;1953306;106;972140;16528;2127
64271;Iholdy;284;4694091;80025;102;3015770;182;1678321;16528;2128
63388;Saint-Priest-des-Champs;427;7057741;100785;155;4533306;272;2524435;16529;2129
24344;Puyrenier;30;495965;6648;12;317218;18;178747;16532;2130
35044;Broualan;200;3306530;42800;74;2036925;126;1269605;16533;2131
52450;Saint-Loup-sur-Aujon;90;1488061;23327;36;986917;54;501144;16534;2132
23081;Flayat;207;3422623;85008;71;1941583;136;1481040;16534;2133
55170;Écurey-en-Verdunois;79;1306324;21329;29;727270;50;579054;16536;2134
03177;Monétay-sur-Loire;165;2728520;60103;56;1621979;109;1106541;16536;2135
24071;Bussière-Badil;219;3621604;72721;80;2312968;139;1308636;16537;2136
10171;Hampigny;140;2315500;44148;57;1496388;83;819112;16539;2137
81279;La Sauzière-Saint-Jean;155;2563624;60010;63;1688342;92;875282;16540;2138
86069;La Chaussée;117;1935132;38233;57;1391528;60;543604;16540;2139
12248;Saint-Sernin-sur-Rance;309;5110920;117022;122;3362823;187;1748097;16540;2140
36150;Parnac;337;5574137;168579;127;3674563;210;1899574;16540;2141
60522;Quinquempoix;191;3159415;71279;83;2345845;108;813570;16541;2142
34055;Castanet-le-Haut;93;1538433;24599;33;931175;60;607258;16542;2143
31276;Larroque;179;2961123;104284;66;2018825;113;942298;16543;2144
36204;Saint-Michel-en-Brenne;207;3424383;175524;76;2372462;131;1051921;16543;2145
05089;Montrond;41;678351;9579;17;405379;24;272972;16545;2146
82024;Brassac;136;2250207;31472;46;1308894;90;941313;16546;2147
2B173;Muro;163;2697203;147436;59;1857686;104;839517;16547;2148
43066;Chaudeyrolles;48;794280;15414;18;515478;30;278802;16548;2149
26025;Barnave;92;1522579;11798;30;898554;62;624025;16550;2150
03131;Isserpent;314;5196795;152893;125;3496791;189;1700004;16550;2151
33382;Saint-Christoly-de-Blaye;1096;18139158;449791;425;11895961;671;6243197;16550;2152
19257;Sérilhac;164;2714319;56960;54;1651637;110;1062682;16551;2153
86175;Nalliers;193;3194331;54191;73;2023298;120;1171033;16551;2154
26055;Boulc;62;1026290;39276;23;778865;39;247425;16553;2155
46319;Théminettes;94;1556019;32810;37;1000812;57;555207;16553;2156
16124;Écuras;350;5794545;113429;134;3626473;216;2168072;16556;2157
02608;Plomion;274;4536527;112911;117;2965281;157;1571246;16557;2158
07048;Chalencon;192;3178940;80279;71;1995052;121;1183888;16557;2159
11104;Counozouls;30;496739;9926;14;331631;16;165108;16558;2160
59616;Vieux-Condé;5725;94803320;2731008;2310;64712593;3415;30090727;16560;2161
33429;Saint-Léger-de-Balson;183;3030506;38584;73;1916851;110;1113655;16560;2162
64336;Lescun;97;1606371;78226;34;1111810;63;494561;16561;2163
04028;Beynes;77;1275235;32755;33;882678;44;392557;16561;2164
70247;Fouvent-Saint-Andoche;140;2318666;46554;58;1548212;82;770454;16562;2165
25408;Montussaint;37;612828;13474;18;448213;19;164615;16563;2166
16195;Lussac;163;2699799;57471;64;1756113;99;943686;16563;2167
89349;Saint-Léger-Vauban;255;4223621;169410;95;2927421;160;1296200;16563;2168
30022;Aujac;97;1606781;61368;35;1061639;62;545142;16565;2169
49380;Vaulandry;174;2882279;39215;76;1932771;98;949508;16565;2170
58078;Cizely;33;546651;16333;12;332025;21;214626;16565;2171
77305;Montereau-Fault-Yonne;9726;161114378;5986255;3936;109563893;5790;51550485;16565;2172
88298;Ménarmont;40;662620;6447;21;493514;19;169106;16566;2173
2B190;Olmi-Cappella;95;1573940;73821;42;1176978;53;396962;16568;2174
15001;Allanche;556;9212450;280182;216;6036957;340;3175493;16569;2175
08010;Ambly-Fleury;82;1358717;32294;34;855133;48;503584;16570;2176
14367;Lison;259;4291768;118447;94;2762352;165;1529416;16571;2177
2B153;Manso;70;1160067;50574;30;870501;40;289566;16572;2178
69185;Saint-Christophe;135;2237674;45637;58;1438932;77;798742;16575;2179
03249;Saint-Palais;116;1922774;50935;43;1258681;73;664093;16576;2180
2A061;Carbini;53;878542;32099;26;650838;27;227704;16576;2181
47014;Armillac;104;1724012;16213;33;949109;71;774903;16577;2182
58289;Ternant;117;1939530;44855;38;1128454;79;811076;16577;2183
88377;Regnévelle;84;1392486;20035;37;895628;47;496858;16577;2184
64455;Portet;104;1724146;42882;39;1097325;65;626821;16578;2185
71163;Curtil-sous-Buffières;52;862080;16662;24;558174;28;303906;16578;2186
2B250;Prunelli-di-Casacconi;112;1856844;62642;52;1336778;60;520066;16579;2187
32138;Garravet;97;1608200;36136;39;1027052;58;581148;16579;2188
11128;Escueillens-et-Saint-Just-de-Bélengard;97;1608265;80150;33;1023857;64;584408;16580;2189
09042;La Bastide-de-Sérou;636;10546077;366466;247;7396673;389;3149404;16582;2190
37146;Marcilly-sur-Maulne;125;2072804;51238;55;1440827;70;631977;16582;2191
62095;Beaumetz-lès-Aire;122;2023089;47031;46;1332187;76;690902;16583;2192
03281;Le Theil;258;4278573;90491;106;2703034;152;1575539;16584;2193
09006;Alliat;28;464358;13728;12;326778;16;137580;16584;2194
25547;Sochaux;2397;39752756;1340049;1099;27985074;1298;11767682;16584;2195
11124;Durban-Corbières;388;6434879;197303;138;4081458;250;2353421;16585;2196
33379;Saint-Brice;199;3300394;127533;74;2349278;125;951116;16585;2197
30339;Valleraugue;639;10597928;381976;250;7258580;389;3339348;16585;2198
76295;Gaillefontaine;788;13069520;412144;330;8847082;458;4222438;16586;2199
11396;Trausse;295;4893194;69962;104;2761020;191;2132174;16587;2200
2B337;Valle-di-Rostino;65;1078216;27331;27;674663;38;403553;16588;2201
65148;Cizos;81;1343779;31176;36;912195;45;431584;16590;2202
04190;Saint-Martin-les-Eaux;56;929088;19686;27;682060;29;247028;16591;2203
34232;Roquebrun;372;6172507;222805;134;4206316;238;1966191;16593;2204
16115;Cressac-Saint-Genis;96;1592965;39040;38;1013953;58;579012;16593;2205
81247;Saint-Cirgue;114;1891683;21680;43;1262138;71;629545;16594;2206
82128;Montfermier;53;879513;10039;19;590815;34;288698;16595;2207
70335;Maussans;35;580878;6644;15;361006;20;219872;16597;2208
2B195;Ortiporio;68;1128621;52100;23;785175;45;343446;16597;2209
39018;Aromas;304;5045613;311893;106;3850047;198;1195566;16597;2210
11004;Alaigne;175;2904722;126011;62;1968518;113;936204;16598;2211
70350;Molay;41;680539;15284;18;446104;23;234435;16599;2212
22328;Saint-Servais;242;4016852;63882;105;2767512;137;1249340;16599;2213
58191;Neuilly;77;1278191;29364;31;786363;46;491828;16600;2214
30119;Fressac;100;1660101;37798;40;1170065;60;490036;16601;2215
23122;Mansat-la-Courrière;54;896495;21022;24;626717;30;269778;16602;2216
62222;Chériennes;93;1544378;42050;39;1026583;54;517795;16606;2217
22342;Trébédan;217;3603929;19325;101;2415979;116;1187950;16608;2218
46333;Vidaillac;98;1627678;28643;38;967515;60;660163;16609;2219
03046;Buxières-les-Mines;669;11111774;247595;268;7185604;401;3926170;16610;2220
21313;Gurgy-le-Château;27;448458;7869;13;281811;14;166647;16610;2221
12080;Coupiac;266;4418496;178629;101;2840600;165;1577896;16611;2222
16390;Tusson;149;2475461;69371;65;1678276;84;797185;16614;2223
36004;Anjouin;210;3489118;76667;86;2203477;124;1285641;16615;2224
16251;Oriolles;155;2575397;29775;56;1512156;99;1063241;16615;2225
59327;Lallaing;3426;56927206;1251567;1348;36277422;2078;20649784;16616;2226
61390;Saint-Georges-d'Annebecq;84;1395866;11691;36;939990;48;455876;16617;2227
15070;Fontanges;138;2293212;53992;48;1408026;90;885186;16617;2228
33247;Listrac-de-Durèze;90;1495625;22622;38;1075840;52;419785;16618;2229
63007;Apchat;122;2027446;44178;53;1408294;69;619152;16618;2230
23233;Saint-Pierre-le-Bost;95;1578749;42329;30;1027066;65;551683;16618;2231
52304;Malaincourt-sur-Meuse;32;531836;9766;17;382707;15;149129;16620;2232
19119;Lostanges;76;1263153;30079;32;817028;44;446125;16620;2233
58029;Beuvron;63;1047147;16234;32;747973;31;299174;16621;2234
2B097;Costa;38;631658;18992;22;477181;16;154477;16623;2235
17223;Massac;100;1662485;60441;41;1154919;59;507566;16625;2236
19036;Chamberet;837;13916481;477663;337;9531322;500;4385159;16627;2237
87016;Les Billanges;173;2876528;39571;71;1946861;102;929667;16627;2238
31363;Montbernard;134;2228167;30479;58;1611582;76;616585;16628;2239
60414;Montataire;6989;116214805;3179766;2947;78271064;4042;37943741;16628;2240
52403;Praslay;39;648635;15634;14;380919;25;267716;16632;2241
16308;Saint-Claud;666;11076836;480481;250;7713390;416;3363446;16632;2242
64390;Moncaup;88;1463705;32307;31;874560;57;589145;16633;2243
2A091;Cognocoli-Monticchi;108;1796596;103617;44;1257460;64;539136;16635;2244
33166;Le Fieu;272;4524854;56992;100;2782130;172;1742724;16635;2245
07109;Joannas;195;3244018;53632;87;2269529;108;974489;16636;2246
65093;Bize;121;2013038;34517;46;1232571;75;780467;16637;2247
81267;Saint-Pierre-de-Trivisy;376;6255408;186953;141;4052490;235;2202918;16637;2248
62413;Harnes;6886;114562539;3107518;2727;75814263;4159;38748276;16637;2249
63435;Tourzel-Ronzières;133;2213084;21200;52;1396071;81;817013;16640;2250
34278;Saint-Michel;33;549112;12348;15;396715;18;152397;16640;2251
18193;Rezay;149;2479372;55944;61;1659008;88;820364;16640;2252
34305;Le Soulié;74;1231537;57355;31;874995;43;356542;16642;2253
40136;Lacajunte;76;1264880;31051;29;787788;47;477092;16643;2254
31279;Latour;53;882096;26692;26;643851;27;238245;16643;2255
05138;Saint-Disdier;82;1364811;35070;37;948093;45;416718;16644;2256
07335;Vaudevant;107;1780933;38895;49;1221973;58;558960;16644;2257
50029;Barenton;745;12400096;270206;311;8647739;434;3752357;16644;2258
63346;Saint-Genès-Champespe;144;2396848;79719;54;1558359;90;838489;16645;2259
88238;Hennezel;236;3928542;85208;100;2439218;136;1489324;16646;2260
79187;Moutiers-sous-Argenton;334;5560397;57262;127;3453147;207;2107250;16648;2261
2A118;Fozzano;133;2214376;66355;47;1379383;86;834993;16649;2262
88370;Rancourt;39;649381;12567;18;473594;21;175787;16651;2263
04155;Prads-Haute-Bléone;116;1931545;57941;45;1268287;71;663258;16651;2264
16164;Hiesse;159;2647564;64261;63;1710120;96;937444;16651;2265
07116;Labégude;923;15369217;470525;395;10528920;528;4840297;16651;2266
62430;Hénu;80;1332305;24398;29;796688;51;535617;16654;2267
63452;Verrières;37;616194;3505;15;390091;22;226103;16654;2268
02036;Augy;50;832787;6178;19;464000;31;368787;16656;2269
70074;Blondefontaine;159;2648596;40170;77;1808694;82;839902;16658;2270
56245;Silfiac;241;4014737;138014;86;2451320;155;1563417;16659;2271
07040;Boucieu-le-Roi;181;3015472;58175;80;2127935;101;887537;16660;2272
16270;Pressignac;236;3932117;126690;75;2250776;161;1681341;16662;2273
44121;Petit-Auverné;236;3932297;63004;105;2702528;131;1229769;16662;2274
86134;Linazay;135;2249453;41502;52;1500830;83;748623;16663;2275
2B009;Aléria;1347;22446145;930479;509;15936231;838;6509914;16664;2276
54068;Beuvezin;67;1116611;19248;28;757700;39;358911;16666;2277
12156;Montpeyroux;308;5133305;140563;108;3199051;200;1934254;16667;2278
43116;Laval-sur-Doulon;33;550013;29432;11;361462;22;188551;16667;2279
29054;La Feuillée;399;6650453;161172;180;4598064;219;2052389;16668;2280
87007;Balledent;117;1950145;44616;48;1243801;69;706344;16668;2281
70406;Percey-le-Grand;66;1100086;18924;30;702255;36;397831;16668;2282
12251;Saint-Victor-et-Melvieu;197;3283890;50828;80;2097378;117;1186512;16669;2283
79074;La Chapelle-Pouilloux;109;1816978;30815;39;1139177;70;677801;16670;2284
36189;Saint-Denis-de-Jouhet;615;10251775;263684;249;6809378;366;3442397;16670;2285
14183;Cossesseville;59;983518;9419;26;643257;33;340261;16670;2286
58233;Saint-Benin-des-Bois;104;1733669;57501;46;1191569;58;542100;16670;2287
97222;Le Robert;13130;218875805;7014180;4125;146032622;9005;72843183;16670;2288
46245;Sabadel-Lauzès;65;1083552;49147;28;788846;37;294706;16670;2289
03274;Sorbier;171;2850742;84688;67;1850025;104;1000717;16671;2290
23129;La Mazière-aux-Bons-Hommes;37;616855;2663;11;372290;26;244565;16672;2291
31030;Ausseing;39;650247;8901;16;417316;23;232931;16673;2292
88123;Damblain;159;2651459;47532;76;1768554;83;882905;16676;2293
50200;Ger;505;8421335;175817;191;5381715;314;3039620;16676;2294
63441;Valcivières;142;2368053;43867;56;1444000;86;924053;16676;2295
43226;Saint-Vert;57;950610;49821;22;712295;35;238315;16677;2296
43055;Chaniat;92;1534451;25987;38;996979;54;537472;16679;2297
50124;La Chapelle-Urée;77;1284311;25553;30;802965;47;481346;16679;2298
54040;Badonviller;945;15762377;398622;362;10430244;583;5332133;16680;2299
23022;Bétête;234;3903065;90075;93;2567726;141;1335339;16680;2300
2B344;Verdèse;24;400326;20072;11;304373;13;95953;16680;2301
55275;Lamouilly;50;834055;6500;18;453308;32;380747;16681;2302
62191;Caffiers;419;6990222;140142;164;4724954;255;2265268;16683;2303
24405;Saint-Félix-de-Villadeix;188;3136431;125586;75;2186976;113;949455;16683;2304
48156;Saint-Germain-du-Teil;465;7757936;298207;199;5815132;266;1942804;16684;2305
63355;Saint-Gervais-sous-Meymont;151;2519700;57208;62;1640353;89;879347;16687;2306
22267;Rouillac;210;3504289;44527;87;2233954;123;1270335;16687;2307
88102;Chermisey;57;951219;9289;24;583703;33;367516;16688;2308
23116;Mainsat;401;6692119;167625;142;4332406;259;2359713;16689;2309
57166;Dalhain;61;1018106;-2406;20;567656;41;450450;16690;2310
16424;Yviers;328;5474729;136521;124;3664372;204;1810357;16691;2311
12041;Cabanès;135;2253346;46453;53;1441589;82;811757;16691;2312
07273;Saint-Maurice-d'Ibie;131;2186602;42052;50;1419040;81;767562;16692;2313
24183;Fleurac;151;2520717;105646;49;1768481;102;752236;16693;2314
2B229;Pietroso;171;2854626;96517;76;1961097;95;893529;16694;2315
66071;Estagel;1165;19448506;526775;477;13221589;688;6226917;16694;2316
58117;Fourchambault;2886;48180938;1431296;1254;33420576;1632;14760362;16695;2317
82144;Puycornet;349;5827227;76309;138;3676104;211;2151123;16697;2318
17276;Le Pin;44;734665;15949;20;543156;24;191509;16697;2319
88212;Grand;264;4408326;131014;100;2911816;164;1496510;16698;2320
70359;Montcourt;31;517651;3555;12;320297;19;197354;16698;2321
39243;Froideville;45;751524;14208;20;487033;25;264491;16701;2322
62862;Vincly;65;1085601;25026;24;685301;41;400300;16702;2323
86269;Ternay;117;1954249;27218;49;1235758;68;718491;16703;2324
43129;Le Mas-de-Tence;106;1770564;45287;40;1090179;66;680385;16703;2325
62249;Courcelles-lès-Lens;3202;53489900;1120238;1287;34327609;1915;19162291;16705;2326
25504;Rosureux;52;868704;30820;20;504224;32;364480;16706;2327
36246;Villiers;116;1937952;27761;48;1237679;68;700273;16706;2328
19141;Monestier-Merlines;153;2556236;96131;71;1928603;82;627633;16707;2329
24184;Florimont-Gaumier;92;1537168;37057;33;924960;59;612208;16708;2330
32355;Sadeillan;49;818711;5034;17;492545;32;326166;16708;2331
36049;Chazelet;79;1320134;21136;34;884508;45;435626;16711;2332
63314;Saint-Amant-Roche-Savine;294;4912916;139092;120;3409009;174;1503907;16711;2333
34160;Mons;379;6333805;196554;157;4346806;222;1986999;16712;2334
03041;Le Brethon;220;3676676;104770;87;2574616;133;1102060;16712;2335
53093;La Dorée;181;3024982;72296;68;1850119;113;1174863;16713;2336
82162;Saint-Georges;128;2139284;23984;53;1404467;75;734817;16713;2337
49354;Le Tremblay;190;3175747;32917;84;2126889;106;1048858;16714;2338
65263;Larroque;61;1019727;20089;25;607243;36;412484;16717;2339
02135;Buironfosse;658;11000664;360391;263;7409005;395;3591659;16718;2340
17287;Pouillac;139;2324143;35216;61;1591075;78;733068;16720;2341
71473;Saint-Racho;111;1856022;42375;48;1295718;63;560304;16721;2342
09281;Sautel;70;1170466;19559;32;757361;38;413105;16721;2343
87092;Marval;345;5769812;179853;124;3576726;221;2193086;16724;2344
76711;Le Tréport;3222;53886543;1776885;1398;37412492;1824;16474051;16725;2345
65477;Villenave-près-Marsac;41;685748;12787;22;484027;19;201721;16726;2346
08360;Renneville;117;1956949;62848;37;1291554;80;665395;16726;2347
88450;Senaide;119;1990585;53970;46;1305732;73;684853;16728;2348
12091;Drulhe;260;4349297;44738;107;2782267;153;1567030;16728;2349
16041;Bessac;78;1304853;23216;24;712947;54;591906;16729;2350
24277;Monfaucon;166;2777293;57378;64;1803973;102;973320;16731;2351
09117;Esplas;55;920227;8013;15;464301;40;455926;16731;2352
26215;La Motte-Chalancon;234;3915166;134081;102;2931539;132;983627;16731;2353
17188;Haimps;262;4383710;99065;108;3103620;154;1280090;16732;2354
24222;La Force;1761;29469164;1086288;725;22033794;1036;7435370;16734;2355
17312;Saint-Bonnet-sur-Gironde;521;8718815;243462;175;5325687;346;3393128;16735;2356
15153;Pleaux;1032;17270828;520610;399;11239683;633;6031145;16735;2357
44044;Conquereuil;579;9690083;111366;223;6149006;356;3541077;16736;2358
07284;Saint-Pierre-Saint-Jean;78;1305439;50503;29;852018;49;453421;16736;2359
19044;La Chapelle-aux-Saints;138;2309671;54655;54;1550966;84;758705;16737;2360
16254;Palluaud;147;2460527;39809;55;1595468;92;865059;16738;2361
17282;Pommiers-Moulons;120;2008751;44427;40;1240176;80;768575;16740;2362
42061;Cherier;282;4720588;47369;119;3035205;163;1685383;16740;2363
65178;Fréchède;29;485463;5225;14;359143;15;126320;16740;2364
42058;Chazelles-sur-Lavieu;149;2494290;9712;62;1549963;87;944327;16740;2365
03186;Montmarault;935;15652331;417781;357;10315236;578;5337095;16740;2366
24245;Loubejac;146;2444181;44251;53;1548868;93;895313;16741;2367
14516;Potigny;1143;19137262;382168;483;12449813;660;6687449;16743;2368
86248;Saint-Secondin;344;5759639;162968;130;3794397;214;1965242;16743;2369
87024;Bujaleuf;543;9092218;241268;213;5756304;330;3335914;16744;2370
24337;Prats-du-Périgord;91;1523799;35234;36;986586;55;537213;16745;2371
17474;Villeneuve-la-Comtesse;427;7150500;151648;153;4431630;274;2718870;16746;2372
50039;Beaucoudray;74;1239233;12861;24;705953;50;533280;16746;2373
23097;Issoudun-Létrieix;174;2914312;51356;72;1837410;102;1076902;16749;2374
12298;Villecomtal;244;4086772;95313;95;2678229;149;1408543;16749;2375
03187;Montoldre;380;6364657;191604;148;4301764;232;2062893;16749;2376
50449;Saint-Aubin-du-Perron;126;2110458;7909;43;1164939;83;945519;16750;2377
81172;Montauriol;32;535991;12247;14;315804;18;220187;16750;2378
82164;Sainte-Juliette;65;1088736;27835;27;768030;38;320706;16750;2379
79267;Saint-Lin;196;3283378;36161;76;2063860;120;1219518;16752;2380
34061;Causses-et-Veyran;338;5662162;142103;119;3524680;219;2137482;16752;2381
2B057;Canale-di-Verde;217;3635237;126840;79;2358341;138;1276896;16752;2382
66019;Bélesta;123;2060602;32250;51;1438409;72;622193;16753;2383
80711;Saint-Ouen;1085;18177282;312737;428;12164575;657;6012707;16753;2384
70468;Saint-Marcel;60;1005203;6560;27;646105;33;359098;16753;2385
08412;Senuc;83;1390535;39985;29;877283;54;513252;16753;2386
02476;Mennevret;359;6015184;146833;162;4235981;197;1779203;16755;2387
14143;Caumont-l'Éventé;761;12750870;349741;296;8301591;465;4449279;16755;2388
71440;Saint-Léger-sous-Beuvray;246;4121906;78967;90;2578677;156;1543229;16756;2389
52358;Noyers;48;804297;8500;18;430536;30;373761;16756;2390
56014;Berné;920;15416626;433841;385;10857053;535;4559573;16757;2391
16376;Suris;171;2865492;52461;67;1906481;104;959011;16757;2392
52008;Andelot-Blancheville;557;9334060;331023;224;6318981;333;3015079;16758;2393
12293;Veyreau;63;1055746;13180;24;631621;39;424125;16758;2394
12228;Saint-Izaire;197;3301726;82172;71;2083221;126;1218505;16760;2395
23048;Champagnat;261;4374448;130386;105;3013307;156;1361141;16760;2396
47189;Montignac-Toupinerie;84;1407947;27240;32;892775;52;515172;16761;2397
54357;Maxéville;4932;82669316;2945932;2147;60054702;2785;22614614;16762;2398
03231;Saint-Fargeol;129;2162277;82376;52;1449997;77;712280;16762;2399
88433;Saint-Prancher;42;704001;788;16;391996;26;312005;16762;2400
40127;Hontanx;312;5229941;93413;141;3607016;171;1622925;16763;2401
46162;Lauzès;109;1827134;60861;34;1199885;75;627249;16763;2402
02681;Saint-Gobert;166;2782683;61968;69;1879899;97;902784;16763;2403
03208;Le Pin;208;3486886;44177;75;1956513;133;1530373;16764;2404
07233;Saint-Étienne-de-Serre;115;1927868;63515;32;1226758;83;701110;16764;2405
22132;Lohuec;154;2581722;78836;51;1675277;103;906445;16764;2406
09212;Montseron;53;888534;21343;21;563168;32;325366;16765;2407
07127;Lalevade-d'Ardèche;689;11550988;370718;265;7337489;424;4213499;16765;2408
48194;Vialas;280;4694481;169330;117;3507554;163;1186927;16766;2409
44148;Ruffigné;369;6186690;50428;164;4029163;205;2157527;16766;2410
50394;Périers;1432;24010880;620443;570;16057903;862;7952977;16767;2411
2B147;Lozzi;70;1173717;31874;30;844379;40;329338;16767;2412
35111;Le Ferré;373;6254481;73447;153;4054963;220;2199518;16768;2413
80695;Sailly-Saillisel;251;4208880;58858;99;2599075;152;1609805;16768;2414
2A056;Campo;63;1056483;10693;27;645819;36;410664;16770;2415
50268;Lestre;156;2616257;64266;63;1668239;93;948018;16771;2416
22131;Loguivy-Plougras;562;9425944;228522;220;6158141;342;3267803;16772;2417
42252;Saint-Laurent-Rochefort;163;2733900;64060;72;1824713;91;909187;16772;2418
08086;Briquenay;65;1090220;18634;26;673667;39;416553;16773;2419
09184;Mauvezin-de-Sainte-Croix;29;486407;8972;12;330039;17;156368;16773;2420
02079;Besmont;88;1476021;33809;32;877650;56;598371;16773;2421
87034;Champagnac-la-Rivière;347;5820276;153306;150;3973530;197;1846746;16773;2422
2B047;Calacuccia;187;3136672;137674;75;2241668;112;895004;16774;2423
50373;Neuville-au-Plain;59;989701;13932;23;659696;36;330005;16775;2424
64313;Lantabat;125;2096829;46690;39;1214781;86;882048;16775;2425
17050;Bois;289;4848692;88139;119;3193207;170;1655485;16777;2426
58094;Dampierre-sous-Bouhy;318;5335465;161544;127;3499549;191;1835916;16778;2427
47265;Saint-Pastour;216;3624195;57322;85;2353959;131;1270236;16779;2428
62570;Méricourt;6289;105524504;2810426;2453;69351095;3836;36173409;16779;2429
83040;Châteauvieux;43;721567;36730;18;571870;25;149697;16781;2430
29211;Plouyé;432;7249288;215503;158;4652811;274;2596477;16781;2431
22250;Pontrieux;652;10942680;346274;250;6996384;402;3946296;16783;2432
54601;Xures;69;1158051;17441;30;762701;39;395350;16783;2433
10294;Poligny;34;570661;3539;14;322408;20;248253;16784;2434
05114;Réallon;147;2467273;79520;52;1616632;95;850641;16784;2435
64174;Castéra-Loubix;31;520311;9266;11;312920;20;207391;16784;2436
17002;Agudelle;78;1309207;28169;37;922641;41;386566;16785;2437
50090;Buais;321;5388415;107378;122;3420824;199;1967591;16786;2438
29125;Leuhan;471;7907065;114316;187;5001886;284;2905179;16788;2439
31141;Ciadoux;133;2232866;71125;60;1524640;73;708226;16788;2440
47247;Saint-Jean-de-Duras;120;2015051;16024;35;1169823;85;845228;16792;2441
2A031;Bastelica;287;4819386;269366;118;3610212;169;1209174;16792;2442
97109;Gourbeyre;4839;81262500;3153807;1636;56947947;3203;24314553;16793;2443
18225;Saint-Maur;160;2686995;62965;67;1827778;93;859217;16794;2444
60245;Formerie;1226;20589162;743713;491;13850829;735;6738333;16794;2445
72003;Allonnes;6199;104107309;2773977;2736;73411637;3463;30695672;16794;2446
56201;Le Saint;388;6516335;175352;157;4434284;231;2082051;16795;2447
59331;Landrecies;2071;34782426;1140036;783;23552860;1288;11229566;16795;2448
2B136;Lama;93;1562121;50675;37;1147329;56;414792;16797;2449
15232;Tanavelle;153;2569968;34215;71;1662779;82;907189;16797;2450
04090;Le Fugeret;137;2301228;69483;63;1674287;74;626941;16797;2451
52063;Bourg-Sainte-Marie;73;1226315;14036;36;786744;37;439571;16799;2452
59651;Wavrechain-sous-Denain;878;14749656;355051;346;9504949;532;5244707;16799;2453
33287;Mongauzy;342;5745363;104605;148;4078307;194;1667056;16799;2454
62193;Calais;41019;689091025;25203672;16865;489211248;24154;199879777;16799;2455
17037;Beauvais-sur-Matha;387;6501493;288178;148;4635207;239;1866286;16800;2456
85184;Puy-de-Serre;187;3141821;47776;77;2057626;110;1084195;16801;2457
17378;Saint-Palais-de-Négrignac;230;3864308;90148;94;2620196;136;1244112;16801;2458
58109;Entrains-sur-Nohain;562;9442919;277143;234;6219863;328;3223056;16802;2459
12193;Pruines;166;2789205;57399;55;1733200;111;1056005;16802;2460
39346;Montagna-le-Reconduit;68;1142731;16783;22;656841;46;485890;16805;2461
79043;Bouillé-Loretz;620;10419033;220068;234;6544305;386;3874728;16805;2462
65053;Aveux;30;504149;15570;14;366418;16;137731;16805;2463
55348;Montiers-sur-Saulx;248;4168099;80565;105;2805663;143;1362436;16807;2464
43008;Arlempdes;73;1226956;28693;33;857477;40;369479;16808;2465
46002;Albiac;43;722765;3834;20;449972;23;272793;16808;2466
81010;Ambialet;245;4118134;77825;102;2816703;143;1301431;16809;2467
83015;Bauduen;197;3311427;120578;78;2365497;119;945930;16809;2468
33385;Saint-Christophe-de-Double;404;6791131;158612;163;4515434;241;2275697;16810;2469
80296;L'Étoile;711;11952345;357283;310;8266367;401;3685978;16811;2470
65190;Gazave;49;823751;16335;24;563607;25;260144;16811;2471
18216;Saint-Hilaire-en-Lignières;328;5514124;125734;131;3678417;197;1835707;16811;2472
71386;Saint-André-en-Bresse;61;1025531;25082;29;782512;32;243019;16812;2473
58264;Saint-Pierre-le-Moûtier;1258;21152484;564211;530;14420519;728;6731965;16814;2474
61267;Ménil-Hermei;102;1715105;3727;35;923275;67;791830;16815;2475
24269;Mialet;408;6860421;167491;160;4461188;248;2399233;16815;2476
79163;Mairé-Levescault;339;5701014;101005;129;3739229;210;1961785;16817;2477
61181;Gacé;1210;20349610;662076;466;13105866;744;7243744;16818;2478
02444;Lugny;71;1194089;36227;33;822925;38;371164;16818;2479
58084;Corvol-d'Embernard;66;1110054;40109;28;780822;38;329232;16819;2480
23138;Moutier-d'Ahun;113;1900568;63298;43;1255353;70;645215;16819;2481
33113;Cauvignac;75;1261487;8200;29;817231;46;444256;16820;2482
39020;Arsure-Arsurette;52;874644;22717;19;632154;33;242490;16820;2483
26299;Sainte-Croix;60;1009209;26874;22;714206;38;295003;16820;2484
39581;Vitreux;140;2354830;34098;59;1660165;81;694665;16820;2485
43231;Salettes;85;1429798;34888;33;915886;52;513912;16821;2486
71396;Saint-Bonnet-en-Bresse;287;4827734;129669;109;2942266;178;1885468;16821;2487
46308;Soucirac;69;1160744;50454;26;817789;43;342955;16822;2488
62696;Reclinghem;104;1749529;16032;39;1086735;65;662794;16822;2489
55078;Brieulles-sur-Meuse;192;3230034;71046;81;2113108;111;1116926;16823;2490
21216;Culètre;51;857986;10950;23;591993;28;265993;16823;2491
65241;Laborde;58;975750;46258;24;725973;34;249777;16823;2492
88007;Ameuvelle;31;521524;6821;12;299624;19;221900;16823;2493
47074;Couthures-sur-Garonne;200;3364769;74599;83;2310515;117;1054254;16824;2494
18252;Sidiailles;214;3600325;94586;93;2507259;121;1093066;16824;2495
04217;Thoard;421;7082898;177976;160;4516883;261;2566015;16824;2496
12207;Rullac-Saint-Cirq;217;3650855;99192;61;2169438;156;1481417;16824;2497
40060;Callen;91;1531030;39851;36;1029681;55;501349;16825;2498
08326;Nouart;83;1396498;29331;32;829320;51;567178;16825;2499
42317;Urbise;75;1261897;17724;31;798762;44;463135;16825;2500
46033;Le Boulvé;115;1935059;68200;43;1296765;72;638294;16827;2501
17033;La Barde;266;4476273;119507;111;2944220;155;1532053;16828;2502
32053;Bézues-Bajon;111;1868043;53542;45;1381415;66;486628;16829;2503
15250;Vebret;298;5015378;86409;140;3421035;158;1594343;16830;2504
08168;La Ferté-sur-Chiers;104;1750449;49667;40;1061048;64;689401;16831;2505
50099;Carentan;3674;61841622;2248220;1460;42524980;2214;19316642;16832;2506
11315;Rieux-Minervois;1107;18633903;555530;413;12552551;694;6081352;16833;2507
88452;Senonges;83;1397202;29905;36;897474;47;499728;16834;2508
89418;Tonnerre;3023;50890015;1936627;1227;36094947;1796;14795068;16834;2509
11115;Cuxac-Cabardès;454;7642898;205281;189;5435011;265;2207887;16835;2510
16185;Ligné;96;1616227;44077;40;1132778;56;483449;16836;2511
76677;Smermesnil;186;3131750;30014;76;1935162;110;1196588;16837;2512
36163;Pouligny-Notre-Dame;385;6482781;180973;156;4375990;229;2106791;16838;2513
03113;Ferrières-sur-Sichon;299;5034855;139915;117;3348085;182;1686770;16839;2514
81192;Murat-sur-Vèbre;504;8487362;174298;187;5469173;317;3018189;16840;2515
46274;Saint-Laurent-Lolmie;104;1751403;83102;40;1196611;64;554792;16840;2516
27467;Pont-Audemer;5706;96095190;3957338;2327;66880473;3379;29214717;16841;2517
23064;Clugnat;406;6837602;185055;158;4535484;248;2302118;16841;2518
18242;Sancoins;2009;33834534;1116115;815;23210512;1194;10624022;16841;2519
63186;Landogne;134;2256855;68437;53;1565818;81;691037;16842;2520
38499;Susville;726;12227492;235656;316;8158706;410;4068786;16842;2521
23008;Aubusson;2509;42259966;1614193;1046;29826886;1463;12433080;16843;2522
52007;Ambonville;44;741231;7544;23;556415;21;184816;16846;2523
63373;Saint-Maigner;119;2005210;46344;52;1320193;67;685017;16851;2524
16117;Curac;70;1179663;8090;29;799964;41;379699;16852;2525
36077;Fontguenand;141;2376362;25321;58;1515737;83;860625;16854;2526
47111;Granges-sur-Lot;328;5528009;87994;130;3576577;198;1951432;16854;2527
65277;Lombrès;49;825837;14803;19;544762;30;281075;16854;2528
52172;Dommartin-le-Saint-Père;175;2949419;49745;83;2014964;92;934455;16854;2529
14357;Lassy;188;3168593;35052;85;2272737;103;895856;16854;2530
16314;Saint-Eutrope;106;1786572;41316;42;1179018;64;607554;16854;2531
22128;Locarn;267;4500424;100545;97;2830382;170;1670042;16856;2532
02741;Thenelles;314;5292671;92094;140;3482729;174;1809942;16856;2533
63369;Saint-Julien-la-Geneste;75;1264185;28687;35;911486;40;352699;16856;2534
19223;Saint-Martin-Sepert;173;2916146;73008;83;2123565;90;792581;16856;2535
24244;Lolme;96;1618232;20383;31;900806;65;717426;16857;2536
63130;La Crouzille;162;2730967;68216;62;1749235;100;981732;16858;2537
30325;Sumène;1008;16992789;420250;394;11392279;614;5600510;16858;2538
19134;Merlines;506;8531046;268704;227;6116458;279;2414588;16860;2539
05003;Aiguilles;261;4400568;165705;120;3440065;141;960503;16860;2540
52367;Ormoy-lès-Sexfontaines;27;455232;518;14;312798;13;142434;16860;2541
02808;Villeret;174;2933807;69835;77;2027436;97;906371;16861;2542
26082;Châteauneuf-de-Bordette;52;876771;23117;17;547433;35;329338;16861;2543
61494;Trun;780;13153607;256859;312;8329410;468;4824197;16864;2544
31531;Sarrecave;39;657728;12504;12;355371;27;302357;16865;2545
76053;Baillolet;68;1146824;17642;36;858268;32;288556;16865;2546
17117;Contré;74;1248073;17254;34;838199;40;409874;16866;2547
29028;Cléden-Cap-Sizun;641;10811919;320531;247;6962863;394;3849056;16867;2548
14151;Champ-du-Boult;218;3677157;101734;97;2618042;121;1059115;16868;2549
79035;Le Beugnon;181;3053163;51139;70;1855504;111;1197659;16868;2550
65192;Gèdre;159;2682194;70074;73;1934983;86;747211;16869;2551
46019;Beaumat;55;927811;19812;23;624658;32;303153;16869;2552
89345;Saint-Florentin;2753;46441288;1473676;1143;30991941;1610;15449347;16869;2553
34211;Le Poujol-sur-Orb;630;10627835;264196;262;7121192;368;3506643;16870;2554
12240;Saint-Parthem;254;4285011;86299;98;2845131;156;1439880;16870;2555
24320;Payzac;611;10307938;243934;242;6523476;369;3784462;16871;2556
07080;Devesset;158;2665602;28878;62;1613786;96;1051816;16871;2557
64194;Coslédaà-Lube-Boast;178;3003052;48094;66;2038750;112;964302;16871;2558
49018;Baugé;2324;39208751;1106899;901;25674003;1423;13534748;16871;2559
85136;Marillet;62;1046080;18556;23;606425;39;439655;16872;2560
55493;Sommeilles;114;1923606;32814;45;1148976;69;774630;16874;2561
46200;Montcléra;178;3003619;66289;65;1846357;113;1157262;16874;2562
57229;Foulcrey;117;1974405;28307;58;1416340;59;558065;16875;2563
52376;Pansey;50;843777;25651;19;564191;31;279586;16876;2564
22148;Mérillac;135;2278292;30995;56;1456971;79;821321;16876;2565
83082;Montferrat;748;12623939;308793;470;10041186;278;2582753;16877;2566
50308;Le Mesnilbus;166;2801592;17915;72;1661247;94;1140345;16877;2567
53006;Argenton-Notre-Dame;94;1586480;1565;41;1071580;53;514900;16877;2568
03034;Boucé;293;4945573;88720;123;3205471;170;1740102;16879;2569
02256;Dagny-Lambercy;66;1114044;1997;23;718466;43;395578;16879;2570
47010;Antagnac;125;2110031;46569;43;1292699;82;817332;16880;2571
24443;Saint-Léon-sur-Vézère;267;4507048;139942;106;3176278;161;1330770;16880;2572
66159;Réal;48;810262;9302;26;620123;22;190139;16880;2573
63304;Roche-d'Agoux;51;860905;12785;20;547077;31;313828;16880;2574
71113;Châteauneuf;58;979106;23630;24;597597;34;381509;16881;2575
69182;Saint-Bonnet-des-Bruyères;226;3815176;100353;92;2473759;134;1341417;16881;2576
46179;Lugagnac;81;1367429;52858;33;1022422;48;345007;16882;2577
70419;Pont-du-Bois;63;1063576;24209;25;656370;38;407206;16882;2578
52208;Fresnes-sur-Apance;107;1806396;41171;37;1101664;70;704732;16882;2579
53236;Saint-Mars-du-Désert;100;1688369;35890;35;1046089;65;642280;16884;2580
30005;Aiguèze;136;2296186;60201;66;1673679;70;622507;16884;2581
64533;Tardets-Sorholus;358;6044523;231471;144;4182334;214;1862189;16884;2582
34097;Félines-Minervois;271;4575733;165705;105;3196400;166;1379333;16885;2583
97310;Roura;1035;17477290;364474;310;11316540;725;6160750;16886;2584
55492;Sommedieue;543;9169384;161751;255;6297826;288;2871558;16887;2585
26376;Villeperdrix;71;1198975;47901;25;743680;46;455295;16887;2586
08278;Marquigny;51;861236;22494;21;605395;30;255841;16887;2587
63391;Saint-Rémy-de-Blot;156;2634384;66252;60;1703649;96;930735;16887;2588
19087;Gourdon-Murat;74;1249649;25090;29;760584;45;489065;16887;2589
50337;Montanel;231;3901031;71634;97;2543157;134;1357874;16888;2590
32421;Savignac-Mona;82;1384847;16894;38;969915;44;414932;16888;2591
23173;Soubrebost;82;1384864;19420;35;853349;47;531515;16889;2592
07307;Sanilhac;287;4847400;160451;115;3252373;172;1595027;16890;2593
44197;Sion-les-Mines;906;15302418;245867;363;9885965;543;5416453;16890;2594
63344;Saint-Gal-sur-Sioule;75;1266758;28611;36;890839;39;375919;16890;2595
08217;Haulmé;57;962739;11526;25;630650;32;332089;16890;2596
31333;Mauvezin;44;743169;14340;17;449093;27;294076;16890;2597
95585;Sarcelles;30631;517373367;16612828;12254;349942131;18377;167431236;16891;2598
09093;Celles;72;1216135;23024;29;768067;43;448068;16891;2599
57268;Guébling;91;1537070;38771;44;1106701;47;430369;16891;2600
15222;Sansac-Veinazès;120;2026941;19140;45;1320874;75;706067;16891;2601
15133;Montmurat;80;1351374;32836;34;867739;46;483635;16892;2602
16328;Saint-Laurent-de-Belzagot;233;3935877;101757;77;2408799;156;1527078;16892;2603
62017;Aix-en-Ergny;81;1368321;45665;25;830154;56;538167;16893;2604
08282;Maubert-Fontaine;549;9274650;228817;224;6054287;325;3220363;16894;2605
52135;Coiffy-le-Bas;68;1148830;26651;30;744361;38;404469;16895;2606
52311;Marcilly-en-Bassigny;148;2500450;61224;60;1579693;88;920757;16895;2607
17430;Soubran;225;3801508;103007;93;2601633;132;1199875;16896;2608
88264;Légéville-et-Bonfays;33;557585;9613;17;420871;16;136714;16897;2609
40242;Rimbez-et-Baudiets;58;980175;29835;25;635905;33;344270;16900;2610
58156;Marcy;104;1757595;38007;40;1075982;64;681613;16900;2611
18161;Neuilly-en-Dun;153;2585949;63131;60;1678539;93;907410;16902;2612
16111;Courgeac;99;1673324;31699;35;1096258;64;577066;16902;2613
62617;Noeux-les-Mines;6854;115855218;3219894;2730;76340519;4124;39514699;16903;2614
80453;Laboissière-en-Santerre;91;1538240;34345;40;1018320;51;519920;16904;2615
56059;Les Forges;251;4243119;84936;108;2817022;143;1426097;16905;2616
19250;Salon-la-Tour;398;6728588;171726;160;4420095;238;2308493;16906;2617
02666;Rozoy-sur-Serre;562;9501371;317398;216;6394980;346;3106391;16906;2618
52539;Violot;58;980579;28775;26;630269;32;350310;16907;2619
70501;Thiénans;45;760795;-2517;16;385902;29;374893;16907;2620
66150;Prats-de-Mollo-la-Preste;664;11226769;473221;277;7811049;387;3415720;16908;2621
33151;Donnezac;482;8149837;189356;191;5410236;291;2739601;16908;2622
14152;La Chapelle-Engerbold;59;997601;20604;23;676184;36;321417;16908;2623
2B299;San-Gavino-d'Ampugnani;54;913064;45722;22;637539;32;275525;16909;2624
16230;Montmoreau-Saint-Cybard;649;10973996;313148;232;7061798;417;3912198;16909;2625
71452;Saint-Martin-de-Salencey;61;1031504;17800;22;656648;39;374856;16910;2626
58128;Glux-en-Glenne;58;980796;28140;21;691197;37;289599;16910;2627
58309;Villapourçon;285;4819459;156873;116;3346337;169;1473122;16910;2628
65015;Antin;69;1166837;15207;27;721416;42;445421;16911;2629
58034;Blismes;96;1623438;41484;40;1030767;56;592671;16911;2630
34086;Courniou;380;6426578;154939;174;4674030;206;1752548;16912;2631
19193;Saint-Cirgues-la-Loutre;113;1911066;55840;46;1290496;67;620570;16912;2632
2A100;Cristinacce;28;473543;27183;12;393374;16;80169;16912;2633
01066;La Burbanche;50;845615;16292;21;580167;29;265448;16912;2634
2B107;Ersa;106;1792707;72487;47;1293508;59;499199;16912;2635
50310;Le Mesnil-Eury;87;1471380;25999;38;1013821;49;457559;16912;2636
09151;Lanoux;35;591989;351;15;360338;20;231651;16914;2637
87134;Sainte-Anne-Saint-Priest;88;1488699;15867;33;838049;55;650650;16917;2638
49197;Meigné-le-Vicomte;174;2943604;83109;70;2070004;104;873600;16917;2639
79255;Saint-Germain-de-Longue-Chaume;208;3518855;37645;89;2346334;119;1172521;16918;2640
73002;Aiguebelle;654;11064603;355356;272;7440508;382;3624095;16918;2641
12010;Arques;69;1167392;28709;23;735876;46;431516;16919;2642
52003;Aillianville;102;1725761;33338;41;1068970;61;656791;16919;2643
62301;Équirre;33;558349;8490;12;358359;21;199990;16920;2644
09319;Unzent;66;1116701;26381;25;775303;41;341398;16920;2645
87190;Sauviat-sur-Vige;610;10321363;315246;234;6821578;376;3499785;16920;2646
47179;Monsempron-Libos;1219;20625864;504528;488;13408782;731;7217082;16920;2647
19256;Sérandon;219;3705556;108696;91;2511237;128;1194319;16920;2648
32025;Ayzieu;91;1539796;44550;30;1010772;61;529024;16921;2649
07039;Bozas;142;2402762;89336;39;1447286;103;955476;16921;2650
66179;Saint-Laurent-de-Cerdans;669;11320444;383416;253;7376353;416;3944091;16921;2651
58223;Rouy;382;6463997;153822;159;4523029;223;1940968;16921;2652
02284;Erloy;57;964639;27973;25;673427;32;291212;16923;2653
89257;Migennes;4027;68151578;2092327;1722;46688938;2305;21462640;16924;2654
30237;Saint-Brès;370;6262090;145226;154;4201046;216;2061044;16925;2655
11159;Gaja-la-Selve;87;1472516;65233;28;960799;59;511717;16925;2656
16292;Ruffec;2244;37983270;1511620;884;26428628;1360;11554642;16927;2657
62388;Grigny;187;3165563;69074;80;2223665;107;941898;16928;2658
07003;Aizac;107;1811323;34058;47;1161540;60;649783;16928;2659
36086;Heugnes;240;4062994;117087;101;2910163;139;1152831;16929;2660
82168;Saint-Nazaire-de-Valentane;180;3047411;58090;63;1893012;117;1154399;16930;2661
33359;Roquebrune;140;2370249;57099;54;1595626;86;774623;16930;2662
06107;Roquestéron-Grasse;43;728136;19773;22;532711;21;195425;16933;2663
24522;Sarrazac;216;3657830;61458;85;2304490;131;1353340;16934;2664
46311;Sousceyrac;552;9347912;288593;209;6328637;343;3019275;16935;2665
02189;Chivres-en-Laonnois;202;3420853;45118;87;2181888;115;1238965;16935;2666
51649;Vitry-le-François;7799;132075991;5277410;3184;91838765;4615;40237226;16935;2667
87003;Arnac-la-Poste;553;9365054;164157;224;6073471;329;3291583;16935;2668
87054;Cussac;713;12075063;320179;254;7233889;459;4841174;16936;2669
44170;Saint-Julien-de-Vouvantes;530;8976137;101398;230;5953132;300;3023005;16936;2670
12113;Gramond;246;4166375;40188;93;2672382;153;1493993;16936;2671
56210;Saint-Caradec-Trégomel;284;4810225;85602;109;2982675;175;1827550;16937;2672
65096;Bonnemazon;48;813002;14211;19;508112;29;304890;16938;2673
83002;Aiguines;125;2117230;83184;59;1498653;66;618577;16938;2674
09296;Sinsat;68;1151911;30297;33;812762;35;339149;16940;2675
62046;Aubin-Saint-Vaast;419;7098059;169825;176;4833959;243;2264100;16940;2676
29083;Île-de-Sein;127;2151551;118688;47;1365020;80;786531;16941;2677
07286;Saint-Pierreville;315;5336822;117839;130;3470662;185;1866160;16942;2678
11304;Quillan;2037;34512116;1123206;827;23582716;1210;10929400;16943;2679
71088;La Chapelle-au-Mans;133;2253393;34682;60;1489517;73;763876;16943;2680
71028;Beauvernois;64;1084344;21063;28;755372;36;328972;16943;2681
24141;Coutures;125;2117984;55511;53;1413773;72;704211;16944;2682
65376;Recurt;126;2134944;54115;59;1569147;67;565797;16944;2683
35268;Saint-Ganton;232;3931188;35523;104;2617614;128;1313574;16945;2684
48032;Le Buisson;119;2016436;6927;50;1339711;69;676725;16945;2685
63064;La Celle;61;1033734;23546;29;778284;32;255450;16946;2686
30296;Saint-Roman-de-Codières;103;1745596;92183;25;931273;78;814323;16948;2687
33491;Saint-Vivien-de-Monségur;219;3711781;115997;91;2655512;128;1056269;16949;2688
33066;Bourdelles;66;1118619;56742;24;762410;42;356209;16949;2689
11221;Les Martys;135;2288179;37551;52;1435657;83;852522;16949;2690
31239;L'Isle-en-Dodon;1089;18458321;587389;421;12106951;668;6351370;16950;2691
29018;Brennilis;293;4966353;98830;120;3240322;173;1726031;16950;2692
15063;Drugeac;215;3644329;103501;87;2463204;128;1181125;16950;2693
17077;Cercoux;703;11916667;256221;269;7445738;434;4470929;16951;2694
19054;Chenailler-Mascheix;114;1932495;48240;40;1145445;74;787050;16952;2695
46159;Latouille-Lentillac;149;2525929;72721;63;1800927;86;725002;16953;2696
15223;Sauvat;115;1949750;30838;49;1250878;66;698872;16954;2697
52482;Soulaucourt-sur-Mouzon;56;949446;19170;25;658331;31;291115;16954;2698
54473;Saint-Firmin;172;2916237;67800;70;1921826;102;994411;16955;2699
24055;Bourdeilles;498;8443623;330918;180;5721163;318;2722460;16955;2700
82141;Pommevic;315;5341329;86210;149;3705413;166;1635916;16957;2701
04042;Castellet-lès-Sausses;68;1153061;34872;35;851349;33;301712;16957;2702
16194;Lupsault;71;1204001;25233;31;849412;40;354589;16958;2703
50097;Canville-la-Rocque;81;1373592;44041;33;970495;48;403097;16958;2704
85087;Faymoreau;124;2102939;42669;45;1223639;79;879300;16959;2705
05165;Savournon;149;2526966;63472;57;1621391;92;905575;16960;2706
09181;Le Mas-d'Azil;704;11939523;388476;263;7974260;441;3965263;16960;2707
19244;Saint-Sulpice-les-Bois;40;678419;16236;13;364492;27;313927;16960;2708
03143;Lételon;68;1153329;18761;36;857099;32;296230;16961;2709
62157;Boubers-lès-Hesmond;44;746330;11648;21;481138;23;265192;16962;2710
46013;Bach;110;1865835;32945;42;1111727;68;754108;16962;2711
17061;Bran;86;1458799;54848;38;1033740;48;425059;16963;2712
70349;Moimay;115;1950756;25398;49;1264933;66;685823;16963;2713
70551;Vezet;104;1764306;51999;41;1132919;63;631387;16964;2714
33374;Saint-Aubin-de-Blaye;441;7481436;163830;172;4979110;269;2502326;16965;2715
33119;Cenon;12494;211958380;7234395;5503;150241657;6991;61716723;16965;2716
08057;Belleville-et-Châtillon-sur-Bar;160;2714408;29827;64;1747784;96;966624;16965;2717
48041;Chastanier;57;967036;17921;30;675894;27;291142;16966;2718
30090;Concoules;188;3189663;76325;81;2316959;107;872704;16966;2719
24347;Rampieux;78;1323622;22197;31;862500;47;461122;16970;2720
23061;Chénérailles;497;8434099;308341;205;5900259;292;2533840;16970;2721
68370;Wildenstein;110;1866787;35505;50;1274739;60;592048;16971;2722
66194;Serralongue;146;2477774;78373;58;1657690;88;820084;16971;2723
24006;Allas-les-Mines;129;2189450;42831;46;1286023;83;903427;16972;2724
44031;La Chapelle-Glain;439;7450983;82097;185;4845404;254;2605579;16973;2725
59601;Trélon;1579;26799831;970846;648;18944753;931;7855078;16973;2726
24481;Saint-Paul-la-Roche;289;4905140;94714;118;3377121;171;1528019;16973;2727
32135;Fustérouau;78;1323880;27336;30;924862;48;399018;16973;2728
09203;Montels;94;1595447;34749;36;989315;58;606132;16973;2729
36010;Azay-le-Ferron;547;9284188;250997;229;6182542;318;3101646;16973;2730
61066;Buré;58;984503;12593;19;525543;39;458960;16974;2731
26163;Léoncel;32;543212;14341;12;360695;20;182517;16975;2732
24116;Châtres;103;1748632;52722;40;1146075;63;602557;16977;2733
09255;Saint-Amans;28;475379;26645;13;377601;15;97778;16978;2734
88307;Mont-lès-Lamarche;61;1035653;10051;24;655624;37;380029;16978;2735
09186;Méras;50;848906;9356;16;583749;34;265157;16978;2736
57595;Rorbach-lès-Dieuze;38;645191;13902;15;426193;23;218998;16979;2737
34059;La Caunette;190;3226030;96913;69;2135816;121;1090214;16979;2738
26240;Plan-de-Baix;84;1426257;26765;40;1007034;44;419223;16979;2739
22285;Saint-Connec;163;2767631;53067;72;1830677;91;936954;16979;2740
19168;Pradines;64;1086697;35124;27;729472;37;357225;16980;2741
34021;Babeau-Bouldoux;161;2733755;67383;68;1877981;93;855774;16980;2742
82094;Lauzerte;857;14553572;524803;315;9526695;542;5026877;16982;2743
47011;Anthé;101;1715254;28976;35;895483;66;819771;16983;2744
14272;La Folie;75;1273755;24911;32;888316;43;385439;16983;2745
17217;Macqueville;161;2734344;110313;60;1902149;101;832195;16984;2746
23103;Lafat;242;4110082;131735;98;2829559;144;1280523;16984;2747
24200;Grand-Brassac;308;5231044;100066;134;3683401;174;1547643;16984;2748
25003;Abbenans;206;3498777;62628;91;2293919;115;1204858;16984;2749
23130;Méasnes;328;5571478;154823;142;3757674;186;1813804;16986;2750
58057;Chantenay-Saint-Imbert;701;11907524;296002;301;8416477;400;3491047;16986;2751
16027;Barbezières;74;1257036;13804;25;711322;49;545714;16987;2752
57120;Burlioncourt;90;1528855;16552;41;1012997;49;515858;16987;2753
02158;Chamouille;135;2293339;53752;59;1598417;76;694922;16988;2754
46131;Grèzes;95;1613938;33918;39;1060598;56;553340;16989;2755
97115;Lamentin;8793;149390891;4454480;2798;99471866;5995;49919025;16990;2756
89280;Nuits;244;4145852;112122;112;2878802;132;1267050;16991;2757
24492;Sainte-Radegonde;36;611696;11659;14;388746;22;222950;16992;2758
43024;Beaux;485;8241516;205881;208;5661856;277;2579660;16993;2759
88096;Châtillon-sur-Saône;83;1410522;16852;33;907394;50;503128;16994;2760
04095;L'Hospitalet;66;1121626;32401;26;750342;40;371284;16994;2761
16207;Marcillac-Lanville;346;5880242;192879;145;4103213;201;1777029;16995;2762
86054;Champniers;219;3721959;57764;96;2645094;123;1076865;16995;2763
88150;Dommartin-sur-Vraine;168;2855231;82825;61;1852778;107;1002453;16995;2764
89055;Brienon-sur-Armançon;1825;31017280;1031447;750;20815799;1075;10201481;16996;2765
11386;Talairan;205;3484166;103899;74;2287700;131;1196466;16996;2766
04024;Beaujeu;86;1461678;50804;32;923421;54;538257;16996;2767
24380;Saint-Barthélemy-de-Bellegarde;293;4979950;172675;131;3568939;162;1411011;16996;2768
65405;Sarlabous;52;883820;24918;30;702955;22;180865;16997;2769
37114;La Guerche;119;2022730;49884;60;1442061;59;580669;16998;2770
71227;Grury;327;5558284;107472;131;3573926;196;1984358;16998;2771
52059;Bonnecourt;81;1376852;49333;34;930081;47;446771;16998;2772
14182;Cormolain;234;3977754;129052;100;2787067;134;1190687;16999;2773
62466;Humbert;137;2328901;48324;51;1400377;86;928524;16999;2774
70366;Villers-Chemin-et-Mont-lès-Étrelles;75;1274970;17440;37;885575;38;389395;17000;2775
16091;Châtignac;107;1819028;19683;43;1197490;64;621538;17000;2776
64492;Saint-Michel;137;2329479;13614;59;1527593;78;801886;17003;2777
46226;Prendeignes;130;2210470;25624;49;1415034;81;795436;17004;2778
62683;Quoeux-Haut-Maînil;147;2499635;45236;65;1756650;82;742985;17004;2779
08382;Saint-Jean-aux-Bois;71;1207328;35022;23;741239;48;466089;17005;2780
24365;Saint-Amand-de-Vergt;136;2312648;11920;47;1355105;89;957543;17005;2781
19262;Soudaine-Lavinadière;121;2057644;98053;46;1366802;75;690842;17005;2782
65326;Mun;60;1020336;27256;25;696068;35;324268;17006;2783
17335;Saint-Georges-des-Agoûts;158;2686952;32268;63;1800837;95;886115;17006;2784
87067;Folles;302;5135904;141290;124;3382474;178;1753430;17006;2785
62293;Embry;133;2261955;36624;51;1495403;82;766552;17007;2786
70284;Hautevelle;141;2398081;27215;65;1569258;76;828823;17008;2787
24220;Lacropte;389;6616075;113435;151;4251451;238;2364624;17008;2788
36196;Saint-Gilles;67;1139583;20890;22;642849;45;496734;17009;2789
66042;Cassagnes;142;2415425;52393;55;1550876;87;864549;17010;2790
48181;Saint-Saturnin;43;731433;3640;20;473204;23;258229;17010;2791
09213;Moulin-Neuf;125;2126358;71780;57;1570323;68;556035;17011;2792
03299;Varennes-sur-Tèche;133;2262529;17846;52;1331147;81;931382;17011;2793
80563;Montigny-les-Jongleurs;49;833572;18409;24;659489;25;174083;17012;2794
79203;Pas-de-Jeu;218;3709247;62238;94;2516591;124;1192656;17015;2795
79209;Pierrefitte;162;2756717;19682;58;1614577;104;1142140;17017;2796
02354;Grandrieux;44;748769;12854;21;574358;23;174411;17017;2797
2B313;San-Nicolao;1003;17069164;648028;413;12199249;590;4869915;17018;2798
88367;Rambervillers;3131;53285445;1772707;1218;36131045;1913;17154400;17019;2799
11423;Villefloure;83;1412561;20170;32;943654;51;468907;17019;2800
63279;Picherande;236;4016698;115981;94;2652091;142;1364607;17020;2801
65087;Bertren;132;2247064;74769;53;1465925;79;781139;17023;2802
47025;Beauville;303;5158294;157514;111;3435863;192;1722431;17024;2803
54077;Blâmont;634;10795223;402338;238;7263114;396;3532109;17027;2804
07224;Saint-Cirgues-en-Montagne;155;2639233;93705;62;1777725;93;861508;17027;2805
86025;Béthines;309;5261872;123643;133;3607878;176;1653994;17029;2806
15077;Gourdièges;36;613041;8344;17;439019;19;174022;17029;2807
55157;Dommartin-la-Montagne;32;544945;13053;17;345614;15;199331;17030;2808
55219;Grimaucourt-en-Woëvre;53;902600;12641;23;603086;30;299514;17030;2809
80271;Épehy;686;11683367;455279;266;7774636;420;3908731;17031;2810
80352;Frémontiers;96;1634999;20908;34;951322;62;683677;17031;2811
50640;Villiers-le-Pré;110;1873469;12596;45;1181793;65;691676;17032;2812
34317;La Vacquerie-et-Saint-Martin-de-Castries;102;1737218;46957;42;1253389;60;483829;17032;2813
24248;Lussas-et-Nontronneau;202;3440486;88698;81;2246704;121;1193782;17032;2814
32315;Peyrusse-Grande;104;1771343;83512;30;1127343;74;644000;17032;2815
55149;Delut;59;1004916;14937;18;486117;41;518799;17032;2816
87179;Saint-Sornin-la-Marche;121;2060934;24640;52;1412489;69;648445;17033;2817
63086;La Chapelle-Agnon;244;4155945;117545;103;2889610;141;1266335;17033;2818
07037;Borée;99;1686328;53956;42;1217498;57;468830;17034;2819
59185;Écaillon;1086;18499051;555586;409;12129914;677;6369137;17034;2820
58255;Saint-Martin-du-Puy;178;3032097;83080;78;2062642;100;969455;17034;2821
12029;Bor-et-Bar;106;1805709;44246;33;1101819;73;703890;17035;2822
30154;Mandagout;253;4310087;147886;106;3118797;147;1191290;17036;2823
33073;Braud-et-Saint-Louis;878;14957562;482320;360;10476339;518;4481223;17036;2824
32413;Sarcos;47;800699;28636;21;589415;26;211284;17036;2825
2B059;Canavaggia;57;971083;29171;28;726892;29;244191;17037;2826
22087;Kergrist-Moëlou;381;6491295;142725;140;4182006;241;2309289;17038;2827
48169;Saint-Léger-du-Malzieu;126;2147096;58905;52;1386652;74;760444;17040;2828
2B046;Cagnano;117;1993837;80541;40;1361824;77;632013;17041;2829
55172;Les Éparges;41;698716;10666;17;435800;24;262916;17042;2830
81244;Saint-Benoît-de-Carmaux;1295;22070518;366580;508;13124795;787;8945723;17043;2831
55360;Mouilly;66;1124900;27930;30;788563;36;336337;17044;2832
11401;Tuchan;474;8078924;275036;187;5577952;287;2500972;17044;2833
63329;Sainte-Christine;94;1602184;37620;42;1103648;52;498536;17045;2834
04005;Allons;51;869297;19829;20;555288;31;314009;17045;2835
79164;Maisonnay;149;2539787;66035;69;1749583;80;790204;17046;2836
07203;Sagnes-et-Goudoulet;69;1176297;31514;25;743063;44;433234;17048;2837
61508;Vimoutiers;2170;36993851;1277118;859;24588259;1311;12405592;17048;2838
86227;Saint-Laon;82;1397946;5556;41;1040358;41;357588;17048;2839
06125;Saint-Martin-d'Entraunes;45;767180;22372;16;532866;29;234314;17048;2840
23192;Saint-Étienne-de-Fursac;488;8320093;186455;196;5372857;292;2947236;17049;2841
70453;La Rosière;43;733191;14978;12;441492;31;291699;17051;2842
80369;Frohen-sur-Authie;126;2148590;46054;47;1267806;79;880784;17052;2843
07136;Laveyrune;55;937886;19223;23;577329;32;360557;17052;2844
19249;Saint-Yrieix-le-Déjalat;238;4058548;99593;100;2673041;138;1385507;17053;2845
34098;Ferrals-les-Montagnes;87;1483736;24247;33;996209;54;487527;17054;2846
23184;Saint-Bard;69;1176778;15485;28;737987;41;438791;17055;2847
04077;Entrevennes;94;1603161;60254;42;1186501;52;416660;17055;2848
80631;Ponches-Estruval;61;1040444;25402;29;761821;32;278623;17056;2849
39568;Villerserine;39;665211;5978;20;467101;19;198110;17057;2850
21024;Arnay-sous-Vitteaux;75;1279276;28714;40;956240;35;323036;17057;2851
24052;Bouillac;65;1108741;30601;24;743615;41;365126;17058;2852
12173;Noailhac;94;1603545;71159;30;1032147;64;571398;17059;2853
03280;Terjat;121;2064168;25159;56;1377127;65;687041;17059;2854
34038;Le Bousquet-d'Orb;999;17042608;558543;422;11583035;577;5459573;17060;2855
48175;Saint-Pierre-de-Nogaret;106;1808363;36879;36;1202042;70;606321;17060;2856
08139;Deville;629;10730781;221075;270;6835717;359;3895064;17060;2857
09259;Saint-Félix-de-Tournegat;77;1313642;36499;28;847545;49;466097;17060;2858
86109;Guesnes;146;2490989;56596;59;1633019;87;857970;17062;2859
62158;Boubers-sur-Canche;331;5647741;116145;125;3609044;206;2038697;17063;2860
32270;Mongausy;50;853191;20897;22;572656;28;280535;17064;2861
61429;Saint-Maurice-lès-Charencey;253;4317223;88714;106;2799923;147;1517300;17064;2862
55122;Commercy;3639;62099032;2546604;1560;44591610;2079;17507422;17065;2863
52237;Harréville-les-Chanteurs;174;2969287;58619;74;1890380;100;1078907;17065;2864
21044;Balot;57;972712;25123;23;632726;34;339986;17065;2865
58259;Saint-Parize-en-Viry;99;1689622;31237;43;1223952;56;465670;17067;2866
16260;Pillac;146;2491999;62795;53;1611699;93;880300;17068;2867
15030;Cayrols;171;2918734;40635;68;2012150;103;906584;17069;2868
05054;La Fare-en-Champsaur;285;4864582;111706;112;3143762;173;1720820;17069;2869
16149;Genouillac;334;5701048;114232;134;3699564;200;2001484;17069;2870
11009;Alzonne;787;13433593;385577;333;9189387;454;4244206;17069;2871
03135;Lalizolle;199;3396836;95629;80;2241513;119;1155323;17070;2872
30040;Blandas;87;1485099;66274;38;1138596;49;346503;17070;2873
17381;Saint-Pardoult;131;2236212;31558;56;1474932;75;761280;17070;2874
65145;Chèze;38;648740;15209;22;503613;16;145127;17072;2875
01370;Saint-Laurent-sur-Saône;1219;20811092;694073;668;15470595;551;5340497;17072;2876
24299;Mussidan;1798;30699320;882765;722;20866901;1076;9832419;17074;2877
22249;Pont-Melvez;369;6300459;113237;153;4181691;216;2118768;17074;2878
22092;Kerpert;171;2919799;147599;68;2003269;103;916530;17075;2879
62313;Estrée-Blanche;507;8656989;241709;197;5588658;310;3068331;17075;2880
86286;Verrue;227;3876214;79517;93;2572159;134;1304055;17076;2881
18102;Givardon;192;3278570;87885;83;2242923;109;1035647;17076;2882
18187;Préveranges;382;6523169;194042;138;4022021;244;2501148;17076;2883
63409;Saurier;140;2390695;41892;69;1663340;71;727355;17076;2884
11001;Aigues-Vives;316;5396284;132820;118;3565670;198;1830614;17077;2885
88107;Clérey-la-Côte;26;444007;14566;11;284178;15;159829;17077;2886
70063;Belonchamp;134;2288417;51368;56;1484535;78;803882;17078;2887
32433;Simorre;417;7121767;289384;156;4816820;261;2304947;17079;2888
30139;Lanuéjols;205;3501148;87708;87;2386574;118;1114574;17079;2889
88511;Villouxel;54;922277;24940;20;577105;34;345172;17079;2890
31224;Gourdan-Polignan;738;12604652;421948;322;8793267;416;3811385;17079;2891
14366;Lisieux;13510;230753012;9753735;5753;164719720;7757;66033292;17080;2892
47170;Monbahus;345;5892708;96933;133;3847563;212;2045145;17080;2893
02526;Morgny-en-Thiérache;51;871173;14067;21;558197;30;312976;17082;2894
30007;Alès;24922;425722960;18415149;9931;300365296;14991;125357664;17082;2895
15186;Sainte-Eulalie;130;2220714;38442;46;1404275;84;816439;17082;2896
63301;Ris;437;7465288;180917;198;5217314;239;2247974;17083;2897
15264;Vitrac;169;2887171;78246;63;1909253;106;977918;17084;2898
63354;Saint-Gervais-d'Auvergne;770;13155737;321093;321;8688556;449;4467181;17085;2899
38217;Marcieu;48;820144;16990;25;618377;23;201767;17086;2900
59647;Watten;1430;24435298;623781;547;15816750;883;8618548;17088;2901
29275;Scrignac;482;8236410;190187;182;4985199;300;3251211;17088;2902
87060;Dournazac;392;6698694;194509;149;4507895;243;2190799;17089;2903
02295;Étréaupont;499;8527213;301455;199;5713445;300;2813768;17089;2904
2B233;Pino;102;1743072;65908;37;1141613;65;601459;17089;2905
52407;Prez-sous-Lafauche;190;3246974;39346;90;2158495;100;1088479;17089;2906
03291;Trézelles;241;4118762;81318;97;2612679;144;1506083;17090;2907
12007;Ambeyrac;113;1931216;64398;44;1228008;69;703208;17090;2908
66231;Vingrau;349;5964603;196055;133;4066103;216;1898500;17091;2909
03150;Louroux-Bourbonnais;142;2427302;52645;63;1674281;79;753021;17094;2910
05102;La Piarre;50;854701;24226;19;510277;31;344424;17094;2911
36060;Crevant;454;7760771;202576;185;5073521;269;2687250;17094;2912
11249;Montjardin;54;923112;19497;20;592780;34;330332;17095;2913
03068;Châtelus;76;1299211;22530;32;777095;44;522116;17095;2914
12110;Golinhac;209;3572955;48357;85;2389757;124;1183198;17095;2915
63119;Condat-lès-Montboissier;133;2273745;29396;60;1533523;73;740222;17096;2916
15185;Saint-Étienne-de-Chomeil;140;2393605;32923;55;1562096;85;831509;17097;2917
66088;Ille-sur-Têt;3261;55754510;1632180;1255;37182334;2006;18572176;17097;2918
63367;Saint-Jean-Saint-Gervais;64;1094268;25874;25;720995;39;373273;17098;2919
57751;Woippy;7193;122991008;4204840;2856;84929076;4337;38061932;17099;2920
35114;Forges-la-Forêt;149;2547759;10106;74;1841197;75;706562;17099;2921
37063;Château-Renault;3274;55983515;1846379;1377;38305677;1897;17677838;17099;2922
80484;Liomer;207;3539953;62918;81;2292639;126;1247314;17101;2923
59033;Aulnoye-Aymeries;4838;82736568;2258086;2047;57077345;2791;25659223;17101;2924
58134;Imphy;2250;38479711;1168496;1086;28198900;1164;10280811;17102;2925
93066;Saint-Denis;55981;957456293;39507693;24215;690853239;31766;266603054;17103;2926
15137;Moussages;167;2856329;66297;66;1867992;101;988337;17104;2927
58195;La Nocle-Maulaix;177;3027462;85023;78;2142534;99;884928;17104;2928
42303;Souternon;170;2907981;30637;66;1713389;104;1194592;17106;2929
66116;Montferrer;122;2086962;87366;42;1481786;80;605176;17106;2930
64056;Arrosès;84;1436928;21604;32;931677;52;505251;17106;2931
64323;Lasserre;49;838217;22421;21;598734;28;239483;17106;2932
07030;Beauvène;128;2189758;43049;55;1525756;73;664002;17107;2933
50280;Lozon;187;3199246;93282;92;2360349;95;838897;17108;2934
17257;Néré;487;8331745;329078;176;5559526;311;2772219;17108;2935
15227;Sériers;83;1420007;14758;36;1008907;47;411100;17109;2936
24136;Coubjours;95;1625359;29143;30;975453;65;649906;17109;2937
89461;Villeneuve-l'Archevêque;685;11719896;301773;296;7904136;389;3815760;17109;2938
15216;Saint-Urcize;239;4089435;102463;98;2781843;141;1307592;17111;2939
15198;Sainte-Marie;63;1078009;15110;25;683023;38;394986;17111;2940
12108;Galgan;203;3473722;53806;79;2219706;124;1254016;17112;2941
03240;Saint-Léon;352;6023661;109252;139;3902031;213;2121630;17113;2942
23069;Crocq;257;4398023;107492;104;2989737;153;1408286;17113;2943
81305;Vabre;484;8282796;216758;181;5218451;303;3064345;17113;2944
43192;Saint-Haon;199;3405560;204231;68;2154325;131;1251235;17113;2945
81033;Blaye-les-Mines;1845;31574239;808681;748;20266530;1097;11307709;17113;2946
04210;Soleilhas;58;992636;19433;26;700003;32;292633;17114;2947
61380;Saint-Denis-de-Villenette;87;1489008;14705;37;978160;50;510848;17115;2948
43254;Vazeilles-Limandre;138;2362053;76722;50;1525506;88;836547;17116;2949
72269;Saint-Calais;2112;36149755;1097158;886;25294861;1226;10854894;17116;2950
54248;Hamonville;51;872946;10118;26;608308;25;264638;17117;2951
14629;Saint-Martin-des-Besaces;667;11417597;188533;267;7203704;400;4213893;17118;2952
26167;Luc-en-Diois;311;5324335;137981;147;3787287;164;1537048;17120;2953
43122;Lissac;155;2653617;29215;63;1724821;92;928796;17120;2954
06144;La Tour;278;4759485;143315;109;3313300;169;1446185;17120;2955
18083;Culan;470;8046902;308698;173;5264262;297;2782640;17121;2956
52273;Larivière-Arnoncourt;84;1438238;35124;37;945542;47;492696;17122;2957
87051;La Croisille-sur-Briance;437;7482587;287262;156;4978836;281;2503751;17123;2958
43026;Bellevue-la-Montagne;263;4503356;98062;94;2914326;169;1589030;17123;2959
45068;Châlette-sur-Loing;7102;121610957;3547484;3085;83071758;4017;38539199;17123;2960
47124;Lacaussade;114;1952124;62137;41;1189650;73;762474;17124;2961
63218;Mayres;108;1849647;31556;45;1213027;63;636620;17126;2962
50152;Les Cresnays;140;2397731;57185;57;1601916;83;795815;17127;2963
24203;Les Graulges;39;667944;14794;15;430656;24;237288;17127;2964
12028;Boisse-Penchot;299;5120985;107266;135;3328232;164;1792753;17127;2965
58168;Millay;254;4350446;89618;103;2800204;151;1550242;17128;2966
10266;Nogent-en-Othe;28;479581;19549;12;371285;16;108296;17128;2967
23194;Sainte-Feyre-la-Montagne;80;1370260;21029;38;1028216;42;342044;17128;2968
12034;Brandonnet;174;2980329;75945;62;1809291;112;1171038;17128;2969
64084;Aydie;82;1404597;39862;34;968282;48;436315;17129;2970
47048;Cancon;782;13395115;373626;295;8441828;487;4953287;17129;2971
23132;Montaigut-le-Blanc;241;4128219;126645;95;2813147;146;1315072;17130;2972
54425;Piennes;1357;23246732;455598;444;12267213;913;10979519;17131;2973
33169;Floudès;55;942204;18260;25;666954;30;275250;17131;2974
03134;Laféline;113;1935833;47515;54;1356607;59;579226;17131;2975
48178;Saint-Privat-de-Vallongue;137;2347080;45203;46;1360516;91;986564;17132;2976
15037;Champagnac;657;11256958;287857;292;7495846;365;3761112;17134;2977
43206;Saint-Just-près-Brioude;260;4455020;75128;106;2921596;154;1533424;17135;2978
55284;Lavincourt;48;822491;33137;23;561098;25;261393;17135;2979
05141;Saint-Eusèbe-en-Champsaur;84;1439367;15280;40;1090063;44;349304;17135;2980
38319;Pont-en-Royans;521;8927612;288663;231;6270117;290;2657495;17136;2981
89250;Méré;99;1696516;35930;38;1158792;61;537724;17137;2982
65129;Castelnau-Magnoac;484;8294319;358033;200;5985693;284;2308626;17137;2983
59139;Caudry;8213;140754289;5129584;3330;99392799;4883;41361490;17138;2984
60471;Noyon;7826;134123727;5215350;3133;94392591;4693;39731136;17138;2985
69251;Trades;66;1131183;23511;35;836532;31;294651;17139;2986
80245;Domléger-Longvillers;164;2810929;66512;76;1912890;88;898039;17140;2987
63140;Durmignat;133;2279598;65560;60;1565037;73;714561;17140;2988
58283;Taconnay;53;908418;28284;24;629034;29;279384;17140;2989
56025;Brignac;108;1851277;41185;51;1257161;57;594116;17141;2990
59574;Somain;6778;116196300;3251380;2765;78731716;4013;37464584;17143;2991
63162;Fournols;223;3823300;159810;97;2736731;126;1086569;17145;2992
72282;Saint-Georges-le-Gaultier;309;5297772;86902;125;3438223;184;1859549;17145;2993
79339;Vasles;996;17076418;370258;399;10967732;597;6108686;17145;2994
46257;Saint-Cirq-Madelon;78;1337448;26779;31;843731;47;493717;17147;2995
11268;Orsans;45;771628;20142;17;517437;28;254191;17147;2996
23227;Saint-Pardoux-Morterolles;138;2366352;55890;59;1526623;79;839729;17147;2997
55030;Baudignécourt;47;805962;19275;22;545702;25;260260;17148;2998
18136;Marçais;189;3241108;90126;81;2197119;108;1043989;17149;2999
06062;Fontan;199;3412798;90727;92;2365468;107;1047330;17150;3000
66057;Corneilla-de-Conflent;257;4407625;109589;114;3071927;143;1335698;17150;3001
17105;Chives;216;3704696;99715;94;2594637;122;1110059;17151;3002
63182;Jumeaux;427;7324249;184399;191;5007988;236;2316261;17153;3003
52250;Joinville;2062;35369568;1651876;819;25010349;1243;10359219;17153;3004
17260;Neuvicq;283;4855021;178113;110;3387419;173;1467602;17156;3005
08411;Semuy;55;943565;18549;26;657010;29;286555;17156;3006
05050;Espinasses;401;6879822;177061;163;4417295;238;2462527;17157;3007
80450;Inval-Boiron;55;943626;27164;22;652425;33;291201;17157;3008
30045;Bordezac;228;3911857;115882;92;2526914;136;1384943;17157;3009
58139;Lanty;80;1372590;22214;34;920521;46;452069;17157;3010
64013;Ainhice-Mongelos;78;1338279;8981;37;893019;41;445260;17157;3011
79280;Saint-Maurice-la-Fougereuse;281;4821275;58393;112;2940724;169;1880551;17158;3012
55084;Broussey-en-Blois;41;703503;10543;18;467465;23;236038;17159;3013
81264;Saint-Michel-Labadié;49;840774;12882;22;584545;27;256229;17159;3014
07062;Chazeaux;73;1252614;11502;31;779589;42;473025;17159;3015
03138;Lapalisse;1922;32980553;1123985;802;22582268;1120;10398285;17159;3016
2B020;Aregno;336;5765805;240952;147;4139212;189;1626593;17160;3017
65137;Caussade-Rivière;55;943884;18238;22;646990;33;296894;17162;3018
57181;Domnom-lès-Dieuze;58;995372;11026;27;632818;31;362554;17162;3019
07216;Saint-Barthélemy-Grozon;305;5234315;156448;129;3517001;176;1717314;17162;3020
21707;Villy-en-Auxois;137;2351174;82438;59;1569879;78;781295;17162;3021
63110;Cisternes-la-Forêt;261;4479923;113689;120;3107633;141;1372290;17164;3022
79075;La Chapelle-Saint-Étienne;184;3158273;58095;79;2129219;105;1029054;17165;3023
54531;Tramont-Saint-André;34;583597;27100;13;417353;21;166244;17165;3024
10217;Maison-des-Champs;28;480631;16571;14;349826;14;130805;17165;3025
36096;Lingé;145;2489092;59423;60;1675943;85;813149;17166;3026
64002;Abère;84;1441991;27634;31;915857;53;526134;17167;3027
59495;Recquignies;1277;21922377;552380;573;15347106;704;6575271;17167;3028
27485;Quillebeuf-sur-Seine;550;9442089;247115;253;6699409;297;2742680;17167;3029
23078;Faux-Mazuras;114;1957133;68458;41;1332188;73;624945;17168;3030
59418;Mortagne-du-Nord;865;14851394;495170;342;10263663;523;4587731;17169;3031
58079;Clamecy;2597;44589736;1753252;1084;31891236;1513;12698500;17170;3032
31080;Boulogne-sur-Gesse;990;16998873;619177;409;11914270;581;5084603;17171;3033
81034;Boissezon;233;4000926;133642;100;2782026;133;1218900;17171;3034
43033;Blesle;392;6731287;212185;169;4605204;223;2126083;17172;3035
10323;Romilly-sur-Seine;8470;145454661;4736236;3701;101114567;4769;44340094;17173;3036
52341;Morancourt;60;1030378;3499;18;527284;42;503094;17173;3037
11364;Saint-Polycarpe;94;1614351;66815;36;1165840;58;448511;17174;3038
87097;Mézières-sur-Issoire;472;8106259;228518;189;5217365;283;2888894;17174;3039
12175;Ols-et-Rinhodes;87;1494246;16245;33;961692;54;532554;17175;3040
22260;Le Quillio;336;5771034;192637;132;3794367;204;1976667;17176;3041
09158;Lasserre;127;2181384;62138;44;1463332;83;718052;17176;3042
70573;La Voivre;84;1442923;55811;29;905222;55;537701;17178;3043
19171;Reygade;103;1769362;14505;43;1154503;60;614859;17178;3044
09285;Seix;466;8005109;311717;180;5387753;286;2617356;17178;3045
44105;Mouais;195;3349851;26594;82;2190867;113;1158984;17179;3046
50415;Prétot-Sainte-Suzanne;183;3143732;68809;67;1948534;116;1195198;17179;3047
2A324;Tavera;249;4277634;166562;120;3123101;129;1154533;17179;3048
56082;Helléan;203;3487389;57096;87;2347127;116;1140262;17179;3049
15231;Talizat;341;5858224;75166;148;3747741;193;2110483;17180;3050
02358;Grougis;216;3711467;104301;89;2458334;127;1253133;17183;3051
21047;Bard-lès-Époisses;44;756043;22653;21;562860;23;193183;17183;3052
58266;Saint-Révérien;117;2010410;57964;54;1429818;63;580592;17183;3053
12283;Trémouilles;268;4605059;47840;100;2989495;168;1615564;17183;3054
66023;Bouleternère;514;8832740;168035;226;6104803;288;2727937;17184;3055
29122;Laz;416;7148776;150769;181;4732048;235;2416728;17185;3056
55183;Étraye;28;481180;7216;15;360565;13;120615;17185;3057
03009;Aubigny;64;1099844;10348;28;748935;36;350909;17185;3058
16315;Saint-Félix;76;1306078;36543;29;817428;47;488650;17185;3059
39272;Ladoye-sur-Seille;36;618678;8818;15;453799;21;164879;17186;3060
97209;Fort-de-France;52652;904861541;35620153;17934;643061173;34718;261800368;17186;3061
32455;Troncens;93;1598326;23093;36;992578;57;605748;17186;3062
82177;Sauveterre;96;1649898;65718;35;1075874;61;574024;17186;3063
86234;Saint-Martin-l'Ars;230;3953204;89071;102;2746920;128;1206284;17188;3064
64046;Armendarits;170;2922080;35233;59;1706968;111;1215112;17189;3065
71531;La Tagnière;149;2561205;106190;63;1744866;86;816339;17189;3066
11390;Thézan-des-Corbières;314;5397708;152667;129;3820165;185;1577543;17190;3067
23124;Marsac;413;7099544;213000;159;4599414;254;2500130;17190;3068
63010;Arlanc;1162;19976287;543986;484;13527630;678;6448657;17191;3069
23236;Saint-Priest-la-Plaine;154;2647492;55697;70;1947597;84;699895;17192;3070
02720;Sissonne;1113;19134267;562039;479;12989761;634;6144506;17192;3071
65399;Saligos;53;911194;21972;25;525654;28;385540;17192;3072
44092;Massérac;377;6481589;128492;151;4138399;226;2343190;17193;3073
18076;Coust;257;4418500;119528;112;3054930;145;1363570;17193;3074
16392;Valence;131;2252277;49933;57;1481857;74;770420;17193;3075
42045;La Chambonie;29;498632;21401;11;334687;18;163945;17194;3076
32427;Sembouès;37;636186;19295;13;433813;24;202373;17194;3077
11333;Saint-Benoît;58;997315;52063;18;705087;40;292228;17195;3078
03108;Échassières;241;4144216;159739;80;2525339;161;1618877;17196;3079
23165;Royère-de-Vassivière;356;6122023;252846;149;4456746;207;1665277;17197;3080
02745;Toulis-et-Attencourt;83;1427398;35164;34;1001740;49;425658;17198;3081
79060;Caunay;101;1737031;54891;47;1239552;54;497479;17198;3082
16215;Médillac;93;1599460;63526;36;1053348;57;546112;17198;3083
65289;Luby-Betmont;57;980327;19396;23;648415;34;331912;17199;3084
79033;Belleville;70;1203918;11121;31;797354;39;406564;17199;3085
42291;Saint-Thurin;108;1857500;56202;42;1225930;66;631570;17199;3086
43076;Connangles;97;1668373;54376;39;1055244;58;613129;17200;3087
04022;Barrême;279;4798857;209204;103;3123488;176;1675369;17200;3088
44123;Pierric;536;9219537;125367;236;6247768;300;2971769;17201;3089
70404;Passavant-la-Rochère;388;6673968;166554;164;4334221;224;2339747;17201;3090
65092;Beyrède-Jumet;122;2098598;62744;56;1503448;66;595150;17202;3091
06009;Bairols;34;584862;12359;14;357942;20;226920;17202;3092
34092;Cruzy;548;9426651;266269;219;6356574;329;3070077;17202;3093
18114;Ineuil;123;2115951;48764;50;1425405;73;690546;17203;3094
53102;Gastines;92;1582695;3337;38;997202;54;585493;17203;3095
33267;Marcillac;666;11457792;357557;254;7770223;412;3687569;17204;3096
38040;Besse;67;1152729;38666;33;853618;34;299111;17205;3097
53091;Désertines;273;4696959;66398;90;2548310;183;2148649;17205;3098
56100;Langonnet;1123;19321605;492620;471;13299094;652;6022511;17205;3099
65296;Madiran;295;5075583;129670;123;3538815;172;1536768;17205;3100
42035;Cezay;114;1961415;26986;44;1169874;70;791541;17205;3101
88078;Bruyères;1932;33241455;1392179;751;22496599;1181;10744856;17206;3102
12047;Campagnac;242;4163792;89942;91;2431500;151;1732292;17206;3103
15020;Beaulieu;55;946417;39263;21;632502;34;313915;17208;3104
03027;Bézenet;546;9395351;251531;252;6775143;294;2620208;17208;3105
82129;Montgaillard;62;1066879;16074;27;729999;35;336880;17208;3106
52142;Consigny;40;688332;18077;21;525450;19;162882;17208;3107
22088;Kerien;141;2426521;17846;55;1475978;86;950543;17209;3108
31266;Lahage;129;2220058;57654;41;1615986;88;604072;17210;3109
81280;Le Ségur;144;2478216;29211;62;1772709;82;705507;17210;3110
03293;Urçay;198;3407632;124915;88;2442656;110;964976;17210;3111
32468;Aussos;38;653996;9283;15;443413;23;210583;17210;3112
24110;La Chapelle-Montabourlet;40;688436;10460;16;428881;24;259555;17211;3113
14371;Livarot;1300;22374380;816206;533;15304671;767;7069709;17211;3114
65165;Esparros;106;1824405;54818;49;1294089;57;530316;17211;3115
54388;Mouacourt;33;568045;3162;12;304055;21;263990;17213;3116
43195;Saint-Ilpize;111;1910790;57483;39;1311369;72;599421;17214;3117
16354;Sainte-Souline;69;1187819;23388;26;746859;43;440960;17215;3118
82042;Cazes-Mondenard;628;10811261;354642;206;6771432;422;4039829;17215;3119
24186;Fonroque;163;2806174;51299;69;1905134;94;901040;17216;3120
33006;Anglade;514;8849168;229326;218;6133625;296;2715543;17216;3121
63384;Saint-Pierre-la-Bourlhonne;80;1377336;38952;31;880159;49;497177;17217;3122
30140;Lasalle;685;11793971;512458;234;7463349;451;4330622;17217;3123
14352;Landelles-et-Coupigny;483;8316245;173298;181;5158983;302;3157262;17218;3124
11413;Villardonnel;256;4407927;123113;106;3111193;150;1296734;17218;3125
49368;Vernantes;1145;19715453;488622;472;13498358;673;6217095;17219;3126
17390;Sainte-Ramée;87;1498074;50416;35;983060;52;515014;17219;3127
2B236;Poggio-di-Nazza;85;1463667;125003;36;1095476;49;368191;17220;3128
23137;Mourioux-Vieilleville;341;5871968;210693;139;3898290;202;1973678;17220;3129
23040;La Celle-sous-Gouzon;78;1343180;37046;32;922721;46;420459;17220;3130
08065;Bièvres;34;585529;6734;15;385158;19;200371;17221;3131
64049;Aroue-Ithorots-Olhaïby;124;2135516;39069;54;1453620;70;681896;17222;3132
02430;Liesse-Notre-Dame;761;13106199;300313;322;8937716;439;4168483;17222;3133
88221;Gruey-lès-Surance;143;2462823;64883;60;1588554;83;874269;17223;3134
15259;Vieillespesse;154;2652410;59746;56;1617152;98;1035258;17223;3135
43044;Cerzat;119;2049673;33928;50;1372911;69;676762;17224;3136
29175;Plonévez-du-Faou;1339;23063734;516681;560;15347780;779;7715954;17225;3137
34306;Soumont;113;1946400;56247;46;1378314;67;568086;17225;3138
12221;Saint-Félix-de-Lunel;218;3755008;67517;96;2612299;122;1142709;17225;3139
70283;Haut-du-Them-Château-Lambert;276;4754177;101163;130;3206116;146;1548061;17225;3140
03141;Lavoine;95;1636462;27465;33;995365;62;641097;17226;3141
17388;Saint-Quantin-de-Rançanne;166;2859604;56118;70;1964201;96;895403;17227;3142
23074;Le Donzeil;108;1860470;56285;51;1410124;57;450346;17227;3143
57044;Azoudange;58;999161;7076;22;614511;36;384650;17227;3144
22359;Trégrom;207;3566135;65105;91;2433613;116;1132522;17228;3145
14512;Pontécoulant;49;844179;10023;23;575602;26;268577;17228;3146
88208;Godoncourt;72;1240430;37752;22;697437;50;542993;17228;3147
65258;Lannemezan;3792;65331169;2515375;1694;47443508;2098;17887661;17229;3148
24159;Échourgnac;257;4427821;158084;104;3217885;153;1209936;17229;3149
03105;Droiturier;208;3583933;61036;83;2268870;125;1315063;17230;3150
89409;Tharoiseau;44;758143;17133;19;554137;25;204006;17231;3151
31071;Bois-de-la-Pierre;241;4152579;119055;100;3159253;141;993326;17231;3152
2B180;Novella;53;913306;24254;25;642800;28;270506;17232;3153
65052;Averan;40;689315;11120;19;512650;21;176665;17233;3154
43175;Saint-Cirgues;95;1637150;32660;40;1094537;55;542613;17233;3155
71290;Mazille;249;4291122;148485;108;3167685;141;1123437;17233;3156
02670;Saint-Algis;91;1568267;33917;40;1072917;51;495350;17234;3157
2B166;Monte;322;5549329;181665;122;3729491;200;1819838;17234;3158
02116;Braye-en-Thiérache;89;1533865;55085;33;962487;56;571378;17234;3159
79072;La Chapelle-Gaudin;126;2171582;12173;53;1360915;73;810667;17235;3160
63095;Charnat;136;2343986;33819;64;1586229;72;757757;17235;3161
50533;Saint-Patrice-de-Claids;92;1585655;33687;37;980379;55;605276;17235;3162
07193;Rocher;177;3050714;117761;79;2193006;98;857708;17236;3163
03165;Le Mayet-de-Montagne;865;14908880;414239;333;9918059;532;4990821;17236;3164
24348;Razac-d'Eymet;170;2930104;47465;71;1838204;99;1091900;17236;3165
23099;Janaillat;201;3464578;81118;81;2317015;120;1147563;17237;3166
55087;Bure;50;861866;28819;16;520803;34;341063;17237;3167
02126;Brunehamel;278;4791984;127795;98;2997749;180;1794235;17237;3168
31017;Arlos;53;913614;33181;29;709618;24;203996;17238;3169
2A330;Ucciani;269;4637039;145143;115;3394869;154;1242170;17238;3170
48015;Pied-de-Borne;129;2223824;52645;58;1620024;71;603800;17239;3171
57564;Réchicourt-le-Château;315;5430376;55240;149;3625338;166;1805038;17239;3172
16289;Roussines;162;2792765;78320;68;2056459;94;736306;17239;3173
59002;Abscon;2308;39794089;898441;951;26091485;1357;13702604;17242;3174
32190;Lannepax;349;6017802;207641;136;4077400;213;1940402;17243;3175
58287;Tazilly;143;2465902;27935;50;1510292;93;955610;17244;3176
50136;Coigny;110;1896878;32526;51;1337967;59;558911;17244;3177
2A197;Osani;63;1086396;51017;26;757018;37;329378;17244;3178
43138;Monlet;235;4052437;100337;77;2397257;158;1655180;17244;3179
71030;Bergesserin;122;2103942;73244;53;1524713;69;579229;17245;3180
23226;Saint-Pardoux-d'Arnet;98;1690056;31405;39;1097108;59;592948;17245;3181
12226;Saint-Hippolyte;278;4794705;104113;102;3197960;176;1596745;17247;3182
47054;Castelmoron-sur-Lot;1035;17851420;508289;411;11943885;624;5907535;17248;3183
23174;Soumans;339;5847224;127320;139;3829326;200;2017898;17248;3184
82187;Varen;435;7503373;209661;163;4625978;272;2877395;17249;3185
32337;Puységur;48;827970;19761;20;549883;28;278087;17249;3186
22169;Peumerit-Quintin;83;1431783;17567;38;991570;45;440213;17250;3187
12089;Decazeville;3629;62603188;2231658;1504;43101721;2125;19501467;17251;3188
16002;Les Adjots;282;4864826;96116;116;3110961;166;1753865;17251;3189
09029;Aulus-les-Bains;90;1552644;36931;44;1108887;46;443757;17252;3190
65361;Peyrun;58;1000744;23107;27;733606;31;267138;17254;3191
09125;Fougax-et-Barrineuf;256;4417389;125753;106;2898033;150;1519356;17255;3192
67491;Tieffenbach;177;3054374;67692;82;2052729;95;1001645;17256;3193
11280;Pépieux;558;9629053;263652;210;6241679;348;3387374;17256;3194
03239;Saint-Léger-sur-Vouzance;160;2761027;56938;69;1893283;91;867744;17256;3195
79282;Saint-Médard;70;1207956;30502;29;811414;41;396542;17257;3196
52483;Soyers;49;845639;19456;22;576563;27;269076;17258;3197
87053;Cromac;150;2588698;48921;64;1708010;86;880688;17258;3198
17309;Saint-Aigulin;1176;20295404;668530;474;13839486;702;6455918;17258;3199
22129;Loc-Envel;43;742118;6832;19;465493;24;276625;17259;3200
56257;La Trinité-Porhoët;394;6799908;171515;153;4376818;241;2423090;17259;3201
64408;Mouhous;25;431474;8013;11;273928;14;157546;17259;3202
58151;La Machine;2132;36796408;1168833;966;25898446;1166;10897962;17259;3203
62767;Saint-Pol-sur-Ternoise;3141;54211566;2226830;1264;37839314;1877;16372252;17259;3204
30231;Saint-André-de-Valborgne;245;4228681;143161;93;2762019;152;1466662;17260;3205
50236;La Haye-du-Puits;1031;17795475;641342;380;11862112;651;5933363;17260;3206
80635;Pont-Remy;771;13309463;363567;315;8701243;456;4608220;17263;3207
86051;Champagné-le-Sec;125;2157930;29742;55;1350239;70;807691;17263;3208
64468;Roquiague;51;880457;6436;24;613803;27;266654;17264;3209
63171;Gouttières;208;3591028;100991;92;2486705;116;1104323;17265;3210
79328;Thorigny-sur-le-Mignon;50;863240;11543;21;539566;29;323674;17265;3211
52303;Maizières-sur-Amance;67;1156795;30987;30;902997;37;253798;17266;3212
04237;Le Vernet;80;1381255;37477;38;1032857;42;348398;17266;3213
08394;Saint-Pierremont;47;811611;19234;19;448784;28;362827;17268;3214
59591;Thivencelle;423;7304795;139831;166;4986118;257;2318677;17269;3215
08081;Bogny-sur-Meuse;2932;50637335;1525066;1234;34507026;1698;16130309;17271;3216
55071;Brandeville;86;1485294;27262;30;900758;56;584536;17271;3217
12085;Crespin;142;2452511;36951;62;1657182;80;795329;17271;3218
62787;Sempy;158;2729368;37986;63;1719450;95;1009918;17274;3219
34002;Adissan;586;10122889;202083;229;6739667;357;3383222;17275;3220
18217;Saint-Jeanvrin;95;1641105;46069;48;1270604;47;370501;17275;3221
33187;Gironde-sur-Dropt;719;12421051;310276;327;8797264;392;3623787;17275;3222
2B187;Olmeta-di-Capocorso;82;1416659;54760;34;993973;48;422686;17276;3223
23189;Saint-Dizier-Leyrenne;502;8673014;234040;218;5897455;284;2775559;17277;3224
55509;Thonne-le-Thil;156;2695202;60195;63;1692484;93;1002718;17277;3225
36092;Langé;176;3040792;76264;69;1968728;107;1072064;17277;3226
63223;Menat;346;5978061;154626;155;4134444;191;1843617;17278;3227
18177;Parnay;25;431989;3119;12;299348;13;132641;17280;3228
33416;Saint-Girons-d'Aiguevives;549;9486556;196084;236;6502404;313;2984152;17280;3229
48115;Le Pompidou;107;1849077;38322;48;1258535;59;590542;17281;3230
22053;Éréac;377;6515243;115325;154;4268176;223;2247067;17282;3231
79131;Geay;187;3231741;41385;82;2211331;105;1020410;17282;3232
52416;Rangecourt;36;622160;12272;20;437952;16;184208;17282;3233
43039;Le Brignon;339;5858767;121659;136;3801706;203;2057061;17282;3234
23072;Domeyrot;152;2627019;64560;64;1808084;88;818935;17283;3235
19064;Couffy-sur-Sarsonne;41;708657;20130;19;480755;22;227902;17284;3236
04092;La Garde;60;1037087;31757;29;731827;31;305260;17285;3237
88349;Plainfaing;1097;18961442;416717;524;13402402;573;5559040;17285;3238
55449;Rupt-en-Woëvre;166;2869329;55199;71;1885376;95;983953;17285;3239
47071;Coulx;141;2437211;66588;60;1664636;81;772575;17285;3240
56209;Sainte-Brigitte;107;1849592;57489;38;1193440;69;656152;17286;3241
61454;Sainte-Scolasse-sur-Sarthe;312;5393459;117295;123;3454874;189;1938585;17287;3242
80663;Rambures;207;3578677;75902;87;2418256;120;1160421;17288;3243
24454;Saint-Martin-de-Gurson;368;6362822;144057;170;4501197;198;1861625;17290;3244
35341;Tremblay;908;15700306;475188;353;10900053;555;4800253;17291;3245
17101;Cherbonnières;204;3527392;72310;77;2169642;127;1357750;17291;3246
65097;Bonrepos;110;1902048;48036;57;1407382;53;494666;17291;3247
2A308;Sainte-Lucie-de-Tallano;271;4686018;197833;128;3532131;143;1153887;17292;3248
87168;Saint-Mathieu;659;11395308;334080;274;7873940;385;3521368;17292;3249
56129;Ménéac;942;16288958;394049;362;10771592;580;5517366;17292;3250
58015;Asnan;92;1590855;62690;40;1031988;52;558867;17292;3251
67421;Saales;505;8732453;202944;213;5734365;292;2998088;17292;3252
66139;Pézilla-de-Conflent;26;449602;7987;13;352406;13;97196;17292;3253
61074;Carrouges;429;7418832;150028;150;4379612;279;3039220;17293;3254
11091;Chalabre;674;11655951;406280;251;7827402;423;3828549;17294;3255
62738;Sains-lès-Fressin;83;1435379;12708;31;873068;52;562311;17294;3256
55338;Milly-sur-Bradon;102;1763991;44719;50;1286886;52;477105;17294;3257
55266;Lachalade;38;657177;6090;13;384736;25;272441;17294;3258
59311;Honnechy;281;4859702;83225;122;3187356;159;1672346;17294;3259
65293;Lustar;73;1262533;52909;31;897802;42;364731;17295;3260
04033;La Bréole;202;3493882;66828;83;2318087;119;1175795;17296;3261
2B244;Popolasca;26;449717;7819;11;326759;15;122958;17297;3262
24500;Saint-Sauveur-Lalande;84;1453227;16163;33;976716;51;476511;17300;3263
88199;Gignéville;47;813119;6338;23;545910;24;267209;17300;3264
39196;Les Deux-Fays;62;1072633;24700;22;634454;40;438179;17301;3265
12258;La Salvetat-Peyralès;600;10380513;251353;235;6872080;365;3508433;17301;3266
17410;Saint-Thomas-de-Conac;341;5899821;245749;127;3910204;214;1989617;17302;3267
18135;Maisonnais;145;2508776;60145;67;1750503;78;758273;17302;3268
58181;Moraches;82;1418761;32704;38;964883;44;453878;17302;3269
22078;Hengoat;139;2404980;80489;62;1707953;77;697027;17302;3270
23265;La Villeneuve;48;830533;25302;20;523463;28;307070;17303;3271
22102;Langourla;321;5554197;140845;141;3777746;180;1776451;17303;3272
65398;Saléchan;143;2474364;57010;65;1713873;78;760491;17303;3273
72194;Meurcé;150;2595504;50686;64;1710548;86;884956;17303;3274
58017;Aunay-en-Bazois;180;3114612;85320;81;2211589;99;903023;17303;3275
76114;Bolbec;6728;116419945;3395809;2912;81298753;3816;35121192;17304;3276
39216;Étival;198;3426161;53959;80;2143504;118;1282657;17304;3277
24001;Abjat-sur-Bandiat;380;6575535;174838;152;4463803;228;2111732;17304;3278
15257;Vezels-Roussy;90;1557415;70670;32;1093776;58;463639;17305;3279
61158;Faverolles;88;1522866;26162;43;1097783;45;425083;17305;3280
14508;Le Plessis-Grimoult;178;3080355;31334;69;2039502;109;1040853;17305;3281
71123;Chenay-le-Châtel;229;3963028;65696;98;2598598;131;1364430;17306;3282
2B080;Castifao;89;1540244;59904;42;1189965;47;350279;17306;3283
03051;Chambérat;179;3097797;75447;77;2111780;102;986017;17306;3284
61297;Moulins-la-Marche;450;7788021;283058;165;5175172;285;2612849;17307;3285
46232;Les Quatre-Routes-du-Lot;369;6386388;226923;145;4184719;224;2201669;17307;3286
85264;Saint-Pierre-du-Chemin;749;12964388;344600;285;8380507;464;4583881;17309;3287
03320;Ygrande;454;7858291;158612;202;5391762;252;2466529;17309;3288
79153;Loubigné;96;1661672;20170;40;1062548;56;599124;17309;3289
55328;Maxey-sur-Vaise;184;3184920;72385;75;2009026;109;1175894;17309;3290
50225;Le Guislain;70;1211708;33915;37;938492;33;273216;17310;3291
79019;Aubigny;98;1696435;17769;40;1050323;58;646112;17311;3292
17211;Loulay;447;7738171;168307;164;4906082;283;2832089;17311;3293
53160;Montreuil-Poulay;214;3704650;21527;92;2418765;122;1285885;17311;3294
34162;Montagnac;2204;38156264;1190300;832;25528386;1372;12627878;17312;3295
81182;Montredon-Labessonnié;1171;20274035;374665;450;13229985;721;7044050;17313;3296
37044;La Celle-Guenand;220;3809062;103758;86;2468534;134;1340528;17314;3297
65143;Chelle-Spou;64;1108132;11214;26;661554;38;446578;17315;3298
02244;Crupilly;33;571427;14430;11;385248;22;186179;17316;3299
40131;Labastide-d'Armagnac;433;7498205;237680;178;5166969;255;2331236;17317;3300
2B303;San-Giuliano;376;6511343;286504;156;4733191;220;1778152;17317;3301
47164;Mazières-Naresse;72;1246947;37240;28;887150;44;359797;17319;3302
82113;Molières;655;11343942;293148;247;7268906;408;4075036;17319;3303
03028;Billezois;205;3550443;58672;86;2313370;119;1237073;17319;3304
52264;Laneuvelle;46;796703;17398;19;516862;27;279841;17320;3305
48123;Recoules-d'Aubrac;102;1766611;127401;30;1072280;72;694331;17320;3306
43143;Montusclat;73;1264371;25097;31;820451;42;443920;17320;3307
88035;Barbey-Seroux;84;1454962;23102;40;1016998;44;437964;17321;3308
34049;Camplong;123;2130489;42394;54;1410450;69;720039;17321;3309
62346;Fortel-en-Artois;111;1922656;33649;41;1157994;70;764662;17321;3310
23030;Bourganeuf;1617;28008522;1178663;610;19105670;1007;8902852;17321;3311
43111;Landos;525;9094443;143573;217;5910363;308;3184080;17323;3312
27395;Mélicourt;49;848934;23375;23;590015;26;258919;17325;3313
18029;Bessais-le-Fromental;201;3482380;94433;89;2354839;112;1127541;17325;3314
42203;Saint-Bonnet-des-Quarts;219;3794528;71547;96;2507516;123;1287012;17327;3315
54013;Amenoncourt;48;831706;13352;19;533790;29;297916;17327;3316
31122;Casties-Labrande;67;1160946;13737;33;786446;34;374500;17328;3317
18162;Neuilly-en-Sancerre;155;2685930;89361;69;1914037;86;771893;17329;3318
50521;Saint-Maur-des-Bois;76;1316981;21701;32;876829;44;440152;17329;3319
16279;Rioux-Martin;152;2633971;80445;63;1845800;89;788171;17329;3320
65215;Hagedet;28;485206;7912;12;342697;16;142509;17329;3321
15081;Jou-sous-Monjou;71;1230351;32659;23;805408;48;424943;17329;3322
07151;Mars;142;2460717;40335;61;1665457;81;795260;17329;3323
23120;Malleret-Boussac;128;2218292;59008;48;1398854;80;819438;17330;3324
24565;Varaignes;242;4194022;109463;105;2843196;137;1350826;17331;3325
36147;Orville;83;1438471;41796;40;986466;43;452005;17331;3326
08143;Doumely-Bégny;49;849223;15716;25;649651;24;199572;17331;3327
06154;Valderoure;239;4142170;162280;99;2919471;140;1222699;17331;3328
82061;Féneyrols;91;1577194;55567;33;1008574;58;568620;17332;3329
23102;Ladapeyre;223;3865022;125123;90;2673446;133;1191576;17332;3330
02757;Vadencourt;338;5858392;167885;143;4000258;195;1858134;17333;3331
82137;Parisot;298;5165117;159509;115;3446149;183;1718968;17333;3332
16180;Laprade;124;2149345;44417;45;1345231;79;804114;17333;3333
64410;Mourenx;3893;67479341;1970343;1733;46510447;2160;20968894;17334;3334
56048;Le Croisty;431;7471027;208340;156;4674731;275;2796296;17334;3335
55228;Hannonville-sous-les-Côtes;353;6119278;158009;145;4119242;208;2000036;17335;3336
79001;L'Absie;575;9967667;217876;220;6427994;355;3539673;17335;3337
02558;Le Nouvion-en-Thiérache;1567;27164090;941982;629;18230285;938;8933805;17335;3338
11038;Bessède-de-Sault;38;658762;60900;13;447422;25;211340;17336;3339
82145;Puygaillard-de-Quercy;188;3259340;24690;78;2155970;110;1103370;17337;3340
58172;Montambert;83;1438984;43936;34;989727;49;449257;17337;3341
79047;Boussais;241;4178268;46439;101;2649631;140;1528637;17337;3342
43246;Tiranges;271;4698501;56204;111;3007660;160;1690841;17338;3343
40176;Mauvezin-d'Armagnac;59;1022971;31151;21;656558;38;366413;17338;3344
18057;Châteaumeillant;1237;21448356;769920;520;15144745;717;6303611;17339;3345
50125;Chasseguey;45;780265;12151;21;537339;24;242926;17339;3346
13077;Port-de-Bouc;10128;175620147;6381953;4334;125387894;5794;50232253;17340;3347
70486;Semmadon;66;1144467;30783;29;805601;37;338866;17340;3348
52285;Leuchey;42;728310;8339;17;437903;25;290407;17341;3349
47148;Leyritz-Moncassin;124;2150421;49280;50;1430381;74;720040;17342;3350
23118;Maisonnisses;117;2029056;74585;46;1423456;71;605600;17342;3351
14619;Sainte-Marie-Outre-l'Eau;57;988655;22760;24;699432;33;289223;17345;3352
61275;Le Merlerault;573;9938824;299836;215;6310975;358;3627849;17345;3353
88036;Barville;52;902049;14907;28;668549;24;233500;17347;3354
14050;La Bazoque;112;1942911;43555;49;1364296;63;578615;17347;3355
35019;Bazouges-la-Pérouse;1112;19292814;661596;463;13897858;649;5394956;17350;3356
57100;Bourscheid;269;4667127;100569;209;4019467;60;647660;17350;3357
33195;Grignols;699;12128173;361710;251;7861841;448;4266332;17351;3358
34226;Quarante;913;15841361;475752;353;10599613;560;5241748;17351;3359
16377;La Tâche;56;971701;16636;22;653561;34;318140;17352;3360
26308;Saint-Julien-en-Quint;87;1509685;32391;30;988362;57;521323;17353;3361
39062;La Boissière;26;451172;10041;12;321698;14;129474;17353;3362
71273;Maltat;170;2950004;67453;78;2049468;92;900536;17353;3363
89028;Baon;40;694147;13391;18;443178;22;250969;17354;3364
79006;Les Alleuds;145;2516347;51134;65;1725112;80;791235;17354;3365
53204;Saint-Calais-du-Désert;214;3714182;61880;96;2513816;118;1200366;17356;3366
03136;Lamaids;109;1891858;64510;48;1268011;61;623847;17356;3367
07322;Thueyts;727;12618356;323440;303;8319687;424;4298669;17357;3368
59464;Poix-du-Nord;1176;20414356;542548;487;13938658;689;6475698;17359;3369
22104;Languédias;272;4722092;87335;116;3135519;156;1586573;17361;3370
12212;Saint-Beaulize;61;1059006;19299;25;683912;36;375094;17361;3371
97221;Rivière-Salée;7088;123056959;3929699;2326;82705901;4762;40351058;17361;3372
04059;Clumanc;122;2118140;90800;55;1502991;67;615149;17362;3373
24190;Fouleix;135;2344059;38250;53;1498934;82;845125;17363;3374
50378;Notre-Dame-de-Cenilly;354;6147024;109301;161;4256736;193;1890288;17364;3375
61025;La Baroche-sous-Lucé;237;4115422;59900;99;2773281;138;1342141;17365;3376
60280;Gourchelles;76;1319715;29312;35;910886;41;408829;17365;3377
70320;Magny-lès-Jussey;66;1146131;35737;27;714831;39;431300;17366;3378
93059;Pierrefitte-sur-Seine;14075;244424211;8486492;5897;169924928;8178;74499283;17366;3379
39509;Senaud;26;451516;13693;11;279944;15;171572;17366;3380
11208;La Louvière-Lauragais;43;746738;23888;20;549444;23;197294;17366;3381
34028;Bédarieux;3743;65003630;2730101;1485;45281036;2258;19722594;17367;3382
17043;Bernay-Saint-Martin;419;7276695;182726;159;4772265;260;2504430;17367;3383
46196;Montamel;57;989961;32551;22;664574;35;325387;17368;3384
11034;Belvèze-du-Razès;527;9153548;309201;208;6212296;319;2941252;17369;3385
19221;Saint-Martial-Entraygues;53;920570;32793;22;615336;31;305234;17369;3386
34189;Olonzac;1025;17803956;596600;390;11954578;635;5849378;17370;3387
42047;Champoly;181;3143986;70516;77;1961968;104;1182018;17370;3388
52406;Pressigny;127;2206114;42447;53;1416578;74;789536;17371;3389
61122;Coulmer;51;885954;20854;23;693555;28;192399;17372;3390
24097;Champagne-et-Fontaine;225;3908666;111998;80;2550979;145;1357687;17372;3391
63449;Le Vernet-Sainte-Marguerite;186;3231263;79345;89;2433862;97;797401;17372;3392
14342;Isigny-sur-Mer;1715;29794867;1168692;721;20310553;994;9484314;17373;3393
37189;Preuilly-sur-Claise;656;11396775;363252;247;7370377;409;4026398;17373;3394
16017;Anville;108;1876326;48489;51;1327908;57;548418;17373;3395
34006;Aigne;145;2519326;86039;54;1777962;91;741364;17375;3396
88473;Tignécourt;72;1251057;44745;27;848908;45;402149;17376;3397
16062;Brie-sous-Barbezieux;70;1216318;15731;28;791764;42;424554;17376;3398
47007;Allons;105;1824494;67198;42;1286752;63;537742;17376;3399
24008;Angoisse;353;6133881;137080;143;3981191;210;2152690;17376;3400
22052;Duault;207;3596932;80573;91;2537440;116;1059492;17376;3401
56208;Saint-Brieuc-de-Mauron;185;3214683;70356;79;2291334;106;923349;17377;3402
12129;Lestrade-et-Thouels;241;4188009;42711;92;2682012;149;1505997;17378;3403
24227;Lanouaille;552;9592462;221959;259;6751171;293;2841291;17378;3404
70490;Servigney;67;1164314;23822;36;857650;31;306664;17378;3405
18175;Ourouer-les-Bourdelins;382;6639005;159416;168;4464170;214;2174835;17380;3406
01453;Virieu-le-Petit;186;3232636;117039;84;2539645;102;692991;17380;3407
22122;Laurenan;419;7282121;77532;188;4882044;231;2400077;17380;3408
47236;Sainte-Colombe-de-Duras;55;955930;8194;22;643963;33;311967;17381;3409
88258;Lamarche;607;10550645;429195;254;7397746;353;3152899;17382;3410
58040;Brinay;93;1616496;60459;31;992146;62;624350;17382;3411
17124;Courant;214;3719907;9929;98;2426596;116;1293311;17383;3412
10261;Mussy-sur-Seine;652;11333598;320620;286;7777989;366;3555609;17383;3413
54368;Mignéville;100;1738309;45734;44;1180890;56;557419;17383;3414
24528;Sceau-Saint-Angel;76;1321187;27081;34;862695;42;458492;17384;3415
58021;Azy-le-Vif;131;2277436;47239;61;1648314;70;629122;17385;3416
55463;Saint-Mihiel;2573;44733089;1839506;1120;32676605;1453;12056484;17386;3417
32274;Monlezun-d'Armagnac;129;2242798;64661;51;1436536;78;806262;17386;3418
50535;Sainte-Pience;184;3199186;36354;78;2057852;106;1141334;17387;3419
09132;Gaudiès;142;2468963;79272;59;1711021;83;757942;17387;3420
02575;Origny-Sainte-Benoite;1016;17666257;487455;448;12546808;568;5119449;17388;3421
02305;Fère-en-Tardenois;1861;32359320;1018206;747;21783220;1114;10576100;17388;3422
59525;Sains-du-Nord;1645;28603698;1032982;654;19640435;991;8963263;17388;3423
04016;Authon;32;556442;23177;13;439847;19;116595;17389;3424
70195;Dambenoît-lès-Colombe;156;2712746;55520;81;1982309;75;730437;17389;3425
72192;Les Mées;60;1043454;27869;27;719831;33;323623;17391;3426
07093;Genestelle;165;2869571;66867;64;1793535;101;1076036;17391;3427
52351;Nijon;54;939163;25046;29;708646;25;230517;17392;3428
07082;Dornas;150;2608945;91102;74;1867339;76;741606;17393;3429
55365;Murvaux;94;1634991;73805;40;1134121;54;500870;17394;3430
16363;Saulgond;278;4835495;114984;118;3372404;160;1463091;17394;3431
70291;Jonvelle;81;1408945;28702;33;916482;48;492463;17394;3432
49114;Courléon;88;1530717;20181;34;1037313;54;493404;17395;3433
23253;Thauron;103;1791674;38079;37;1094767;66;696907;17395;3434
88105;Claudon;140;2435456;40481;52;1556195;88;879261;17396;3435
89445;Vézannes;36;626276;23637;16;458330;20;167946;17397;3436
22269;Runan;138;2400738;50226;60;1668613;78;732125;17397;3437
88029;Bains-les-Bains;753;13099950;421019;292;8793569;461;4306381;17397;3438
89204;L'Isle-sur-Serein;431;7498224;318098;180;5525935;251;1972289;17397;3439
54263;Homécourt;3554;61830282;1658768;1452;40382262;2102;21448020;17397;3440
11266;Port-la-Nouvelle;3605;62718977;2307705;1558;43630591;2047;19088386;17398;3441
56105;Lanvénégen;695;12091914;353483;302;8150278;393;3941636;17398;3442
65423;Sère-Rustaing;78;1357080;37489;37;942683;41;414397;17398;3443
08307;Montmeillant;57;991776;21117;23;677235;34;314541;17400;3444
42039;Chalmazel;262;4558874;111646;101;2911691;161;1647183;17400;3445
11140;Ferrals-les-Corbières;686;11936983;336756;281;8171545;405;3765438;17401;3446
14564;Saint-Charles-de-Percy;108;1879338;44730;41;1169172;67;710166;17401;3447
35248;Sains;285;4959495;88747;129;3430693;156;1528802;17402;3448
23202;Saint-Hilaire-le-Château;171;2975700;114167;70;2045136;101;930564;17402;3449
87105;Neuvic-Entier;559;9727944;299462;255;7189244;304;2538700;17402;3450
16083;Charmé;214;3724317;108553;87;2459593;127;1264724;17403;3451
24316;Parcoul;239;4159590;135615;101;2868827;138;1290763;17404;3452
17149;Les Éduts;39;678814;33375;13;420578;26;258236;17405;3453
56221;Saint-Jacut-les-Pins;990;17231618;371564;426;11468983;564;5762635;17406;3454
11146;Floure;170;2958975;59652;72;2054605;98;904370;17406;3455
07049;Le Chambon;35;609201;16498;13;364062;22;245139;17406;3456
66096;Latour-de-France;600;10444175;337369;225;6988896;375;3455279;17407;3457
65345;Ossun-ez-Angles;28;487419;8571;13;358617;15;128802;17408;3458
16192;Roumazières-Loubert;1545;26896318;870289;683;18623479;862;8272839;17409;3459
14413;Le Mesnil-Auzouf;192;3342576;86533;81;2243244;111;1099332;17409;3460
50234;La Haye-Bellefond;41;713856;17895;15;428074;26;285782;17411;3461
55490;Sivry-sur-Meuse;205;3569460;62048;98;2551272;107;1018188;17412;3462
30190;Notre-Dame-de-la-Rouvière;230;4005177;126798;88;2697831;142;1307346;17414;3463
82172;Saint-Projet;173;3012601;85296;69;2011595;104;1001006;17414;3464
63023;Auzelles;217;3778829;105928;89;2434672;128;1344157;17414;3465
50361;La Mouche;106;1845924;27826;43;1201283;63;644641;17414;3466
01242;Mérignat;77;1340915;18998;40;970795;37;370120;17414;3467
65238;Labassère;147;2559945;59516;67;1791641;80;768304;17415;3468
04134;La Motte-du-Caire;315;5485852;133234;139;3751969;176;1733883;17415;3469
09079;Carla-Bayle;357;6217666;199076;143;4403988;214;1813678;17416;3470
10401;Vendeuvre-sur-Barse;1379;24017487;761544;589;16403232;790;7614255;17417;3471
65474;Villembits;63;1097284;5935;24;691286;39;405998;17417;3472
39273;Lains;49;853452;32633;26;619797;23;233655;17417;3473
50214;Gouvets;149;2595212;64333;66;1785184;83;810028;17418;3474
14146;Cauville;77;1341169;21258;37;979289;40;361880;17418;3475
02298;Étreux;864;15048988;420879;403;10576189;461;4472799;17418;3476
12109;Gissac;63;1097330;10076;27;652809;36;444521;17418;3477
62327;Febvin-Palfart;292;5086314;87961;116;3359160;176;1727154;17419;3478
08135;La Croix-aux-Bois;73;1271588;23334;29;814571;44;457017;17419;3479
47106;Fumel;2994;52153274;1718984;1167;34279962;1827;17873312;17419;3480
04115;Méailles;56;975507;23084;27;689425;29;286082;17420;3481
09295;Siguer;68;1184554;24886;27;748135;41;436419;17420;3482
31251;Labastide-Paumès;85;1480715;23501;31;972492;54;508223;17420;3483
07148;Malbosc;91;1585264;74272;33;1165474;58;419790;17420;3484
71008;Anglure-sous-Dun;83;1445950;14798;35;918395;48;527555;17421;3485
2B307;Santa-Lucia-di-Moriani;715;12456458;509360;303;8999662;412;3456796;17422;3486
09177;Madière;111;1933801;37555;41;1207128;70;726673;17422;3487
24519;Sarlande;241;4198722;105457;101;2754878;140;1443844;17422;3488
24441;Saint-Léon-d'Issigeac;73;1271826;34385;28;792538;45;479288;17422;3489
11173;Hounoux;75;1306698;44367;32;928858;43;377840;17423;3490
48070;Grandrieu;429;7474425;227012;169;4951902;260;2522523;17423;3491
12278;Tayrac;96;1672601;46623;35;1157276;61;515325;17423;3492
22228;Plounévez-Moëdec;828;14427147;307794;323;9329676;505;5097471;17424;3493
63072;Chabreloche;790;13765418;306362;334;9198868;456;4566550;17425;3494
11339;Saint-Denis;285;4966106;124614;125;3574615;160;1391491;17425;3495
02580;Oulchy-le-Château;489;8520823;213784;209;5717072;280;2803751;17425;3496
32048;Betcave-Aguin;46;801551;17121;18;579733;28;221818;17425;3497
39363;Montrevel;66;1150162;33761;31;832324;35;317838;17427;3498
14729;Vaudeloges;109;1899629;27899;48;1243128;61;656501;17428;3499
03191;Murat;171;2980205;42776;80;1996216;91;983989;17428;3500
31461;Rouède;165;2875724;57089;77;1999158;88;876566;17429;3501
56242;Séglien;379;6605468;120242;162;4411802;217;2193666;17429;3502
42195;Sail-sous-Couzan;585;10196042;233399;251;6695240;334;3500802;17429;3503
40265;Saint-Julien-d'Armagnac;66;1150335;48725;28;764550;38;385785;17429;3504
46208;Montvalent;196;3416219;78427;86;2338691;110;1077528;17430;3505
55512;Tilly-sur-Meuse;141;2457698;53716;49;1486183;92;971515;17430;3506
64368;Masparraute;110;1917425;10783;45;1217714;65;699711;17431;3507
58080;La Collancelle;106;1847748;43747;46;1193828;60;653920;17432;3508
24012;Archignac;191;3329592;73079;80;2251344;111;1078248;17432;3509
23071;Croze;119;2074472;57605;51;1355491;68;718981;17433;3510
55379;Le Neufour;44;767034;10663;18;478989;26;288045;17433;3511
73277;Sainte-Reine;93;1621343;51173;44;1180442;49;440901;17434;3512
58268;Saint-Seine;126;2196876;47993;51;1474294;75;722582;17436;3513
08464;Vaux-lès-Mouron;41;714860;10483;17;438225;24;276635;17436;3514
61299;Moussonvilliers;144;2510816;61065;61;1644440;83;866376;17436;3515
03005;Archignat;179;3121188;79547;74;2087467;105;1033721;17437;3516
76178;Cléon;2872;50080297;1634196;1282;36374867;1590;13705430;17437;3517
47152;Lougratte;240;4185086;101161;104;2830904;136;1354182;17438;3518
64322;Lasse;144;2511399;61150;62;1661602;82;849797;17440;3519
62060;Auxi-le-Château;1657;28899097;1184354;598;19008734;1059;9890363;17441;3520
80253;Doullens;3691;64376568;2920244;1461;45101761;2230;19274807;17441;3521
14549;Rully;128;2232582;87067;46;1361756;82;870826;17442;3522
51497;Saint-Lumier-la-Populeuse;27;470941;9629;13;301145;14;169796;17442;3523
30263;Saint-Hippolyte-du-Fort;2308;40257076;1359649;955;28357311;1353;11899765;17442;3524
08036;Autry;74;1290832;25339;31;827401;43;463431;17444;3525
32041;Bellegarde;87;1517640;40720;36;1057164;51;460476;17444;3526
57494;Munster;142;2477072;67291;57;1651004;85;826068;17444;3527
09157;Laroque-d'Olmes;1607;28033328;891420;631;18366698;976;9666630;17445;3528
09246;Rimont;341;5948617;202432;143;4159894;198;1788723;17445;3529
80275;Équancourt;177;3087845;77116;76;2125442;101;962403;17445;3530
25520;Saint-Juan;96;1674791;26146;40;1033042;56;641749;17446;3531
16052;Bors (Canton de Montmoreau-Saint-Cybard);161;2808811;41342;67;1853266;94;955545;17446;3532
16114;Couture;93;1622482;59861;37;1151703;56;470779;17446;3533
87159;Saint-Léger-la-Montagne;203;3541596;54937;87;2385088;116;1156508;17446;3534
59041;Bachant;1266;22087408;636991;544;14994342;722;7093066;17447;3535
54101;Brouville;71;1238787;18524;31;820267;40;418520;17448;3536
11307;Raissac-d'Aude;155;2704401;101323;67;1928019;88;776382;17448;3537
65193;Gembrie;43;750282;19894;20;522307;23;227975;17448;3538
31319;Marliac;71;1238846;26830;29;820876;42;417970;17449;3539
14222;Le Désert;48;837530;10236;25;579792;23;257738;17449;3540
64457;Poursiugues-Boucoue;117;2041484;27841;48;1330962;69;710522;17449;3541
15200;Saint-Martin-Cantalès;106;1849605;52970;45;1223605;61;626000;17449;3542
02427;Lhuys;81;1413415;46642;30;883300;51;530115;17450;3543
50634;Videcosville;47;820139;13472;19;485556;28;334583;17450;3544
22253;Pouldouran;111;1936949;52380;53;1419797;58;517152;17450;3545
87089;Magnac-Laval;1111;19387311;714054;436;13153154;675;6234157;17450;3546
08171;Fléville;57;994736;10710;22;563710;35;431026;17452;3547
88092;Charmois-l'Orgueilleux;348;6073397;105428;139;4075033;209;1998364;17452;3548
89325;Ronchères;49;855173;22470;19;552039;30;303134;17453;3549
11334;Sainte-Camelle;62;1082065;25405;24;701033;38;381032;17453;3550
66154;Puyvalador;56;977374;37975;31;760985;25;216389;17453;3551
66097;Lesquerde;98;1710440;48330;42;1207480;56;502960;17453;3552
34046;Cambon-et-Salvergues;33;575983;25966;12;408105;21;167878;17454;3553
08128;Condé-lès-Autry;48;837829;24344;20;589739;28;248090;17455;3554
32281;Mont-de-Marrast;62;1082215;21510;24;737246;38;344969;17455;3555
12071;Compolibat;197;3438704;64311;69;2161191;128;1277513;17455;3556
56110;Lignol;532;9286298;291854;215;6221160;317;3065138;17455;3557
50121;La Chapelle-Cécelin;135;2356712;38844;67;1617336;68;739376;17457;3558
70292;Jussey;1036;18086471;687593;416;12526934;620;5559537;17458;3559
16042;Bessé;95;1658563;73991;37;1170685;58;487878;17459;3560
30267;Saint-Jean-de-Serres;272;4748740;91352;106;3055680;166;1693060;17459;3561
46277;Saint-Martin-le-Redon;114;1990312;75197;50;1365575;64;624737;17459;3562
52486;Ternat;37;645995;29377;20;492081;17;153914;17459;3563
63448;Vernet-la-Varenne;405;7071248;176281;173;4872677;232;2198571;17460;3564
79045;Bouin;74;1292123;25088;34;884379;40;407744;17461;3565
16409;Villefagnan;595;10389372;301259;224;6807086;371;3582286;17461;3566
11246;Montgradail;33;576245;13572;14;404777;19;171468;17462;3567
09047;Bélesta;666;11629996;324355;289;8083592;377;3546404;17462;3568
34219;Prémian;304;5308997;181546;136;3762138;168;1546859;17464;3569
59160;Crespin;2269;39626034;1127309;954;27373960;1315;12252074;17464;3570
56160;Pleugriffet;680;11876163;266228;293;7963734;387;3912429;17465;3571
21298;Gissey-le-Vieil;59;1030432;25927;30;745538;29;284894;17465;3572
24354;La Roche-Chalais;1730;30215628;995202;705;20343841;1025;9871787;17466;3573
58192;Neuville-lès-Decize;149;2602632;63829;62;1714219;87;888413;17467;3574
59276;Guesnain;2537;44315838;1289944;1023;29668178;1514;14647660;17468;3575
42119;Leigneux;225;3930260;87353;88;2493278;137;1436982;17468;3576
23196;Saint-Frion;133;2323262;34255;54;1482731;79;840531;17468;3577
81141;Lédas-et-Penthiès;89;1554693;19862;29;891900;60;662793;17468;3578
54183;Essey-la-Côte;46;803557;2984;19;531964;27;271593;17469;3579
31170;Escanecrabe;134;2340859;49500;53;1460648;81;880211;17469;3580
21302;Gomméville;80;1397634;29551;40;1083105;40;314529;17470;3581
81314;Viane;332;5800220;138214;125;3706758;207;2093462;17471;3582
07054;Chanéac;153;2673114;62406;70;1974542;83;698572;17471;3583
48053;Cubières;113;1974267;39999;56;1415629;57;558638;17471;3584
32299;Noulens;68;1188102;57747;30;858398;38;329704;17472;3585
09067;Brie;106;1852052;13815;49;1257756;57;594296;17472;3586
15248;Valuéjols;335;5853206;96639;143;3768870;192;2084336;17472;3587
48173;Saint-Michel-de-Dèze;129;2254048;58119;51;1490248;78;763800;17473;3588
40185;Miramont-Sensacq;210;3669547;105043;78;2440282;132;1229265;17474;3589
12183;Plaisance;134;2341582;70477;57;1609534;77;732048;17474;3590
62722;Rougefay;55;961099;31351;19;604749;36;356350;17475;3591
43070;Chilhac;118;2062026;59118;54;1433997;64;628029;17475;3592
47018;Auriac-sur-Dropt;110;1922310;51502;49;1368097;61;554213;17476;3593
15044;Chastel-sur-Murat;69;1205816;8389;27;736597;42;469219;17476;3594
23114;Lussat;260;4543676;92652;115;3154286;145;1389390;17476;3595
88350;Pleuvezain;43;751473;3591;16;461401;27;290072;17476;3596
66109;Molitg-les-Bains;127;2219477;62089;56;1532337;71;687140;17476;3597
59569;Sin-le-Noble;8722;152435696;4613698;3724;106597098;4998;45838598;17477;3598
15073;Fridefont;70;1223531;42197;33;880768;37;342763;17479;3599
71306;Montceau-les-Mines;11478;200626926;7105511;5089;138978991;6389;61647935;17479;3600
62400;Haillicourt;2676;46775087;1404154;1086;31370500;1590;15404587;17479;3601
86061;Charroux;684;11955999;242479;285;7961731;399;3994268;17480;3602
70342;Mercey-sur-Saône;83;1450833;33829;37;965209;46;485624;17480;3603
50291;Margueray;78;1363466;19142;36;926083;42;437383;17480;3604
08373;Rumigny;182;3181444;100597;66;1995923;116;1185521;17480;3605
79011;Ardilleux;81;1415952;28325;34;967746;47;448206;17481;3606
38347;Roybon;755;13198085;449345;294;8900672;461;4297413;17481;3607
64437;Ostabat-Asme;104;1818108;32315;45;1268318;59;549790;17482;3608
57240;Freyming-Merlebach;7646;133673307;4571200;3231;90944006;4415;42729301;17483;3609
85150;Mormaison;644;11259347;181955;291;7963192;353;3296155;17483;3610
48126;Ribennes;99;1730881;38657;42;1202436;57;528445;17484;3611
07278;Saint-Michel-de-Chabrillanoux;213;3724107;87930;93;2649936;120;1074171;17484;3612
36176;Ruffec;347;6067058;184515;156;4236702;191;1830356;17484;3613
76479;Nullemont;67;1171460;39870;29;813844;38;357616;17484;3614
49202;Méon;147;2570257;71872;51;1620592;96;949665;17485;3615
12291;Verrières;228;3986631;57849;102;2791637;126;1194994;17485;3616
63100;Châteauneuf-les-Bains;184;3217324;78031;86;2288842;98;928482;17485;3617
22025;Callac;1486;25983740;1054357;567;17720370;919;8263370;17486;3618
63144;Égliseneuve-d'Entraigues;281;4913577;269151;111;3311832;170;1601745;17486;3619
08363;Revin;3888;67986061;2018322;1571;45420798;2317;22565263;17486;3620
80706;Saint-Léger-lès-Domart;979;17119579;419848;456;12220352;523;4899227;17487;3621
11239;Montauriol;46;804431;15690;22;569139;24;235292;17488;3622
36213;Sauzelles;166;2903124;48792;77;2018218;89;884906;17489;3623
42114;Jeansagnière;48;839472;13475;18;478794;30;360678;17489;3624
23089;Genouillac;451;7887750;208347;197;5597943;254;2289807;17489;3625
70323;Mailleroncourt-Saint-Pancras;118;2063799;61418;55;1541373;63;522426;17490;3626
71176;Digoin;5029;87957857;2717915;2204;61196215;2825;26761642;17490;3627
64411;Musculdy;104;1819000;51184;45;1170461;59;648539;17490;3628
66060;Corsavy;128;2238975;103165;54;1712718;74;526257;17492;3629
18230;Saint-Pierre-les-Bois;182;3183745;56789;72;2113455;110;1070290;17493;3630
63286;Pouzol;168;2939098;68988;74;2005060;94;934038;17495;3631
71349;La Petite-Verrière;39;682313;9097;22;503655;17;178658;17495;3632
08413;Seraincourt;140;2449401;43651;53;1509108;87;940293;17496;3633
63022;Auzat-la-Combelle;1322;23129653;476078;634;15937003;688;7192650;17496;3634
19266;Thalamy;52;909818;19720;22;604298;30;305520;17497;3635
24489;Saint-Priest-les-Fougères;224;3919268;102593;98;2700066;126;1219202;17497;3636
21359;Lucey;35;612389;10779;24;518239;11;94150;17497;3637
47072;Courbiac;60;1049829;39367;21;729387;39;320442;17497;3638
52424;Rivières-le-Bois;42;734901;5068;20;485587;22;249314;17498;3639
11421;Villedaigne;251;4391936;133621;100;2923347;151;1468589;17498;3640
03214;Rocles;168;2939725;95669;71;2117446;97;822279;17498;3641
69091;Givors;10455;182979699;5387906;4664;127377126;5791;55602573;17502;3642
61006;Argentan;8385;146754435;5576512;3669;105732261;4716;41022174;17502;3643
07129;Lamastre;1438;25169040;889822;567;16530815;871;8638225;17503;3644
43108;Jullianges;251;4393262;53301;104;2932531;147;1460731;17503;3645
50338;Montbray;217;3798223;143072;77;2444209;140;1354014;17503;3646
03277;Target;139;2432990;73705;60;1707240;79;725750;17504;3647
88045;Beaufremont;45;787724;19581;23;592260;22;195464;17505;3648
50628;Vernix;88;1540473;5097;33;957687;55;582786;17505;3649
25436;Orve;37;647714;7659;12;322162;25;325552;17506;3650
10064;Brienne-le-Château;1903;33313913;1350086;836;24435296;1067;8878617;17506;3651
24473;Sainte-Orse;231;4043904;135405;97;2748145;134;1295759;17506;3652
32383;Saint-Justin;88;1540563;66638;35;1121311;53;419252;17506;3653
2B124;Ghisoni;144;2520974;129118;58;1865858;86;655116;17507;3654
2B290;Speloncato;157;2748794;97986;73;2009875;84;738919;17508;3655
02760;La Vallée-Mulâtre;86;1505753;31038;33;870549;53;635204;17509;3656
14096;Brémoy;125;2188638;24455;57;1595667;68;592971;17509;3657
33521;Talais;410;7178816;186124;181;4903669;229;2275147;17509;3658
87104;Nedde;295;5165383;146299;129;3551416;166;1613967;17510;3659
07025;Barnas;130;2276308;47739;45;1453029;85;823279;17510;3660
49102;Cléré-sur-Layon;178;3116971;29061;64;1861453;114;1255518;17511;3661
87199;Vayres;481;8422919;309573;196;5827042;285;2595877;17511;3662
61449;Saint-Pierre-la-Rivière;77;1348383;34188;33;916390;44;431993;17511;3663
76495;Pavilly;4089;71606314;2522765;1804;53910610;2285;17695704;17512;3664
86015;Availles-Limouzine;766;13414633;350614;314;9026928;452;4387705;17513;3665
64404;Montory;166;2907191;83446;72;1975079;94;932112;17513;3666
09064;Bouan;26;455366;9212;14;353616;12;101750;17514;3667
88138;Dombasle-devant-Darney;52;910802;18489;19;540524;33;370278;17515;3668
71407;Saint-Didier-sur-Arroux;128;2241990;28604;52;1452703;76;789287;17516;3669
79089;Le Chillou;95;1664012;13772;38;1005918;57;658094;17516;3670
06106;Roquesteron;273;4782041;128510;126;3372191;147;1409850;17517;3671
59012;Anor;1708;29918568;950060;709;20916936;999;9001632;17517;3672
14223;Le Détroit;51;893355;23722;22;587860;29;305495;17517;3673
65407;Sarp;68;1191177;19022;31;778760;37;412417;17517;3674
24032;Beauronne;216;3783981;121821;96;2572529;120;1211452;17518;3675
24430;Saint-Julien-de-Bourdeilles;58;1016109;26362;25;650014;33;366095;17519;3676
24084;Carves;68;1191336;23002;24;742156;44;449180;17520;3677
82023;Bourret;472;8269373;181231;207;5679525;265;2589848;17520;3678
62895;Wingles;4562;79927545;2103694;1923;54184882;2639;25742663;17520;3679
50304;Le Mesnil-Aubert;82;1436732;17408;38;1008082;44;428650;17521;3680
22072;Gurunhuel;224;3924849;43581;93;2558741;131;1366108;17522;3681
57401;Lidrezing;58;1016272;15156;28;734186;30;282086;17522;3682
14443;Montchauvet;199;3486901;86987;78;2291942;121;1194959;17522;3683
16335;Saint-Martin-du-Clocher;81;1419324;28134;32;905451;49;513873;17523;3684
50468;Saint-Fromond;409;7167449;108500;177;4743462;232;2423987;17524;3685
62186;Bully-les-Mines;6828;119656595;3268923;2895;81984701;3933;37671894;17524;3686
53250;Saint-Poix;208;3645188;28911;93;2353283;115;1291905;17525;3687
11253;Montolieu;535;9376648;329302;217;6714702;318;2661946;17526;3688
22149;Merléac;271;4749692;101122;124;3386351;147;1363341;17527;3689
85053;La Chapelle-aux-Lys;131;2296089;7005;59;1539346;72;756743;17527;3690
81206;Penne;333;5836636;188813;137;3916829;196;1919807;17527;3691
27468;Pont-Authou;401;7028640;281221;182;5012599;219;2016041;17528;3692
80355;Fresneville;53;929070;38088;24;660430;29;268640;17530;3693
19230;Saint-Pardoux-Corbier;230;4031818;132378;87;2710362;143;1321456;17530;3694
85102;Grand'Landes;309;5416834;-1680;134;3340002;175;2076832;17530;3695
88120;La Croix-aux-Mines;318;5574728;84653;153;4014327;165;1560401;17531;3696
52319;Mennouveaux;41;718764;16744;19;496891;22;221873;17531;3697
23197;Saint-Georges-la-Pouge;215;3769190;113744;90;2554649;125;1214541;17531;3698
31316;Marignac;293;5137147;126247;132;3472591;161;1664556;17533;3699
03069;Châtillon;192;3366495;77608;77;2251694;115;1114801;17534;3700
38108;Choranche;82;1437786;52455;34;996029;48;441757;17534;3701
10122;Davrey;146;2559963;47828;69;1778022;77;781941;17534;3702
07196;Rocles;135;2367106;99781;45;1608384;90;758722;17534;3703
88074;Brechainville;35;613712;9462;17;434568;18;179144;17535;3704
34011;Arboras;65;1139774;8424;21;604645;44;535129;17535;3705
18196;Saint-Aignan-des-Noyers;50;876752;17447;18;550856;32;325896;17535;3706
55063;Bouligny;1462;25636422;531932;461;13274344;1001;12362078;17535;3707
21083;Blanot;72;1262574;44302;29;846891;43;415683;17536;3708
57011;Albestroff;385;6751296;220742;154;4823913;231;1927383;17536;3709
22137;Maël-Carhaix;920;16135001;462128;393;11173075;527;4961926;17538;3710
62838;Vaulx;39;683988;12798;16;478608;23;205380;17538;3711
53239;Saint-Martin-de-Connée;239;4191702;89461;98;2743004;141;1448698;17539;3712
81231;Rouairoux;225;3946321;64014;94;2588130;131;1358191;17539;3713
30183;Moulézan;338;5928550;148661;143;4197676;195;1730874;17540;3714
54427;Pierre-Percée;46;806847;21909;21;598714;25;208133;17540;3715
01329;Rossillon;79;1385707;34534;36;945155;43;440552;17541;3716
87061;Droux;235;4122092;106581;99;2821489;136;1300603;17541;3717
58271;Saizy;72;1263004;17058;26;811550;46;451454;17542;3718
33135;Courpiac;78;1368365;28617;34;892284;44;476081;17543;3719
07161;Montpezat-sous-Bauzon;425;7456094;192568;170;4903404;255;2552690;17544;3720
09223;Oust;341;5982550;199897;149;4201190;192;1781360;17544;3721
08419;Signy-l'Abbaye;768;13474083;366169;332;9427633;436;4046450;17544;3722
23080;Féniers;59;1035121;35141;23;657008;36;378113;17544;3723
32465;Villefranche;84;1473815;44771;36;1121248;48;352567;17545;3724
17011;Annepont;204;3579321;53158;92;2464243;112;1115078;17546;3725
12124;Lassouts;182;3193457;71972;66;2127173;116;1066284;17546;3726
07029;Beaumont;137;2403899;51513;54;1709779;83;694120;17547;3727
81216;Puycalvel;127;2228555;36163;64;1636647;63;591908;17548;3728
32127;Estang;382;6703481;238317;147;4510532;235;2192949;17548;3729
39330;Miéry;89;1561873;28416;36;1000299;53;561574;17549;3730
56081;Guiscriff;1419;24903677;700698;641;16994107;778;7909570;17550;3731
57594;Roppeviller;69;1210975;28260;34;895813;35;315162;17550;3732
88504;Vicherey;92;1614651;29693;35;975911;57;638740;17551;3733
55292;Liny-devant-Dun;102;1790163;24123;39;1110042;63;680121;17551;3734
64403;Montfort;102;1790165;36886;41;1190998;61;599167;17551;3735
01420;Thoissey;1019;17884634;584306;488;12492654;531;5391980;17551;3736
17005;Allas-Bocage;103;1807795;46257;39;1189249;64;618546;17551;3737
50198;Geffosses;259;4545826;116290;115;3030986;144;1514840;17551;3738
89120;Coulours;95;1667440;60683;35;1062363;60;605077;17552;3739
02789;Vervins;1529;26837286;1289664;631;19336716;898;7500570;17552;3740
70360;Montdoré;41;719677;12734;16;448127;25;271550;17553;3741
49229;Noyant-la-Gravoyère;1079;18940652;252611;481;12234324;598;6706328;17554;3742
05167;Sigottier;46;807493;14202;24;612886;22;194607;17554;3743
18043;La Celle-Condé;142;2492711;56955;56;1614266;86;878445;17554;3744
50096;Canteloup;119;2089170;20225;57;1436723;62;652447;17556;3745
08251;Lépron-les-Vallées;48;842724;8565;19;577705;29;265019;17557;3746
23239;Saint-Sébastien;434;7619634;252731;178;5222714;256;2396920;17557;3747
79111;Ensigné;162;2844330;44002;74;1937790;88;906540;17558;3748
81278;Sauveterre;105;1843559;20573;45;1192931;60;650628;17558;3749
80592;Neuville-Coppegueule;310;5442955;155918;128;3728237;182;1714718;17558;3750
65139;Cazarilh;31;544298;16799;16;420886;15;123412;17558;3751
62808;Teneur;144;2528452;45919;59;1666529;85;861923;17559;3752
47252;Sainte-Livrade-sur-Lot;3570;62684731;2039421;1401;41953532;2169;20731199;17559;3753
58030;Biches;175;3072872;66895;87;2263070;88;809802;17559;3754
10424;Villeret;35;614643;6506;16;391426;19;223217;17561;3755
31295;Lespugue;49;860502;21087;24;648462;25;212040;17561;3756
53142;Madré;216;3793349;122781;94;2771733;122;1021616;17562;3757
58118;Fours;459;8061703;272777;216;5724028;243;2337675;17564;3758
52133;Clinchamp;63;1106517;19443;27;689809;36;416708;17564;3759
54028;Auboué;1522;26732106;689714;651;17988475;871;8743631;17564;3760
39117;Chatelay;55;966129;24816;19;597251;36;368878;17566;3761
18245;Saulzais-le-Potier;317;5568606;186654;121;3786362;196;1782244;17567;3762
17343;Saint-Grégoire-d'Ardennes;76;1335182;42342;26;851949;50;483233;17568;3763
60615;Sérévillers;64;1124400;21425;35;860739;29;263661;17569;3764
46201;Montcuq;736;12931099;446808;269;8473261;467;4457838;17569;3765
07295;Saint-Sauveur-de-Montagut;726;12755499;311246;279;7823711;447;4931788;17570;3766
21040;Avosnes;44;773084;17667;15;468720;29;304364;17570;3767
19097;Lafage-sur-Sombre;73;1282641;38388;30;829369;43;453272;17570;3768
76426;Mésangueville;93;1634054;24699;41;1062017;52;572037;17570;3769
39551;Véria;76;1335362;54316;34;1015918;42;319444;17571;3770
46219;Peyrilles;233;4093964;71395;91;2726711;142;1367253;17571;3771
71510;Semur-en-Brionnais;426;7485519;331541;165;5443952;261;2041567;17572;3772
62377;Gosnay;534;9383517;234979;227;6384949;307;2998568;17572;3773
42339;Chausseterre;141;2477686;36564;67;1692873;74;784813;17572;3774
80373;Gamaches;1629;28625473;1024353;710;20175186;919;8450287;17572;3775
08044;Balham;73;1282793;25708;34;913255;39;369538;17573;3776
50431;Remilly-sur-Lozon;350;6150380;99323;157;4243982;193;1906398;17573;3777
28214;La Loupe;2157;37906011;1154273;907;25164656;1250;12741355;17573;3778
2A119;Frasseto;50;878692;39655;21;565196;29;313496;17574;3779
21548;Saint-Germain-de-Modéon;109;1915557;54970;50;1352249;59;563308;17574;3780
32186;Lamaguère;43;755744;36079;16;478489;27;277255;17575;3781
15099;Lavastrie;163;2864899;54522;67;1972394;96;892505;17576;3782
34302;Siran;335;5888004;187566;139;4053792;196;1834212;17576;3783
79152;Lorigné;163;2864980;88181;73;2037201;90;827779;17577;3784
12262;Sauveterre-de-Rouergue;461;8102812;224928;185;5415987;276;2686825;17577;3785
50004;Airel;304;5343333;98417;137;3628469;167;1714864;17577;3786
61258;Le Mêle-sur-Sarthe;446;7839407;199448;180;5005509;266;2833898;17577;3787
76312;Gournay-en-Bray;3902;68586438;2326560;1837;49522344;2065;19064094;17577;3788
17152;Épargnes;479;8419525;186894;190;5510975;289;2908550;17577;3789
52023;Auberive;107;1880775;32096;46;1262654;61;618121;17577;3790
03201;Nizerolles;190;3339870;87014;69;2157250;121;1182620;17578;3791
87083;Laurière;339;5959342;146698;149;4044197;190;1915145;17579;3792
07068;Colombier-le-Jeune;324;5695768;117108;133;3630427;191;2065341;17580;3793
14478;Orbec;1317;23152801;870358;518;15685955;799;7466846;17580;3794
15226;Sénezergues;123;2162355;57797;51;1524802;72;637553;17580;3795
64534;Taron-Sadirac-Viellenave;109;1916270;36775;42;1303149;67;613121;17580;3796
24164;Excideuil;775;13624966;492874;316;9310089;459;4314877;17581;3797
62362;Frévillers;118;2074543;33730;47;1283729;71;790814;17581;3798
33538;Valeyrac;300;5274768;160254;117;3398499;183;1876269;17583;3799
62637;Oignies;5343;93946430;2726947;2170;62300269;3173;31646161;17583;3800
12181;Peyrusse-le-Roc;121;2127612;20558;41;1211580;80;916032;17584;3801
64159;Cadillon;62;1090205;5780;24;689321;38;400884;17584;3802
02779;Vénérolles;132;2321102;52362;60;1584390;72;736712;17584;3803
33419;Saint-Hilaire-du-Bois;43;756147;15842;21;550946;22;205201;17585;3804
22288;Saint-Étienne-du-Gué-de-l'Isle;211;3710467;63419;97;2567561;114;1142906;17585;3805
12011;Arvieu;450;7913596;70233;163;4754188;287;3159408;17586;3806
32376;Sainte-Gemme;71;1248619;44459;27;816810;44;431809;17586;3807
11203;Lézignan-Corbières;5760;101298510;3914768;2411;73536676;3349;27761834;17587;3808
19167;Confolent-Port-Dieu;27;474848;19063;15;381198;12;93650;17587;3809
07071;Coucouron;457;8037459;197721;184;5402642;273;2634817;17587;3810
03164;Le Mayet-d'École;168;2954758;56076;74;1949633;94;1005125;17588;3811
35190;Monthault;125;2198483;33941;48;1282800;77;915683;17588;3812
87139;Saint-Bonnet-de-Bellac;267;4696054;168698;101;3186027;166;1510027;17588;3813
31508;Saint-Paul-d'Oueil;29;510080;15100;12;378340;17;131740;17589;3814
16329;Saint-Laurent-de-Céris;467;8214180;234574;171;5304944;296;2909236;17589;3815
50617;Varenguebec;183;3218851;54723;84;2251948;99;966903;17589;3816
39268;Ivrey;37;650808;15937;16;427595;21;223213;17589;3817
24051;Bosset;112;1970029;47304;51;1464727;61;505302;17590;3818
79059;Le Busseau;414;7282273;175419;157;4634687;257;2647586;17590;3819
24174;Fanlac;80;1407240;38484;27;886054;53;521186;17591;3820
50482;Saint-Germain-sur-Sèves;107;1882184;23480;43;1209031;64;673153;17591;3821
64441;Pagolle;115;2022952;50049;38;1236374;77;786578;17591;3822
65290;Luc;130;2286892;59416;56;1626208;74;660684;17591;3823
11192;Lasbordes;406;7142250;158479;184;4960280;222;2181970;17592;3824
32129;Estramiac;81;1424968;36973;33;1002306;48;422662;17592;3825
71129;Chissey-en-Morvan;188;3307349;74900;91;2298141;97;1009208;17592;3826
18045;Chalivoy-Milon;236;4151849;95970;107;2829226;129;1322623;17593;3827
03158;Maillet;198;3483369;84157;93;2469516;105;1013853;17593;3828
09270;Saint-Martin-d'Oydes;140;2463022;48104;62;1785453;78;677569;17593;3829
62802;Le Souich;87;1530717;37234;34;1018542;53;512175;17594;3830
26317;Saint-Maurice-sur-Eygues;388;6826757;172397;167;4743621;221;2083136;17595;3831
65278;Lomné;24;422290;26485;13;359770;11;62520;17595;3832
49226;Noëllet;247;4346150;59787;115;2958957;132;1387193;17596;3833
46097;Estal;47;827051;17275;19;551191;28;275860;17597;3834
88276;Lusse;251;4417152;116429;95;2889831;156;1527321;17598;3835
65247;Arrayou-Lahitte;67;1179094;8858;31;785757;36;393337;17598;3836
79132;Genneton;156;2745403;13622;50;1538513;106;1206890;17599;3837
21631;Thomirey;41;721554;52637;13;445329;28;276225;17599;3838
46288;Saint-Perdoux;113;1988686;48468;49;1309830;64;678856;17599;3839
02470;Martigny;243;4276575;150227;101;2993578;142;1282997;17599;3840
69161;Propières;283;4980628;107331;120;3226128;163;1754500;17599;3841
17468;Vibrac;89;1566356;41093;37;1084590;52;481766;17600;3842
58275;Saxi-Bourdon;171;3009520;76056;69;2033497;102;976023;17600;3843
82117;Montaigu-de-Quercy;824;14503264;496417;312;9474030;512;5029234;17601;3844
54085;Borville;62;1091345;24692;24;660465;38;430880;17602;3845
82029;Castanet;142;2499545;87290;49;1696763;93;802782;17602;3846
88181;Fraize;1864;32812272;1014342;840;22896717;1024;9915555;17603;3847
17052;Boisredon;407;7164552;128766;165;4796825;242;2367727;17603;3848
43144;Moudeyres;60;1056210;12800;26;723093;34;333117;17604;3849
63426;Tauves;486;8555397;238220;208;5996469;278;2558928;17604;3850
27155;Chennebrun;63;1109090;18460;29;707763;34;401327;17605;3851
52207;Frécourt;62;1091510;25127;26;787355;36;304155;17605;3852
06102;Rimplas;49;862672;26838;25;609861;24;252811;17606;3853
16213;Mazerolles;200;3521147;95184;83;2460345;117;1060802;17606;3854
03071;Chavroches;157;2764152;76224;66;1898238;91;865914;17606;3855
77182;La Ferté-Gaucher;2728;48031545;1311413;1225;33460540;1503;14571005;17607;3856
16245;Nieuil;553;9737033;210204;240;6497106;313;3239927;17608;3857
52160;Daillancourt;44;774794;9373;19;501972;25;272822;17609;3858
63471;Youx;597;10513329;244436;281;7065085;316;3448244;17610;3859
39282;La Latette;33;581176;11754;11;363309;22;217867;17611;3860
46323;Ussel;56;986241;45561;22;762371;34;223870;17611;3861
35271;Saint-Georges-de-Reintembault;878;15463136;377591;332;10093630;546;5369506;17612;3862
72211;Mont-Saint-Jean;344;6058541;79497;140;3689149;204;2369392;17612;3863
25246;Fontaine-lès-Clerval;141;2483376;47143;62;1633484;79;849892;17613;3864
25006;Adam-lès-Passavant;45;792576;6825;19;484532;26;308044;17613;3865
86064;Château-Garnier;367;6463978;209168;131;4155797;236;2308181;17613;3866
57042;Avricourt;379;6675565;203795;167;4618520;212;2057045;17614;3867
60104;Breteuil;2471;43524124;1596691;1037;30413127;1434;13110997;17614;3868
81136;Larroque;110;1937586;61408;47;1341799;63;595787;17614;3869
50456;Saint-Clément-Rancoudray;302;5319794;94656;133;3519766;169;1800028;17615;3870
24280;Monpazier;315;5548953;217965;125;3730789;190;1818164;17616;3871
02057;Beaurevoir;801;14110497;412051;303;9062774;498;5047723;17616;3872
62137;Blangerval-Blangermont;53;933662;19650;25;685182;28;248480;17616;3873
21280;Fontangy;99;1744259;55521;50;1350057;49;394202;17619;3874
12280;Thérondels;262;4616157;148510;111;3130921;151;1485236;17619;3875
12222;Saint-Félix-de-Sorgues;120;2114352;34076;49;1270557;71;843795;17620;3876
52116;Chatenay-Vaudin;33;581449;8272;15;440107;18;141342;17620;3877
32459;Valence-sur-Baïse;693;12211223;361376;291;8328007;402;3883216;17621;3878
61289;Mont-Ormel;36;634371;17274;21;501587;15;132784;17621;3879
16362;Salles-Lavalette;199;3506780;89396;87;2402475;112;1104305;17622;3880
62217;Cauchy-à-la-Tour;1550;27314487;573945;631;18160580;919;9153907;17622;3881
11063;Campagne-sur-Aude;382;6732009;248344;165;4723988;217;2008021;17623;3882
80013;Airaines;1309;23068687;658665;571;15953043;738;7115644;17623;3883
24180;Firbeix;175;3084165;104933;63;1916561;112;1167604;17624;3884
63233;Montaigut;591;10416258;426447;242;7365582;349;3050676;17625;3885
50364;Muneville-le-Bingard;361;6362587;25590;150;3967397;211;2395190;17625;3886
66007;Arboussols;67;1180868;57018;24;819391;43;361477;17625;3887
69259;Vénissieux;31132;548698832;17096183;14238;388847109;16894;159851723;17625;3888
09336;Villeneuve-d'Olmes;645;11368389;271174;274;7575046;371;3793343;17625;3889
2B275;Sermano;38;669785;23073;16;488841;22;180944;17626;3890
71036;Bissy-sous-Uxelles;45;793223;14624;25;609967;20;183256;17627;3891
14658;Saint-Sever-Calvados;789;13908017;460229;311;9478522;478;4429495;17627;3892
53133;Lignières-Orgères;423;7456461;138197;186;5003315;237;2453146;17628;3893
01384;Saint-Rambert-en-Bugey;1292;22775094;619275;608;16156934;684;6618160;17628;3894
32026;Bajonnette;58;1022419;25260;23;688056;35;334363;17628;3895
55110;Chauvency-Saint-Hubert;137;2415296;34750;58;1477654;79;937642;17630;3896
24538;Siorac-en-Périgord;576;10155088;366683;250;7152845;326;3002243;17630;3897
03117;Franchesse;265;4672309;199949;106;3189436;159;1482873;17631;3898
32330;Préchac-sur-Adour;116;2045268;78762;47;1359537;69;685731;17632;3899
02517;Montigny-sur-Crécy;182;3208977;48932;82;2085835;100;1123142;17632;3900
43080;Craponne-sur-Arzon;1312;23135464;725146;520;15669856;792;7465608;17634;3901
73221;Saint-Alban-des-Villards;50;881713;34363;25;631643;25;250070;17634;3902
33240;Lesparre-Médoc;3537;62375620;2713592;1454;44011324;2083;18364296;17635;3903
24297;Moulin-Neuf;506;8923609;179887;241;6291610;265;2631999;17636;3904
48101;Montbrun;41;723068;41106;14;478077;27;244991;17636;3905
02404;Landouzy-la-Cour;99;1745972;31005;43;1187770;56;558202;17636;3906
46171;Lherm;135;2380889;82319;52;1536822;83;844067;17636;3907
61385;Saint-Evroult-de-Montfort;183;3227448;50086;92;2406497;91;820951;17636;3908
24133;La Coquille;853;15043895;505825;337;10126985;516;4916910;17636;3909
70025;Arbecey;137;2416298;46314;63;1671417;74;744881;17637;3910
86169;Morton;193;3404134;33053;91;2365559;102;1038575;17638;3911
23031;Boussac;868;15310274;456119;357;10041951;511;5268323;17639;3912
17324;Saint-Dizant-du-Bois;67;1181894;24090;26;731539;41;450355;17640;3913
24093;Cercles;119;2099216;68060;44;1338590;75;760626;17640;3914
59382;Maretz;795;14024204;410816;324;9623017;471;4401187;17641;3915
60294;Hainvillers;40;705622;15652;17;492943;23;212679;17641;3916
62533;Lugy;73;1287786;23931;28;692258;45;595528;17641;3917
32304;Panassac;150;2646143;35346;66;1831592;84;814551;17641;3918
19199;Saint-Étienne-aux-Clos;131;2311065;39308;63;1585042;68;726023;17642;3919
26244;Le Poët-Sigillat;56;987954;43376;20;747803;36;240151;17642;3920
62153;Bomy;321;5663257;104717;129;3694763;192;1968494;17643;3921
50626;Ver;205;3616900;47182;92;2527519;113;1089381;17643;3922
64319;Larribar-Sorhapuru;88;1552795;32639;32;994117;56;558678;17645;3923
65032;Arrens-Marsous;448;7905241;312864;213;6155419;235;1749822;17646;3924
15025;Albepierre-Bredons;148;2611554;71361;71;1821673;77;789881;17646;3925
62737;Sains-en-Gohelle;3352;59149491;1521204;1439;41189879;1913;17959612;17646;3926
62342;Fontaine-lès-Boulans;45;794097;-38;20;519479;25;274618;17647;3927
12117;Lacalm;106;1870586;24262;46;1264864;60;605722;17647;3928
23020;Bellegarde-en-Marche;248;4376553;135215;102;2951050;146;1425503;17647;3929
14217;Dampierre;76;1341223;23011;39;1020266;37;320957;17648;3930
02455;Malzy;111;1958938;59706;51;1474462;60;484476;17648;3931
39295;Loisia;99;1747172;42994;46;1167785;53;579387;17648;3932
42186;Rive-de-Gier;7833;138244204;3498800;3289;92186183;4544;46058021;17649;3933
24292;Montpeyroux;235;4147557;86991;90;2692902;145;1454655;17649;3934
48188;Serverette;163;2876872;153577;59;2303973;104;572899;17650;3935
86200;Pressac;333;5877398;164405;145;4250447;188;1626951;17650;3936
79116;Faye-l'Abbesse;609;10748818;230594;227;6742316;382;4006502;17650;3937
61214;L'Aigle;4958;87508509;3824275;2038;61953983;2920;25554526;17650;3938
40249;Saint-Aubin;300;5295004;92321;143;3731570;157;1563434;17650;3939
16250;Orgedeuil;124;2188661;36666;54;1422919;70;765742;17650;3940
79154;Loubillé;217;3830261;153771;80;2380581;137;1449680;17651;3941
81186;Moularès;167;2947721;87327;65;1932618;102;1015103;17651;3942
04233;Vaumeilh;161;2841922;92827;67;1965384;94;876538;17652;3943
65128;Castelbajac;68;1200371;27085;27;770777;41;429594;17653;3944
08344;Prez;74;1306292;3870;23;683516;51;622776;17653;3945
07004;Ajoux;54;953253;30455;23;664905;31;288348;17653;3946
34245;Saint-Chinian;1141;20142099;801936;458;14004926;683;6137173;17653;3947
2B277;Serra-di-Fiumorbo;209;3689596;127389;90;2695443;119;994153;17654;3948
14150;Cesny-Bois-Halbout;350;6178776;126851;137;3962712;213;2216064;17654;3949
63098;Chastreix;151;2665917;77146;63;1845817;88;820100;17655;3950
24019;Azerat;259;4572843;165209;99;3183810;160;1389033;17656;3951
16173;Juillé;101;1783235;16498;45;1170365;56;612870;17656;3952
47167;Mézin;944;16667141;503910;373;11056329;571;5610812;17656;3953
63363;Saint-Jacques-d'Ambur;180;3178273;66345;90;2205622;90;972651;17657;3954
43049;Chamalières-sur-Loire;262;4626174;116666;114;3038355;148;1587819;17657;3955
34205;Les Plans;176;3107680;71543;79;2210766;97;896914;17657;3956
61475;Soligny-la-Trappe;447;7892929;284497;196;5624075;251;2268854;17658;3957
32396;Saint-Mézard;108;1907059;63725;37;1188439;71;718620;17658;3958
03241;Saint-Léopardin-d'Augy;202;3566927;88144;77;2412268;125;1154659;17658;3959
26056;Bourdeaux;382;6745589;224828;147;4711302;235;2034287;17659;3960
12153;Montjaux;246;4344176;139638;105;3023895;141;1320281;17659;3961
15095;Laroquevieille;207;3655698;42747;101;2440335;106;1215363;17660;3962
81081;Dourgne;800;14128388;441564;332;10155209;468;3973179;17660;3963
47029;Blanquefort-sur-Briolance;271;4786010;141474;92;3026611;179;1759399;17661;3964
32070;Cahuzac-sur-Adour;131;2313548;80717;61;1645970;70;667578;17661;3965
33506;Sauveterre-de-Guyenne;1124;19850784;667848;426;13276170;698;6574614;17661;3966
02832;Wiège-Faty;122;2154629;68664;47;1465567;75;689062;17661;3967
86082;Couhé;1114;19675421;646486;454;13090281;660;6585140;17662;3968
58235;Saint-Brisson;162;2861274;87219;70;1941168;92;920106;17662;3969
02369;Harcigny;148;2614013;64211;67;1840377;81;773636;17662;3970
09235;Prat-Bonrepaux;529;9343365;297410;238;6545852;291;2797513;17662;3971
30032;Beaucaire;8938;157867256;5714987;3645;111164928;5293;46702328;17662;3972
09055;Bethmale;60;1059791;28515;25;699469;35;360322;17663;3973
17423;Semillac;37;653555;1500;13;397347;24;256208;17664;3974
36072;Faverolles;212;3744987;87594;103;2718811;109;1026176;17665;3975
12088;Curières;132;2331834;57894;53;1507161;79;824673;17665;3976
62419;Haut-Loquin;82;1448598;36518;36;1073621;46;374977;17666;3977
64394;Monpezat;47;830308;15594;21;559953;26;270355;17666;3978
27112;Breteuil;2003;35385474;1239906;892;24935752;1111;10449722;17666;3979
2B230;Piève;74;1307315;26615;34;888084;40;419231;17666;3980
06071;Guillaumes;375;6625110;266289;165;4764515;210;1860595;17667;3981
24128;Comberanche-et-Épeluche;104;1837443;47834;47;1286256;57;551187;17668;3982
39566;Villeneuve-lès-Charnod;43;759729;8730;21;473603;22;286126;17668;3983
12144;Meljac;83;1466530;39681;30;924613;53;541917;17669;3984
24235;Léguillac-de-Cercles;166;2933192;57651;64;1850641;102;1082551;17670;3985
58178;Montigny-sur-Canne;94;1661020;32024;45;1229806;49;431214;17670;3986
54325;Loromontzey;48;848186;20829;20;571159;28;277027;17671;3987
26369;Verclause;47;830536;54148;18;609349;29;221187;17671;3988
43167;Saint-Arcons-d'Allier;115;2032300;41685;42;1245720;73;786580;17672;3989
16158;Grassac;175;3092649;115559;69;2027210;106;1065439;17672;3990
33232;Lartigue;33;583196;17829;13;358608;20;224588;17673;3991
55156;Dombras;71;1254803;9204;27;705072;44;549731;17673;3992
47219;Rayet;99;1749727;12478;47;1133850;52;615877;17674;3993
50486;Saint-Jacques-de-Néhou;288;5090337;54685;124;3322992;164;1767345;17675;3994
48124;Recoules-de-Fumas;61;1078200;21902;30;807594;31;270606;17675;3995
33499;Les Salles-de-Castillon;202;3570610;71785;91;2472749;111;1097861;17676;3996
24549;Thénac;169;2987296;66844;68;2147651;101;839645;17676;3997
49228;Noyant;1037;18332234;433775;416;11737485;621;6594749;17678;3998
59599;Tourcoing;50542;893525097;28140959;22536;639350303;28006;254174794;17679;3999
55257;Jouy-en-Argonne;33;583403;8589;15;380784;18;202619;17679;4000
12134;Lugan;210;3712583;67673;85;2351814;125;1360769;17679;4001
2A211;Petreto-Bicchisano;354;6258373;269969;141;4454306;213;1804067;17679;4002
63399;Saint-Sulpice;57;1007719;13787;15;633730;42;373989;17679;4003
61191;Glos-la-Ferrière;330;5834270;217032;129;3791561;201;2042709;17680;4004
26229;La Penne-sur-l'Ouvèze;48;848630;14917;20;560782;28;287848;17680;4005
32035;Beaucaire;162;2864132;84897;70;1997967;92;866165;17680;4006
58291;Thianges;115;2033278;62929;51;1336140;64;697138;17681;4007
34083;Combes;158;2793633;124750;68;2220482;90;573151;17681;4008
43118;Lavoûte-Chilhac;186;3288879;96552;77;2137251;109;1151628;17682;4009
14361;Lénault;94;1662165;19680;45;1205606;49;456559;17683;4010
18283;Villecelin;71;1255505;39533;38;977658;33;277847;17683;4011
08354;Raucourt-et-Flaba;481;8505919;209191;209;5738748;272;2767171;17684;4012
03225;Saint-Désiré;280;4951500;128907;123;3572093;157;1379407;17684;4013
32015;Aujan-Mournède;54;954957;31604;20;636347;34;318610;17684;4014
71075;Chalmoux;402;7109178;147864;172;4755379;230;2353799;17685;4015
07221;Saint-Cierge-la-Serre;134;2369748;63834;58;1561978;76;807770;17685;4016
36187;Saint-Civran;101;1786166;35801;42;1162163;59;624003;17685;4017
63428;Teilhet;184;3254006;104765;75;2101992;109;1152014;17685;4018
88363;Punerot;92;1627156;17760;34;1050947;58;576209;17686;4019
85210;Saint-Étienne-du-Bois;1111;19650494;379604;469;13011579;642;6638915;17687;4020
17132;Cramchaban;352;6225907;104162;154;4152462;198;2073445;17687;4021
17319;Sainte-Colombe;65;1149731;19328;28;803007;37;346724;17688;4022
31221;Gouaux-de-Larboust;32;566036;35415;14;381925;18;184111;17689;4023
61106;Chênedouit;107;1892700;21369;48;1185785;59;706915;17689;4024
56068;La Grée-Saint-Laurent;183;3237130;56042;83;2248966;100;988164;17689;4025
70576;Vougécourt;100;1768985;41153;52;1382247;48;386738;17690;4026
42194;Sail-les-Bains;116;2052029;36338;45;1272363;71;779666;17690;4027
87170;Saint-Méard;201;3555849;71434;83;2346761;118;1209088;17691;4028
87186;Saint-Vitte-sur-Briance;166;2936736;64848;60;1846383;106;1090353;17691;4029
30176;Montdardier;132;2335250;81781;59;1678955;73;656295;17691;4030
2B036;Bigorno;44;778418;39053;21;587266;23;191152;17691;4031
52074;Breuvannes-en-Bassigny;425;7518864;178881;169;5114619;256;2404245;17691;4032
02784;Petit-Verly;103;1822241;53985;45;1284123;58;538118;17692;4033
48037;Chadenet;58;1026147;25299;28;755462;30;270685;17692;4034
03064;Château-sur-Allier;118;2087789;75361;52;1449992;66;637797;17693;4035
88262;Laveline-devant-Bruyères;374;6617264;155574;160;4450663;214;2166601;17693;4036
62665;Le Ponchel;123;2176276;64058;58;1546610;65;629666;17693;4037
47135;Laparade;230;4069738;95058;106;2988352;124;1081386;17695;4038
08328;Nouzonville;3427;60641402;1725162;1438;41960970;1989;18680432;17695;4039
02337;Froidestrées;113;1999565;38860;56;1479047;57;520518;17695;4040
48161;Saint-Juéry;41;725588;13897;18;473448;23;252140;17697;4041
08090;Carignan;1738;30760441;885212;717;20709516;1021;10050925;17699;4042
23198;Saint-Georges-Nigremont;90;1592892;38623;33;1128878;57;464014;17699;4043
63221;Medeyrolles;77;1362831;41244;32;884440;45;478391;17699;4044
39287;Lavans-sur-Valouse;78;1380594;32640;32;913293;46;467301;17700;4045
24546;Temple-Laguyon;29;513300;13813;12;350553;17;162747;17700;4046
64337;Lespielle;84;1486805;18718;35;945937;49;540868;17700;4047
07267;Saint-Martial;154;2725831;95159;66;1857316;88;868515;17700;4048
52320;Merrey;69;1221430;21838;33;822251;36;399179;17702;4049
57660;Stiring-Wendel;7303;129278411;4166531;3185;87689775;4118;41588636;17702;4050
16037;Bellon;90;1593189;62838;34;1020332;56;572857;17702;4051
71348;Perrigny-sur-Loire;78;1380776;18992;36;890822;42;489954;17702;4052
88275;Lubine;124;2195207;48580;60;1548481;64;646726;17703;4053
55262;Juvigny-sur-Loison;140;2478581;65957;56;1600592;84;877989;17704;4054
87082;Ladignac-le-Long;668;11827532;243731;254;7558930;414;4268602;17706;4055
62202;Campagne-lès-Boulonnais;277;4904583;74119;108;3105091;169;1799492;17706;4056
46039;Brengues;105;1859139;38372;49;1386675;56;472464;17706;4057
09123;Fornex;75;1327957;57995;29;942150;46;385807;17706;4058
65213;Guizerix;85;1505018;52779;43;1162207;42;342811;17706;4059
03037;Braize;156;2762163;119670;63;1996523;93;765640;17706;4060
50088;Brouains;95;1682087;25719;44;1181539;51;500548;17706;4061
66190;Salses-le-Château;1791;31712114;940967;799;22508583;992;9203531;17706;4062
88351;Plombières-les-Bains;1072;18981643;540944;442;12601032;630;6380611;17707;4063
79136;Gournay-Loizé;337;5967431;124575;146;4056372;191;1911059;17708;4064
86012;Asnois;88;1558342;73236;35;1148028;53;410314;17708;4065
64310;Lanne-en-Barétous;260;4604428;125499;121;3174768;139;1429660;17709;4066
79124;Les Forges;68;1204266;1405;20;507858;48;696408;17710;4067
63295;Randan;922;16328546;596628;381;11447465;541;4881081;17710;4068
42314;La Tuilière;182;3223223;62107;72;1977732;110;1245491;17710;4069
79087;Chey;330;5844636;81080;141;3849800;189;1994836;17711;4070
25546;Silley-Bléfond;36;637599;17692;18;495486;18;142113;17711;4071
52175;Donjeux;214;3790258;82137;99;2630777;115;1159481;17711;4072
16361;Salles-de-Villefagnan;202;3577804;81262;90;2522904;112;1054900;17712;4073
60221;Esquennoy;404;7155972;185465;190;5050097;214;2105875;17713;4074
63002;Aix-la-Fayette;48;850216;48220;18;650150;30;200066;17713;4075
02235;Craonnelle;70;1239905;25126;34;892879;36;347026;17713;4076
15085;Labrousse;250;4428362;53256;107;2863347;143;1565015;17713;4077
84139;Fontaine-de-Vaucluse;409;7244878;188761;179;4861089;230;2383789;17714;4078
24498;Saint-Saud-Lacoussière;544;9636254;295000;214;6438299;330;3197955;17714;4079
42196;Sainte-Agathe-en-Donzy;68;1204593;24704;29;774646;39;429947;17715;4080
23106;Lépaud;226;4003710;124762;100;2800590;126;1203120;17716;4081
62204;Campagne-lès-Hesdin;1006;17822152;526303;430;13252536;576;4569616;17716;4082
50315;Le Mesnillard;144;2551201;25122;51;1468308;93;1082893;17717;4083
80182;Cayeux-sur-Mer;1734;30723310;1256124;751;22021996;983;8701314;17718;4084
64363;Lys;206;3650172;132400;75;2554690;131;1095482;17719;4085
62859;Villers-l'Hôpital;148;2622609;44075;69;1833287;79;789322;17720;4086
46186;Masclat;214;3792185;117011;83;2526191;131;1265994;17720;4087
55096;Chaillon;64;1134117;14249;29;818936;35;315181;17721;4088
03103;Le Donjon;675;11961755;429434;262;7934638;413;4027117;17721;4089
80832;Yvrench;150;2658235;53406;55;1793487;95;864748;17722;4090
02445;Luzoir;160;2835460;66194;73;2033691;87;801769;17722;4091
32139;Gaudonville;62;1098755;33596;25;829609;37;269146;17722;4092
59531;Saint-Benin;197;3491208;73672;91;2420844;106;1070364;17722;4093
52414;Rachecourt-sur-Marne;420;7443217;163559;173;4863840;247;2579377;17722;4094
62333;Fiefs;187;3314109;56844;80;2266142;107;1047967;17723;4095
23015;Azerables;551;9765229;319455;229;6785502;322;2979727;17723;4096
70423;Preigney;74;1311491;44479;29;914870;45;396621;17723;4097
22033;Caurel;234;4147151;71757;96;2588367;138;1558784;17723;4098
79008;Amailloux;437;7744953;97545;171;4843157;266;2901796;17723;4099
39254;Gillois;69;1222904;17928;31;882832;38;340072;17723;4100
70112;Cemboing;119;2109252;42336;47;1361677;72;747575;17725;4101
87041;Châteauponsac;1319;23380761;600937;565;15744180;754;7636581;17726;4102
21316;Heuilley-sur-Saône;200;3545257;85335;94;2469618;106;1075639;17726;4103
14462;Neuilly-la-Forêt;257;4555743;108236;119;3254176;138;1301567;17727;4104
87068;Fromental;302;5353516;135493;133;3742788;169;1610728;17727;4105
52095;Chalvraines;121;2144969;63912;63;1513171;58;631798;17727;4106
06024;Briançonnet;86;1524578;34194;45;1195014;41;329564;17728;4107
14374;Les Loges;63;1116899;16816;30;768307;33;348592;17729;4108
42076;Cremeaux;497;8811367;82305;213;5696804;284;3114563;17729;4109
31412;Péguilhan;126;2233917;85178;53;1520591;73;713326;17730;4110
49062;Chalonnes-sous-le-Lude;76;1347507;31549;35;959889;41;387618;17730;4111
32365;Saint-Blancard;141;2500033;58549;66;1926973;75;573060;17731;4112
02531;Moussy-Verneuil;67;1187965;22329;23;661784;44;526181;17731;4113
65207;Gourgue;33;585126;9003;11;298069;22;287057;17731;4114
36221;Thevet-Saint-Julien;272;4822885;225031;117;3386078;155;1436807;17731;4115
61239;Lucé;50;886609;20985;22;603445;28;283164;17732;4116
09086;Caumont;200;3546726;92055;100;2596310;100;950416;17734;4117
19022;Benayes;169;2997045;90761;68;2050574;101;946471;17734;4118
08242;Laifour;291;5160609;132887;125;3411661;166;1748948;17734;4119
02141;La Capelle;1092;19365835;954331;440;13507862;652;5857973;17734;4120
24376;Saint-Aulaye;839;14879483;530017;366;10339749;473;4539734;17735;4121
10118;Les Croûtes;59;1046360;29558;27;682376;32;363984;17735;4122
43151;Pinols;135;2394502;85614;54;1696731;81;697771;17737;4123
03171;Mercy;151;2678448;53878;71;1851449;80;826999;17738;4124
2B264;Rusio;38;674088;30764;17;496592;21;177496;17739;4125
57107;Bréhain;59;1046618;21731;25;709647;34;336971;17739;4126
33399;Saint-Félix-de-Foncaude;183;3246319;95289;71;2242589;112;1003730;17739;4127
19271;Tudeils;139;2465818;57263;61;1696068;78;769750;17740;4128
36045;Châtillon-sur-Indre;1728;30656623;939226;710;20743911;1018;9912712;17741;4129
31168;Eoux;85;1508046;65036;30;1015809;55;492237;17742;4130
70399;Ormoy;139;2466148;53558;57;1651696;82;814452;17742;4131
02402;Lanchy;29;514553;16920;18;418598;11;95955;17743;4132
29038;Commana;615;10912093;340624;256;7560242;359;3351851;17743;4133
2B079;Castello-di-Rostino;226;4010055;101311;107;2763371;119;1246684;17744;4134
82060;Fauroux;99;1756620;44059;37;1100904;62;655716;17744;4135
17266;Les Nouillers;358;6352322;117878;152;4381676;206;1970646;17744;4136
70133;Chargey-lès-Port;138;2448708;50264;61;1663372;77;785336;17744;4137
17110;Clérac;571;10133284;249370;247;6763032;324;3370252;17747;4138
72330;Savigné-sous-le-Lude;228;4046249;28479;112;2831839;116;1214410;17747;4139
61155;L'Épinay-le-Comte;100;1774741;38540;34;1112684;66;662057;17747;4140
46031;Blars;86;1526289;47505;38;1116624;48;409665;17748;4141
58140;Larochemillay;157;2786570;108351;57;1853195;100;933375;17749;4142
46227;Promilhanes;118;2094518;54204;49;1521194;69;573324;17750;4143
24584;Villefranche-de-Lonchat;485;8609623;267847;193;5792119;292;2817504;17752;4144
02173;Chauny;7121;126410860;5613585;2986;91244841;4135;35166019;17752;4145
11070;Carlipa;168;2982370;100342;70;2038599;98;943771;17752;4146
12247;Saint-Saturnin-de-Lenne;191;3390710;73697;87;2362731;104;1027979;17752;4147
32111;Courties;26;461579;18533;11;311962;15;149617;17753;4148
80330;Forceville-en-Vimeu;146;2591963;60433;63;1772123;83;819840;17753;4149
29115;Lannédern;168;2982570;49038;62;1750527;106;1232043;17753;4150
11257;Monze;120;2130472;31712;53;1419620;67;710852;17754;4151
32187;Lamazère;74;1313845;20525;36;900862;38;412983;17755;4152
39393;Onglières;42;745717;16399;15;419290;27;326427;17755;4153
07111;Juvinas;107;1899875;76255;51;1357571;56;542304;17756;4154
47105;Frespech;162;2876459;62689;61;1941463;101;934996;17756;4155
14375;Les Loges-Saulces;88;1562528;37221;38;1073956;50;488572;17756;4156
23230;Saint-Pierre-Chérignat;109;1935448;71808;42;1370387;67;565061;17756;4157
33481;Saint-Sulpice-de-Guilleragues;129;2290634;66341;56;1586278;73;704356;17757;4158
48067;Gabriac;51;905617;25967;26;681406;25;224211;17757;4159
42227;Saint-Georges-en-Couzan;251;4457090;66284;107;2707460;144;1749630;17757;4160
03287;Treban;225;3995413;98015;108;2895719;117;1099694;17757;4161
26333;Saint-Vallier;2419;42957040;1921067;1029;30203423;1390;12753617;17758;4162
58304;Varzy;776;13780366;479206;344;9675900;432;4104466;17758;4163
76212;Darnétal;5580;99091368;3235629;2709;73171837;2871;25919531;17758;4164
43031;Blassac;77;1367428;32327;33;931810;44;435618;17759;4165
43042;Cayres;402;7139180;139326;194;5051444;208;2087736;17759;4166
28387;Thiron-Gardais;618;10975270;302699;271;7537042;347;3438228;17759;4167
24213;Jaure;100;1775968;44853;39;1125882;61;650086;17760;4168
50325;Le Mesnil-Vigot;121;2148942;51683;51;1457506;70;691436;17760;4169
81105;Graulhet;7104;126168498;3725190;2827;84171731;4277;41996767;17760;4170
16423;Xambes;172;3054769;94458;78;2154720;94;900049;17760;4171
32061;Boulaur;100;1776041;88912;37;1394744;63;381297;17760;4172
64427;Orion;88;1562941;9525;35;939232;53;623709;17761;4173
07032;Berzème;96;1705042;34567;41;1153028;55;552014;17761;4174
02468;Marle;1379;24492782;845981;535;16990135;844;7502647;17761;4175
42158;Les Noës;107;1900539;32632;50;1362825;57;537714;17762;4176
26168;Lus-la-Croix-Haute;299;5310995;84495;119;3330224;180;1980771;17763;4177
09102;Coutens;100;1776355;83464;46;1284662;54;491693;17764;4178
14431;Mézidon-Canon;2667;47376024;1039724;1172;31349189;1495;16026835;17764;4179
12246;Saint-Santin;313;5560272;126594;136;3777499;177;1782773;17764;4180
82036;Le Causé;77;1367890;20387;29;850493;48;517397;17765;4181
15038;Champs-sur-Tarentaine-Marchal;623;11067533;271470;240;6526707;383;4540826;17765;4182
53176;Le Pas;284;5045287;48759;110;3003361;174;2041926;17765;4183
71198;Flacey-en-Bresse;225;3997192;95723;98;2628947;127;1368245;17765;4184
72078;Chérancé;208;3695260;79562;94;2609211;114;1086049;17766;4185
08304;Montigny-sur-Meuse;55;977181;21749;26;669064;29;308117;17767;4186
23141;Naillat;406;7213409;170018;178;4981422;228;2231987;17767;4187
97307;Matoury;12649;224735135;6998955;3923;150363330;8726;74371805;17767;4188
80630;Poix-de-Picardie;1466;26046800;1041742;634;19358271;832;6688529;17767;4189
2A249;Propriano;2084;37027533;1772833;853;26450678;1231;10576855;17768;4190
88240;Herpelmont;148;2629659;4981;70;1649907;78;979752;17768;4191
48066;Fraissinet-de-Lozère;125;2221005;79530;53;1577817;72;643188;17768;4192
85292;Thouarsais-Bouildroux;399;7089460;132646;165;4908860;234;2180600;17768;4193
16053;Bors (Canton de Baignes-Sainte-Radegonde);73;1297190;26606;26;832756;47;464434;17770;4194
09280;Saurat;414;7357536;317082;174;5309315;240;2048221;17772;4195
88436;Saint-Stail;44;781969;10883;20;519896;24;262073;17772;4196
30272;Saint-Julien-de-la-Nef;100;1777210;107808;37;1160168;63;617042;17772;4197
52177;Doulaincourt-Saucourt;582;10344071;459113;223;6912091;359;3431980;17773;4198
79196;Oiron;551;9793168;231074;242;6626937;309;3166231;17773;4199
93039;L'Île-Saint-Denis;3964;70455227;3099812;1839;53514968;2125;16940259;17774;4200
64276;Issor;140;2488351;59753;62;1764923;78;723428;17774;4201
63175;Herment;167;2968294;89953;70;2028715;97;939579;17774;4202
03203;Paray-le-Frésil;259;4603853;160755;120;3213792;139;1390061;17775;4203
17034;Barzan;293;5208251;170384;124;3506452;169;1701799;17776;4204
48051;Le Collet-de-Dèze;388;6897752;224626;160;4600504;228;2297248;17778;4205
07210;Saint-Andéol-de-Vals;324;5760155;147403;154;4275630;170;1484525;17778;4206
03057;La Chapelle-aux-Chasses;130;2311175;46795;66;1565286;64;745889;17778;4207
08375;Sachy;100;1777937;48204;41;1123012;59;654925;17779;4208
70520;Vanne;63;1120219;32781;24;754007;39;366212;17781;4209
43148;Paulhaguet;552;9816733;322638;232;6816117;320;3000616;17784;4210
56156;Persquen;201;3574689;198023;72;2304031;129;1270658;17785;4211
87133;Saint-Amand-Magnazeix;312;5549068;181966;130;3836533;182;1712535;17785;4212
08461;Vandy;120;2134291;72090;53;1480957;67;653334;17786;4213
88378;Regney;51;907234;22735;22;563872;29;343362;17789;4214
33316;Pellegrue;604;10744774;449282;206;7128217;398;3616557;17789;4215
23157;La Pouge;52;925047;16510;17;440732;35;484315;17789;4216
83084;Montmeyan;324;5763841;169614;136;3947868;188;1815973;17790;4217
16400;Verteuil-sur-Charente;369;6564455;200013;169;4568421;200;1996034;17790;4218
11113;Cucugnan;84;1494367;57194;32;1006218;52;488149;17790;4219
25597;Vellevans;111;1974706;-485;48;1221534;63;753172;17790;4220
17347;Saint-Jean-d'Angély;4768;84823848;3590840;1944;60462332;2824;24361516;17790;4221
32084;Castéron;40;711620;28473;15;497800;25;213820;17791;4222
16246;Nonac;165;2935497;76150;64;1953835;101;981662;17791;4223
32079;Castelnau-d'Auzan;618;10994949;329894;242;7247341;376;3747608;17791;4224
28134;Dreux;16893;300555039;11387303;7222;212138734;9671;88416305;17792;4225
11121;Donazac;60;1067544;30680;25;714508;35;353036;17792;4226
71077;Chambilly;283;5035964;92135;118;3168341;165;1867623;17795;4227
30258;Saint-Gilles;7473;132995136;4232103;3026;91309349;4447;41685787;17797;4228
70499;Theuley;57;1014415;25444;25;660044;32;354371;17797;4229
64115;Berrogain-Laruns;74;1316993;33909;30;872858;44;444135;17797;4230
48026;Blavignac;132;2349299;39635;66;1676541;66;672758;17798;4231
23029;Le Bourg-d'Hem;140;2491715;65774;58;1682082;82;809633;17798;4232
09136;Gourbit;52;925507;47366;26;722749;26;202758;17798;4233
63320;Saint-Avit;154;2741011;56795;66;1897158;88;843853;17799;4234
62140;Bléquin;241;4289652;20756;103;2643264;138;1646388;17799;4235
31140;Chein-Dessus;122;2171568;80791;63;1635897;59;535671;17800;4236
14298;Géfosse-Fontenay;76;1352804;34933;42;1091957;34;260847;17800;4237
64414;Narp;58;1032520;15560;30;759239;28;273281;17802;4238
55280;Lanhères;33;587485;12672;12;374261;21;213224;17803;4239
63197;Lisseuil;57;1014756;47151;25;751627;32;263129;17803;4240
05027;Cervières;96;1709097;26128;45;1146455;51;562642;17803;4241
18051;La Chapelotte;100;1780334;42465;39;1144229;61;636105;17803;4242
47321;Villeneuve-de-Duras;164;2919758;68676;64;1851629;100;1068129;17803;4243
62814;Thièvres;67;1192836;41123;31;819354;36;373482;17804;4244
2B193;Omessa;337;5999830;206917;138;4042444;199;1957386;17804;4245
71020;Barnay;67;1192893;30816;25;716161;42;476732;17804;4246
11345;Saint-Jean-de-Barrou;158;2813172;106823;67;1988899;91;824273;17805;4247
08110;Le Châtelet-sur-Sormonne;103;1833916;40967;52;1285409;51;548507;17805;4248
80438;Heudicourt;274;4878603;120441;119;3483461;155;1395142;17805;4249
24165;Eygurande-et-Gardedeuil;225;4006252;183895;92;2877255;133;1128997;17806;4250
62495;Ledinghem;144;2564032;43454;59;1671835;85;892197;17806;4251
46129;Gréalou;152;2706577;57816;66;1909427;86;797150;17806;4252
03288;Treignat;262;4665410;102163;96;2897564;166;1767846;17807;4253
23145;Nouhant;192;3419262;143151;86;2416507;106;1002755;17809;4254
86159;Millac;318;5663240;208323;133;3864958;185;1798282;17809;4255
09109;Durfort;96;1709691;8980;35;1136499;61;573192;17809;4256
32130;Faget-Abbatial;135;2404331;75578;53;1705846;82;698485;17810;4257
30236;Saint-Bonnet-de-Salendrinque;58;1033020;26686;21;685829;37;347191;17811;4258
17330;Sainte-Gemme;728;12966632;474167;301;9133102;427;3833530;17811;4259
31217;Génos;40;712453;38471;19;506290;21;206163;17811;4260
58010;Arleuf;475;8461040;228534;209;5615442;266;2845598;17813;4261
11256;Montséret;274;4880801;131322;123;3642432;151;1238369;17813;4262
64486;Saint-Jean-Poudge;41;730346;12278;20;529021;21;201325;17813;4263
31548;Signac;29;516595;12316;13;335472;16;181123;17814;4264
37035;Braye-sous-Faye;195;3473679;125351;71;2168870;124;1304809;17814;4265
2B083;Castirla;102;1817011;45859;43;1295051;59;521960;17814;4266
82021;Bouloc;106;1888280;62002;35;1194493;71;693787;17814;4267
30046;Boucoiran-et-Nozières;427;7607063;156901;184;5232051;243;2375012;17815;4268
46218;Pescadoires;88;1567786;49994;36;1016734;52;551052;17816;4269
30247;Saint-Denis;161;2868350;62892;54;1750650;107;1117700;17816;4270
12062;Castelnau-Pégayrols;208;3705735;91729;91;2570693;117;1135042;17816;4271
81217;Puycelsi;304;5416271;207107;117;3872760;187;1543511;17817;4272
03154;Luneau;164;2922225;83564;61;1931750;103;990475;17818;4273
64425;Orègue;250;4454662;122510;99;2946766;151;1507896;17819;4274
15212;Saint-Santin-de-Maurs;222;3955823;72964;94;2711969;128;1243854;17819;4275
52321;Mertrud;121;2156174;76739;64;1615242;57;540932;17820;4276
24581;Villamblard;518;9230610;247255;197;6105903;321;3124707;17820;4277
42044;Le Chambon-Feugerolles;6889;122760950;3086696;3047;83107764;3842;39653186;17820;4278
59234;Flers-en-Escrebieux;3036;54101141;1445885;1303;37167262;1733;16933879;17820;4279
16125;Édon;153;2726520;60984;73;1902451;80;824069;17820;4280
46318;Thémines;141;2512698;68822;69;1886413;72;626285;17821;4281
63123;Cournols;138;2459237;116961;62;2034877;76;424360;17821;4282
12114;Grand-Vabre;225;4009706;105919;88;2779012;137;1230694;17821;4283
82191;Verfeil;178;3172164;135938;57;1941965;121;1230199;17821;4284
36239;Vigoux;271;4829548;90816;120;3307844;151;1521704;17821;4285
62368;Gaudiempré;102;1817840;21503;35;1096305;67;721535;17822;4286
79068;Chantecorps;168;2994111;38305;75;2018539;93;975572;17822;4287
24196;Génis;320;5703119;203216;147;4111768;173;1591351;17822;4288
85271;Saint-Sulpice-en-Pareds;221;3938799;24460;94;2341675;127;1597124;17823;4289
06131;Sallagriffon;27;481223;17144;11;356222;16;125001;17823;4290
86264;Sommières-du-Clain;450;8020558;320318;177;5519437;273;2501121;17823;4291
87052;La Croix-sur-Gartempe;103;1835953;31323;42;1119110;61;716843;17825;4292
88455;Serécourt;66;1176452;23362;28;685711;38;490741;17825;4293
2B223;Pietralba;273;4866246;232819;121;3483650;152;1382596;17825;4294
79150;Limalonges;501;8930768;184896;204;5772945;297;3157823;17826;4295
50273;Lithaire;310;5526196;96603;137;3628488;173;1897708;17826;4296
61357;Rouperroux;91;1622278;37067;42;1149868;49;472410;17827;4297
65441;Thèbe;46;820117;19963;19;524910;27;295207;17829;4298
17254;Nachamps;113;2014711;49322;50;1382014;63;632697;17829;4299
02764;Vassogne;44;784539;15193;18;555929;26;228610;17830;4300
24550;Thenon;772;13765296;457968;344;9703798;428;4061498;17831;4301
36014;Bazaiges;134;2389467;61453;54;1528121;80;861346;17832;4302
53199;Saint-Aubin-Fosse-Louvain;125;2228994;12165;48;1487522;77;741472;17832;4303
05043;Les Costes;93;1658381;15764;38;1103257;55;555124;17832;4304
88303;Midrevaux;123;2193422;55001;51;1434266;72;759156;17833;4305
02182;Chevennes;77;1373137;18974;37;918591;40;454546;17833;4306
59037;Avesnes-les-Aubert;1997;35612762;1133489;858;24700627;1139;10912135;17833;4307
32136;Galiax;106;1890319;58632;44;1315147;62;575172;17833;4308
62603;Nesles;509;9077424;194340;227;6316029;282;2761395;17834;4309
21715;Voudenay;118;2104553;50519;52;1367667;66;736886;17835;4310
48068;Gabrias;87;1551676;18798;44;1172749;43;378927;17835;4311
12118;Lacroix-Barrez;293;5225821;162241;121;3440635;172;1785186;17836;4312
21318;Ivry-en-Montagne;101;1801402;56405;40;1162596;61;638806;17836;4313
58130;Grenois;75;1337713;43439;38;956811;37;380902;17836;4314
36022;Bouesse;240;4280765;76781;106;2772339;134;1508426;17837;4315
61324;Passais;477;8508129;279908;181;5722430;296;2785699;17837;4316
19280;Végennes;107;1908576;69695;43;1358360;64;550216;17837;4317
33175;Frontenac;420;7491615;158348;167;5030875;253;2460740;17837;4318
62443;Hersin-Coupigny;3245;57886301;1676305;1375;40611719;1870;17274582;17839;4319
09030;Auzat;305;5440855;145456;148;4039813;157;1401042;17839;4320
72063;La Chapelle-Gaugain;218;3888880;127643;84;2735608;134;1153272;17839;4321
70541;Velorcey;115;2051545;8407;55;1323421;60;728124;17840;4322
19170;Queyssac-les-Vignes;123;2194353;49925;53;1493352;70;701001;17840;4323
36090;Jeu-Maloches;80;1427271;39360;36;1005626;44;421645;17841;4324
07236;Saint-Félicien;744;13273626;372402;325;9187054;419;4086572;17841;4325
37196;Richelieu;1140;20338697;807357;487;14358138;653;5980559;17841;4326
17113;La Clotte;381;6797491;193206;155;4514563;226;2282928;17841;4327
05055;La Faurie;175;3122231;89336;82;2285762;93;836469;17841;4328
31313;Malvezie;71;1266822;35411;34;977673;37;289149;17843;4329
87011;Bellac;2579;46016152;1910897;1118;33193724;1461;12822428;17843;4330
18192;Reigny;152;2712123;100572;62;1895188;90;816935;17843;4331
03210;Pouzy-Mésangy;230;4103921;112155;96;2857834;134;1246087;17843;4332
43166;Saint-André-de-Chalencon;201;3586472;102019;77;2309446;124;1277026;17843;4333
58085;Corvol-l'Orgueilleux;448;7993934;250934;202;5686514;246;2307420;17844;4334
72180;Mamers;3252;58028861;1814334;1445;40971532;1807;17057329;17844;4335
08319;Neuville-lez-Beaulieu;181;3229941;59059;76;2124301;105;1105640;17845;4336
19159;Péret-Bel-Air;62;1106419;22449;23;678778;39;427641;17845;4337
07141;Lentillères;128;2284269;55550;59;1684474;69;599795;17846;4338
63380;Saint-Nectaire;491;8762435;293689;209;6059807;282;2702628;17846;4339
26298;Saint-Christophe-et-le-Laris;225;4015466;93852;110;3013929;115;1001537;17847;4340
62616;Noeux-lès-Auxi;87;1552682;57677;38;1137602;49;415080;17847;4341
24231;Lavalade;60;1070835;26158;30;748704;30;322131;17847;4342
05033;Chanousse;27;481882;28667;11;362915;16;118967;17847;4343
50629;Vesly;383;6835679;93494;177;4693724;206;2141955;17848;4344
23199;Saint-Germain-Beaupré;225;4015742;120171;94;2719618;131;1296124;17848;4345
63015;Aubusson-d'Auvergne;139;2480923;51367;61;1740564;78;740359;17848;4346
36047;La Châtre-Langlin;350;6246991;194060;154;4265474;196;1981517;17849;4347
12188;Prades-Salars;167;2980710;49178;78;2053656;89;927054;17849;4348
12276;Tauriac-de-Naucelle;218;3891008;107109;68;2283873;150;1607135;17849;4349
81060;Carmaux;6264;111805208;3417779;2547;75266165;3717;36539043;17849;4350
64493;Saint-Palais;1156;20633345;807264;477;14697975;679;5935370;17849;4351
19283;Veyrières;44;785374;24079;22;622341;22;163033;17849;4352
26195;Montclar-sur-Gervanne;116;2070547;49683;52;1486360;64;584187;17850;4353
52386;Perthes;297;5301356;104382;143;3766021;154;1535335;17850;4354
50128;Le Chefresne;158;2820392;36543;68;1939121;90;881271;17851;4355
87130;Roziers-Saint-Georges;107;1910013;48805;54;1427190;53;482823;17851;4356
86132;Liglet;190;3391645;106745;75;2374814;115;1016831;17851;4357
36081;Gargilesse-Dampierre;165;2945467;104999;69;2032078;96;913389;17851;4358
31178;Fabas;118;2106467;55899;42;1272109;76;834358;17851;4359
71322;Morlet;42;749768;24325;18;529800;24;219968;17852;4360
25443;Palantine;31;553408;-661;17;410998;14;142410;17852;4361
43071;Chomelix;277;4945067;117459;114;3250376;163;1694691;17852;4362
63294;Queuille;158;2820695;51698;76;1934240;82;886455;17853;4363
47181;Montagnac-sur-Lède;153;2731788;75055;58;1854721;95;877067;17855;4364
81241;Saint-Antonin-de-Lacalm;141;2517638;49978;58;1616401;83;901237;17856;4365
08026;Aubigny-les-Pothées;167;2981976;51748;73;2063342;94;918634;17856;4366
36155;Pellevoisin;486;8679364;239400;184;5386519;302;3292845;17859;4367
42204;Saint-Bonnet-le-Château;918;16394538;548055;383;11018765;535;5375773;17859;4368
70172;La Corbière;60;1071599;27052;33;824289;27;247310;17860;4369
12003;Les Albres;194;3464845;62311;84;2288039;110;1176806;17860;4370
47119;Houeillès;359;6411958;175050;152;4414896;207;1997062;17861;4371
30106;Durfort-et-Saint-Martin-de-Sossenac;403;7198303;208534;167;5020553;236;2177750;17862;4372
50329;Milly;183;3268722;41874;91;2277650;92;991072;17862;4373
11136;Fanjeaux;437;7805916;232029;158;5574802;279;2231114;17863;4374
97230;La Trinité;7901;141132671;5262382;2754;99389781;5147;41742890;17863;4375
06061;Les Ferres;45;803866;25775;19;525980;26;277886;17864;4376
76498;Le Petit-Quevilly;12891;230317073;7916375;6431;171410102;6460;58906971;17867;4377
40198;Morganx;108;1929584;22866;45;1320943;63;608641;17867;4378
17361;Saint-Martial;82;1465058;53123;41;1112922;41;352136;17867;4379
42248;Saint-Just-en-Chevalet;727;12989020;330493;317;8918116;410;4070904;17867;4380
31062;Bellesserre;50;893396;11812;21;546458;29;346938;17868;4381
79084;Chenay;285;5092544;127214;120;3556250;165;1536294;17869;4382
65219;Hères;75;1340170;41545;36;994745;39;345425;17869;4383
52216;Germaines;24;428855;12755;13;324636;11;104219;17869;4384
33230;Lapouyade;265;4735286;99145;100;3024802;165;1710484;17869;4385
22027;Le Cambout;279;4985478;112525;124;3523564;155;1461914;17869;4386
87057;Dompierre-les-Églises;216;3859790;66367;69;2062275;147;1797515;17869;4387
50159;Dangy;372;6647443;186201;144;4409069;228;2238374;17869;4388
03053;Chantelle;699;12491587;461509;276;8821606;423;3669981;17871;4389
07238;Saint-Genest-de-Beauzon;181;3234612;122359;71;2118757;110;1115855;17871;4390
06001;Aiglun;45;804198;15473;19;490051;26;314147;17871;4391
32102;Cézan;110;1965837;56821;53;1472886;57;492951;17871;4392
80825;Wiry-au-Mont;61;1090156;20349;34;820187;27;269969;17871;4393
33283;Mesterrieux;109;1948071;54845;48;1419196;61;528875;17872;4394
87074;Les Grands-Chézeaux;154;2752328;85649;70;1930419;84;821909;17872;4395
63147;Églisolles;163;2913285;64399;76;1931308;87;981977;17873;4396
43267;Vorey;902;16121626;503423;402;11216902;500;4904724;17873;4397
02574;Origny-en-Thiérache;880;15728458;489799;358;10897557;522;4830901;17873;4398
61174;La Forêt-Auvray;99;1769466;39650;37;1125232;62;644234;17873;4399
08399;Sapogne-sur-Marche;78;1394138;18577;33;935594;45;458544;17874;4400
66104;Los Masos;475;8490629;150520;226;6425578;249;2065051;17875;4401
11323;Roquetaillade;120;2145033;70266;47;1419544;73;725489;17875;4402
55310;Luzy-Saint-Martin;58;1036769;14343;25;669815;33;366954;17875;4403
88108;Le Clerjus;326;5827710;135517;139;3879368;187;1948342;17876;4404
57231;Foville;46;822352;1212;21;525686;25;296666;17877;4405
2B140;Lento;53;947497;41593;24;736218;29;211279;17877;4406
11212;Mailhac;260;4648288;84959;103;2935587;157;1712701;17878;4407
50018;Argouges;315;5631728;106104;144;3952408;171;1679320;17879;4408
59017;Armentières;14348;256524537;9037853;6410;185605115;7938;70919422;17879;4409
34293;La Salvetat-sur-Agout;723;12926409;439195;324;9419599;399;3506810;17879;4410
05044;Crévoux;81;1448190;25801;35;1036468;46;411722;17879;4411
46264;Saint-Denis-Catus;107;1913158;40935;50;1331179;57;581979;17880;4412
65409;Sarriac-Bigorre;177;3164830;62774;83;2179245;94;985585;17880;4413
58062;Château-Chinon (Ville);1174;20992054;899891;496;14839244;678;6152810;17881;4414
80143;Brocourt;60;1072850;48013;28;797998;32;274852;17881;4415
03265;Saligny-sur-Roudon;414;7402976;133319;186;5062524;228;2340452;17882;4416
70003;Achey;38;679513;15699;19;506789;19;172724;17882;4417
62318;Étaples;6041;108027217;3167250;2551;73621732;3490;34405485;17882;4418
16212;Massignac;232;4148878;167576;86;2666789;146;1482089;17883;4419
56026;Bubry;1473;26345536;725368;658;18153653;815;8191883;17886;4420
35249;Sainte-Anne-sur-Vilaine;525;9390267;122844;227;6139416;298;3250851;17886;4421
34171;Montoulieu;95;1699231;64816;38;1219880;57;479351;17887;4422
56134;Mohon;553;9891332;250436;229;6568542;324;3322790;17887;4423
17358;Saint-Mandé-sur-Brédoire;179;3201751;82311;73;2075752;106;1125999;17887;4424
69201;Sainte-Foy-l'Argentière;801;14328035;390424;382;10077295;419;4250740;17888;4425
15125;Mentières;69;1234258;22041;26;792620;43;441638;17888;4426
47082;Dondas;125;2235985;57912;49;1497942;76;738043;17888;4427
34194;Paulhan;2127;38048810;1041336;892;26050253;1235;11998557;17888;4428
12155;Fondamente;173;3094805;52710;66;2007325;107;1087480;17889;4429
82032;Castelsagrat;282;5044897;150731;110;3402907;172;1641990;17890;4430
64050;Arrast-Larrebieu;48;858710;19541;24;601030;24;257680;17890;4431
54282;Joppécourt;73;1305978;9905;24;655017;49;650961;17890;4432
87032;Châlus;1066;19070997;670151;458;13210294;608;5860703;17890;4433
12067;Le Clapier;54;966119;23119;23;613773;31;352346;17891;4434
44095;La Meilleraye-de-Bretagne;774;13847925;220374;331;9165462;443;4682463;17891;4435
58074;Chiddes;199;3560546;66537;82;2360785;117;1199761;17892;4436
07110;Joyeuse;1024;18322327;630303;414;12590483;610;5731844;17893;4437
50397;Perriers-en-Beauficel;120;2147214;50085;49;1407667;71;739547;17893;4438
48096;Meyrueis;530;9483600;401447;226;6762851;304;2720749;17894;4439
19069;Darazac;88;1574675;42224;36;1144184;52;430491;17894;4440
06115;Saint-Antonin;54;966309;20801;27;695441;27;270868;17895;4441
08017;Apremont;74;1324217;41218;31;901140;43;423077;17895;4442
88110;Clézentaine;119;2129504;66481;50;1408599;69;720905;17895;4443
06163;Tende;1221;21850029;859672;546;16149661;675;5700368;17895;4444
29114;Lannéanou;202;3614853;61598;93;2525175;109;1089678;17895;4445
33447;Saint-Médard-de-Guizières;1409;25215133;1040277;586;17512291;823;7702842;17896;4446
58047;Cervon;389;6961490;203119;183;5123048;206;1838442;17896;4447
64294;Labets-Biscay;77;1378071;34058;33;848139;44;529932;17897;4448
88292;Mattaincourt;519;9288762;309688;240;6921452;279;2367310;17897;4449
50497;Saint-Jores;202;3615286;74724;86;2513042;116;1102244;17897;4450
50005;Amfreville;162;2899467;39941;71;1863905;91;1035562;17898;4451
37130;Ligueil;1357;24289399;957508;490;15770450;867;8518949;17899;4452
02668;Sains-Richaumont;568;10167009;281666;221;6614762;347;3552247;17900;4453
50103;Carquebut;188;3365246;49334;68;2314395;120;1050851;17900;4454
24360;Sagelat;185;3311562;68496;84;2338423;101;973139;17900;4455
64412;Nabas;59;1056121;36505;25;697828;34;358293;17900;4456
86128;Lencloître;1422;25454933;671234;627;17540744;795;7914189;17901;4457
71493;Saisy;203;3633934;83693;91;2443884;112;1190050;17901;4458
56183;Quelneuc;316;5656931;127010;153;4070176;163;1586755;17902;4459
29016;Brasparts;595;10651583;360391;261;7496936;334;3154647;17902;4460
52448;Saint-Dizier;14975;268084619;11274593;6555;194089809;8420;73994810;17902;4461
17438;Tanzac;168;3007629;65012;71;2051817;97;955812;17903;4462
24167;Eymet;1692;30293273;905747;696;20930975;996;9362298;17904;4463
71196;Le Fay;377;6749789;121163;187;4847049;190;1902740;17904;4464
32114;Cuélas;66;1181665;34677;28;851060;38;330605;17904;4465
71566;Verdun-sur-le-Doubs;682;12210781;424195;284;8289062;398;3921719;17904;4466
57609;Saint-Epvre;94;1683037;41303;38;1170654;56;512383;17905;4467
61503;Vieux-Pont;124;2220219;38408;56;1544052;68;676167;17905;4468
21655;Vanvey;159;2846915;92631;67;1988724;92;858191;17905;4469
36220;Thenay;496;8881043;231990;224;6329123;272;2551920;17905;4470
58018;Authiou;30;537195;29508;12;365643;18;171552;17907;4471
82088;Laguépie;422;7556682;255442;164;4938237;258;2618445;17907;4472
83005;Artignosc-sur-Verdon;181;3241215;88138;82;2223416;99;1017799;17907;4473
09107;Dun;344;6160137;187796;148;4288923;196;1871214;17907;4474
50210;Gorges;197;3527753;44901;81;2137899;116;1389854;17907;4475
31344;Miramont-de-Comminges;444;7950916;240195;222;5901891;222;2049025;17907;4476
80196;Citerne;172;3080141;134280;82;2217127;90;863014;17908;4477
34045;Cabrières;281;5032131;122986;107;3385384;174;1646747;17908;4478
63323;Saint-Bonnet-le-Bourg;94;1683387;63339;37;1081990;57;601397;17908;4479
34175;Mourèze;107;1916215;61185;45;1382883;62;533332;17909;4480
48179;Saint-Privat-du-Fau;70;1253612;34996;28;892988;42;360624;17909;4481
11053;Brugairolles;144;2578967;73343;54;1707071;90;871896;17909;4482
79215;Pougne-Hérisson;192;3438723;71629;85;2326237;107;1112486;17910;4483
32373;Sainte-Dode;133;2382072;75244;55;1601324;78;780748;17910;4484
08262;Lucquy;316;5660140;114508;142;3884779;174;1775361;17912;4485
41079;Les Essarts;61;1092629;16595;25;685019;36;407610;17912;4486
35339;Trans-la-Forêt;323;5785581;90928;139;3893579;184;1892002;17912;4487
21626;Terrefondrée;37;662777;21360;16;475685;21;187092;17913;4488
89475;Villon;67;1200190;53221;30;833452;37;366738;17913;4489
25596;Vellerot-lès-Vercel;29;519516;-277;14;328272;15;191244;17914;4490
79044;Bouillé-Saint-Paul;202;3618732;55739;87;2402191;115;1216541;17915;4491
62668;Prédefin;105;1881056;36065;40;1190335;65;690721;17915;4492
88129;Derbamont;56;1003247;16159;27;758025;29;245222;17915;4493
42255;Saint-Marcel-d'Urfé;150;2687427;29608;58;1713337;92;974090;17916;4494
47210;Port-Sainte-Marie;1002;17952275;423633;396;12057365;606;5894910;17916;4495
17365;Saint-Martin-d'Ary;278;4981031;147450;118;3361287;160;1619744;17917;4496
07028;Beaulieu;290;5196117;175103;120;3526893;170;1669224;17918;4497
64517;Séméacq-Blachon;96;1720193;27624;34;958705;62;761488;17919;4498
80651;Le Quesne;158;2831310;62190;79;2010018;79;821292;17920;4499
87031;Le Chalard;179;3207681;117992;83;2443964;96;763717;17920;4500
10024;Avreuil;94;1684508;44052;50;1210816;44;473692;17920;4501
32342;Ricourt;33;591379;2615;12;435898;21;155481;17921;4502
08189;Girondelle;74;1326136;18685;29;823777;45;502359;17921;4503
32017;Aurensan;82;1469503;33134;42;1118837;40;350666;17921;4504
12227;Saint-Igest;106;1899699;44948;40;1308537;66;591162;17922;4505
18152;Montlouis;73;1308303;53609;32;1003365;41;304938;17922;4506
64205;Escos;142;2545008;76087;61;1692939;81;852069;17923;4507
43188;Saint-Georges-d'Aurac;273;4893074;71130;123;3237035;150;1656039;17923;4508
89044;Blannay;83;1487639;45897;44;1142942;39;344697;17923;4509
71474;Sainte-Radegonde;98;1756592;27519;49;1237224;49;519368;17924;4510
12139;Marnhagues-et-Latour;65;1165209;37131;24;717227;41;447982;17926;4511
57434;Maizières-lès-Vic;264;4732966;67148;112;3238527;152;1494439;17928;4512
76410;Maromme;6611;118524534;3783480;3259;86456557;3352;32067977;17928;4513
62581;Monchy-Cayeux;190;3406475;85166;84;2500473;106;906002;17929;4514
16156;Gourville;380;6813172;168090;157;4590173;223;2222999;17929;4515
62521;La Loge;110;1972237;41977;45;1270024;65;702213;17929;4516
46090;Durbans;81;1452319;55830;42;1148167;39;304152;17930;4517
32285;Montesquiou;344;6167910;236729;135;4185944;209;1981966;17930;4518
58129;Gouloux;124;2223383;97494;51;1566841;73;656542;17931;4519
63324;Saint-Bonnet-le-Chastel;129;2313058;77481;54;1620414;75;692644;17931;4520
17303;La Ronde;595;10669382;133254;260;7128546;335;3540836;17932;4521
16025;Baignes-Sainte-Radegonde;726;13018938;329207;280;8310876;446;4708062;17932;4522
18104;Groises;89;1596010;60233;43;1187771;46;408239;17933;4523
17248;Mortagne-sur-Gironde;616;11046569;363955;238;7390408;378;3656161;17933;4524
21375;Manlay;136;2438895;86987;58;1618266;78;820629;17933;4525
42181;Régny;817;14651380;342221;362;9973078;455;4678302;17933;4526
61487;Torchamp;160;2869396;57135;58;1707636;102;1161760;17934;4527
15181;Saint-Constant;344;6169386;153956;144;4316257;200;1853129;17934;4528
62745;Saint-Denoeux;81;1452692;42195;31;956276;50;496416;17934;4529
63305;Rochefort-Montagne;549;9846427;429449;202;6882689;347;2963738;17935;4530
11003;Ajac;127;2277919;78347;60;1630946;67;646973;17936;4531
11220;Marseillette;432;7748543;397167;189;5592618;243;2155925;17936;4532
16414;Villognon;202;3623223;73624;89;2365505;113;1257718;17937;4533
08486;Vireux-Molhain;903;16197179;460979;409;11606776;494;4590403;17937;4534
86289;Le Vigeant;395;7085339;200503;175;4868501;220;2216838;17938;4535
54201;Fontenoy-la-Joûte;173;3103234;81216;81;2171965;92;931269;17938;4536
15003;Ally;389;6977825;235585;170;4925242;219;2052583;17938;4537
59545;Saint-Souplet;681;12215693;385681;285;8601214;396;3614479;17938;4538
62321;Évin-Malmaison;2281;40919153;887869;978;27301584;1303;13617569;17939;4539
29014;Botsorhel;265;4753972;127985;113;3200703;152;1553269;17940;4540
48057;Estables;100;1794054;31013;36;1173487;64;620567;17941;4541
21015;Antigny-la-Ville;58;1040560;13613;25;662321;33;378239;17941;4542
06082;Massoins;71;1273853;50351;31;873992;40;399861;17942;4543
25491;Rignosot;69;1237972;26481;39;938003;30;299969;17942;4544
94078;Villeneuve-Saint-Georges;17757;318601296;11347552;8549;237027848;9208;81573448;17942;4545
06143;Touët-sur-Var;355;6369585;130132;145;4130121;210;2239464;17942;4546
34020;Azillanet;231;4144761;216424;82;2937928;149;1206833;17943;4547
58031;Billy-Chevannes;195;3498885;96799;89;2528513;106;970372;17943;4548
24555;Tourtoirac;376;6746584;182635;149;4296939;227;2449645;17943;4549
34187;Olargues;329;5903319;232728;140;4359205;189;1544114;17943;4550
12103;Florentin-la-Capelle;187;3355531;120721;65;2035392;122;1320139;17944;4551
03251;Saint-Plaisir;233;4181107;60124;105;2872659;128;1308448;17945;4552
24397;Saint-Cyr-les-Champagnes;181;3248078;123618;87;2405000;94;843078;17945;4553
30311;Sauve;1075;19291805;906325;433;13610290;642;5681515;17946;4554
79341;Vautebis;66;1184441;15033;25;777300;41;407141;17946;4555
37034;Braslou;193;3463617;112746;80;2275540;113;1188077;17946;4556
36194;Saint-Genou;585;10498836;235062;273;7194026;312;3304810;17947;4557
34167;Montels;128;2297192;61386;58;1649689;70;647503;17947;4558
47184;Montaut;139;2494635;36514;60;1617844;79;876791;17947;4559
17384;Saint-Pierre-de-l'Isle;118;2117783;71032;40;1344435;78;773348;17947;4560
56027;Buléon;280;5025300;105108;132;3347033;148;1678267;17948;4561
16365;Sauvignac;53;951285;34679;27;714622;26;236663;17949;4562
10040;Bernon;119;2135979;75723;48;1471900;71;664079;17949;4563
09168;Lieurac;102;1830919;35073;42;1226997;60;603922;17950;4564
33221;Lamothe-Landerron;603;10823973;282679;248;7436889;355;3387084;17950;4565
52388;Pierremont-sur-Amance;96;1723256;33236;46;1265116;50;458140;17951;4566
56187;Quily;184;3302924;46541;92;2300019;92;1002905;17951;4567
50290;Marcilly;194;3482448;56147;92;2416777;102;1065671;17951;4568
46169;Léobard;124;2225957;45358;51;1410147;73;815810;17951;4569
82095;Lavaurette;124;2226049;25385;47;1270388;77;955661;17952;4570
12025;Belmont-sur-Rance;598;10735440;409558;238;7381110;360;3354330;17952;4571
07077;Darbres;136;2441555;40375;58;1648385;78;793170;17953;4572
25505;Rougemont;717;12872434;406347;340;9534386;377;3338048;17953;4573
50182;La Feuillie;164;2944654;44744;66;1845736;98;1098918;17955;4574
11033;Belpech;745;13377085;387815;305;9129882;440;4247203;17956;4575
42019;Boën;2011;36110516;1310042;781;23864808;1230;12245708;17956;4576
88503;Vexaincourt;102;1831699;62478;47;1285396;55;546303;17958;4577
50635;Vidouville;79;1418700;23110;41;974802;38;443898;17958;4578
16334;Saint-Martial;99;1777915;75689;36;1279964;63;497951;17959;4579
59412;Montay;172;3088917;83168;74;2126258;98;962659;17959;4580
31070;Blajan;241;4328128;126787;111;3047474;130;1280654;17959;4581
46167;Lentillac-du-Causse;60;1077660;35196;24;713205;36;364455;17961;4582
14370;Le Molay-Littry;1766;31719528;949751;776;22442682;990;9276846;17961;4583
62644;Ouve-Wirquin;277;4975263;71292;131;3527268;146;1447995;17961;4584
11378;Serviès-en-Val;142;2550531;76233;55;1604128;87;946403;17961;4585
59424;Neuf-Mesnil;735;13201826;572687;324;9551141;411;3650685;17962;4586
16107;Coulgens;308;5532332;159034;142;3988275;166;1544057;17962;4587
62532;Lozinghem;611;10975027;221372;269;7488562;342;3486465;17962;4588
24131;Connezac;49;880178;17540;21;634557;28;245621;17963;4589
53223;Saint-Germain-de-Coulamer;200;3592603;78827;82;2375588;118;1217015;17963;4590
17068;Brie-sous-Mortagne;143;2568747;43134;60;1721820;83;846927;17963;4591
63290;Pulvérières;220;3952022;58775;107;2814284;113;1137738;17964;4592
33453;Saint-Michel-de-Lapujade;125;2245509;42407;56;1591884;69;653625;17964;4593
02425;Leuze;91;1634741;42860;40;1217456;51;417285;17964;4594
46260;Sainte-Colombe;106;1904215;75764;37;1278463;69;625752;17964;4595
82130;Montjoi;101;1814486;79463;41;1223850;60;590636;17965;4596
88468;Le Thillot;2159;38787186;1119365;895;25750535;1264;13036651;17965;4597
88013;Aroffe;47;844376;18152;20;575018;27;269358;17965;4598
17210;Lorignac;285;5120628;166014;104;3332877;181;1787751;17967;4599
26356;Truinas;75;1347583;40066;27;885322;48;462261;17968;4600
09084;Castex;57;1024242;79125;17;719568;40;304674;17969;4601
24272;Minzac;239;4294790;115053;102;3022356;137;1272434;17970;4602
47278;Saint-Sernin;221;3971344;145335;83;2713095;138;1258249;17970;4603
17084;Champagnolles;332;5966029;174806;137;4102758;195;1863271;17970;4604
50334;Montabot;144;2587714;48853;58;1745787;86;841927;17970;4605
95487;Persan;6090;109445299;2828916;2983;79922382;3107;29522917;17971;4606
03008;Arronnes;203;3648215;114037;96;2570709;107;1077506;17972;4607
24417;Saint-Germain-des-Prés;315;5661081;133548;140;3855418;175;1805663;17972;4608
50016;Appeville;120;2156637;67182;53;1534253;67;622384;17972;4609
01076;Chaley;98;1761395;50458;52;1291850;46;469545;17973;4610
56128;Melrand;957;17200663;440007;443;11797707;514;5402956;17974;4611
33362;Sablons;732;13156834;342238;338;9285311;394;3871523;17974;4612
80544;Mézerolles;108;1941410;31541;53;1385952;55;555458;17976;4613
64375;Méharin;124;2229031;22917;44;1417351;80;811680;17976;4614
83052;Esparron;189;3397482;59174;82;2265761;107;1131721;17976;4615
08025;Attigny;675;12134595;353972;272;8640067;403;3494528;17977;4616
61392;Saint-Germain-d'Aunay;76;1366303;32570;35;906170;41;460133;17978;4617
63192;La Tour-d'Auvergne;409;7352875;228787;178;5117801;231;2235074;17978;4618
43164;Roche-en-Régnier;292;5249703;155079;129;3561782;163;1687921;17978;4619
88283;Malaincourt;57;1024781;30810;26;754504;31;270277;17979;4620
52372;Outremécourt;67;1204603;28450;36;857065;31;347538;17979;4621
50326;Le Mesnil-Villeman;132;2373251;55176;58;1637619;74;735632;17979;4622
06101;Rigaud;112;2013719;56241;50;1408139;62;605580;17980;4623
36193;Sainte-Gemme;175;3146438;114684;73;2175813;102;970625;17980;4624
42187;Roanne;22546;405376976;16005890;10282;291952345;12264;113424631;17980;4625
49221;Mouliherne;490;8810467;187424;193;5688994;297;3121473;17981;4626
52079;Brousseval;397;7138300;175423;192;4935778;205;2202522;17981;4627
46282;Saint-Médard-Nicourby;48;863099;-3290;20;546956;28;316143;17981;4628
88475;Tollaincourt;70;1258690;39145;37;942127;33;316563;17981;4629
53213;Saint-Ellier-du-Maine;278;4998889;4850;119;3104120;159;1894769;17982;4630
03107;Ébreuil;816;14673025;558396;351;10904368;465;3768657;17982;4631
16413;Villiers-le-Roux;73;1312672;21182;25;810417;48;502255;17982;4632
19032;Brivezac;111;1996013;59879;42;1373073;69;622940;17982;4633
70420;Pont-sur-l'Ognon;30;539463;11948;14;395538;16;143925;17982;4634
11008;Alet-les-Bains;265;4765266;142398;121;3455645;144;1309621;17982;4635
17271;Paillé;193;3470636;110898;81;2290158;112;1180478;17983;4636
63187;Lapeyrouse;306;5502707;146975;141;3869489;165;1633218;17983;4637
19238;Saint-Rémy;131;2355779;61877;58;1612387;73;743392;17983;4638
58004;Alluy;242;4351993;109007;117;3050457;125;1301536;17983;4639
70153;Cintrey;71;1276848;37384;29;849749;42;427099;17984;4640
59137;Catillon-sur-Sambre;462;8308530;313338;176;5480265;286;2828265;17984;4641
82038;Caylus;870;15646151;554221;351;10620323;519;5025828;17984;4642
21379;Marcheseuil;97;1744466;35710;42;1168271;55;576195;17984;4643
26290;Saint-Agnan-en-Vercors;232;4172332;88961;93;2775425;139;1396907;17984;4644
19014;Auriac;128;2302004;78399;55;1598867;73;703137;17984;4645
44193;Saint-Vincent-des-Landes;829;14909085;280061;335;9975948;494;4933137;17984;4646
21335;Lacour-d'Arcenay;70;1258970;21352;33;943545;37;315425;17985;4647
16206;Mansle;1004;18057844;687146;420;12455224;584;5602620;17986;4648
65414;Ségalas;59;1061220;26836;27;739312;32;321908;17987;4649
57342;Ibigny;51;917342;16110;22;609360;29;307982;17987;4650
11172;Homps;357;6421525;214672;139;4455009;218;1966516;17987;4651
57524;Ommeray;61;1097277;16517;27;718653;34;378624;17988;4652
59481;Le Quesnoy;3002;54001615;2217914;1276;38981803;1726;15019812;17989;4653
64229;Gamarthe;51;917437;4133;18;556541;33;360896;17989;4654
65243;Lafitole;271;4875299;118361;119;3520279;152;1355020;17990;4655
64424;Ordiarp;272;4893381;121862;112;3174209;160;1719172;17990;4656
63283;Pontaumur;409;7358074;243214;164;5016105;245;2341969;17990;4657
08016;Aouste;106;1907018;36980;41;1150696;65;756322;17991;4658
79336;Vançais;153;2752595;83757;58;1805569;95;947026;17991;4659
26340;Séderon;159;2860655;135950;67;2051290;92;809365;17992;4660
61383;Saint-Didier-sous-Écouves;90;1619285;40718;42;1171982;48;447303;17992;4661
22290;Saint-Gelven;171;3076642;77104;73;2038236;98;1038406;17992;4662
81316;Vieux;116;2087082;46117;49;1458139;67;628943;17992;4663
11275;Payra-sur-l'Hers;113;2033177;70588;50;1449829;63;583348;17993;4664
64093;Barcus;345;6207515;141572;136;4000293;209;2207222;17993;4665
19281;Veix;41;737743;19066;17;499145;24;238598;17994;4666
80685;Roye;3602;64813851;2647343;1563;46749236;2039;18064615;17994;4667
2B169;Morosaglia;586;10545117;434968;234;7456848;352;3088269;17995;4668
21288;Frôlois;99;1781585;18750;45;1186977;54;594608;17996;4669
63389;Saint-Quentin-sur-Sauxillanges;66;1187818;27570;32;909808;34;278010;17997;4670
79331;Tourtenay;83;1493775;52693;42;1112200;41;381575;17997;4671
53191;La Roë;132;2375657;23801;50;1426961;82;948696;17997;4672
04037;Le Caire;40;719899;24053;16;467739;24;252160;17997;4673
31562;Urau;87;1565808;34628;41;1054254;46;511554;17998;4674
79190;Neuvy-Bouin;259;4661454;34013;117;3150222;142;1511232;17998;4675
32296;Nogaro;1268;22821527;1007411;555;16381145;713;6440382;17998;4676
33114;Cavignac;993;17872281;669445;403;12267131;590;5605150;17998;4677
24033;Beaussac;108;1943860;81965;45;1418475;63;525385;17999;4678
43141;Montfaucon-en-Velay;739;13302015;275531;332;9167867;407;4134148;18000;4679
62765;Saint-Omer;8767;157814228;7855307;3527;117438191;5240;40376037;18001;4680
09342;Sainte-Suzanne;139;2502264;62246;68;1827456;71;674808;18002;4681
2B273;Scata;31;558072;28857;11;370190;20;187882;18002;4682
24329;Le Pizou;723;13016207;345599;323;8879020;400;4137187;18003;4683
86009;Archigny;648;11666470;323350;274;7913961;374;3752509;18004;4684
36008;Arpheuilles;142;2556543;67868;55;1643527;87;913016;18004;4685
52029;Autigny-le-Grand;98;1764591;40222;48;1307215;50;457376;18006;4686
23133;Montboucher;223;4015404;141409;95;2799299;128;1216105;18006;4687
32088;Castillon-Debats;198;3565390;146201;78;2488829;120;1076561;18007;4688
97125;Saint-François;8893;160157337;5793713;2804;108063000;6089;52094337;18009;4689
24434;Saint-Just;84;1512802;56579;28;909812;56;602990;18010;4690
64305;Lahontan;269;4844610;88956;122;3301634;147;1542976;18010;4691
88100;Chef-Haut;30;540298;15671;16;424283;14;116015;18010;4692
63189;Laqueuille;194;3494044;73438;98;2517654;96;976390;18011;4693
92036;Gennevilliers;24139;434765772;16822723;11238;316992697;12901;117773075;18011;4694
65086;Bernadets-Dessus;91;1639012;54850;49;1242187;42;396825;18011;4695
72278;Saint-Denis-d'Orques;471;8483269;188314;204;5715134;267;2768135;18011;4696
21660;Veilly;39;702446;22544;22;575289;17;127157;18011;4697
71521;Sigy-le-Châtel;54;972663;21574;26;671860;28;300803;18012;4698
17450;Torxé;149;2683874;76622;68;1875471;81;808403;18013;4699
47230;Saint-Aubin;205;3692647;72364;78;2307634;127;1385013;18013;4700
21441;Mont-Saint-Jean;154;2774011;119828;67;1949050;87;824961;18013;4701
24486;Saint-Pierre-de-Frugie;234;4215139;89588;100;2935321;134;1279818;18013;4702
70460;Saint-Bresson;258;4647499;132411;104;3126992;154;1520507;18014;4703
89004;Aisy-sur-Armançon;166;2990271;78030;77;2109915;89;880356;18014;4704
86005;Angliers;371;6683340;130519;179;4598357;192;2084983;18014;4705
84021;Brantes;48;864750;14832;22;588578;26;276172;18016;4706
09211;Montségur;79;1423235;57627;35;1075812;44;347423;18016;4707
61228;Livaie;106;1909747;31753;47;1344454;59;565293;18016;4708
02264;Dizy-le-Gros;420;7567000;241113;157;4787483;263;2779517;18017;4709
46305;Sérignac;169;3044830;80647;60;1929279;109;1115551;18017;4710
79092;Clavé;193;3477265;73933;78;2373520;115;1103745;18017;4711
57683;Uckange;3254;58628025;1499503;1238;35390940;2016;23237085;18017;4712
09048;Belloc;40;720689;36972;20;538165;20;182524;18017;4713
88479;Trémonzey;131;2360379;63171;58;1637445;73;722934;18018;4714
63281;Pionsat;635;11441609;444060;282;8182808;353;3258801;18018;4715
63374;Saint-Martin-des-Olmes;163;2937025;54673;85;2071180;78;865845;18019;4716
53258;La Selle-Craonnaise;479;8631559;110080;203;5942081;276;2689478;18020;4717
39508;Sellières;498;8974038;302638;232;6513580;266;2460458;18020;4718
39052;Bief-des-Maisons;41;738829;11231;16;506859;25;231970;18020;4719
52225;Goncourt;165;2973405;93476;68;2043305;97;930100;18021;4720
39500;Salins-les-Bains;1850;33338281;1300508;771;23094758;1079;10243523;18021;4721
48098;Molezon;59;1063240;35848;25;780288;34;282952;18021;4722
17372;Saint-Médard;47;847007;18908;25;624224;22;222783;18021;4723
35140;Lalleu;294;5298676;31003;141;3548409;153;1750267;18023;4724
02654;Romery;47;847101;21569;27;687635;20;159466;18023;4725
88082;Celles-sur-Plaine;475;8561153;232680;220;6010009;255;2551144;18023;4726
43043;Céaux-d'Allègre;279;5028649;100101;116;3309838;163;1718811;18024;4727
24460;Saint-Méard-de-Drône;279;5028756;97963;129;3624625;150;1404131;18024;4728
08281;Matton-et-Clémency;247;4451984;93557;102;2985755;145;1466229;18024;4729
49024;Beausse;206;3713253;17724;95;2515695;111;1197558;18026;4730
11228;Mazerolles-du-Razès;101;1820613;43275;35;1208452;66;612161;18026;4731
11427;Villelongue-d'Aude;173;3118707;68701;71;2108648;102;1010059;18027;4732
81193;Nages;210;3785880;88833;96;2606487;114;1179393;18028;4733
57496;Nébing;198;3569552;66424;96;2486622;102;1082930;18028;4734
29267;Saint-Thois;393;7085265;109230;179;4889234;214;2196031;18029;4735
41060;Cormenon;439;7914636;200697;198;5348295;241;2566341;18029;4736
15192;Saint-Jacques-des-Blats;197;3551783;104111;95;2521588;102;1030195;18029;4737
50245;Heussé;111;2001264;5262;43;1248909;68;752355;18029;4738
62304;Erny-Saint-Julien;161;2902746;35873;70;1817905;91;1084841;18029;4739
59452;Ostricourt;2810;50663225;1325081;1133;34223263;1677;16439962;18030;4740
05032;Champoléon;89;1604747;55806;41;1071135;48;533612;18031;4741
23219;Saint-Maurice-la-Souterraine;681;12279107;260941;319;8631636;362;3647471;18031;4742
21422;Molphey;85;1532660;34885;39;1149339;46;383321;18031;4743
07244;Saint-Jean-Chambre;139;2506417;103147;52;1720824;87;785593;18032;4744
18058;Châteauneuf-sur-Cher;958;17274617;512827;452;12341668;506;4932949;18032;4745
88456;Serocourt;60;1081953;12010;22;653457;38;428496;18033;4746
09253;Sabarat;197;3552454;124224;90;2608978;107;943476;18033;4747
65091;Bettes;36;649192;13973;17;486891;19;162301;18033;4748
48153;Saint-Gal;43;775437;3612;17;469732;26;305705;18033;4749
08502;Yoncq;55;991849;9634;24;624213;31;367636;18034;4750
02416;Lemé;256;4616644;96348;111;3139032;145;1477612;18034;4751
17137;La Croix-Comtesse;125;2254282;57190;47;1485474;78;768808;18034;4752
55502;Stenay;1609;29017342;1252876;655;20698706;954;8318636;18034;4753
58297;Trois-Vèvres;134;2416624;70784;73;1825125;61;591499;18035;4754
24403;Saint-Félix-de-Bourdeilles;36;649250;12578;17;424074;19;225176;18035;4755
55533;Vaucouleurs;1202;21678244;660951;521;15038650;681;6639594;18035;4756
30017;Arrigas;118;2128162;71289;52;1524873;66;603289;18035;4757
24303;Nanteuil-Auriac-de-Bourzac;136;2452846;68494;52;1529872;84;922974;18036;4758
71155;Cronat;314;5663494;186128;133;3774488;181;1889006;18037;4759
87086;Linards;637;11489368;299289;276;8283540;361;3205828;18037;4760
24090;Celles;317;5717674;139211;146;4114849;171;1602825;18037;4761
18031;Blet;356;6421334;221535;152;4420629;204;2000705;18037;4762
24278;Monmadalès;44;793675;16890;20;505435;24;288240;18038;4763
12030;Bouillac;250;4509551;112272;112;3043879;138;1465672;18038;4764
16094;Chenommet;92;1659582;53145;37;1007192;55;652390;18039;4765
28149;La Ferté-Vidame;430;7756764;253533;190;5380825;240;2375939;18039;4766
80318;Flixecourt;1744;31460695;781730;789;22062002;955;9398693;18039;4767
66134;Passa;365;6584445;183952;143;4211093;222;2373352;18040;4768
62624;Noyelles-Godault;2822;50909609;1648828;1233;35049942;1589;15859667;18040;4769
80269;Épaumesnil;66;1190734;43839;27;825911;39;364823;18041;4770
78621;Trappes;15560;280729332;8623932;7420;201128345;8140;79600987;18042;4771
18099;Garigny;144;2598124;110274;59;1799100;85;799024;18043;4772
36107;Lye;498;8985439;291183;223;6376828;275;2608611;18043;4773
29007;Berrien;562;10140535;313387;257;7221563;305;2918972;18044;4774
51358;Maurupt-le-Montois;309;5575490;130884;154;3923428;155;1652062;18044;4775
87095;Meuzac;474;8552704;249423;208;5980581;266;2572123;18044;4776
43056;Chanteuges;254;4583119;97484;107;3097962;147;1485157;18044;4777
62243;Coullemont;55;992423;7476;24;680536;31;311887;18044;4778
66126;Oms;176;3175781;130977;73;2277990;103;897791;18044;4779
26112;Curnier;121;2183564;66183;60;1635528;61;548036;18046;4780
56016;Bieuzy;463;8355502;210145;215;5852603;248;2502899;18046;4781
30203;Portes;209;3771719;140285;82;2614119;127;1157600;18047;4782
32437;Sorbets;116;2093467;64305;57;1492082;59;601385;18047;4783
09026;Audressein;83;1497938;36648;35;1050051;48;447887;18047;4784
40009;Arjuzanx;119;2147702;62552;64;1649211;55;498491;18048;4785
40073;Castelner;67;1209291;22195;33;896435;34;312856;18049;4786
57491;Moyeuvre-Grande;4348;78480329;1873475;1765;49594986;2583;28885343;18050;4787
29102;Landeleau;574;10360599;280686;258;7223193;316;3137406;18050;4788
81161;Massals;56;1010860;11540;20;603351;36;407509;18051;4789
31039;Bachas;36;649839;15016;16;446349;20;203490;18051;4790
03297;Vallon-en-Sully;1026;18523128;576747;442;12848570;584;5674558;18054;4791
26122;Espenel;86;1552623;35358;40;1043169;46;509454;18054;4792
50134;Chevry;45;812424;-4047;22;591872;23;220552;18054;4793
82147;Puylagarde;200;3610826;95472;81;2538062;119;1072764;18054;4794
46020;Beauregard;151;2726180;79307;68;1977954;83;748226;18054;4795
50582;Sourdeval;1637;29554839;765120;685;19544607;952;10010232;18054;4796
19128;Margerides;184;3322049;102356;86;2341336;98;980713;18055;4797
24414;Saint-Georges-de-Montclard;160;2888825;101497;69;2000004;91;888821;18055;4798
03088;Courçais;191;3448648;78048;87;2332854;104;1115794;18056;4799
14704;Le Tourneur;315;5687663;85633;132;3634196;183;2053467;18056;4800
87044;Chéronnac;186;3358447;107506;69;2341038;117;1017409;18056;4801
79174;Melle;2227;40213095;1404192;918;28334355;1309;11878740;18057;4802
35348;Vendel;213;3846228;47606;107;2702109;106;1144119;18057;4803
48029;Le Born;92;1661359;48069;42;1156301;50;505058;18058;4804
40325;Vielle-Tursan;160;2889372;61956;77;2129477;83;759895;18059;4805
54494;Saulxerotte;52;939059;8358;22;611884;30;327175;18059;4806
88446;Saulxures-lès-Bulgnéville;145;2618677;62171;66;1861833;79;756844;18060;4807
17111;Clion;491;8867474;244990;219;6275205;272;2592269;18060;4808
63184;Lachaux;173;3124483;82590;71;2065754;102;1058729;18061;4809
69243;Tarare;6228;112481795;3515486;2785;77250766;3443;35231029;18061;4810
80406;Hallencourt;783;14142156;396720;349;9900566;434;4241590;18062;4811
21583;Santosse;30;541865;9513;16;393474;14;148391;18062;4812
61062;Brieux;53;957309;26434;26;684433;27;272876;18062;4813
48133;Saint-Amans;93;1679811;32392;43;1182230;50;497581;18062;4814
78440;Les Mureaux;17743;320484104;10933973;7914;227811127;9829;92672977;18063;4815
38316;Pont-de-Chéruy;2957;53411093;1444356;1459;38046457;1498;15364636;18063;4816
33264;Maransin;568;10259675;364968;240;7056808;328;3202867;18063;4817
22058;La Ferrière;259;4678307;80004;121;3165988;138;1512319;18063;4818
36056;Cluis;630;11379848;381217;264;7841576;366;3538272;18063;4819
70022;Angirey;76;1372918;26979;31;892982;45;479936;18065;4820
21646;Trouhaut;76;1372950;34446;38;1031151;38;341799;18065;4821
32154;Homps;57;1029717;26452;25;697558;32;332159;18065;4822
36054;Cléré-du-Bois;147;2655627;34658;70;1915922;77;739705;18065;4823
2A196;Orto;35;632328;28281;21;524413;14;107915;18067;4824
58007;Annay;198;3577195;94861;104;2629371;94;947824;18067;4825
50327;La Meurdraquière;92;1662133;30676;40;1082337;52;579796;18067;4826
14613;Saint-Marcouf;52;939473;1945;17;535396;35;404077;18067;4827
50043;Bellefontaine;87;1571845;14382;34;1056427;53;515418;18067;4828
16281;La Rochefoucauld;1981;35791722;1364821;832;25159966;1149;10631756;18068;4829
62101;Beauvois;69;1246675;22190;29;843374;40;403301;18068;4830
24579;Vieux-Mareuil;206;3722059;109400;95;2757724;111;964335;18068;4831
36224;Tournon-Saint-Martin;727;13135798;342623;296;8499618;431;4636180;18068;4832
16132;Étagnac;593;10714760;366704;272;7462043;321;3252717;18069;4833
02408;Laon;14891;269065422;12925254;6601;203262817;8290;65802605;18069;4834
43217;Saint-Pierre-du-Champ;291;5258103;112306;127;3487450;164;1770653;18069;4835
40087;Créon-d'Armagnac;198;3577718;86572;91;2544162;107;1033556;18069;4836
54413;Ozerailles;84;1517849;6844;32;948671;52;569178;18070;4837
60248;Fouilloy;109;1969603;55611;45;1288731;64;680872;18070;4838
19028;Bort-les-Orgues;1939;35038001;1430083;841;25871301;1098;9166700;18070;4839
62026;Ambricourt;65;1174588;16902;30;868697;35;305891;18071;4840
02707;Septvaux;101;1825180;52332;47;1350302;54;474878;18071;4841
80104;Biencourt;77;1391485;33939;36;979774;41;411711;18071;4842
62550;Marconnelle;669;12089894;477663;290;8162687;379;3927207;18072;4843
61237;Lougé-sur-Maire;194;3505982;78855;85;2343640;109;1162342;18072;4844
36192;Saint-Gaultier;1106;19988835;696584;440;13270924;666;6717911;18073;4845
61205;Heugon;127;2295301;34757;61;1587427;66;707874;18073;4846
62643;Outreau;7778;140573980;3377436;3487;97644779;4291;42929201;18073;4847
40106;Garrey;109;1970087;34483;51;1396171;58;573916;18074;4848
79032;Béceleuf;419;7573108;210348;169;5069620;250;2503488;18074;4849
30167;Meyrannes;554;10013642;426877;231;7222532;323;2791110;18075;4850
26297;Saint-Bonnet-de-Valclérieux;121;2187121;31140;51;1420769;70;766352;18075;4851
65183;Galan;446;8061878;280052;186;5657316;260;2404562;18076;4852
08240;Justine-Herbigny;101;1825713;20590;48;1156723;53;668990;18076;4853
62666;Pont-à-Vendin;1601;28941929;631012;722;19987573;879;8954356;18077;4854
07248;Saint-Jean-Roure;147;2657504;54918;64;1865598;83;791906;18078;4855
14258;Falaise;5011;90592208;3502047;2098;64547795;2913;26044413;18079;4856
21420;Molinot;108;1952514;51734;46;1302395;62;650119;18079;4857
29262;Saint-Sauveur;411;7430443;160876;199;5290382;212;2140061;18079;4858
73005;Aillon-le-Vieux;106;1916380;46834;49;1405331;57;511049;18079;4859
46316;Thédirac;171;3091525;75850;80;2106229;91;985296;18079;4860
65085;Bernadets-Debat;55;994417;15935;23;657872;32;336545;18080;4861
64522;Sévignacq-Meyracq;312;5641107;143761;134;4058669;178;1582438;18080;4862
49302;Saint-Macaire-du-Bois;235;4248976;58929;89;2693163;146;1555813;18081;4863
24029;Beaupouyet;267;4828247;130914;109;3307564;158;1520683;18083;4864
43079;Couteuges;142;2567947;23519;67;1722636;75;845311;18084;4865
09110;Encourtiech;64;1157389;36922;37;889695;27;267694;18084;4866
18130;Loye-sur-Arnon;173;3128663;75645;73;2145732;100;982931;18085;4867
61186;Geneslay;174;3146789;54227;106;2390296;68;756493;18085;4868
26373;Vesc;163;2947883;94007;68;2114140;95;833743;18085;4869
32319;Plaisance;968;17507411;637393;427;12546923;541;4960488;18086;4870
48166;Saint-Laurent-de-Trèves;84;1519309;28502;35;1010161;49;509148;18087;4871
59218;Étroeungt;752;13603286;389404;325;9318949;427;4284337;18089;4872
18261;Thaumiers;242;4377697;114886;120;3266937;122;1110760;18090;4873
35205;Noyal-sous-Bazouges;216;3907416;87107;100;2752043;116;1155373;18090;4874
61153;Écouché;830;15014758;519925;386;10707500;444;4307258;18090;4875
22337;Sévignac;618;11179691;189467;268;7674887;350;3504804;18090;4876
25513;Sainte-Anne;24;434177;15052;12;344911;12;89266;18091;4877
60545;Romescamps;286;5173953;121785;144;3754828;142;1419125;18091;4878
21095;Bousselange;33;596996;14667;15;413272;18;183724;18091;4879
76028;Aubéguimont;101;1827248;42707;48;1284123;53;543125;18092;4880
23004;Anzême;343;6205556;187232;158;4364922;185;1840634;18092;4881
52420;Reynel;77;1393086;58331;37;1003586;40;389500;18092;4882
22362;Tréguier;1608;29092040;1190803;604;19928694;1004;9163346;18092;4883
33551;Villeneuve;216;3907904;103271;86;2624633;130;1283271;18092;4884
24310;Nojals-et-Clotte;112;2026425;50432;48;1350647;64;675778;18093;4885
25261;Froidevaux;42;759931;19721;20;554751;22;205180;18094;4886
89158;Étais-la-Sauvin;428;7744077;337998;176;5400593;252;2343484;18094;4887
05121;Rochebrune;96;1737015;39381;46;1241307;50;495708;18094;4888
2A129;Grossa;29;524739;21364;12;357692;17;167047;18094;4889
63046;Boudes;168;3039978;87614;68;1997565;100;1042413;18095;4890
17263;Nieul-le-Virouil;331;5989520;111346;138;3987477;193;2002043;18095;4891
50221;Grimesnil;31;560963;14089;12;314092;19;246871;18096;4892
24551;Thiviers;1851;33495125;1126207;780;23045393;1071;10449732;18096;4893
62347;Fosseux;80;1447698;15205;33;909589;47;538109;18096;4894
52047;Beurville;64;1158159;23973;24;761873;40;396286;18096;4895
36087;Ingrandes;195;3528868;107772;95;2575641;100;953227;18097;4896
38207;Lavaldens;99;1791598;54888;48;1306767;51;484831;18097;4897
62800;Souastre;203;3673692;53075;81;2375766;122;1297926;18097;4898
53132;Levaré;176;3185094;58324;76;2221936;100;963158;18097;4899
2B296;Sant'Antonino;62;1122022;47838;26;836918;36;285104;18097;4900
12152;Montfranc;74;1339202;33046;29;884780;45;454422;18097;4901
28115;Courtalain;344;6225591;209920;144;4124915;200;2100676;18098;4902
63412;Sauvessanges;285;5157882;71887;120;3276743;165;1881139;18098;4903
72029;Beaumont-sur-Sarthe;1203;21772920;771938;507;14904868;696;6868052;18099;4904
59344;Leval;1290;23347814;646496;592;16256459;698;7091355;18099;4905
50007;Ancteville;141;2551988;40852;59;1613112;82;938876;18099;4906
19115;Ligneyrac;190;3438862;126727;90;2760631;100;678231;18099;4907
53095;Épineux-le-Seguin;130;2352940;30040;61;1620714;69;732226;18100;4908
50500;Saint-Laurent-de-Terregatte;331;5991096;90379;154;4130458;177;1860638;18100;4909
02313;Flavigny-le-Grand-et-Beaurain;257;4651834;126633;120;3314294;137;1337540;18101;4910
32151;Goux;41;742125;31014;14;518648;27;223477;18101;4911
47196;Nicole;139;2515990;59731;57;1618355;82;897635;18101;4912
64454;Pontiacq-Viellepinte;91;1647261;30320;39;1093787;52;553474;18102;4913
17089;La Chapelle-des-Pots;567;10263862;447358;256;8479890;311;1783972;18102;4914
52398;Poissons;405;7331362;166857;175;4897818;230;2433544;18102;4915
85077;Curzon;253;4579945;144255;98;2985053;155;1594892;18103;4916
80001;Abbeville;14474;262024086;12842053;6046;192135126;8428;69888960;18103;4917
08364;Rilly-sur-Aisne;67;1212928;20850;24;695187;43;517741;18103;4918
79188;Moutiers-sous-Chantemerle;332;6010332;77806;151;4005178;181;2005154;18103;4919
52149;Courcelles-sur-Blaise;61;1104318;10495;22;629355;39;474963;18104;4920
11297;Pradelles-Cabardès;85;1538968;45721;40;1100916;45;438052;18106;4921
53188;Renazé;1513;27394159;684216;635;18186703;878;9207456;18106;4922
11097;Conilhac-de-la-Montagne;37;669923;16130;17;476427;20;193496;18106;4923
02830;Wassigny;541;9795652;391971;230;7064439;311;2731213;18107;4924
33403;Sainte-Foy-la-Longue;65;1176939;26144;32;913072;33;263867;18107;4925
55325;Maucourt-sur-Orne;29;525115;-1298;12;267854;17;257261;18107;4926
82096;La Ville-Dieu-du-Temple;1628;29479480;607991;714;20516293;914;8963187;18108;4927
48135;Saint-André-Capcèze;87;1575399;32466;39;1063957;48;511442;18108;4928
33159;Étauliers;903;16352959;628943;393;11866477;510;4486482;18110;4929
37259;Tournon-Saint-Pierre;293;5306130;192902;136;3728604;157;1577526;18110;4930
59603;Trith-Saint-Léger;3541;64127355;2049012;1632;45902726;1909;18224629;18110;4931
31359;Montastruc-Savès;39;706323;15719;15;459713;24;246610;18111;4932
02363;Guny;252;4563950;157045;107;3067873;145;1496077;18111;4933
19169;Puy-d'Arnac;161;2915861;102641;66;1970876;95;944985;18111;4934
32242;Masseube;854;15466963;517513;371;10892277;483;4574686;18111;4935
64083;Autevielle-Saint-Martin-Bideren;107;1937966;36017;44;1287101;63;650865;18112;4936
35242;Rimou;196;3549998;78369;82;2332504;114;1217494;18112;4937
63139;Dore-l'Église;381;6900823;206341;163;4746349;218;2154474;18112;4938
88508;Ville-sur-Illon;329;5959094;123958;135;3996515;194;1962579;18113;4939
19079;Eyburie;286;5180303;108259;131;3598082;155;1582221;18113;4940
47109;Gavaudun;148;2681355;100846;66;1843325;82;838030;18117;4941
64327;Lecumberry;87;1576216;39495;34;947898;53;628318;18117;4942
15166;Roumégoux;152;2753922;47201;65;1832333;87;921589;18118;4943
63298;La Renaudie;82;1485705;27922;29;983256;53;502449;18118;4944
26137;Francillon-sur-Roubion;89;1612547;50268;39;1172019;50;440528;18119;4945
80410;Ham;2893;52417832;1861089;1154;37506258;1739;14911574;18119;4946
36216;Selles-sur-Nahon;42;761030;19311;16;503782;26;257248;18120;4947
48008;Arzenc-de-Randon;113;2047607;51435;48;1380232;65;667375;18120;4948
15159;Raulhac;203;3678542;214899;76;2569370;127;1109172;18121;4949
14279;Fontenermont;79;1431559;24182;34;1017903;45;413656;18121;4950
62303;Érin;101;1830297;33885;36;1159742;65;670555;18122;4951
18199;Saint-Baudel;182;3298177;88560;86;2289026;96;1009151;18122;4952
48127;Rieutort-de-Randon;398;7212772;169573;178;4969554;220;2243218;18123;4953
58187;Myennes;348;6306731;165617;174;4634876;174;1671855;18123;4954
79184;La Mothe-Saint-Héray;1030;18667053;527683;439;12842247;591;5824806;18123;4955
05086;Montjay;59;1069290;41208;27;710287;32;359003;18124;4956
14225;Dives-sur-Mer;3481;63088176;2256421;1605;44992096;1876;18096080;18124;4957
64515;Sedze-Maubecq;119;2156749;20903;45;1299013;74;857736;18124;4958
80109;Le Boisle;234;4241086;139045;93;2942737;141;1298349;18124;4959
2B217;Piazzole;26;471286;24015;11;342854;15;128432;18126;4960
48198;Villefort;350;6344511;260215;154;4581963;196;1762548;18127;4961
46023;Belfort-du-Quercy;301;5456390;178425;114;3636611;187;1819779;18128;4962
71537;Thil-sur-Arroux;74;1341465;8056;28;727242;46;614223;18128;4963
79121;Fomperron;217;3934130;69296;99;2683646;118;1250484;18130;4964
09180;Manses;74;1341616;47152;26;869975;48;471641;18130;4965
63334;Saint-Dier-d'Auvergne;335;6073634;163730;152;4341102;183;1732532;18130;4966
36043;Chassignolles;354;6418234;158279;181;4779469;173;1638765;18131;4967
16081;La Chapelle;126;2284580;69074;46;1486910;80;797670;18132;4968
32235;Margouët-Meymes;104;1885852;39728;42;1246233;62;639619;18133;4969
70202;Demangevelle;204;3699205;190608;88;2551791;116;1147414;18133;4970
63039;Beurières;193;3499841;65618;92;2510568;101;989273;18134;4971
79332;Trayes;66;1196852;8482;28;736290;38;460562;18134;4972
44206;Touvois;950;17228260;230198;409;11382130;541;5846130;18135;4973
54393;Moyen;291;5277292;138491;124;3566499;167;1710793;18135;4974
50266;Lengronne;245;4443278;103347;107;2888754;138;1554524;18136;4975
14439;Monfréville;60;1088153;22117;26;768386;34;319767;18136;4976
66149;Prades;3845;69733451;2998262;1552;49455812;2293;20277639;18136;4977
47202;Paulhiac;162;2938107;45340;65;2022301;97;915806;18136;4978
12167;Najac;444;8052628;281718;175;5543618;269;2509010;18137;4979
76527;Richemont;267;4842500;114909;128;3347027;139;1495473;18137;4980
12168;Nant;581;10537863;320579;231;7011341;350;3526522;18137;4981
46259;Saint-Clair;93;1686795;79138;42;1206393;51;480402;18138;4982
56051;Cruguel;330;5985516;78617;159;4179213;171;1806303;18138;4983
58110;Epiry;122;2212881;76452;56;1548753;66;664128;18138;4984
24317;Paulin;157;2847743;74624;67;2010032;90;837711;18138;4985
31201;Frontignan-Savès;31;562297;17356;13;376489;18;185808;18139;4986
37191;Razines;126;2285596;50829;55;1492858;71;792738;18140;4987
82182;Touffailles;164;2974937;82455;56;1901220;108;1073717;18140;4988
46072;Concorès;202;3664600;106941;88;2573306;114;1091294;18142;4989
86104;Genouillé;292;5297372;161745;121;3770512;171;1526860;18142;4990
66222;Vernet-les-Bains;1030;18686504;657906;441;13153948;589;5532556;18142;4991
18002;Ainay-le-Vieil;125;2267798;72213;59;1615315;66;652483;18142;4992
39485;Saint-Julien;283;5134320;140246;120;3562540;163;1571780;18142;4993
49369;Vernoil-le-Fourrier;698;12663856;175257;283;8383959;415;4279897;18143;4994
85177;Le Poiré-sur-Velluire;354;6423288;89805;167;4333254;187;2090034;18145;4995
11222;Mas-Cabardès;105;1905286;62650;46;1337729;59;567557;18146;4996
2B319;Talasani;408;7403729;285343;185;5527502;223;1876227;18146;4997
93030;Dugny;5153;93508556;3104946;2504;68764842;2649;24743714;18146;4998
58087;Cossaye;451;8184049;298234;205;5752438;246;2431611;18146;4999
2B170;Morsiglia;78;1415501;54242;31;989894;47;425607;18147;5000
66032;Calmeilles;29;526296;11349;12;345516;17;180780;18148;5001
50518;Saint-Martin-le-Bouillant;161;2921904;45503;72;2098699;89;823205;18148;5002
49044;Breil;160;2903766;84564;70;2042748;90;861018;18149;5003
48138;Saint-Bonnet-de-Chirac;41;744102;16421;24;552101;17;192001;18149;5004
08067;Blagny;658;11942719;313095;274;7787596;384;4155123;18150;5005
13014;Berre-l'Étang;8103;147070491;5320685;3704;106188366;4399;40882125;18150;5006
11207;Loupia;144;2613647;72179;69;1871396;75;742251;18150;5007
16401;Vervant;83;1506495;48520;36;1091385;47;415110;18151;5008
31513;Saint-Plancard;236;4283666;138198;99;2960031;137;1323635;18151;5009
69209;Saint-Igny-de-Vers;361;6552600;211071;159;4728481;202;1824119;18151;5010
53118;Le Housseau-Brétignolles;121;2196311;21997;55;1475343;66;720968;18151;5011
35316;Saint-Sulpice-des-Landes;420;7624056;178586;187;5251490;233;2372566;18153;5012
02634;Raillimont;46;835026;23742;21;666713;25;168313;18153;5013
72138;Fresnay-sur-Sarthe;1346;24433597;1015530;566;16505842;780;7927755;18153;5014
58173;Montaron;111;2015079;61294;50;1381610;61;633469;18154;5015
02806;Villeneuve-sur-Fère;155;2813904;80844;72;1933115;83;880789;18154;5016
80265;Embreville;316;5736854;130902;149;4038874;167;1697980;18155;5017
89084;Charentenay;180;3267863;89512;96;2422504;84;845359;18155;5018
07214;Saint-Apollinaire-de-Rias;111;2015237;48855;52;1449288;59;565949;18155;5019
02625;Proix;79;1434279;34183;34;971964;45;462315;18155;5020
82069;Ginals;117;2124207;56637;44;1410842;73;713365;18156;5021
32412;Saramon;484;8787440;285528;231;6348901;253;2438539;18156;5022
50607;La Trinité;190;3449771;21003;89;2307674;101;1142097;18157;5023
70009;Aisey-et-Richecourt;64;1162042;42710;25;768290;39;393752;18157;5024
31414;Peyrissas;58;1053103;40187;27;788056;31;265047;18157;5025
05171;Théus;123;2233319;81725;60;1721606;63;511713;18157;5026
66206;Le Tech;42;762612;49928;17;602561;25;160051;18157;5027
17401;Saint-Séverin-sur-Boutonne;62;1125783;19989;23;641450;39;484333;18158;5028
79102;Coulonges-Thouarsais;243;4412562;61862;95;2876438;148;1536124;18159;5029
70053;Les Bâties;42;762704;7915;17;455822;25;306882;18160;5030
11032;Bellegarde-du-Razès;121;2197524;61960;51;1638313;70;559211;18161;5031
65435;Soulom;167;3032985;86666;91;2160036;76;872949;18162;5032
24533;Servanches;56;1017060;26852;23;667122;33;349938;18162;5033
85260;Saint-Paul-Mont-Penit;402;7301206;80328;202;5204883;200;2096323;18162;5034
35354;Vieux-Viel;169;3069476;79120;80;2128861;89;940615;18163;5035
21334;Lacanche;332;6030036;134737;141;3909615;191;2120421;18163;5036
86136;Lizant;247;4486265;122001;105;3112216;142;1374049;18163;5037
60360;Liancourt;3833;69619185;2315067;1979;53397240;1854;16221945;18163;5038
38145;Dionay;73;1325933;37309;31;962311;42;363622;18163;5039
40007;Argelos;102;1852674;36525;35;1147637;67;705037;18163;5040
19051;Chaumeil;108;1961766;71816;53;1452042;55;509724;18165;5041
26210;Montrigaud;266;4831901;117215;116;3251943;150;1579958;18165;5042
37084;Couesmes;323;5867318;102586;149;4095673;174;1771645;18165;5043
23244;Saint-Sulpice-le-Dunois;363;6594045;203423;166;4717198;197;1876847;18165;5044
16162;Gurat;110;1998211;62526;51;1381378;59;616833;18166;5045
59414;Montigny-en-Ostrevent;2620;47594651;1456764;1125;33307469;1495;14287182;18166;5046
30269;Saint-Jean-du-Gard;1622;29465755;977806;623;19885408;999;9580347;18166;5047
82084;Lacour;94;1707688;58058;34;1039989;60;667699;18167;5048
87040;Châteauneuf-la-Forêt;1002;18203622;611068;439;12641735;563;5561887;18167;5049
14139;Carville;195;3542781;82133;90;2594341;105;948440;18168;5050
32238;Marseillan;55;999269;4182;18;602737;37;396532;18169;5051
23076;Évaux-les-Bains;918;16678719;604512;392;11647860;526;5030859;18169;5052
09003;L'Aiguillon;258;4687690;141231;107;2959187;151;1728503;18169;5053
58166;Mhère;164;2979875;110999;81;2168509;83;811366;18170;5054
22217;Plougras;250;4542505;125294;105;3089963;145;1452542;18170;5055
72209;Montreuil-le-Chétif;172;3125363;98061;77;2163631;95;961732;18171;5056
08405;Sauville;139;2525745;33901;55;1505157;84;1020588;18171;5057
24529;Segonzac;122;2216854;55731;62;1654189;60;562665;18171;5058
50399;Le Petit-Celland;114;2071571;79792;45;1335690;69;735881;18172;5059
25178;Crosey-le-Petit;61;1108481;14885;29;790311;32;318170;18172;5060
21140;Champignolles;43;781398;20633;19;571511;24;209887;18172;5061
47264;Saint-Pardoux-Isaac;736;13374727;353201;332;9145028;404;4229699;18172;5062
88317;Moussey;393;7141785;222964;175;4850331;218;2291454;18172;5063
29218;Pont-Croix;1024;18609184;560917;435;12721931;589;5887253;18173;5064
46206;Montlauzun;68;1235818;40168;26;831346;42;404472;18174;5065
54064;Bertrambois;192;3489407;127163;84;2472470;108;1016937;18174;5066
09092;Cazenave-Serres-et-Allens;39;708802;22903;18;525047;21;183755;18174;5067
66199;Taillet;60;1090516;22404;28;819196;32;271320;18175;5068
22240;Plumaugat;624;11341802;203957;283;7678093;341;3663709;18176;5069
49083;Chaudron-en-Mauges;801;14559899;146631;362;9914276;439;4645623;18177;5070
47033;Boudy-de-Beauregard;204;3708301;63169;91;2429976;113;1278325;18178;5071
24582;Villars;313;5689734;161306;143;3995230;170;1694504;18178;5072
45208;Montargis;9629;175047250;9316003;4144;127415712;5485;47631538;18179;5073
08381;Saint-Germainmont;439;7980839;160569;173;5153028;266;2827811;18180;5074
66085;Fuilla;239;4345134;139478;112;3158150;127;1186984;18180;5075
57508;Nilvange;3006;54652187;1053060;1105;31573375;1901;23078812;18181;5076
60128;Canny-sur-Thérain;111;2018199;64876;47;1374876;64;643323;18182;5077
08184;Fromy;48;872759;20988;22;592612;26;280147;18182;5078
09299;Soueix-Rogalle;253;4600459;147070;122;3453789;131;1146670;18184;5079
02237;Crécy-sur-Serre;871;15837983;639024;375;11142146;496;4695837;18184;5080
80258;Driencourt;55;1000128;21813;27;689217;28;310911;18184;5081
23203;Saint-Julien-la-Genête;138;2509722;56539;61;1840529;77;669193;18186;5082
22313;Saint-Martin-des-Prés;181;3291743;45729;80;2167608;101;1124135;18186;5083
42295;Les Salles;280;5092211;193273;132;3768270;148;1323941;18186;5084
21098;Boux-sous-Salmaise;87;1582226;53759;36;1036680;51;545546;18187;5085
32036;Beaumarchés;344;6256187;141883;159;4568461;185;1687726;18187;5086
07280;Saint-Paul-le-Jeune;584;10620998;318789;245;7170585;339;3450413;18187;5087
76749;Wanchy-Capval;192;3491844;76573;81;2215586;111;1276258;18187;5088
47260;Saint-Maurin;259;4710704;155479;98;3073005;161;1637699;18188;5089
21274;Foissy;103;1873374;66319;44;1432872;59;440502;18188;5090
34079;Clermont-l'Hérault;5045;91759994;3999374;2073;66240576;2972;25519418;18188;5091
79226;Le Retail;158;2873777;60820;70;1964280;88;909497;18188;5092
59241;Floyon;281;5111065;100584;119;3549636;162;1561429;18189;5093
70555;La Villedieu-en-Fontenette;96;1746193;33346;46;1290682;50;455511;18190;5094
47052;Casteljaloux;2969;54006960;1836494;1278;37243792;1691;16763168;18190;5095
32364;Saint-Avit-Frandat;60;1091424;32945;19;683778;41;407646;18190;5096
19287;Vitrac-sur-Montane;144;2619468;65721;61;1774210;83;845258;18191;5097
58226;Saint-Agnan;100;1819077;56734;44;1307147;56;511930;18191;5098
70451;Ronchamp;1631;29669441;768993;746;20360308;885;9309133;18191;5099
02318;Folembray;829;15080352;366738;356;10378892;473;4701460;18191;5100
82089;Lamagistère;643;11696944;325012;303;8210289;340;3486655;18191;5101
47283;Saint-Vite;644;11715380;287256;257;7532555;387;4182825;18192;5102
57035;Assenoncourt;61;1109718;32738;33;860761;28;248957;18192;5103
62091;Beaudricourt;54;982395;13450;22;591066;32;391329;18193;5104
21321;Jailly-les-Moulins;55;1000591;29568;23;703485;32;297106;18193;5105
17477;Villiers-Couture;69;1255350;91852;27;895212;42;360138;18193;5106
24101;Champs-Romain;184;3347626;80773;86;2350975;98;996651;18194;5107
71186;Écuelles;124;2256035;50399;50;1429794;74;826241;18194;5108
16231;Montrollet;169;3074781;65350;84;2244947;85;829834;18194;5109
71415;Sainte-Foy;79;1437364;23010;34;954663;45;482701;18194;5110
04162;Revest-des-Brousses;137;2492687;73525;55;1692214;82;800473;18195;5111
89062;Carisey;239;4348643;130283;107;2989940;132;1358703;18195;5112
32055;Bivès;69;1255469;18955;27;917475;42;337994;18195;5113
48064;Fournels;236;4294127;161028;101;3071548;135;1222579;18195;5114
86040;La Bussière;208;3784658;104356;97;2708713;111;1075945;18195;5115
64136;Borce;66;1200928;39109;30;892377;36;308551;18196;5116
27413;Montfort-sur-Risle;480;8734280;321242;222;6394793;258;2339487;18196;5117
03079;Cindré;186;3384574;81724;82;2395574;104;989000;18197;5118
88471;Les Thons;77;1401159;35998;34;940718;43;460441;18197;5119
25009;Aïssey;97;1765118;24870;41;1162993;56;602125;18197;5120
12079;Coubisou;283;5150127;142304;117;3682509;166;1467618;18198;5121
57080;Bickenholtz;42;764348;6301;25;583926;17;180422;18199;5122
49087;Chavaignes;54;982766;17210;21;643622;33;339144;18199;5123
34104;Fos;50;909986;14217;14;599889;36;310097;18200;5124
34289;Saint-Thibéry;1374;25006736;735012;602;17236148;772;7770588;18200;5125
19039;Champagnac-la-Noaille;140;2548036;89546;64;1803138;76;744898;18200;5126
53245;Saint-Pierre-des-Landes;500;9100431;84095;221;5993897;279;3106534;18201;5127
16317;Saint-Fraigne;254;4623078;128172;124;3365470;130;1257608;18201;5128
54496;Saulxures-lès-Vannes;193;3512834;56111;95;2482984;98;1029850;18201;5129
06013;Belvédère;442;8045386;260982;202;5543294;240;2502092;18202;5130
55261;Juvigny-en-Perthois;85;1547212;54363;37;1101694;48;445518;18202;5131
16137;Feuillade;174;3167270;62062;75;2089513;99;1077757;18203;5132
58041;Brinon-sur-Beuvron;136;2475589;108323;68;1806444;68;669145;18203;5133
86093;Dercé;101;1838521;42476;42;1167877;59;670644;18203;5134
16350;Saint-Séverin;440;8009587;252450;185;5556460;255;2453127;18204;5135
76070;Bellencombre;375;6826477;168984;178;4934184;197;1892293;18204;5136
08369;La Romagne;79;1438121;82016;27;867569;52;570552;18204;5137
50054;Biéville;98;1784062;2197;50;1269136;48;514926;18205;5138
87059;Le Dorat;1097;19970914;949224;474;14891840;623;5079074;18205;5139
28016;Les Autels-Villevillon;91;1656695;40906;41;1195021;50;461674;18205;5140
84075;Méthamis;236;4296531;103588;91;2772338;145;1524193;18206;5141
19052;Chavanac;31;564394;12833;15;397008;16;167386;18206;5142
33512;Sigalens;201;3659467;109415;88;2649007;113;1010460;18206;5143
54278;Jevoncourt;50;910341;19109;24;641164;26;269177;18207;5144
65003;Adervielle-Pouchergues;63;1147047;28180;27;781834;36;365213;18207;5145
33233;Laruscade;1307;23798076;602019;569;16666370;738;7131706;18208;5146
24241;Limeyrat;254;4624921;114417;107;3135503;147;1489418;18208;5147
23065;Colondannes;165;3004382;81991;66;1950080;99;1054302;18208;5148
65116;Cadéac;150;2731285;61626;68;1905838;82;825447;18209;5149
12204;La Roque-Sainte-Marguerite;126;2294307;90628;45;1501234;81;793073;18209;5150
09111;Engomer;189;3441469;115020;83;2400552;106;1040917;18209;5151
81056;Campagnac;67;1220010;27529;24;756550;43;463460;18209;5152
32161;Izotges;54;983339;25115;23;721321;31;262018;18210;5153
02753;Tupigny;209;3805905;142656;75;2478230;134;1327675;18210;5154
35004;Antrain;794;14459136;431026;339;10015597;455;4443539;18210;5155
64031;Arancou;59;1074422;34106;26;693598;33;380824;18211;5156
36111;Malicornay;116;2112509;75323;54;1541896;62;570613;18211;5157
54470;Saint-Baussant;39;710255;19287;20;510174;19;200081;18212;5158
70067;Betoncourt-lès-Brotte;59;1074514;19167;31;785268;28;289246;18212;5159
15029;Cassaniouze;301;5482038;212162;116;3734402;185;1747636;18213;5160
68298;Sainte-Marie-aux-Mines;2943;53601444;1658283;1294;38447750;1649;15153694;18213;5161
64185;Cette-Eygun;55;1001807;54486;27;765171;28;236636;18215;5162
07211;Saint-André-de-Cruzières;272;4954570;171439;100;3339012;172;1615558;18215;5163
62397;Guînes;2902;52861003;1503758;1179;35987827;1723;16873176;18215;5164
21137;Champ-d'Oiseau;51;929039;25035;27;648137;24;280902;18216;5165
65304;Maubourguet;1492;27179911;1008204;631;18998459;861;8181452;18217;5166
24382;Saint-Capraise-de-Lalinde;319;5811371;133089;147;4037641;172;1773730;18217;5167
26262;Recoubeau-Jansac;161;2933023;121695;61;2108406;100;824617;18218;5168
16122;Ébréon;93;1694233;60476;37;1109344;56;584889;18218;5169
48003;Allenc;136;2477597;55946;59;1703853;77;773744;18218;5170
50638;Villechien;105;1912892;34105;45;1175947;60;736945;18218;5171
16155;Les Gours;73;1330001;57488;30;911419;43;418582;18219;5172
10192;Lentilles;58;1056854;8888;26;689578;32;367276;18222;5173
53235;Sainte-Marie-du-Bois;132;2405267;80133;65;1755942;67;649325;18222;5174
61216;La Lande-de-Goult;106;1931560;85077;39;1366532;67;565028;18222;5175
88145;Domfaing;125;2277967;31943;64;1597553;61;680414;18224;5176
52009;Andilly-en-Bassigny;67;1220998;27758;26;789074;41;431924;18224;5177
24243;Lisle;577;10515294;272446;260;7055917;317;3459377;18224;5178
17130;Coux;275;5011626;140667;119;3478031;156;1533595;18224;5179
07347;Vocance;351;6396853;194196;173;4669211;178;1727642;18225;5180
2B242;Poggio-Mezzana;375;6834289;273969;172;4959846;203;1874443;18225;5181
40102;Gabarret;798;14543396;577234;337;10247195;461;4296201;18225;5182
24398;Saint-Estèphe;361;6579268;184468;157;4534998;204;2044270;18225;5183
88270;Liffol-le-Grand;1363;24842098;604449;620;17138727;743;7703371;18226;5184
08214;Hargnies;261;4757025;137256;120;3361539;141;1395486;18226;5185
37248;Seuilly;209;3809283;94921;96;2673789;113;1135494;18226;5186
84033;Castellet;74;1348759;22844;30;764643;44;584116;18226;5187
36002;Aize;75;1366998;43188;36;970007;39;396991;18227;5188
55397;Pagny-la-Blanche-Côte;142;2588413;92731;61;1779486;81;808927;18228;5189
42246;Saint-Julien-Molin-Molette;716;13051441;330827;331;9293024;385;3758417;18228;5190
72334;Sillé-le-Guillaume;1398;25483652;958746;604;18170369;794;7313283;18229;5191
50127;Chef-du-Pont;423;7710751;178994;204;5598031;219;2112720;18229;5192
32096;Cazaubon;1042;18994610;699087;466;13741892;576;5252718;18229;5193
55158;Dommary-Baroncourt;405;7382833;96191;154;4103415;251;3279418;18229;5194
79077;La Chapelle-Thireuil;236;4302134;79479;96;2841014;140;1461120;18229;5195
23191;Saint-Éloi;124;2260586;59156;53;1532982;71;727604;18231;5196
56145;Néant-sur-Yvel;556;10136665;193370;259;7009113;297;3127552;18231;5197
42276;Saint-Priest-la-Prugne;284;5177794;181593;116;3501932;168;1675862;18232;5198
79230;Rom;497;9061361;285020;211;6374262;286;2687099;18232;5199
15122;Maurs;1316;23995208;858187;558;16791954;758;7203254;18233;5200
60111;Broyes;88;1604591;28906;40;1071001;48;533590;18234;5201
71450;Saint-Martin-de-Commune;66;1203456;17248;29;788475;37;414981;18234;5202
47144;Lavergne;334;6090255;109787;145;4129320;189;1960935;18234;5203
25613;Viéthorey;63;1148809;32131;22;680663;41;468146;18235;5204
31115;Castelgaillard;36;656467;19805;16;414166;20;242301;18235;5205
60286;Grandvilliers;1773;32331797;1507394;767;23716061;1006;8615736;18236;5206
23045;Chambon-sur-Voueize;562;10249117;439543;229;7227175;333;3021942;18237;5207
17206;Loiré-sur-Nie;168;3064005;74496;74;2140944;94;923061;18238;5208
17024;Aulnay;894;16305315;498498;369;11098267;525;5207048;18239;5209
59624;Villers-Outréaux;1174;21412303;669886;479;14486601;695;6925702;18239;5210
59504;Roeulx;1868;34070861;837858;816;23172373;1052;10898488;18239;5211
55024;Azannes-et-Soumazannes;100;1824000;63923;44;1330207;56;493793;18240;5212
24356;Rouffignac-Saint-Cernin-de-Reilhac;962;17548222;599077;413;12194320;549;5353902;18241;5213
32393;Saint-Maur;67;1222179;27638;27;850175;40;372004;18241;5214
76578;Sainte-Geneviève;144;2626779;41746;67;1807772;77;819007;18242;5215
61389;Sainte-Gauburge-Sainte-Colombe;664;12112440;340953;318;8544043;346;3568397;18242;5216
70114;Cendrecourt;138;2517361;52162;69;1804344;69;713017;18242;5217
81045;Les Cabannes;201;3666788;180187;79;2627571;122;1039217;18243;5218
03319;Voussac;269;4907474;149326;128;3556250;141;1351224;18243;5219
57045;Bacourt;68;1240602;20823;33;849281;35;391321;18244;5220
02276;Englancourt;70;1277124;32227;33;943030;37;334094;18245;5221
58249;Saint-Léger-de-Fougeret;134;2444787;114269;62;1873266;72;571521;18245;5222
85248;Saint-Martin-Lars-en-Sainte-Hermine;232;4232919;69919;107;2874227;125;1358692;18245;5223
30297;Saint-Sauveur-Camprieu;135;2463222;112353;60;1842668;75;620554;18246;5224
73201;Planay;274;4999517;148443;153;3775205;121;1224312;18246;5225
59555;Sars-Poteries;820;14962144;585549;333;10561657;487;4400487;18247;5226
24058;Bourg-du-Bost;134;2445080;98858;51;1586314;83;858766;18247;5227
33210;Juillac;145;2645877;104748;56;1801710;89;844167;18247;5228
46098;Fajoles;160;2919627;91251;62;1848781;98;1070846;18248;5229
57483;Morhange;1939;35384259;1461696;796;24278236;1143;11106023;18249;5230
25156;Clerval;555;10128106;248121;245;6533489;310;3594617;18249;5231
64365;Malaussanne;239;4361512;88154;92;2871815;147;1489697;18249;5232
24279;Monmarvès;33;602235;17295;17;464158;16;138077;18250;5233
62051;Auchy-les-Mines;2418;44128923;1041466;1101;31027123;1317;13101800;18250;5234
15053;Coltines;237;4325496;55761;110;3016037;127;1309459;18251;5235
82115;Monclar-de-Quercy;944;17229400;492820;415;12054530;529;5174870;18251;5236
51070;Boissy-le-Repos;129;2354451;74310;64;1769410;65;585041;18252;5237
57399;Lezey;60;1095104;31662;21;689738;39;405366;18252;5238
88510;Villotte;101;1843436;54343;42;1272993;59;570443;18252;5239
23200;Saint-Goussaud;118;2153737;81633;56;1627736;62;526001;18252;5240
80368;Friville-Escarbotin;2722;49682598;1527766;1281;35593212;1441;14089386;18252;5241
44116;Paimboeuf;1886;34424004;939305;923;24646608;963;9777396;18252;5242
14087;Bonnoeil;72;1314189;26112;36;976192;36;337997;18253;5243
33057;Blasimon;509;9290587;276532;220;6680314;289;2610273;18253;5244
02559;Nouvion-et-Catillon;294;5366342;134301;128;3622842;166;1743500;18253;5245
76217;Dieppe;19725;360041058;16891187;8696;265952894;11029;94088164;18253;5246
31523;Salies-du-Salat;1197;21849845;891681;522;15537636;675;6312209;18254;5247
58013;Arthel;48;876202;23384;21;557132;27;319070;18254;5248
57332;Hombourg-Haut;3886;70937263;2203254;1658;48187315;2228;22749948;18255;5249
02529;Mortiers;121;2208859;42772;53;1482315;68;726544;18255;5250
76709;Le Trait;3049;55661768;1664024;1485;40496717;1564;15165051;18256;5251
47130;Lagruère;201;3669491;122515;89;2561738;112;1107753;18256;5252
14053;Beaumais;106;1935263;49125;54;1383821;52;551442;18257;5253
78361;Mantes-la-Jolie;23931;436917876;20423616;10742;317635890;13189;119281986;18257;5254
32164;Juillac;70;1278030;36759;30;917999;40;360031;18258;5255
58006;Anlezy;160;2921257;139864;64;2002203;96;919054;18258;5256
21710;Vitteaux;662;12086902;597087;289;8732771;373;3354131;18258;5257
23231;Saint-Pierre-de-Fursac;461;8417228;222582;204;5808176;257;2609052;18259;5258
36161;Le Pont-Chrétien-Chabenet;565;10316329;308056;281;7547959;284;2768370;18259;5259
43077;Costaros;307;5605650;122580;145;4027823;162;1577827;18259;5260
36243;Villegouin;212;3871018;83557;102;2647541;110;1223477;18260;5261
72356;Thoiré-sur-Dinan;234;4272984;90397;107;2967032;127;1305952;18261;5262
55306;Louppy-sur-Loison;76;1387832;41047;37;1003279;39;384553;18261;5263
50542;Saint-Pois;287;5240892;123060;108;3420088;179;1820804;18261;5264
89072;Champcevrais;200;3652198;131069;78;2377319;122;1274879;18261;5265
19025;Beyssenac;192;3506494;77083;78;2321702;114;1184792;18263;5266
65440;Tarbes;28145;514011892;24471521;13083;386734725;15062;127277167;18263;5267
64287;Laàs;67;1223639;22885;24;674979;43;548660;18263;5268
62516;Lillers;5502;100485870;3832658;2341;72587441;3161;27898429;18264;5269
63463;Viscomtat;346;6319407;190779;141;4393198;205;1926209;18264;5270
33373;Saint-Antoine-sur-l'Isle;314;5735118;133963;146;4046080;168;1689038;18265;5271
36168;Prissac;413;7543521;235574;168;4919750;245;2623771;18265;5272
56039;La Chapelle-Neuve;481;8785598;130938;216;5964306;265;2821292;18265;5273
39248;Geraise;26;474898;16415;13;353444;13;121454;18265;5274
23257;Vallière;452;8256650;320053;197;5880496;255;2376154;18267;5275
65254;Laméac;77;1406580;39229;34;974854;43;431726;18267;5276
82013;Beaumont-de-Lomagne;2253;41157371;1535652;930;28757590;1323;12399781;18268;5277
85206;Saint-Cyr-en-Talmondais;215;3927673;89407;102;2740615;113;1187058;18268;5278
30010;Anduze;2073;37870564;1601123;835;26593688;1238;11276876;18268;5279
07218;Saint-Basile;183;3343322;63810;73;2154455;110;1188867;18270;5280
53042;Brecé;461;8422577;95183;207;5624937;254;2797640;18270;5281
07165;Nonières;112;2046276;29623;52;1458580;60;587696;18270;5282
64277;Isturits;236;4311843;66600;95;2816472;141;1495371;18271;5283
36184;Saint-Chartier;333;6084119;169931;153;4186522;180;1897597;18271;5284
03221;Saint-Bonnet-Tronçais;470;8587200;271931;196;5746409;274;2840791;18271;5285
50370;Néhou;312;5700475;104998;150;4055163;162;1645312;18271;5286
08302;Monthermé;1442;26347055;813387;651;18577740;791;7769315;18271;5287
80432;Herleville;99;1808872;61762;48;1314451;51;494421;18271;5288
72018;Avesnes-en-Saosnois;60;1096290;18263;36;842966;24;253324;18272;5289
84117;Saint-Roman-de-Malegarde;192;3508375;114620;91;2494245;101;1014130;18273;5290
81049;Cahuzac;138;2521783;64511;45;1405416;93;1116367;18274;5291
11130;Espezel;126;2302601;96331;56;1755390;70;547211;18275;5292
03084;Cosne-d'Allier;1378;25182446;935014;602;17492544;776;7689902;18275;5293
71190;Épinac;1397;25530066;772871;613;17294500;784;8235566;18275;5294
87036;Champsac;378;6907974;99107;168;4717329;210;2190645;18275;5295
04218;Thorame-Basse;141;2576813;89466;66;1841088;75;735725;18275;5296
71527;Sommant;116;2120094;40197;56;1492610;60;627484;18277;5297
08033;Authe;49;895588;7899;18;507556;31;388032;18277;5298
63210;Maringues;1542;28183819;933620;664;20219395;878;7964424;18277;5299
84148;Villes-sur-Auzon;726;13270018;363178;315;9379441;411;3890577;18278;5300
61465;Ségrie-Fontaine;232;4240654;84913;107;2926426;125;1314228;18279;5301
79268;Saint-Loup-Lamairé;575;10512002;294256;267;7474531;308;3037471;18282;5302
87117;Peyrat-le-Château;598;10932781;349294;264;7602317;334;3330464;18282;5303
63011;Ars-les-Favets;122;2230661;28026;61;1623786;61;606875;18284;5304
61159;Fay;38;694839;24707;13;400064;25;294775;18285;5305
16085;Chasseneuil-sur-Bonnieure;1771;32384254;1049115;789;22875850;982;9508404;18286;5306
30172;Monoblet;345;6308791;164511;135;4094022;210;2214769;18286;5307
57573;Réning;67;1225240;27711;31;805048;36;420192;18287;5308
80796;Villeroy;131;2395672;92043;58;1751925;73;643747;18288;5309
66017;Le Barcarès;3628;66347624;2947820;1798;50555393;1830;15792231;18288;5310
10196;Lignières;142;2596869;87044;70;1784651;72;812218;18288;5311
63165;Giat;526;9619657;368685;217;6707846;309;2911811;18288;5312
70106;Buffignécourt;74;1353350;32468;45;1059955;29;293395;18289;5313
51621;Vienne-le-Château;327;5980351;227306;146;4260909;181;1719442;18289;5314
36244;Villentrois;368;6730282;202921;159;4581322;209;2148960;18289;5315
86119;Joussé;195;3566319;72752;82;2328358;113;1237961;18289;5316
29128;Loc-Eguiner;187;3420146;57537;90;2449703;97;970443;18290;5317
50472;Saint-Georges-de-Livoye;109;1993598;40473;53;1368501;56;625097;18290;5318
82179;Septfonds;1289;23575881;766196;542;16200018;747;7375863;18290;5319
76157;Canteleu;8009;146485387;4962420;3941;109166581;4068;37318806;18290;5320
35329;Sougéal;344;6291925;167982;166;4442210;178;1849715;18290;5321
36169;Pruniers;293;5359112;135983;132;3543635;161;1815477;18290;5322
24092;Cendrieux;321;5871507;109702;122;3842655;199;2028852;18291;5323
39173;Cousance;751;13736827;357722;367;9888090;384;3848737;18291;5324
08244;Lametz;49;896309;25672;24;667839;25;228470;18292;5325
17081;Chamouillac;195;3566973;55061;81;2285865;114;1281108;18292;5326
55465;Saint-Remy-la-Calonne;52;951202;33214;21;694361;31;256841;18292;5327
02121;Breny;130;2378012;57483;61;1662389;69;715623;18292;5328
71365;Rancy;320;5853837;170592;145;4070574;175;1783263;18293;5329
50510;Saint-Martin-d'Aubigny;278;5085617;42090;129;3507021;149;1578596;18294;5330
22241;Plumieux;595;10885060;184822;291;7798055;304;3087005;18294;5331
80235;Dargnies;719;13154176;423552;336;9124556;383;4029620;18295;5332
53120;Izé;284;5195883;62966;114;3318544;170;1877339;18295;5333
85229;Saint-Hilaire-de-Voust;352;6440546;53021;146;4130448;206;2310098;18297;5334
40158;Losse;161;2945983;127288;67;1980398;94;965585;18298;5335
2A272;Sartène;1925;35224261;1495056;871;26205667;1054;9018594;18298;5336
16380;Le Tâtre;209;3824377;103308;100;2677469;109;1146908;18298;5337
34019;Avène;180;3293763;114618;83;2427723;97;866040;18299;5338
50464;Saint-Denis-le-Vêtu;314;5745887;48905;156;3954248;158;1791639;18299;5339
53231;Saint-Laurent-des-Mortiers;111;2031234;31665;43;1345244;68;685990;18299;5340
07349;La Voulte-sur-Rhône;3141;57478444;1856299;1465;40566755;1676;16911689;18299;5341
19177;Rosiers-de-Juillac;106;1939800;47098;48;1293566;58;646234;18300;5342
50445;Saint-André-de-Bohon;187;3422235;70613;93;2434696;94;987539;18301;5343
70006;Aillevillers-et-Lyaumont;894;16361513;413783;416;11600456;478;4761057;18301;5344
56218;Saint-Gravé;405;7412214;128237;184;5049381;221;2362833;18302;5345
48072;Grèzes;114;2086440;46226;54;1510017;60;576423;18302;5346
09192;Miglos;73;1336108;44375;32;910051;41;426057;18303;5347
26040;Beaurières;53;970071;44880;22;679104;31;290967;18303;5348
14655;Saint-Pierre-Tarentaine;203;3715630;85032;95;2543358;108;1172272;18304;5349
35075;Chauvigné;409;7486283;55000;183;4835259;226;2651024;18304;5350
46113;Frayssinet;176;3221540;70332;67;2078660;109;1142880;18304;5351
50227;Le Ham;187;3423040;82535;83;2315783;104;1107257;18305;5352
19018;Bassignac-le-Haut;110;2013582;46133;50;1427668;60;585914;18305;5353
24191;Fraisse;85;1555988;46912;36;1069153;49;486835;18306;5354
62257;Créquy;262;4796272;99746;112;3320086;150;1476186;18306;5355
22263;Le Quiou;170;3112162;51138;80;2131642;90;980520;18307;5356
30051;Branoux-les-Taillades;786;14389303;350644;349;9744045;437;4645258;18307;5357
87138;Saint-Bonnet-Briance;342;6261169;156088;135;4267224;207;1993945;18308;5358
07299;Saint-Symphorien-de-Mahun;73;1336529;20467;30;820762;43;515767;18309;5359
63078;Chaméane;69;1263301;31259;27;841996;42;421305;18309;5360
47187;Monteton;135;2471761;54014;58;1721204;77;750557;18309;5361
09041;La Bastide-du-Salat;127;2325363;68533;60;1658595;67;666768;18310;5362
62672;Puisieux;370;6774740;161708;166;4712226;204;2062514;18310;5363
61512;Les Yveteaux;58;1062001;18250;27;732228;31;329773;18310;5364
62694;Rebreuve-sur-Canche;120;2197366;62518;57;1649664;63;547702;18311;5365
52091;Cerisières;51;933898;7607;22;589953;29;343945;18312;5366
71514;Sens-sur-Seille;204;3735631;97000;96;2715791;108;1019840;18312;5367
17386;Saint-Pierre-du-Palais;174;3186326;77367;80;2167139;94;1019187;18312;5368
87124;Rilhac-Lastours;217;3973805;87899;97;2666451;120;1307354;18312;5369
2A060;Cannelle;30;549383;23323;15;407380;15;142003;18313;5370
58174;Montenoison;76;1391774;50450;37;1051885;39;339889;18313;5371
2B311;Santa-Maria-Poggio;418;7654895;327242;186;5840183;232;1814712;18313;5372
11027;Barbaira;382;6995738;149348;176;4898752;206;2096986;18313;5373
31302;Lodes;160;2930171;86293;69;2044678;91;885493;18314;5374
26180;Mérindol-les-Oliviers;129;2362470;59574;52;1718273;77;644197;18314;5375
36119;Mérigny;386;7069112;296871;141;4645242;245;2423870;18314;5376
79083;Chef-Boutonne;1320;24175543;926971;528;16812082;792;7363461;18315;5377
18143;Menetou-Couture;214;3919485;61070;102;2752107;112;1167378;18315;5378
23220;Saint-Médard-la-Rochette;366;6703455;283530;139;4561006;227;2142449;18315;5379
25496;Roche-lès-Clerval;55;1007369;18962;26;648431;29;358938;18316;5380
22062;Gomené;341;6245767;140347;151;4309567;190;1936200;18316;5381
89420;Treigny;574;10513423;390290;253;7502601;321;3010822;18316;5382
79197;Oroux;61;1117295;19890;24;661433;37;455862;18316;5383
46143;Lacapelle-Marival;803;14708278;549361;344;10599040;459;4109238;18317;5384
64019;Amorots-Succos;109;1996525;15818;48;1380202;61;616323;18317;5385
21314;Hauteroche;48;879217;28243;24;654866;24;224351;18317;5386
88005;Allarmont;147;2692726;91400;65;1958214;82;734512;18318;5387
58101;Dompierre-sur-Nièvre;111;2033283;74207;45;1472275;66;561008;18318;5388
65234;Jézeau;75;1373845;46292;31;981853;44;391992;18318;5389
32450;Tourdun;65;1190667;29933;31;897224;34;293443;18318;5390
70013;Ambiévillers;60;1099165;45730;25;668837;35;430328;18319;5391
81160;Massaguel;230;4213590;117166;105;2897937;125;1315653;18320;5392
52526;Villars-Santenoge;59;1080910;22022;24;745614;35;335296;18321;5393
28079;Chapelle-Royale;193;3535962;115858;90;2543707;103;992255;18321;5394
31426;Pointis-de-Rivière;503;9216468;262960;227;6689592;276;2526876;18323;5395
24573;Verteillac;373;6834587;224073;163;4685369;210;2149218;18323;5396
06072;Ilonse;26;476410;34371;11;357461;15;118949;18323;5397
59564;La Sentinelle;1774;32506603;1447583;772;23473112;1002;9033491;18324;5398
27116;Brionne;2629;48173726;1897780;1237;35490671;1392;12683055;18324;5399
32222;Magnan;139;2547084;92321;60;1820838;79;726246;18324;5400
23032;Boussac-Bourg;480;8795799;235455;232;6309423;248;2486376;18325;5401
52423;Rimaucourt;384;7036671;170060;170;4765869;214;2270802;18325;5402
61075;Ceaucé;731;13395582;283539;308;8780765;423;4614817;18325;5403
12305;Viviez;853;15631356;549602;391;10795287;462;4836069;18325;5404
62492;Lebiez;126;2308976;87359;50;1612503;76;696473;18325;5405
11433;Villeneuve-Minervois;472;8649601;253341;198;6096149;274;2553452;18325;5406
29081;Huelgoat;1023;18746972;754639;425;13046723;598;5700249;18325;5407
70272;Gourgeon;118;2162410;26359;47;1412609;71;749801;18326;5408
23063;Clairavaux;95;1740949;57248;45;1231486;50;509463;18326;5409
33208;Jau-Dignac-et-Loirac;613;11234393;411481;267;7815443;346;3418950;18327;5410
63430;Thiers;7129;130659109;4966974;3096;92937414;4033;37721695;18328;5411
72309;Saint-Paul-le-Gaultier;173;3170721;61914;89;2297842;84;872879;18328;5412
53016;Bais;752;13783054;402015;337;9935021;415;3848033;18329;5413
29013;Botmeur;139;2547804;135878;54;1837884;85;709920;18330;5414
97224;Saint-Joseph;9557;175181716;5964934;3425;122750578;6132;52431138;18330;5415
21566;Saint-Pierre-en-Vaux;105;1924685;50970;37;989241;68;935444;18330;5416
47080;Dévillac;80;1466438;29792;36;972498;44;493940;18330;5417
89377;Sauvigny-le-Beuréal;47;861533;19857;21;513731;26;347802;18330;5418
71314;Montjay;101;1851384;57886;51;1398397;50;452987;18331;5419
39045;Beffia;35;641604;16954;11;376174;24;265430;18332;5420
60581;Saint-Just-en-Chaussée;3428;62840716;2128322;1632;46129326;1796;16711390;18332;5421
27438;Nonancourt;1400;25664483;1070035;692;19108130;708;6556353;18332;5422
81254;Saint-Jean-de-Marcel;198;3629800;86188;76;2309610;122;1320190;18332;5423
70094;Breuchotte;183;3354828;99326;84;2332873;99;1021955;18332;5424
52013;Anrosey;94;1723253;54006;45;1261199;49;462054;18332;5425
48061;Florac;1140;20899103;702848;530;15183666;610;5715437;18333;5426
18239;Saligny-le-Vif;100;1833288;39925;44;1307152;56;526136;18333;5427
07266;Sainte-Marguerite-Lafigère;49;898318;62854;22;674268;27;224050;18333;5428
84112;Saint-Martin-de-Castillon;457;8378244;341645;195;6252233;262;2126011;18333;5429
11397;Trèbes;3191;58501270;2086686;1429;42356767;1762;16144503;18333;5430
13108;Tarascon;7827;143494207;5803600;3281;102635103;4546;40859104;18333;5431
36051;Chitray;99;1815144;50103;41;1136937;58;678207;18335;5432
32408;Salles-d'Armagnac;74;1356786;29061;33;893496;41;463290;18335;5433
56264;Kernascléden;218;3997037;139530;88;2772405;130;1224632;18335;5434
73273;Saint-Pierre-de-Curtille;256;4693910;208404;111;3592901;145;1101009;18336;5435
02569;Oisy;235;4308954;133383;104;3084424;131;1224530;18336;5436
62659;Planques;53;971819;20261;26;720552;27;251267;18336;5437
08301;Montgon;43;788459;23918;21;533922;22;254537;18336;5438
15124;Menet;313;5739401;189400;130;3933309;183;1806092;18337;5439
32370;Saint-Clar;612;11223105;451287;274;8185215;338;3037890;18338;5440
40235;Poyanne;333;6106804;128747;156;4400072;177;1706732;18339;5441
40134;Labouheyre;1454;26664978;790349;661;18256873;793;8408105;18339;5442
19106;Lapleau;226;4144910;156111;96;2756444;130;1388466;18340;5443
18113;Ignol;104;1907394;62181;46;1351468;58;555926;18340;5444
14416;Le Mesnil-Caussois;65;1192149;21039;33;847032;32;345117;18341;5445
88236;La Haye;77;1412246;42738;37;989166;40;423080;18341;5446
34285;Saint-Pons-de-Mauchiens;375;6878190;238625;150;4802961;225;2075229;18342;5447
47303;Soumensac;124;2274398;81992;58;1677695;66;596703;18342;5448
47259;Saint-Maurice-de-Lestapel;50;917110;12979;24;654218;26;262892;18342;5449
87029;Les Cars;359;6584913;107002;154;4203086;205;2381827;18342;5450
28059;Brezolles;1016;18636133;515778;446;12481976;570;6154157;18343;5451
42107;Gumières;179;3283390;68246;88;2377477;91;905913;18343;5452
41044;Châtres-sur-Cher;686;12583331;335694;313;8595055;373;3988276;18343;5453
48172;Saint-Maurice-de-Ventalon;49;898824;23188;19;605611;30;293213;18343;5454
52127;Choiseul;56;1027266;32579;24;711041;32;316225;18344;5455
85056;La Chapelle-Thémer;201;3687408;66118;94;2589882;107;1097526;18345;5456
16211;Marthon;328;6017282;140963;137;4083129;191;1934153;18345;5457
50487;Saint-James;1700;31188365;1166804;667;21772519;1033;9415846;18346;5458
59502;Rieux-en-Cambrésis;812;14897491;439435;363;10706647;449;4190844;18347;5459
61146;Dompierre;208;3816123;61510;103;2639753;105;1176370;18347;5460
15152;Pierrefort;558;10238074;503507;242;7505681;316;2732393;18348;5461
84048;Gignac;35;642180;26212;15;454797;20;187383;18348;5462
30322;Soudorgues;162;2972564;107782;59;2120839;103;851725;18349;5463
23036;Bussière-Dunoise;620;11377626;337056;289;8226313;331;3151313;18351;5464
88278;Maconcourt;48;880969;24841;22;594619;26;286350;18354;5465
62523;Loison-sous-Lens;2892;53078717;1608446;1359;38290456;1533;14788261;18354;5466
52103;Champigny-sous-Varennes;67;1229762;23995;31;906561;36;323201;18355;5467
55471;Saulmory-et-Villefranche;60;1101283;38201;27;797212;33;304071;18355;5468
76040;Autigny;142;2606493;62449;68;2039891;74;566602;18356;5469
64397;Montagut;72;1321660;34540;28;894267;44;427393;18356;5470
24294;Montpon-Ménestérol;3706;68029858;2869790;1671;50184028;2035;17845830;18357;5471
81191;Mouzieys-Panens;135;2478214;61779;52;1653990;83;824224;18357;5472
81091;Ferrières;90;1652192;47099;47;1233257;43;418935;18358;5473
50237;La Haye-Pesnel;800;14686170;493028;304;9680605;496;5005565;18358;5474
16035;Beaulieu-sur-Sonnette;153;2808901;137921;58;1884821;95;924080;18359;5475
18276;Vernais;113;2074570;82629;49;1587161;64;487409;18359;5476
24353;La Rochebeaucourt-et-Argentine;204;3745289;123894;93;2734810;111;1010479;18359;5477
05019;La Beaume;92;1689155;41245;48;1264306;44;424849;18360;5478
12135;Lunac;269;4938969;260074;103;3491591;166;1447378;18360;5479
62818;Tilly-Capelle;90;1652445;58729;39;1117187;51;535258;18361;5480
08106;Charnois;51;936393;26792;25;686388;26;250005;18361;5481
2B220;Piedigriggio;89;1634101;58630;41;1191115;48;442986;18361;5482
46275;Saint-Martin-de-Vers;57;1046563;34921;24;741386;33;305177;18361;5483
81312;Verdalle;513;9419099;187833;222;6719360;291;2699739;18361;5484
14343;Les Isles-Bardel;39;716073;-425;14;403446;25;312627;18361;5485
54487;Saint-Rémy-aux-Bois;43;789538;15845;22;609747;21;179791;18361;5486
88494;Vaubexy;72;1322062;44149;33;935278;39;386784;18362;5487
87111;Oradour-sur-Vayres;944;17335054;570193;409;11828035;535;5507019;18363;5488
47310;Tonneins;5489;100796926;4029315;2313;71654123;3176;29142803;18363;5489
62705;Rety;1053;19336808;502787;465;13561364;588;5775444;18364;5490
02709;Serain;229;4205314;105429;96;2915520;133;1289794;18364;5491
03048;Cérilly;816;14984876;567605;366;10872580;450;4112296;18364;5492
50263;Lapenty;220;4040178;59777;96;2724435;124;1315743;18364;5493
17328;Saint-Fort-sur-Gironde;550;10100645;394980;206;6565552;344;3535093;18365;5494
19184;Saint-Bazile-de-Meyssac;84;1542682;45286;38;1101320;46;441362;18365;5495
80222;Crécy-en-Ponthieu;844;15500652;477709;330;10543029;514;4957623;18366;5496
44017;Bonnoeuvre;311;5711794;110016;138;3798365;173;1913429;18366;5497
42287;Saint-Sauveur-en-Rue;637;11699177;258685;291;8099134;346;3600043;18366;5498
18160;Nérondes;912;16750118;423994;391;11384995;521;5365123;18366;5499
07269;Saint-Martin-de-Valamas;743;13646604;365865;352;9592055;391;4054549;18367;5500
24339;Preyssac-d'Excideuil;94;1726532;41797;47;1244392;47;482140;18367;5501
02799;Vierzy;226;4151045;131681;109;3090409;117;1060636;18367;5502
62812;Thiembronne;421;7732716;232130;178;5229315;243;2503401;18367;5503
06156;Venanson;90;1653089;74640;46;1186649;44;466440;18368;5504
55142;Dainville-Bertheléville;85;1561288;44268;30;939217;55;622071;18368;5505
21607;Seurre;1490;27369414;1019351;662;19327065;828;8042349;18369;5506
68024;Bellemagny;119;2185880;145125;36;1685370;83;500510;18369;5507
63335;Saint-Diéry;233;4280297;80330;112;3067196;121;1213101;18370;5508
59312;Honnecourt-sur-Escaut;460;8450447;301004;184;5795397;276;2655050;18371;5509
52130;Cirfontaines-en-Azois;102;1873798;52931;49;1369135;53;504663;18371;5510
52291;Longchamp;40;734834;14721;14;441312;26;293522;18371;5511
51658;Vroil;67;1230950;33620;33;885056;34;345894;18372;5512
65064;Bareilles;34;624671;22586;20;494527;14;130144;18373;5513
43038;Bournoncle-Saint-Pierre;612;11244271;290525;301;7968447;311;3275824;18373;5514
80827;Woincourt;847;15562010;479801;377;11008336;470;4553674;18373;5515
54035;Avricourt;233;4281260;102410;120;3112873;113;1168387;18375;5516
21675;Vianges;36;661496;17148;19;495231;17;166265;18375;5517
83013;La Bastide;112;2058009;62287;63;1614558;49;443451;18375;5518
71246;Juif;155;2848241;54672;79;2024951;76;823290;18376;5519
18077;Couy;218;4005978;114066;102;2819493;116;1186485;18376;5520
88090;Charmes;2723;50038462;1808749;1201;35952274;1522;14086188;18376;5521
03289;Treteau;318;5843700;220426;132;3984894;186;1858806;18376;5522
64193;Corbère-Abères;57;1047457;38846;28;741387;29;306070;18376;5523
30329;Thoiras;255;4686084;205462;98;3294675;157;1391409;18377;5524
31385;Montmaurin;139;2554478;97162;59;1845710;80;708768;18378;5525
71213;La Genête;337;6193244;158081;165;4434052;172;1759192;18378;5526
88252;Jésonville;76;1396708;31545;30;883159;46;513549;18378;5527
05115;Remollon;268;4925253;148789;125;3501514;143;1423739;18378;5528
2B121;Galéria;205;3767624;175998;106;2884289;99;883335;18379;5529
48038;Chambon-le-Château;125;2297334;55842;52;1598473;73;698861;18379;5530
64074;Aubous;31;569755;30872;12;412338;19;157417;18379;5531
64297;Lacarre;80;1470394;50826;36;1000535;44;469859;18380;5532
58179;Montreuillon;159;2922417;95273;67;1931722;92;990695;18380;5533
70175;Cornot;77;1415312;34653;35;921105;42;494207;18381;5534
65074;Bazordan;75;1378558;35735;36;977354;39;401204;18381;5535
40305;Sorbets;105;1930121;45939;51;1445396;54;484725;18382;5536
04199;Saint-Vincent-sur-Jabron;110;2022099;58804;47;1354273;63;667826;18383;5537
06023;Breil-sur-Roya;1426;26215471;1029185;688;19751542;738;6463929;18384;5538
44075;Issé;1005;18476153;422976;466;12702379;539;5773774;18384;5539
46115;Frayssinhes;110;2022360;52555;44;1337849;66;684511;18385;5540
69248;Thizy;1357;24948737;944917;619;17672815;738;7275922;18385;5541
88327;Nomexy;1218;22393601;473645;578;15611705;640;6781896;18386;5542
02703;Seboncourt;603;11086547;309072;287;7889531;316;3197016;18386;5543
18279;Vierzon;16338;300387842;11112619;7561;218474150;8777;81913692;18386;5544
22075;Hémonstoir;386;7097043;149694;192;5169402;194;1927641;18386;5545
65286;Lourdes;10244;188357082;8230444;4546;135858425;5698;52498657;18387;5546
65132;Castéra-Lanusse;30;551614;11410;16;416120;14;135494;18387;5547
17470;Villars-les-Bois;156;2868522;101832;63;1891330;93;977192;18388;5548
02043;Bagneux;35;643593;12121;18;457219;17;186374;18388;5549
50328;Millières;387;7116314;106915;165;4557060;222;2559254;18388;5550
16069;Cellettes;235;4321373;153821;103;2986533;132;1334840;18389;5551
55145;Damvillers;367;6748701;266506;147;4727843;220;2020858;18389;5552
54512;Tanconville;62;1140118;12174;32;816688;30;323430;18389;5553
58218;Prémery;1247;22932293;822757;571;16022626;676;6909667;18390;5554
24488;Saint-Pompont;246;4524081;177419;94;2944254;152;1579827;18391;5555
17157;Fenioux;89;1636784;25193;41;1172723;48;464061;18391;5556
86276;Usson-du-Poitou;781;14363360;519636;328;9932779;453;4430581;18391;5557
53086;La Croixille;341;6271603;94280;160;4371993;181;1899610;18392;5558
66165;Rodès;360;6621153;160363;155;4512234;205;2108919;18392;5559
72068;La Chartre-sur-le-Loir;923;16976160;561215;412;11965102;511;5011058;18392;5560
58005;Amazy;140;2574975;73128;63;1756171;77;818804;18393;5561
44065;Grand-Auverné;415;7633030;193335;174;5098785;241;2534245;18393;5562
23123;Les Mars;123;2262394;73419;46;1451090;77;811304;18393;5563
57254;Gorze;745;13703236;536022;312;10247231;433;3456005;18394;5564
54261;Herserange;2484;45690181;793506;814;23100008;1670;22590173;18394;5565
59650;Wattrelos;22360;411291430;10449564;10862;296906567;11498;114384863;18394;5566
59024;Auberchicourt;2499;45967212;1477291;1056;32410491;1443;13556721;18394;5567
62325;Fauquembergues;478;8792490;288614;186;6027791;292;2764699;18394;5568
09307;Taurignan-Castet;118;2170564;97417;60;1684778;58;485786;18395;5569
83145;Varages;725;13336106;475108;314;9584892;411;3751214;18395;5570
08356;Remaucourt;93;1710703;57566;41;1246135;52;464568;18395;5571
56028;Caden;884;16261153;342109;388;10941385;496;5319768;18395;5572
02769;Vaux-Andigny;518;9528643;325908;213;6332593;305;3196050;18395;5573
14596;Saint-Jean-des-Essartiers;115;2115441;26210;54;1440836;61;674605;18395;5574
81096;Le Fraysse;215;3955035;106377;87;2738366;128;1216669;18396;5575
08196;Grandchamp;51;938199;15936;20;664247;31;273952;18396;5576
63079;Champagnat-le-Jeune;73;1342936;40039;37;997888;36;345048;18396;5577
14402;Le Marais-la-Chapelle;54;993412;11881;23;639598;31;353814;18397;5578
43098;Freycenet-la-Tour;74;1361355;52709;30;950023;44;411332;18397;5579
63431;Thiolières;96;1766109;30006;39;1210990;57;555119;18397;5580
80016;Albert;6081;111872159;4578083;2825;82719794;3256;29152365;18397;5581
70124;Champtonnay;48;883074;15307;24;605255;24;277819;18397;5582
55391;Olizy-sur-Chiers;101;1858172;64076;43;1291199;58;566973;18398;5583
39118;Châtel-de-Joux;33;607141;2390;15;411595;18;195546;18398;5584
32462;Vic-Fezensac;2285;42041706;1662707;965;29880670;1320;12161036;18399;5585
08198;Grandpré;259;4765523;132606;105;3404190;154;1361333;18400;5586
63145;Égliseneuve-des-Liards;81;1490384;30282;35;1040443;46;449941;18400;5587
71042;Bonnay;185;3403973;159055;80;2463574;105;940399;18400;5588
50285;Magneville;182;3348983;87985;79;2334178;103;1014805;18401;5589
58149;Luzy;1272;23406195;836339;557;16504103;715;6902092;18401;5590
64307;Lalongue;112;2060942;42817;39;1312462;73;748480;18401;5591
64182;Castillon (Canton de Lembeye);40;736089;14159;21;564737;19;171352;18402;5592
03206;La Petite-Marche;109;2005858;85910;42;1283544;67;722314;18402;5593
08269;Malandry;34;625688;5380;15;404586;19;221102;18403;5594
89091;Châtel-Censoir;426;7839628;277873;183;5354359;243;2485269;18403;5595
15245;Vabres;133;2447627;14638;58;1621037;75;826590;18403;5596
37197;Rigny-Ussé;285;5244955;169170;135;3647604;150;1597351;18403;5597
08470;Verpel;51;938608;36698;23;654921;28;283687;18404;5598
03236;Saint-Germain-des-Fossés;2151;39587801;1194210;1017;28443322;1134;11144479;18404;5599
32087;Castex-d'Armagnac;65;1196300;70984;27;877388;38;318912;18405;5600
43134;Mézères;89;1638029;37354;36;1071327;53;566702;18405;5601
79148;Lezay;1281;23577082;778764;494;16017328;787;7559754;18405;5602
22292;Saint-Gilles-du-Mené;263;4840584;104313;122;3366723;141;1473861;18405;5603
88001;Les Ableuvenettes;44;809851;23202;21;585628;23;224223;18406;5604
35045;Bruc-sur-Aff;472;8687732;136691;221;5987984;251;2699748;18406;5605
26354;Treschenu-Creyers;74;1362068;60498;32;1003339;42;358729;18406;5606
24056;Le Bourdeix;150;2760975;95424;62;1873005;88;887970;18407;5607
19209;Saint-Hilaire-les-Courbes;99;1822261;67848;39;1286214;60;536047;18407;5608
29155;Ouessant;561;10326283;477263;252;7429349;309;2896934;18407;5609
71101;Charette-Varennes;240;4417693;120685;110;3171939;130;1245754;18407;5610
70545;Venisey;79;1454182;38006;37;1070200;42;383982;18407;5611
63365;Saint-Jean-des-Ollières;288;5301386;173738;123;3833673;165;1467713;18408;5612
88052;Belrupt;54;994011;28847;23;678542;31;315469;18408;5613
14229;Dozulé;1130;20801465;696936;446;13924108;684;6877357;18408;5614
70550;Vesoul;10027;184581430;9623177;4687;140016131;5340;44565299;18408;5615
07181;Le Pouzin;1656;30485126;811972;740;20912822;916;9572304;18409;5616
18146;Ménétréol-sous-Sancerre;237;4362916;169012;105;3009908;132;1353008;18409;5617
86087;Craon;109;2006599;61339;43;1303132;66;703467;18409;5618
24157;Douzillac;461;8486639;197743;206;6046373;255;2440266;18409;5619
17458;Vanzac;96;1767295;73432;40;1269708;56;497587;18409;5620
37105;Faye-la-Vineuse;156;2871911;69760;63;1839264;93;1032647;18410;5621
48141;Mas-Saint-Chély;76;1399137;45068;36;1024992;40;374145;18410;5622
32252;Miélan;742;13659997;511099;300;9511187;442;4148810;18410;5623
64432;Ossas-Suhare;46;846890;14956;18;476013;28;370877;18411;5624
81175;Montdurausse;193;3553398;65983;80;2247358;113;1306040;18411;5625
09062;Les Bordes-sur-Lez;110;2025260;66048;57;1484936;53;540324;18411;5626
46064;Catus;551;10144919;396370;240;7158107;311;2986812;18412;5627
09085;Castillon-en-Couserans;275;5063282;310304;96;3543243;179;1520039;18412;5628
56071;Guéhenno;482;8874895;238723;231;6415177;251;2459718;18413;5629
33473;Saint-Savin;1620;29828728;758709;683;20207180;937;9621548;18413;5630
33380;Saint-Caprais-de-Blaye;298;5487038;168969;130;3912124;168;1574914;18413;5631
79348;Villefollet;104;1915038;47684;48;1409431;56;505607;18414;5632
50216;Graignes-Mesnil-Angot;406;7476152;122595;173;4788277;233;2687875;18414;5633
12211;Saint-André-de-Vézines;80;1473145;48665;34;1015322;46;457823;18414;5634
35162;Louvigné-du-Désert;2066;38045118;834092;920;25716312;1146;12328806;18415;5635
56076;Guern;798;14695141;399640;355;9995758;443;4699383;18415;5636
04211;Sourribes;118;2173063;90379;65;1749403;53;423660;18416;5637
11185;Lagrasse;303;5579988;338434;114;4109816;189;1470172;18416;5638
32358;Saint-Antoine;114;2099402;56850;50;1507721;64;591681;18416;5639
89058;Bussières;79;1454849;25448;33;1056300;46;398549;18416;5640
15134;Montsalvy;547;10073578;388223;244;6964657;303;3108921;18416;5641
11392;Tournissan;160;2946569;100537;62;1929444;98;1017125;18416;5642
76672;Serqueux;567;10442025;230734;258;7154960;309;3287065;18416;5643
07204;Saint-Agrève;1504;27698241;866317;632;18709360;872;8988881;18416;5644
02522;Mont-Saint-Jean;28;515692;1137;13;354945;15;160747;18418;5645
52094;Vals-des-Tilles;101;1860196;49154;44;1290131;57;570065;18418;5646
2B246;La Porta;130;2394346;135482;56;1735596;74;658750;18418;5647
17129;Courpignac;248;4567696;168575;99;3227479;149;1340217;18418;5648
31552;Terrebasse;83;1528770;27736;43;1168555;40;360215;18419;5649
40226;Pimbo;107;1970840;54753;50;1443811;57;527029;18419;5650
16008;Ambérac;197;3628574;98800;94;2564095;103;1064479;18419;5651
52440;Rouvroy-sur-Marne;200;3683928;79900;102;2768280;98;915648;18420;5652
81320;Vindrac-Alayrac;90;1657785;40599;40;1181494;50;476291;18420;5653
49366;Vergonnes;168;3094547;17207;79;2024045;89;1070502;18420;5654
17448;Tonnay-Boutonne;689;12691506;315835;273;8396124;416;4295382;18420;5655
50630;Vessey;230;4236706;120814;106;2991698;124;1245008;18420;5656
04026;Bellaffaire;93;1713165;62369;38;1159113;55;554052;18421;5657
59614;Viesly;813;14976437;385291;354;10275503;459;4700934;18421;5658
82004;Asques;73;1344752;55324;29;973604;44;371148;18421;5659
64447;Piets-Plasence-Moustrou;71;1307922;48255;28;882686;43;425236;18421;5660
16135;Eymouthiers;173;3186916;73691;84;2339564;89;847352;18421;5661
88056;Bettoncourt;58;1068449;28953;30;807925;28;260524;18422;5662
05082;Mont-Dauphin;84;1547430;27426;42;1091907;42;455523;18422;5663
16044;Bioussac;132;2431684;52975;60;1665691;72;765993;18422;5664
16134;Exideuil;579;10666507;234693;272;7402147;307;3264360;18422;5665
25476;Rahon;72;1326474;42159;31;970432;41;356042;18423;5666
30181;Montmirat;197;3629520;89920;85;2570860;112;1058660;18424;5667
55167;Dun-sur-Meuse;405;7461780;276689;165;5213178;240;2248602;18424;5668
52475;Sommancourt;33;607997;9709;14;350626;19;257371;18424;5669
17098;Chenac-Saint-Seurin-d'Uzet;362;6669808;189979;140;4237004;222;2432804;18425;5670
02691;Saint-Quentin;32821;604766583;29386842;14223;448749493;18598;156017090;18426;5671
36073;Feusines;123;2266435;63329;45;1459716;78;806719;18426;5672
55067;Boviolles;60;1105641;33390;24;742649;36;362992;18427;5673
42052;Charlieu;2295;42291057;1506001;1009;29509473;1286;12781584;18427;5674
41222;Saint-Loup;218;4017228;100445;108;2938148;110;1079080;18428;5675
40221;Perquie;194;3574983;80878;91;2523391;103;1051592;18428;5676
54044;Barbas;93;1713817;25626;36;1144220;57;569597;18428;5677
55174;Épinonville;40;737127;16824;20;595261;20;141866;18428;5678
87072;Glanges;283;5215207;121753;128;3729049;155;1486158;18428;5679
30240;Saint-Césaire-de-Gauzignan;179;3298771;101340;74;2243895;105;1054876;18429;5680
23241;Saint-Silvain-Bellegarde;115;2119365;58818;54;1515256;61;604109;18429;5681
86052;Champagné-Saint-Hilaire;490;9030409;145645;201;5813769;289;3216640;18429;5682
71344;Passy;33;608187;12240;15;373053;18;235134;18430;5683
42050;La Chapelle-en-Lafaye;57;1050537;14392;27;739261;30;311276;18430;5684
61219;La Lande-Saint-Siméon;86;1585047;38025;44;1158635;42;426412;18431;5685
43160;Rauret;104;1916842;45498;40;1254372;64;662470;18431;5686
49088;Chazé-Henry;452;8331060;108890;226;5728762;226;2602298;18432;5687
35164;Marcillé-Raoul;405;7465182;98841;184;5129616;221;2335566;18433;5688
29250;Saint-Hernin;455;8386874;234096;204;5991478;251;2395396;18433;5689
50591;Le Teilleul;725;13363946;354207;290;8964557;435;4399389;18433;5690
12260;Sauclières;103;1898602;96581;44;1392588;59;506014;18433;5691
55133;Couvertpuis;51;940096;14529;23;619660;28;320436;18433;5692
55207;Géry;29;534566;11431;13;370060;16;164506;18433;5693
33490;Saint-Vivien-de-Médoc;1108;20424113;742700;508;14919182;600;5504931;18433;5694
82093;Larrazet;334;6156788;175238;136;4159225;198;1997563;18433;5695
50514;Chaulieu;139;2562314;25185;66;1801454;73;760860;18434;5696
79307;Sauzé-Vaussais;978;18028631;727227;411;12794496;567;5234135;18434;5697
51559;Suippes;1955;36039008;763310;1059;26582998;896;9456010;18434;5698
62778;Sars-le-Bois;41;755813;13276;23;572245;18;183568;18434;5699
57086;Belles-Forêts;145;2673026;85251;62;1853577;83;819449;18435;5700
12061;Castelnau-de-Mandailles;281;5180211;158321;127;3656779;154;1523432;18435;5701
53057;La Chapelle-au-Riboul;271;4995890;87971;119;3266393;152;1729497;18435;5702
80243;Domesmont;24;442462;7120;11;306888;13;135574;18436;5703
32293;Mouchès;56;1032425;30233;29;734431;27;297994;18436;5704
34141;La Livinière;313;5770530;152732;115;4027083;198;1743447;18436;5705
89299;Pimelles;40;737453;26978;17;512803;23;224650;18436;5706
63319;Saint-Anthème;486;8960131;314396;218;6467926;268;2492205;18436;5707
12256;Salvagnac-Cajarc;222;4092904;118243;99;2859290;123;1233614;18437;5708
23095;Le Grand-Bourg;734;13532656;368736;332;9543121;402;3989535;18437;5709
46249;Saint-Bressou;73;1345912;23694;29;893801;44;452111;18437;5710
64239;Gerderest;61;1124681;34112;29;787323;32;337358;18437;5711
33088;Camps-sur-l'Isle;307;5660365;127415;145;3951889;162;1708476;18438;5712
19264;Soursac;302;5568231;199101;139;4092160;163;1476071;18438;5713
09023;Ascou;84;1548784;62321;39;1098102;45;450682;18438;5714
67509;Volksberg;193;3558517;71305;88;2333790;105;1224727;18438;5715
50572;Sénoville;107;1972885;12192;53;1446684;54;526201;18438;5716
59055;Bazuel;313;5771313;188992;134;4075485;179;1695828;18439;5717
87009;Beaumont-du-Lac;98;1807044;67961;51;1377898;47;429146;18439;5718
08109;Chatel-Chéhéry;89;1641205;53665;42;1202257;47;438948;18441;5719
86273;La Trimouille;576;10621826;348019;253;7331437;323;3290389;18441;5720
56057;Le Faouët;1766;32566311;975311;805;23335561;961;9230750;18441;5721
37233;Saint-Pierre-des-Corps;8809;162447600;5094226;4452;120690476;4357;41757124;18441;5722
89191;Gland;26;479471;12570;14;355788;12;123683;18441;5723
33239;Lerm-et-Musset;275;5071458;193429;112;3782558;163;1288900;18442;5724
24438;Saint-Laurent-la-Vallée;149;2747917;71393;57;1800108;92;947809;18442;5725
32397;Saint-Michel;147;2711076;79371;68;1945240;79;765836;18443;5726
07331;Vals-les-Bains;2482;45774893;2254232;1132;33204062;1350;12570831;18443;5727
64529;Sus;190;3504152;151792;87;2681310;103;822842;18443;5728
18072;Cornusse;150;2766568;54945;76;1994275;74;772293;18444;5729
50404;Placy-Montaigu;129;2379304;50827;72;1806637;57;572667;18444;5730
49291;Saint-Just-sur-Dive;207;3818196;57915;100;2670899;107;1147297;18445;5731
39291;Lemuy;140;2582356;64859;60;1699920;80;882436;18445;5732
61064;Brullemail;57;1051422;12284;26;746144;31;305278;18446;5733
55059;Bonnet;119;2195078;60162;48;1516311;71;678767;18446;5734
22096;Landébia;286;5275646;91578;137;3646702;149;1628944;18446;5735
36135;Moulins-sur-Céphons;182;3357452;65818;87;2306368;95;1051084;18448;5736
80642;Prouville;167;3080784;78911;71;2249526;96;831258;18448;5737
07247;Saint-Jean-le-Centenier;376;6936420;143163;164;4591329;212;2345091;18448;5738
34032;Béziers;44920;828751121;42546815;18086;608090922;26834;220660199;18449;5739
70055;Baudoncourt;291;5369120;103673;131;3541003;160;1828117;18451;5740
79167;Marnes;152;2804541;78180;60;1923276;92;881265;18451;5741
72351;Tennie;584;10775380;171870;235;6918188;349;3857192;18451;5742
16084;Charras;180;3321274;58015;83;2363141;97;958133;18452;5743
07253;Saint-Julien-du-Gua;107;1974387;71738;46;1354740;61;619647;18452;5744
63394;Saint-Romain;122;2251245;55591;57;1662177;65;589068;18453;5745
39234;Foulenay;50;922651;33450;19;583500;31;339151;18453;5746
55416;Rarécourt;125;2306629;74898;51;1515408;74;791221;18453;5747
85304;Vouillé-les-Marais;413;7621314;179829;169;4974214;244;2647100;18454;5748
58205;Ouroux-en-Morvan;427;7880110;236063;198;5531961;229;2348149;18455;5749
62427;Hénin-Beaumont;14787;272907927;10456282;6584;197721519;8203;75186408;18456;5750
88372;Raon-l'Étape;3801;70154966;2547513;1707;50380865;2094;19774101;18457;5751
21117;Busseaut;35;646057;11862;15;402928;20;243129;18459;5752
32273;Monlezun;104;1919774;31426;43;1342330;61;577444;18459;5753
64474;Saint-Dos;77;1421384;40826;38;1073154;39;348230;18460;5754
23166;Sagnat;122;2252155;86521;50;1553373;72;698782;18460;5755
34186;Octon;243;4485853;123907;105;3211871;138;1273982;18460;5756
71295;Mervans;826;15249255;511691;325;9937891;501;5311364;18462;5757
36233;La Vernelle;446;8233930;206338;196;5483056;250;2750874;18462;5758
62678;Quesques;318;5870940;90819;134;3815167;184;2055773;18462;5759
43112;Langeac;2486;45897603;1883970;1053;32888549;1433;13009054;18462;5760
14259;Familly;63;1163134;23170;29;869130;34;294004;18462;5761
30058;La Cadière-et-Cambo;121;2233957;31771;51;1431960;70;801997;18462;5762
65240;Labatut-Rivière;235;4338859;115206;104;3048788;131;1290071;18463;5763
24531;Sergeac;128;2363405;126611;52;1712488;76;650917;18464;5764
80552;Moislains;737;13608245;457231;347;9748429;390;3859816;18464;5765
37148;Marigny-Marmande;349;6444173;200290;153;4585618;196;1858555;18465;5766
33178;Gajac;233;4302448;120053;102;3103078;131;1199370;18465;5767
50169;Écausseville;50;923292;6316;19;519399;31;403893;18466;5768
36069;Écueillé;812;14994659;514658;356;10452922;456;4541737;18466;5769
05090;La Motte-en-Champsaur;123;2271541;48122;57;1554847;66;716694;18468;5770
14253;Estry;196;3619771;64444;78;2265208;118;1354563;18468;5771
58240;Saint-Franchy;54;997301;34173;28;747072;26;250229;18469;5772
76462;Neufchâtel-en-Bray;2962;54704449;2227274;1270;39191214;1692;15513235;18469;5773
23179;Saint-Alpinien;168;3102756;103167;84;2287637;84;815119;18469;5774
64108;Bellocq;493;9105315;175625;228;6256622;265;2848693;18469;5775
53164;Neuilly-le-Vendin;231;4266388;111303;94;2750223;137;1516165;18469;5776
88330;Nonville;95;1754579;29564;37;1083957;58;670622;18469;5777
72222;Nouans;141;2604211;39679;73;1860687;68;743524;18470;5778
03272;Servilly;150;2770545;56080;73;1990982;77;779563;18470;5779
80488;Longpré-les-Corps-Saints;930;17177634;447865;429;12315742;501;4861892;18471;5780
70219;Esprels;401;7406707;166280;208;5504556;193;1902151;18471;5781
58229;Saint-André-en-Morvan;184;3398651;113278;89;2516455;95;882196;18471;5782
17290;Prignac;179;3306352;99077;88;2498272;91;808080;18471;5783
58197;Nuars;99;1828653;49395;51;1335402;48;493251;18471;5784
04205;Seyne;881;16273739;498842;392;11404457;489;4869282;18472;5785
43201;Saint-Julien-d'Ance;136;2512209;45598;58;1699663;78;812546;18472;5786
12004;Almont-les-Junies;255;4710665;92710;101;3056708;154;1653957;18473;5787
79342;Vernoux-en-Gâtine;326;6022276;152144;124;3755363;202;2266913;18473;5788
61107;Ciral;233;4304344;97105;92;2757175;141;1547169;18474;5789
50574;Servon;141;2604823;54019;69;1838828;72;765995;18474;5790
21299;Gissey-sous-Flavigny;69;1274705;39457;39;994370;30;280335;18474;5791
24452;Saint-Martial-Viveyrol;124;2290787;63845;56;1540430;68;750357;18474;5792
09215;Nalzen;79;1459480;25343;44;1139469;35;320011;18474;5793
15183;Saint-Étienne-de-Carlat;68;1256267;4614;29;825791;39;430476;18475;5794
25279;Gouhelans;65;1200867;32942;30;838373;35;362494;18475;5795
59227;Fenain;2846;52581378;1432133;1238;35829291;1608;16752087;18476;5796
50586;Surville;128;2364915;72210;60;1683917;68;680998;18476;5797
33520;Taillecavat;144;2660530;62696;55;1721437;89;939093;18476;5798
12059;Castanet;267;4933164;64825;94;3017795;173;1915369;18476;5799
71209;Frontenaud;428;7907926;234922;204;5733590;224;2174336;18476;5800
50109;Cérences;1060;19585823;582741;464;13374535;596;6211288;18477;5801
53123;Juvigné;751;13876748;222123;317;9065700;434;4811048;18478;5802
16066;Brossac;298;5506353;232821;115;3740424;183;1765929;18478;5803
62726;Ruisseauville;102;1884740;19224;44;1257338;58;627402;18478;5804
85132;Maillé;453;8370955;207629;220;6022450;233;2348505;18479;5805
26263;Reilhanette;84;1552283;94655;38;1191853;46;360430;18480;5806
79177;Messé;112;2069762;67429;50;1560281;62;509481;18480;5807
32443;Termes-d'Armagnac;115;2125209;88577;54;1604927;61;520282;18480;5808
50170;Écoquenéauville;40;739225;2285;22;525355;18;213870;18481;5809
31521;Saleich;221;4084417;123596;92;2676052;129;1408365;18482;5810
15146;Pailherols;86;1589447;40280;31;994774;55;594673;18482;5811
48040;Chasseradès;86;1589450;51564;36;1065426;50;524024;18482;5812
50590;Le Tanu;201;3715042;37613;88;2521407;113;1193635;18483;5813
72259;Rouperroux-le-Coquet;152;2809446;31796;69;1880770;83;928676;18483;5814
18089;Épineuil-le-Fleuriel;262;4842679;158942;121;3430928;141;1411751;18484;5815
19102;Lamazière-Basse;197;3641302;132265;81;2593664;116;1047638;18484;5816
84007;Avignon;54664;1010404502;50173591;24268;759444378;30396;250960124;18484;5817
16321;Saint-Georges;31;573010;22443;17;457336;14;115674;18484;5818
86160;Mirebeau;1277;23604414;842518;522;16678390;755;6926024;18484;5819
55053;Billy-sous-Mangiennes;169;3123845;97491;74;2024913;95;1098932;18484;5820
86288;Vicq-sur-Gartempe;415;7671426;271239;192;5392767;223;2278659;18485;5821
66010;Ayguatébia-Talau;28;517600;17708;12;371249;16;146351;18486;5822
33198;Guîtres;914;16895950;540478;403;12050338;511;4845612;18486;5823
32461;Verlus;51;942809;16408;19;626852;32;315957;18486;5824
50395;La Pernelle;150;2772982;34768;81;2081867;69;691115;18487;5825
24369;Saint-Antoine-d'Auberoche;78;1441968;29729;30;1003598;48;438370;18487;5826
29041;Coray;1090;20150596;413994;532;14262160;558;5888436;18487;5827
17279;Plassac;332;6137670;124383;153;4430565;179;1707105;18487;5828
50457;Sainte-Colombe;108;1996635;20861;56;1426901;52;569734;18487;5829
64423;Oraàs;95;1756317;14909;38;1059817;57;696500;18488;5830
11013;Argens-Minervois;210;3882560;96135;102;2820699;108;1061861;18488;5831
03190;Moulins;12563;232270800;11115707;6071;176192703;6492;56078097;18488;5832
47005;Allemans-du-Dropt;297;5491347;149147;116;3519051;181;1972296;18489;5833
81234;Roussayrolles;41;758072;12788;16;525851;25;232221;18490;5834
50563;Saint-Vigor-des-Monts;155;2865976;67860;55;1803895;100;1062081;18490;5835
71280;Marly-sous-Issy;50;924509;16631;22;618765;28;305744;18490;5836
2B149;Lugo-di-Nazza;38;702668;26488;20;533389;18;169279;18491;5837
56230;Saint-Nicolas-du-Tertre;242;4474909;89041;119;3272219;123;1202690;18491;5838
38298;Le Péage-de-Roussillon;3726;68899087;2229508;1659;48580864;2067;20318223;18491;5839
03022;Bellenaves;603;11150874;381296;281;8055559;322;3095315;18492;5840
79270;Saint-Maixent-l'École;3752;69386086;2619275;1644;49076554;2108;20309532;18493;5841
37115;Descartes;2240;41426804;1305798;1017;29404966;1223;12021838;18494;5842
62764;Saint-Nicolas;2665;49287223;1811629;1211;36738377;1454;12548846;18494;5843
51635;Villers-le-Sec;59;1091176;29312;28;772787;31;318389;18495;5844
61083;Chambois;244;4512749;149395;107;3031186;137;1481563;18495;5845
40013;Arthez-d'Armagnac;66;1220665;16934;32;855028;34;365637;18495;5846
65191;Gazost;84;1553656;28769;43;1140443;41;413213;18496;5847
47294;Savignac-de-Duras;121;2238035;69663;48;1449745;73;788290;18496;5848
50570;Savigny-le-Vieux;223;4124662;106779;84;2612692;139;1511970;18496;5849
88146;Domjulien;109;2016169;46985;52;1427752;57;588417;18497;5850
46121;Ginouillac;97;1794208;48287;40;1223959;57;570249;18497;5851
21072;Bézouotte;130;2404663;72843;55;1847298;75;557365;18497;5852
62677;Le Quesnoy-en-Artois;177;3274159;74750;69;2177226;108;1096933;18498;5853
40132;Labatut;788;14576634;318640;368;10229184;420;4347450;18498;5854
49232;Nueil-sur-Layon;773;14299583;327285;303;9492740;470;4806843;18499;5855
31544;Sengouagnet;134;2478878;104049;67;1876105;67;602773;18499;5856
55216;Gouraincourt;33;610487;16860;15;392765;18;217722;18500;5857
35185;Montautour;134;2479000;48195;61;1656953;73;822047;18500;5858
70159;Cognières;60;1110014;40287;31;843472;29;266542;18500;5859
82099;Lizac;248;4588217;112437;104;3103147;144;1485070;18501;5860
12054;La Capelle-Bleys;202;3737177;82588;77;2535438;125;1201739;18501;5861
56019;Billio;213;3940822;83278;109;2843942;104;1096880;18502;5862
15179;Saint-Cirgues-de-Malbert;148;2738227;75978;61;1826004;87;912223;18502;5863
32434;Sion;69;1276622;28281;31;899893;38;376729;18502;5864
08257;Logny-Bogny;96;1776212;35031;39;1170632;57;605580;18502;5865
24453;Saint-Martin-de-Fressengeas;207;3829969;84148;87;2562874;120;1267095;18502;5866
18120;Jussy-le-Chaudrier;377;6975440;187530;189;5087924;188;1887516;18502;5867
65200;Germs-sur-l'Oussouet;68;1258196;35226;26;791092;42;467104;18503;5868
26311;Saint-Laurent-en-Royans;763;14118276;332215;370;10397661;393;3720615;18504;5869
63056;Brousse;212;3922843;141577;86;2700803;126;1222040;18504;5870
63163;Gelles;508;9400357;226670;208;6301870;300;3098487;18505;5871
87064;Eymoutiers;1277;23631310;864916;576;17032777;701;6598533;18505;5872
2A212;Piana;281;5200064;262333;128;3944977;153;1255087;18506;5873
80673;Riencourt;114;2109673;41091;65;1665156;49;444517;18506;5874
10431;Villiers-le-Bois;54;999329;30796;13;569757;41;429572;18506;5875
54329;Lunéville;11647;215549571;9482715;5210;158106124;6437;57443447;18507;5876
50513;Saint-Martin-de-Cenilly;117;2165375;41873;47;1402922;70;762453;18507;5877
88311;Montmotier;27;499702;14413;12;340637;15;159065;18507;5878
70372;Montureux-lès-Baulay;94;1739751;67097;44;1275479;50;464272;18508;5879
33544;Le Verdon-sur-Mer;985;18230841;695629;490;13443119;495;4787722;18508;5880
23057;Châtelus-Malvaleix;359;6644614;263552;168;4798269;191;1846345;18509;5881
12116;Huparlac;140;2591262;34281;62;1715198;78;876064;18509;5882
09161;Léran;330;6108212;169375;149;4384331;181;1723881;18510;5883
57719;Villers-sur-Nied;33;610865;5151;13;379388;20;231477;18511;5884
81286;Serviès;343;6349344;139539;141;4102726;202;2246618;18511;5885
24107;La Chapelle-Faucher;234;4332068;159810;118;3220979;116;1111089;18513;5886
16190;Longré;121;2240132;80464;51;1524353;70;715779;18513;5887
09087;Caussou;38;703514;16992;15;483774;23;219740;18514;5888
76165;Caudebec-lès-Elbeuf;5877;108804267;3647715;2933;81636206;2944;27168061;18514;5889
36001;Aigurande;962;17810281;693062;383;11828626;579;5981655;18514;5890
32467;Saint-Caprais;73;1351546;39622;32;972557;41;378989;18514;5891
22205;Plorec-sur-Arguenon;233;4313997;109924;107;3066730;126;1247267;18515;5892
53238;Saint-Mars-sur-la-Futaie;331;6128712;66706;154;4276647;177;1852065;18516;5893
09007;Allières;32;592529;20528;11;434150;21;158379;18517;5894
54420;Petit-Failly;43;796263;11383;14;453720;29;342543;18518;5895
70542;Venère;107;1981411;24599;47;1371069;60;610342;18518;5896
34273;Saint-Martin-de-l'Arçon;90;1666619;109161;35;1231198;55;435421;18518;5897
55347;Les Monthairons;204;3777720;115516;89;2558846;115;1218874;18518;5898
09019;Artigat;314;5814820;227182;133;4128300;181;1686520;18519;5899
17191;La Jard;187;3462984;79564;89;2481238;98;981746;18519;5900
22202;Plévin;459;8500130;288374;212;6120346;247;2379784;18519;5901
60463;Nogent-sur-Oise;10196;188819712;6803668;4827;140164406;5369;48655306;18519;5902
71367;Ratte;244;4518746;125078;131;3494478;113;1024268;18519;5903
64354;Louvie-Soubiron;73;1351949;50346;38;1076179;35;275770;18520;5904
63385;Saint-Pierre-le-Chastel;193;3574445;83166;93;2589039;100;985406;18520;5905
26063;Buis-les-Baronnies;1427;26429537;975699;632;19136047;795;7293490;18521;5906
86120;Lathus-Saint-Rémy;699;12946229;434842;297;9068592;402;3877637;18521;5907
04097;La Javie;226;4185936;137158;109;2908110;117;1277826;18522;5908
36153;Paulnay;225;4167500;137334;102;2904143;123;1263357;18522;5909
31308;Luscan;34;629790;28204;13;400070;21;229720;18523;5910
32291;Mormès;74;1370722;44348;32;1048853;42;321869;18523;5911
35332;Teillay;551;10206561;170808;261;7012119;290;3194442;18524;5912
21309;Griselles;59;1092903;23678;25;726985;34;365918;18524;5913
2B152;Luri;500;9261954;543928;200;6698057;300;2563897;18524;5914
62027;Ambrines;124;2296979;73990;54;1565077;70;731902;18524;5915
24267;Mescoules;101;1871019;57770;45;1352538;56;518481;18525;5916
2A282;Soccia;68;1259719;39887;32;877444;36;382275;18525;5917
61120;Coudehard;46;852168;20804;18;624293;28;227875;18525;5918
72264;Sablé-sur-Sarthe;7044;130492989;4697016;3374;96713555;3670;33779434;18525;5919
72121;Douillet;175;3242039;62317;80;2151817;95;1090222;18526;5920
12097;Espeyrac;149;2760407;52226;64;1934448;85;825959;18526;5921
89005;Ancy-le-Franc;618;11449350;429683;273;7935678;345;3513672;18526;5922
88515;Vioménil;93;1723012;55896;44;1299296;49;423716;18527;5923
80561;Montdidier;3730;69105967;2931376;1606;49340201;2124;19765766;18527;5924
11103;Couiza;647;11987073;381234;265;8174220;382;3812853;18527;5925
59429;Neuville-sur-Escaut;1440;26679751;656921;694;18998699;746;7681052;18528;5926
65381;Sabarros;25;463205;20290;12;340743;13;122462;18528;5927
65012;Anla;43;796761;11476;21;562145;22;234616;18529;5928
88242;Houéville;29;537360;13271;14;333994;15;203366;18530;5929
11081;Caunes-Minervois;908;16825392;748989;353;11705996;555;5119396;18530;5930
84138;Valréas;5593;103639413;3887073;2431;73343403;3162;30296010;18530;5931
12021;La Bastide-l'Évêque;479;8876038;253923;181;5629305;298;3246733;18530;5932
29168;Plogoff;839;15547523;527036;355;10521100;484;5026423;18531;5933
14602;Saint-Lambert;144;2668558;89662;73;1900357;71;768201;18532;5934
03226;Saint-Didier-en-Donjon;150;2779755;73986;52;1715536;98;1064219;18532;5935
30321;Sommières;2556;47369391;1897690;1021;33784127;1535;13585264;18533;5936
65275;Lies;43;796913;25797;19;553629;24;243284;18533;5937
31471;Saint-Béat;204;3780711;116942;93;2600303;111;1180408;18533;5938
49309;Saint-Michel-et-Chanveaux;204;3780746;36110;93;2616104;111;1164642;18533;5939
86203;Queaux;322;5967671;229930;138;4155064;184;1812607;18533;5940
57423;Lubécourt;36;667256;11852;16;495688;20;171568;18535;5941
26086;Châtillon-en-Diois;343;6357575;197076;148;4536294;195;1821281;18535;5942
24043;Biron;90;1668189;35249;38;1177350;52;490839;18535;5943
04017;Auzet;54;1000969;17505;24;690645;30;310324;18536;5944
85042;Chaillé-les-Marais;1111;20594299;593808;501;14472570;610;6121729;18537;5945
88223;Gugney-aux-Aulx;93;1723921;59865;42;1259362;51;464559;18537;5946
59571;Solesmes;2539;47065328;1832222;1043;32639807;1496;14425521;18537;5947
50022;Aumeville-Lestre;79;1464454;28499;34;972272;45;492182;18537;5948
23042;Ceyroux;80;1482999;49614;32;975502;48;507497;18537;5949
24396;Saint-Cyprien;966;17907644;672478;404;12297780;562;5609864;18538;5950
89381;Sceaux;85;1575840;33105;39;1123806;46;452034;18539;5951
22284;Saint-Connan;165;3058988;111295;70;2130237;95;928751;18539;5952
24413;Saint-Georges-Blancaneix;130;2410119;60978;66;1744072;64;666047;18539;5953
47272;Saint-Quentin-du-Dropt;100;1853958;27280;42;1169477;58;684481;18540;5954
57391;Lemoncourt;43;797222;24225;25;630992;18;166230;18540;5955
04186;Saint-Laurent-du-Verdon;45;834304;16613;21;575242;24;259062;18540;5956
47290;La Sauvetat-du-Dropt;307;5691909;167957;135;4072482;172;1619427;18540;5957
08288;Mesmont;60;1112441;30693;26;778314;34;334127;18541;5958
24404;Saint-Félix-de-Reillac-et-Mortemart;111;2058064;75606;44;1430196;67;627868;18541;5959
79057;Brioux-sur-Boutonne;893;16557259;560474;375;11603875;518;4953384;18541;5960
40197;Morcenx;2643;49005193;1446145;1239;34648705;1404;14356488;18542;5961
43088;Espalem;141;2614359;42846;62;1861486;79;752873;18542;5962
52479;Sommevoire;430;7972919;232063;216;5886549;214;2086370;18542;5963
17181;Grandjean;163;3022409;66386;71;2163993;92;858416;18542;5964
81165;Milhars;157;2911159;104625;69;2069424;88;841735;18542;5965
21531;Rouvray;355;6582909;256319;153;4497105;202;2085804;18543;5966
76537;Ronchois;90;1669018;28579;41;1208656;49;460362;18545;5967
59104;Boussois;1695;31433403;955390;784;22211163;911;9222240;18545;5968
76652;Saint-Vaast-d'Équiqueville;347;6435146;182785;162;4733514;185;1701632;18545;5969
52200;Flagey;49;908795;27049;28;675746;21;233049;18547;5970
21364;Magny-Lambert;60;1112816;36054;26;772700;34;340116;18547;5971
11028;Belcaire;261;4841043;170383;120;3483664;141;1357379;18548;5972
06134;Séranon;255;4729855;94241;124;3387604;131;1342251;18548;5973
2B347;Vezzani;188;3487247;194815;73;2487448;115;999799;18549;5974
50037;La Bazoge;80;1483938;26484;40;1023873;40;460065;18549;5975
16410;Villegats;135;2504297;68545;71;1888194;64;616103;18550;5976
32227;Manciet;482;8941282;279386;206;6146945;276;2794337;18550;5977
88304;Mirecourt;3358;62292829;2850441;1505;46885175;1853;15407654;18551;5978
82155;Saint-Antonin-Noble-Val;1129;20943857;774662;432;13958104;697;6985753;18551;5979
43069;Chenereilles;156;2893988;52203;61;1834840;95;1059148;18551;5980
12115;L'Hospitalet-du-Larzac;144;2671378;43782;63;1876163;81;795215;18551;5981
14636;Saint-Ouen-des-Besaces;199;3691750;40155;86;2428816;113;1262934;18552;5982
05129;Saint-André-de-Rosans;86;1595442;34834;40;1162095;46;433347;18552;5983
17234;Migré;201;3728916;91799;85;2608418;116;1120498;18552;5984
09221;Ornolac-Ussat-les-Bains;135;2504521;85061;56;1673040;79;831481;18552;5985
31011;Arbas;142;2634405;83223;66;1932242;76;702163;18552;5986
57335;Honskirch;121;2244826;27538;52;1451804;69;793022;18552;5987
14441;Mont-Bertrand;113;2096418;37277;49;1397886;64;698532;18552;5988
03155;Lurcy-Lévis;1212;22485723;1018229;508;15772270;704;6713453;18553;5989
80586;Nesle-l'Hôpital;96;1781104;52632;56;1434723;40;346381;18553;5990
47141;Laussou;159;2949992;115951;69;2183577;90;766415;18553;5991
03112;Étroussat;373;6920422;238547;169;4939638;204;1980784;18553;5992
76305;Gonfreville-l'Orcher;4926;91402513;2676899;2424;68093735;2502;23308778;18555;5993
11351;Saint-Laurent-de-la-Cabrerisse;404;7496283;194417;176;5176078;228;2320205;18555;5994
60387;Marseille-en-Beauvaisis;704;13062832;419963;341;9344548;363;3718284;18555;5995
94074;Valenton;6201;115063696;3691384;2981;83547714;3220;31515982;18556;5996
16411;Villejésus;328;6086400;149745;143;4035870;185;2050530;18556;5997
33371;Saint-Antoine;233;4323625;126701;108;3057813;125;1265812;18556;5998
09204;Montesquieu-Avantès;142;2635004;81187;53;1764132;89;870872;18556;5999
82183;Tréjouls;117;2171124;42636;51;1494981;66;676143;18557;6000
58145;Lormes;820;15216532;441066;361;10645836;459;4570696;18557;6001
16337;Saint-Maurice-des-Lions;511;9482544;283046;208;6285640;303;3196904;18557;6002
33227;Langon;4952;91894962;4353415;2209;67702144;2743;24192818;18557;6003
03248;Saint-Nicolas-des-Biefs;105;1948515;122146;36;1361577;69;586938;18557;6004
18109;Henrichemont;1159;21508399;832250;499;15359254;660;6149145;18558;6005
09239;Quérigut;83;1540299;49418;42;1176296;41;364003;18558;6006
46063;Castelnau-Montratier;1152;21378910;855099;468;15203960;684;6174950;18558;6007
70186;La Creuse;39;723772;14698;17;532005;22;191767;18558;6008
08376;Sailly;136;2523951;41217;58;1560032;78;963919;18558;6009
63231;La Monnerie-le-Montel;1070;19857846;709188;460;13634178;610;6223668;18559;6010
82037;Caussade;4112;76315211;3123451;1738;54320845;2374;21994366;18559;6011
71045;Bouhans;83;1540460;26090;34;1021692;49;518768;18560;6012
44007;Avessac;1343;24926349;527180;613;17139041;730;7787308;18560;6013
66136;Perpignan;70226;1303432575;75373726;29594;987619017;40632;315813558;18561;6014
47142;Lauzun;429;7962475;329056;169;5664663;260;2297812;18561;6015
25057;Bethoncourt;2894;53714358;1875275;1250;36802998;1644;16911360;18561;6016
36186;Saint-Christophe-en-Boucherie;151;2802706;87435;68;1961865;83;840841;18561;6017
79122;Fontenille-Saint-Martin-d'Entraigues;315;5846709;143005;140;3900562;175;1946147;18561;6018
17417;Salignac-de-Mirambeau;87;1614809;56995;39;1216406;48;398403;18561;6019
32077;Castelnau-d'Anglès;54;1002305;33751;27;764799;27;237506;18561;6020
86118;Journet;199;3693745;68225;95;2683273;104;1010472;18562;6021
16108;Coulonges;86;1596343;52099;39;1136868;47;459475;18562;6022
47127;Lafitte-sur-Lot;472;8761636;374737;176;5781494;296;2980142;18563;6023
62872;Wamin;131;2431726;73079;60;1756182;71;675544;18563;6024
66215;Trévillach;82;1522157;39888;33;1049918;49;472239;18563;6025
34200;Pézènes-les-Mines;129;2394614;69395;59;1771922;70;622692;18563;6026
15117;Marcolès;342;6348661;201909;133;4136447;209;2212214;18563;6027
23007;Ars;149;2765945;92534;70;2005009;79;760936;18563;6028
29034;Le Cloître-Saint-Thégonnec;363;6738561;132558;176;5035467;187;1703094;18564;6029
24514;Saint-Vivien;149;2766000;90931;68;2040292;81;725708;18564;6030
64004;Abitain;61;1132458;20893;29;824665;32;307793;18565;6031
32101;Céran;107;1986454;45648;53;1476573;54;509881;18565;6032
85111;L'Île-d'Elle;863;16022418;505924;403;11397838;460;4624580;18566;6033
58144;Livry;383;7110804;194763;173;4856688;210;2254116;18566;6034
88411;Saint-Baslemont;46;854058;33158;21;571124;25;282934;18566;6035
50181;Feugères;180;3342049;48850;73;2030986;107;1311063;18567;6036
18009;Arcomps;178;3304931;54403;88;2424275;90;880656;18567;6037
17249;Mortiers;114;2116648;98783;44;1494410;70;622238;18567;6038
33486;Saint-Trojan;178;3305001;72919;75;2170835;103;1134166;18567;6039
26126;Eygalayes;48;891244;28411;23;669249;25;221995;18568;6040
24511;Saint-Vincent-Jalmoutiers;144;2673733;85293;61;1825478;83;848255;18568;6041
17236;Mirambeau;873;16209740;795631;342;11282028;531;4927712;18568;6042
08059;Belval-Bois-des-Dames;24;445635;13616;12;337574;12;108061;18568;6043
62322;Famechon;65;1206932;14962;34;887087;31;319845;18568;6044
61157;Exmes;155;2878129;64725;77;2071203;78;806926;18569;6045
23146;Nouzerines;136;2525434;99716;54;1677697;82;847737;18569;6046
29291;Trégourez;549;10194995;223311;242;6866326;307;3328669;18570;6047
62264;Dannes;694;12887762;257955;319;8882552;375;4005210;18570;6048
62236;Contes;189;3510096;71407;100;2511355;89;998741;18572;6049
46154;Laramière;185;3435916;67867;83;2492112;102;943804;18573;6050
39063;Bonlieu;146;2711634;77071;62;1699069;84;1012565;18573;6051
29070;Guiler-sur-Goyen;302;5609135;109662;142;3866875;160;1742260;18573;6052
22204;Ploëzal;723;13428943;367350;320;9228510;403;4200433;18574;6053
56080;Guilliers;736;13670653;394083;338;9719565;398;3951088;18574;6054
40193;Montégut;39;724403;21853;19;537562;20;186841;18574;6055
43103;Grenier-Montgon;72;1337388;47012;34;962730;38;374658;18575;6056
80194;Chuignes;74;1374540;40089;27;825168;47;549372;18575;6057
50494;Saint-Jean-du-Corail;148;2749100;63252;66;1842535;82;906565;18575;6058
70549;La Vernotte;39;724433;17558;16;499399;23;225034;18575;6059
63465;Viverols;257;4773957;143527;125;3470842;132;1303115;18576;6060
09139;L'Hospitalet-près-l'Andorre;37;687305;12675;19;488654;18;198651;18576;6061
32181;Laguian-Mazous;155;2879270;74256;80;2119044;75;760226;18576;6062
44086;Lusanger;557;10346829;212876;247;7287373;310;3059456;18576;6063
89019;Arthonnay;100;1857643;78689;47;1442914;53;414729;18576;6064
56188;Quistinic;847;15734278;490743;399;11165970;448;4568308;18576;6065
48014;Bagnols-les-Bains;128;2377882;64295;62;1670143;66;707739;18577;6066
79176;Ménigoute;507;9419023;323458;197;6358377;310;3060646;18578;6067
31343;Mirambeau;38;705968;33221;16;513712;22;192256;18578;6068
71207;Fretterans;149;2768151;41645;59;1776998;90;991153;18578;6069
09027;Augirein;33;613095;34580;13;481211;20;131884;18579;6070
15042;La Chapelle-Laurent;176;3269871;113974;70;2271471;106;998400;18579;6071
88272;Lironcourt;40;743161;20804;19;514219;21;228942;18579;6072
42095;Firminy;9871;183396943;6005648;4625;129574245;5246;53822698;18579;6073
2B281;Sisco;613;11389270;495863;277;8474031;336;2915239;18580;6074
27431;La Neuve-Lyre;341;6335697;314199;163;4719604;178;1616093;18580;6075
21663;Venarey-les-Laumes;1827;33945267;1086342;935;24698811;892;9246456;18580;6076
73090;La Compôte;147;2731271;53516;75;1952371;72;778900;18580;6077
62457;Houdain;3984;74025180;2238480;1613;49893984;2371;24131196;18581;6078
97133;Vieux-Fort;1083;20123373;868343;387;14727972;696;5395401;18581;6079
46085;Cuzac;126;2341261;36417;55;1592204;71;749057;18581;6080
63037;Bertignat;299;5555859;195989;141;4129270;158;1426589;18581;6081
08254;Liart;288;5351465;138299;118;3653923;170;1697542;18581;6082
07201;Ruoms;1546;28727579;1102653;672;19965137;874;8762442;18582;6083
22335;Senven-Léhart;133;2471410;49440;61;1793355;72;678055;18582;6084
66148;Port-Vendres;2651;49261178;2627720;1139;35358036;1512;13903142;18582;6085
24161;Église-Neuve-d'Issac;71;1319334;69380;28;946915;43;372419;18582;6086
33309;Ordonnac;271;5035881;120731;133;3591673;138;1444208;18583;6087
30266;Saint-Jean-de-Maruéjols-et-Avéjan;544;10109056;296882;228;7007563;316;3101493;18583;6088
72071;Château-du-Loir;2884;53593438;2011842;1269;39068596;1615;14524842;18583;6089
55322;Marson-sur-Barboure;32;594684;17909;14;424753;18;169931;18584;6090
86106;Glénouze;67;1245205;72331;22;748037;45;497168;18585;6091
88112;Colroy-la-Grande;308;5724522;121948;152;4028756;156;1695766;18586;6092
72240;Poncé-sur-le-Loir;238;4423533;139762;107;3118492;131;1305041;18586;6093
2A312;Santa-Maria-Siché;252;4683759;200944;113;3509940;139;1173819;18586;6094
30038;Bez-et-Esparon;208;3865976;101734;98;2714478;110;1151498;18586;6095
40028;Bastennes;148;2750799;55449;61;1821694;87;929105;18586;6096
25625;Villers-la-Combe;28;520445;7395;14;373764;14;146681;18587;6097
49140;Fontevraud-l'Abbaye;866;16097113;576675;490;12348856;376;3748257;18588;6098
27386;Le Manoir;649;12063942;259597;342;8816760;307;3247182;18589;6099
65413;Sazos;78;1449919;54757;38;1091223;40;358696;18589;6100
58203;Oulon;49;910847;26938;26;680894;23;229953;18589;6101
40076;Cauna;248;4610015;96508;125;3294703;123;1315312;18589;6102
63419;Servant;292;5427979;154886;139;3736328;153;1691651;18589;6103
65308;Mazerolles;65;1208296;34220;27;828366;38;379930;18589;6104
55181;Étain;2174;40413708;1123518;991;27336090;1183;13077618;18590;6105
24038;Bertric-Burée;255;4740368;115178;118;3377968;137;1362400;18590;6106
21525;La Roche-en-Brenil;541;10057256;331913;233;7036921;308;3020335;18590;6107
19260;Sioniac;147;2732899;86099;71;1996536;76;736363;18591;6108
46050;Cambayrac;99;1840533;45784;52;1444464;47;396069;18591;6109
82026;Bruniquel;403;7492660;280042;166;5192089;237;2300571;18592;6110
50112;La Chaise-Baudouin;239;4443704;97122;102;2951874;137;1491830;18593;6111
48036;Cassagnas;63;1171386;29811;29;802104;34;369282;18593;6112
64436;Ossès;425;7902337;230857;185;5449008;240;2453329;18594;6113
46062;Castelfranc;227;4220883;105003;103;3004301;124;1216582;18594;6114
55256;Jonville-en-Woëvre;83;1543321;40014;45;1156078;38;387243;18594;6115
70580;Vy-le-Ferroux;97;1803641;36186;53;1299310;44;504331;18594;6116
16046;Blanzac-Porcheresse;442;8218846;269420;194;5861937;248;2356909;18595;6117
18093;Faverdines;81;1506185;60824;38;1106865;43;399320;18595;6118
01029;Beaupont;357;6638562;174169;164;5004960;193;1633602;18595;6119
24083;Carsac-de-Gurson;112;2082719;72419;44;1429955;68;652764;18596;6120
35259;Saint-Broladre;594;11045969;291609;255;7605801;339;3440168;18596;6121
72311;Saint-Pierre-de-Chevillé;202;3756490;61379;92;2571566;110;1184924;18596;6122
34060;Causse-de-la-Selle;203;3775253;91669;80;2428015;123;1347238;18597;6123
87018;Blond;426;7922473;255342;191;5696850;235;2225623;18597;6124
25478;Randevillers;66;1227443;32285;29;848993;37;378450;18598;6125
55199;Froidos;54;1004320;28099;24;691491;30;312829;18599;6126
50155;Crollon;140;2603793;38458;69;1802840;71;800953;18599;6127
53125;Landivy;656;12200634;225705;287;8022342;369;4178292;18599;6128
30210;Quissac;1678;31209297;866105;720;21879358;958;9329939;18599;6129
46254;Saint-Chels;87;1618136;50805;37;1087210;50;530926;18599;6130
65051;Aventignan;130;2417946;74235;62;1706064;68;711882;18600;6131
08453;Toges;60;1115978;31490;32;840113;28;275865;18600;6132
32072;Callian;29;539390;16594;13;409155;16;130235;18600;6133
60416;Montgérain;100;1860006;61155;43;1254619;57;605387;18600;6134
65287;Loures-Barousse;453;8426073;458809;187;6081610;266;2344463;18601;6135
24461;Saint-Méard-de-Gurçon;445;8277321;307289;196;5860795;249;2416526;18601;6136
63318;Saint-Angel;247;4594598;148530;120;3282029;127;1312569;18602;6137
59430;Neuvilly;581;10807906;294653;253;7374998;328;3432908;18602;6138
16345;Saint-Quentin-sur-Charente;126;2343884;62785;63;1750260;63;593624;18602;6139
61233;Lonlay-le-Tesson;130;2418322;13412;65;1704701;65;713621;18602;6140
80040;Aumâtre;116;2157938;44402;58;1632558;58;525380;18603;6141
03118;Gannat;3424;63698120;2370662;1583;45817667;1841;17880453;18603;6142
39385;Neublans-Abergement;287;5339411;188791;136;3884151;151;1455260;18604;6143
81007;Alos;52;967502;29956;21;612012;31;355490;18606;6144
04072;Draix;49;911696;27434;21;693642;28;218054;18606;6145
21425;Montbard;3374;62778110;2585078;1592;45964485;1782;16813625;18606;6146
36177;Sacierges-Saint-Martin;187;3479426;145577;83;2351763;104;1127663;18607;6147
25324;Lanans;83;1544389;35926;40;1051587;43;492802;18607;6148
52524;Vignory;156;2902711;105223;76;2089570;80;813141;18607;6149
12150;Monteils;309;5749714;131687;152;4299807;157;1449907;18607;6150
36164;Pouligny-Saint-Martin;130;2418992;46963;58;1569324;72;849668;18608;6151
47183;Montauriol;111;2065503;56834;52;1471457;59;594046;18608;6152
09091;Cazavet;143;2661005;98568;72;2006403;71;654602;18608;6153
36066;Douadic;283;5266191;174601;132;3766708;151;1499483;18608;6154
43238;Séneujols;159;2958774;57996;70;1982364;89;976410;18609;6155
18259;Sury-ès-Bois;174;3237905;114647;82;2435979;92;801926;18609;6156
65362;Pierrefitte-Nestalas;756;14068204;407272;383;10016236;373;4051968;18609;6157
24571;Vergt;992;18460467;619440;426;12949737;566;5510730;18609;6158
33439;Saint-Mariens;814;15148273;427179;372;10818414;442;4329859;18610;6159
31493;Saint-Lary-Boujean;80;1488794;57192;37;1103253;43;385541;18610;6160
32115;Dému;209;3889898;124726;96;2758201;113;1131697;18612;6161
44207;Trans-sur-Erdre;516;9603958;243434;210;6417478;306;3186480;18612;6162
50158;Cuves;177;3294408;98209;71;2174478;106;1119930;18612;6163
72251;René;204;3796979;126815;96;2711384;108;1085595;18613;6164
63067;La Cellette;92;1712408;53803;38;1134565;54;577843;18613;6165
18111;Humbligny;116;2159140;60400;58;1574352;58;584788;18613;6166
12214;Saint-Chély-d'Aubrac;299;5565469;192797;120;3948619;179;1616850;18614;6167
31503;Saint-Martory;566;10535571;400554;240;7360462;326;3175109;18614;6168
79090;Chizé;538;10014918;276468;216;7224214;322;2790704;18615;6169
89270;Mouffy;73;1358917;58356;36;1011541;37;347376;18615;6170
05153;Saint-Michel-de-Chaillol;221;4114063;130542;104;3074523;117;1039540;18616;6171
24326;Peyzac-le-Moustier;107;1991899;49133;43;1421093;64;570806;18616;6172
16275;Ranville-Breuillaud;104;1936059;86387;42;1299619;62;636440;18616;6173
23082;Fleurat;180;3350887;94847;82;2439618;98;911269;18616;6174
2A181;Ocana;279;5193897;141856;137;3842039;142;1351858;18616;6175
22095;Landebaëron;106;1973397;50377;46;1363638;60;609759;18617;6176
88149;Dommartin-lès-Vallois;25;465424;4906;12;335336;13;130088;18617;6177
35119;Gennes-sur-Seiche;469;8731412;74535;223;6152513;246;2578899;18617;6178
82153;Saint-Amans-du-Pech;115;2140987;39719;49;1469848;66;671139;18617;6179
2B274;Scolca;48;893642;34275;19;566842;29;326800;18618;6180
16040;Berneuil;190;3537506;161207;79;2463153;111;1074353;18618;6181
62602;Nempont-Saint-Firmin;98;1824613;49977;49;1376429;49;448184;18619;6182
70194;Cuve;91;1694330;43351;44;1213841;47;480489;18619;6183
16381;Theil-Rabier;88;1638555;21336;42;1181145;46;457410;18620;6184
88319;Moyenmoutier;1890;35193599;892136;899;24493255;991;10700344;18621;6185
44124;Le Pin;392;7299841;100813;166;4962875;226;2336966;18622;6186
30137;Lamelouze;63;1173216;39128;28;880635;35;292581;18622;6187
61169;Flers;8883;165428138;7401834;3830;117945295;5053;47482843;18623;6188
50040;Beauficel;87;1620205;39277;41;1087820;46;532385;18623;6189
80518;Martainneville;210;3910928;72009;103;2852687;107;1058241;18623;6190
36062;Cuzion;301;5605847;194212;138;3941967;163;1663880;18624;6191
18153;Morlac;183;3408325;120648;84;2507514;99;900811;18625;6192
43237;Sembadel;137;2551609;66311;63;1766060;74;785549;18625;6193
07176;Planzolles;71;1322379;34432;34;944386;37;377993;18625;6194
17017;Archingeay;346;6444657;195754;153;4518911;193;1925746;18626;6195
02232;Coyolles;209;3892979;165228;79;2804367;130;1088612;18627;6196
60399;Le Mesnil-Saint-Firmin;95;1769544;46541;43;1188066;52;581478;18627;6197
50228;Hambye;662;12331250;379599;250;7935567;412;4395683;18627;6198
70257;Fretigney-et-Velloreille;382;7115752;206929;173;4991973;209;2123779;18628;6199
24188;Fossemagne;335;6240409;227772;130;4088716;205;2151693;18628;6200
18052;Charenton-du-Cher;657;12238683;440733;300;8847338;357;3391345;18628;6201
52233;Guyonvelle;66;1229461;29905;28;809561;38;419900;18628;6202
57336;L'Hôpital;2984;55587805;1261583;1441;38781353;1543;16806452;18629;6203
46015;Bagnac-sur-Célé;900;16765839;496357;408;11917147;492;4848692;18629;6204
02657;Rougeries;120;2235446;80752;47;1504792;73;730654;18629;6205
23225;Saint-Oradoux-près-Crocq;68;1266780;48358;23;862846;45;403934;18629;6206
11076;Castelnaudary;6237;116190041;4683585;2749;83835837;3488;32354204;18629;6207
47249;Saint-Laurent;254;4731877;108333;103;3119847;151;1612030;18629;6208
42163;La Pacaudière;662;12332752;388891;286;8349626;376;3983126;18630;6209
62885;Westrehem;125;2328854;60942;50;1536468;75;792386;18631;6210
63128;Crevant-Laveine;553;10302927;310277;263;7580080;290;2722847;18631;6211
19061;Cornil;810;15092306;565720;347;10840885;463;4251421;18632;6212
02602;Pinon;967;18017763;562074;447;12703525;520;5314238;18633;6213
09277;Saint-Ybars;376;7005921;256823;170;4978028;206;2027893;18633;6214
46173;Limogne-en-Quercy;496;9241956;321833;228;6722171;268;2519785;18633;6215
46195;Molières;208;3875718;130435;100;2889825;108;985893;18633;6216
17085;Champdolent;215;4006175;48223;106;2782301;109;1223874;18633;6217
24479;Saint-Pardoux-la-Rivière;728;13565187;442248;329;9474974;399;4090213;18633;6218
17138;Dampierre-sur-Boutonne;167;3111821;100651;78;2319913;89;791908;18634;6219
73166;Montendry;29;540381;19827;16;421396;13;118985;18634;6220
34145;Lunel;14751;274868097;10025266;6408;199208046;8343;75660051;18634;6221
38509;La Tour-du-Pin;4654;86722284;3368675;2188;62953650;2466;23768634;18634;6222
14174;Condé-sur-Noireau;3085;57486688;2204677;1363;41279801;1722;16206887;18634;6223
57520;Obreck;27;503126;15621;11;350896;16;152230;18634;6224
08107;Château-Porcien;748;13938806;512203;296;9398059;452;4540747;18635;6225
21139;Champeau-en-Morvan;153;2851166;76160;72;2050691;81;800475;18635;6226
14573;Saint-Denis-Maisoncelles;63;1174027;38009;24;793349;39;380678;18635;6227
17457;Vandré;427;7957750;135575;200;5618073;227;2339677;18636;6228
71288;Massy;32;596381;17112;12;365365;20;231016;18637;6229
26098;Cobonne;90;1677323;40266;36;1081284;54;596039;18637;6230
17310;Saint-André-de-Lidon;547;10194629;242735;255;7300216;292;2894413;18637;6231
18184;Précy;211;3932505;102952;81;2504664;130;1427841;18637;6232
24264;Ménesplet;968;18041149;561717;498;13460727;470;4580422;18638;6233
32104;Clermont-Pouyguillès;107;1994231;40818;52;1371233;55;622998;18638;6234
49348;Tigné;415;7734665;156213;182;5222629;233;2512036;18638;6235
86253;Sanxay;332;6187744;168784;149;4264027;183;1923717;18638;6236
58024;Bazolles;189;3522556;145231;96;2812100;93;710456;18638;6237
35174;Mellé;352;6560574;130468;162;4575308;190;1985266;18638;6238
19002;Aix;240;4473219;112167;116;3346523;124;1126696;18638;6239
81069;Cordes-sur-Ciel;597;11127178;504032;234;7853478;363;3273700;18638;6240
80259;Dromesnil;56;1043793;35533;34;854026;22;189767;18639;6241
66082;Formiguères;238;4436163;98494;120;3334672;118;1101491;18639;6242
03082;Commentry;4083;76104858;2722268;1950;56003364;2133;20101494;18639;6243
24309;Neuvic;1930;35974272;1116289;860;25225970;1070;10748302;18640;6244
40057;Buanes;155;2889203;56730;80;2182576;75;706627;18640;6245
18270;Vallenay;453;8444115;307440;236;6324624;217;2119491;18640;6246
61080;Chahains;50;932028;552;22;647895;28;284133;18641;6247
16347;Saint-Romain;266;4958438;123788;117;3313749;149;1644689;18641;6248
62670;Preures;310;5778946;106941;130;3876277;180;1902669;18642;6249
32116;Duffort;76;1416780;39890;34;1021953;42;394827;18642;6250
22296;Saint-Glen;335;6245164;106854;156;4504020;179;1741144;18642;6251
2A360;Zigliara;94;1752381;100982;44;1400936;50;351445;18642;6252
16184;Lichères;60;1118543;32154;33;863822;27;254721;18642;6253
44001;Abbaretz;1001;18661034;347354;421;12166156;580;6494878;18642;6254
73234;Saint-François-de-Sales;99;1845672;30400;56;1426759;43;418913;18643;6255
86098;Fleix;94;1752495;35113;44;1228536;50;523959;18644;6256
43135;Le Monastier-sur-Gazeille;1054;19650561;608419;478;13915823;576;5734738;18644;6257
46006;Anglars-Nozac;192;3579630;86195;92;2547582;100;1032048;18644;6258
62277;Drocourt;1540;28712165;693184;697;20063018;843;8649147;18644;6259
21460;Noiron-sur-Seine;52;969504;36564;25;695125;27;274379;18644;6260
53190;Le Ribay;245;4568036;49812;112;2913297;133;1654739;18645;6261
15224;La Ségalassière;74;1379751;26744;29;925945;45;453806;18645;6262
30064;Campestre-et-Luc;83;1547567;36639;29;941600;54;605967;18645;6263
01079;Champagne-en-Valromey;475;8856945;278077;202;6429276;273;2427669;18646;6264
24564;Vanxains;397;7402581;271429;173;5311108;224;2091473;18646;6265
81276;Salvagnac;659;12288570;360192;277;8684859;382;3603711;18647;6266
18112;Ids-Saint-Roch;183;3412489;90962;81;2310162;102;1102327;18647;6267
2B172;Murato;364;6787713;336700;166;5152379;198;1635334;18648;6268
43100;Frugières-le-Pin;89;1659643;79992;33;1152360;56;507283;18648;6269
71220;Gilly-sur-Loire;299;5575878;100251;157;4136605;142;1439273;18648;6270
71239;Issy-l'Évêque;467;8708852;300861;186;5855013;281;2853839;18649;6271
62473;Isbergues;5064;94436069;2726562;2318;65941696;2746;28494373;18649;6272
02578;Oulches-la-Vallée-Foulon;39;727305;15032;21;576178;18;151127;18649;6273
63228;Miremont;203;3785782;125066;95;2717895;108;1067887;18649;6274
32203;Lauraët;139;2592296;91486;58;1817625;81;774671;18650;6275
24172;Les Eyzies-de-Tayac-Sireuil;540;10071006;411398;242;7219902;298;2851104;18650;6276
19144;Montgibaud;129;2405866;53081;58;1717706;71;688160;18650;6277
07058;Chassiers;584;10891779;397554;271;8285484;313;2606295;18650;6278
58069;Chaumot;92;1715838;36975;54;1368443;38;347395;18650;6279
62661;Bouin-Plumoison;274;5110267;122384;126;3683447;148;1426820;18651;6280
82101;Malause;604;11265081;256248;276;7894638;328;3370443;18651;6281
2A348;Vico;620;11563550;522791;292;8798637;328;2764913;18651;6282
08490;Vouziers;2496;46552749;2390046;1063;34628718;1433;11924031;18651;6283
2B207;Penta-di-Casinca;1814;33832988;1388254;785;24611609;1029;9221379;18651;6284
81205;Péchaudier;100;1865150;40498;43;1278937;57;586213;18652;6285
47151;Loubès-Bernac;187;3487869;155403;79;2522711;108;965158;18652;6286
35095;Dol-de-Bretagne;3236;60357358;1964401;1429;43226979;1807;17130379;18652;6287
88116;Cornimont;2054;38310921;1055407;963;26656304;1091;11654617;18652;6288
32395;Sainte-Mère;122;2275553;58347;48;1493983;74;781570;18652;6289
14327;Hérouville-Saint-Clair;11760;219351108;9171502;5811;165934025;5949;53417083;18652;6290
12077;Cornus;197;3674530;63077;88;2554133;109;1120397;18652;6291
21271;Flavigny-sur-Ozerain;193;3599930;223114;76;2777678;117;822252;18652;6292
88058;Biécourt;56;1044550;29955;27;706551;29;337999;18653;6293
10033;Bar-sur-Aube;3120;58199425;2330803;1397;42433654;1723;15765771;18654;6294
87004;Augne;64;1193908;45763;32;925305;32;268603;18655;6295
39565;Villeneuve-d'Aval;48;895433;9547;24;659795;24;235638;18655;6296
47190;Montpezat;337;6286803;180788;138;4496242;199;1790561;18655;6297
62108;Berck;9310;173685762;7652270;4463;132272878;4847;41412884;18656;6298
49036;Bouillé-Ménard;377;7033753;54795;172;4624318;205;2409435;18657;6299
61345;Rémalard;744;13881001;413191;345;9872961;399;4008040;18657;6300
65319;Montégut;91;1697857;53489;44;1264910;47;432947;18658;6301
70056;Baulay;181;3377068;98945;90;2419988;91;957080;18658;6302
79354;Vouhé;204;3806243;67624;95;2686223;109;1120020;18658;6303
79168;Massais;301;5616193;89003;138;3925016;163;1691177;18658;6304
80596;Neuvillette;115;2145736;40469;56;1527835;59;617901;18659;6305
19137;Meyrignac-l'Église;32;597116;7863;16;380991;16;216125;18660;6306
84035;Cavaillon;15695;292869889;12581259;6783;210695668;8912;82174221;18660;6307
35297;Saint-Méen-le-Grand;2638;49226110;1441158;1265;35701330;1373;13524780;18660;6308
64175;Castet;87;1623461;56792;34;1051225;53;572236;18660;6309
70243;Fontenois-lès-Montbozon;155;2892400;38253;71;2006184;84;886216;18661;6310
58201;Oudan;88;1642271;49090;49;1256857;39;385414;18662;6311
17283;Pons;2586;48261166;1726256;1167;34860319;1419;13400847;18662;6312
22061;Glomel;853;15919722;576101;373;11549569;480;4370153;18663;6313
76259;Fécamp;12113;226069434;9101702;5569;164420981;6544;61648453;18663;6314
82186;Valence;3068;57259437;2169069;1302;40820640;1766;16438797;18663;6315
62188;Burbure;1610;30048545;752535;709;20257746;901;9790799;18664;6316
70344;Meurcourt;177;3303536;63495;91;2377041;86;926495;18664;6317
22041;Coatascorn;128;2388998;47386;67;1767279;61;621719;18664;6318
55350;Montigny-lès-Vaucouleurs;50;933213;26670;28;708639;22;224574;18664;6319
36074;Fléré-la-Rivière;330;6159237;188430;153;4375443;177;1783794;18664;6320
88089;La Chapelle-devant-Bruyères;325;6066052;86864;153;4194815;172;1871237;18665;6321
62093;Beaulencourt;135;2519751;66493;64;1968906;71;550845;18665;6322
40078;Caupenne;230;4292943;97719;99;2958546;131;1334397;18665;6323
86078;Civray;1668;31133330;1178747;705;22104899;963;9028431;18665;6324
36020;Bonneuil;54;1007916;40348;21;638617;33;369299;18665;6325
16003;Agris;486;9071281;227187;244;6707935;242;2363346;18665;6326
80688;Rue;1879;35072611;1266063;795;23943089;1084;11129522;18666;6327
22244;Plussulien;267;4983872;159503;121;3586391;146;1397481;18666;6328
62455;Hocquinghen;59;1101330;9591;28;792819;31;308511;18667;6329
89343;Saint-Denis-sur-Ouanne;88;1642669;43012;47;1215828;41;426841;18667;6330
57099;Bourdonnay;136;2538742;60578;56;1737934;80;800808;18667;6331
80440;Hiermont;74;1381391;41277;32;963909;42;417482;18667;6332
64234;Garos;134;2501468;67722;65;1800897;69;700571;18668;6333
86192;Plaisance;92;1717456;40108;34;1075433;58;642023;18668;6334
50336;Montaigu-les-Bois;126;2352232;38039;61;1672216;65;680016;18669;6335
46142;Lacapelle-Cabanac;91;1698845;35191;43;1242749;48;456096;18669;6336
62890;Willeman;103;1922897;33849;46;1268432;57;654465;18669;6337
47064;Cazideroque;135;2520367;74693;50;1608289;85;912078;18669;6338
10218;Maisons-lès-Chaource;109;2034968;82576;51;1516047;58;518921;18669;6339
39308;Malange;149;2781765;63824;54;1832009;95;949756;18670;6340
46133;Issepts;121;2259040;27809;54;1585411;67;673629;18670;6341
60439;Mouy;3066;57242183;1724047;1559;43161169;1507;14081014;18670;6342
55119;Cléry-le-Petit;117;2184406;36991;63;1594440;54;589966;18670;6343
14614;Sainte-Marguerite-d'Elle;409;7636127;132229;190;5254581;219;2381546;18670;6344
15008;Antignac;181;3379333;103752;88;2357436;93;1021897;18670;6345
61073;La Carneille;326;6086551;152353;154;4250760;172;1835791;18670;6346
19214;Saint-Julien-aux-Bois;305;5694539;175446;135;3978806;170;1715733;18671;6347
79147;Largeasse;390;7281630;171046;170;4865589;220;2416041;18671;6348
17301;Romazières;45;840194;22611;19;578802;26;261392;18671;6349
2A278;Serra-di-Scopamène;62;1157618;69046;26;884874;36;272744;18671;6350
87049;Coussac-Bonneval;804;15011820;497579;357;10324357;447;4687463;18671;6351
70414;Plancher-les-Mines;614;11464277;339420;310;8189296;304;3274981;18671;6352
12087;Cruéjouls;222;4145100;108062;86;2760289;136;1384811;18672;6353
63469;Vollore-Ville;437;8160265;290627;188;5678767;249;2481498;18673;6354
44219;Vritz;415;7749496;159057;191;5560146;224;2189350;18673;6355
32407;Saint-Soulan;93;1736643;30682;43;1275958;50;460685;18674;6356
10140;Ervy-le-Châtel;701;13090189;620374;291;9360502;410;3729687;18674;6357
34170;Montouliers;126;2352874;75578;54;1690623;72;662251;18674;6358
33370;Saint-Androny;342;6386411;239943;148;4664380;194;1722031;18674;6359
18025;Beffes;419;7824808;211961;212;5658727;207;2166081;18675;6360
54382;Mont-Saint-Martin;4014;74962567;1715651;1255;38916346;2759;36046221;18675;6361
2A198;Ota;280;5229098;229019;139;3971661;141;1257437;18675;6362
50352;Montreuil-sur-Lozon;167;3118931;62731;73;2044927;94;1074004;18676;6363
16028;Barbezieux-Saint-Hilaire;2893;54030587;2116702;1236;39211467;1657;14819120;18676;6364
10387;Troyes;35021;654064974;34549041;16519;497821214;18502;156243760;18676;6365
17281;Polignac;80;1494192;15336;36;1048844;44;445348;18677;6366
70211;Écuelle;43;803133;13703;21;584369;22;218764;18678;6367
17317;Saint-Ciers-du-Taillon;306;5715362;205910;128;3896855;178;1818507;18678;6368
55528;Varnéville;33;616379;11400;18;455183;15;161196;18678;6369
40253;Saint-Cricq-Chalosse;344;6425290;154875;160;4529848;184;1895442;18678;6370
12013;Aubin;2362;44117883;1310837;1086;31006456;1276;13111427;18678;6371
64366;Mascaraàs-Haron;60;1120737;51441;28;859993;32;260744;18679;6372
35117;Gaël;891;16643497;352429;421;11833562;470;4809935;18680;6373
88059;Biffontaine;234;4371087;99430;111;3011403;123;1359684;18680;6374
01013;Arandas;87;1625168;37013;45;1233484;42;391684;18680;6375
22333;Saint-Vran;422;7883004;157444;190;5121407;232;2761597;18680;6376
17118;Corignac;184;3437254;80803;82;2409438;102;1027816;18681;6377
16063;Brie-sous-Chalais;101;1886767;56809;46;1265546;55;621221;18681;6378
64489;Saint-Martin-d'Arberoue;152;2839535;55138;67;1937863;85;901672;18681;6379
62779;Sarton;101;1886843;31408;56;1406491;45;480352;18682;6380
71523;Simard;642;11993953;323809;324;9101463;318;2892490;18682;6381
56131;Meslan;812;15170101;340814;362;10391924;450;4778177;18682;6382
35362;Le Tronchet;605;11302979;351381;284;8218278;321;3084701;18683;6383
52257;Laferté-sur-Amance;67;1251755;30353;38;939310;29;312445;18683;6384
24351;Ribagnac;177;3306876;84317;83;2343021;94;963855;18683;6385
23006;Arrènes;146;2727711;123693;61;1942003;85;785708;18683;6386
24151;Doissat;73;1363889;87198;24;875920;49;487969;18683;6387
04198;Saint-Vincent-les-Forts;177;3306982;83223;76;2242322;101;1064660;18684;6388
65061;Barbachen;34;635270;21533;16;436832;18;198438;18684;6389
17255;Nancras;401;7492478;178550;194;5452989;207;2039489;18684;6390
81238;Saint-Amans-Soult;952;17788111;422595;394;11684966;558;6103145;18685;6391
79278;Saint-Martin-du-Fouilloux;130;2429112;50701;51;1483699;79;945413;18685;6392
88413;Saint-Dié-des-Vosges;12555;234596462;10567364;5415;171676642;7140;62919820;18686;6393
17026;Authon-Ébéon;242;4521991;186500;97;3069527;145;1452464;18686;6394
19285;Vigeois;742;13865125;439659;347;10038016;395;3827109;18686;6395
21448;Mussy-la-Fosse;51;952999;6768;28;637081;23;315918;18686;6396
39529;Thésy;36;672717;10141;14;438144;22;234573;18687;6397
22163;Paule;379;7082399;137526;173;5062355;206;2020044;18687;6398
17299;Rochefort;15584;291221492;12314325;7270;217438593;8314;73782899;18687;6399
67046;Bischwiller;6603;123392174;3992066;3023;89658555;3580;33733619;18687;6400
67414;Rothau;915;17099196;435228;461;12126789;454;4972407;18688;6401
65273;Liac;114;2130415;44578;57;1615552;57;514863;18688;6402
08104;Chardeny;27;504573;9900;14;358559;13;146014;18688;6403
07220;Saint-Christol;71;1326876;37240;34;941611;37;385265;18688;6404
86008;Arçay;224;4186240;120410;103;2920014;121;1266226;18689;6405
14115;Bures-les-Monts;73;1364278;36624;27;850602;46;513676;18689;6406
53197;Saint-Aignan-sur-Roë;511;9550055;215601;236;6610117;275;2939938;18689;6407
19084;Forgès;189;3532217;102075;89;2525112;100;1007105;18689;6408
36113;Martizay;615;11494023;305359;250;7449037;365;4044986;18689;6409
32454;Traversères;44;822341;11463;23;612155;21;210186;18690;6410
65272;Lhez;47;878419;18419;29;672004;18;206415;18690;6411
26015;Aubenasson;29;542010;4543;12;343986;17;198024;18690;6412
14740;La Vespière;547;10223454;327747;263;7773535;284;2449919;18690;6413
24218;Jumilhac-le-Grand;759;14186107;501508;331;10039292;428;4146815;18691;6414
81125;Lacaze;183;3420460;96875;63;2269022;120;1151438;18691;6415
58052;Champallement;25;467302;3568;11;298645;14;168657;18692;6416
12237;Saint-Laurent-d'Olt;353;6598444;247743;144;4680479;209;1917965;18692;6417
11295;Portel-des-Corbières;716;13384479;407701;320;9587950;396;3796529;18693;6418
50247;Hocquigny;97;1813483;-248;40;1019457;57;794026;18696;6419
88389;Repel;48;897432;14540;22;643930;26;253502;18697;6420
55422;Regnéville-sur-Meuse;26;486139;12749;15;383834;11;102305;18698;6421
16029;Bardenac;140;2617710;92745;53;1770654;87;847056;18698;6422
50074;Brécey;1292;24157785;682516;525;16322188;767;7835597;18698;6423
65408;Sarrancolin;375;7011759;202802;178;5096849;197;1914910;18698;6424
46040;Cabrerets;141;2636453;153506;69;1982624;72;653829;18698;6425
80482;Limeux;80;1495900;39300;35;1066564;45;429336;18699;6426
14656;Saint-Rémy;613;11462365;285640;306;8215584;307;3246781;18699;6427
53131;Lesbois;110;2056935;47238;51;1369264;59;687671;18699;6428
62610;Neuville-sous-Montreuil;380;7105780;277868;160;4875946;220;2229834;18699;6429
44077;Joué-sur-Erdre;1270;23749034;436389;570;16212756;700;7536278;18700;6430
10312;Racines;88;1645631;27539;45;1147906;43;497725;18700;6431
54562;Verdenal;76;1421239;11750;35;943108;41;478131;18701;6432
80533;Mers-les-Bains;1897;35475544;1399507;936;26522268;961;8953276;18701;6433
46299;Sauliac-sur-Célé;74;1383937;41930;29;917459;45;466478;18702;6434
61444;Saint-Philbert-sur-Orne;70;1309134;26366;34;866226;36;442908;18702;6435
42337;Vivans;129;2412601;39042;63;1753323;66;659278;18702;6436
08178;Fraillicourt;103;1926349;49647;43;1318172;60;608177;18702;6437
50343;Montgardon;240;4488583;88068;116;3185942;124;1302641;18702;6438
34013;Aspiran;853;15954327;461122;348;11235959;505;4718368;18704;6439
81005;Albine;309;5779720;132865;140;3931979;169;1847741;18705;6440
88235;Hautmougey;90;1683415;53154;41;1164530;49;518885;18705;6441
27502;Rugles;1462;27348124;1058615;700;20323871;762;7024253;18706;6442
61235;Loré;86;1608754;69464;39;1183226;47;425528;18706;6443
44058;Fercé;254;4751437;86138;124;3334126;130;1417311;18706;6444
37102;Les Essards;92;1721007;31321;48;1242538;44;478469;18707;6445
83074;La Martre;115;2151277;82872;57;1727584;58;423693;18707;6446
52114;Châteauvillain;934;17472224;572787;429;12452017;505;5020207;18707;6447
61054;Le Bosc-Renoult;129;2413314;52578;57;1699829;72;713485;18708;6448
33180;Gans;118;2207634;70440;52;1549320;66;658314;18709;6449
09198;Montardit;112;2095415;54832;54;1529900;58;565515;18709;6450
48106;Noalhac;49;916751;23063;20;630371;29;286380;18709;6451
12154;Montlaur;381;7128785;165932;170;4999702;211;2129083;18711;6452
02184;Chevresis-Monceau;227;4247404;209913;88;2993083;139;1254321;18711;6453
08467;Vaux-Montreuil;59;1104014;31222;27;798012;32;306002;18712;6454
15162;Riom-ès-Montagnes;1729;32354296;1273464;765;22863854;964;9490442;18713;6455
50593;Teurthéville-Bocage;330;6175303;185893;142;4178692;188;1996611;18713;6456
24482;Saint-Paul-Lizonne;175;3274809;112084;84;2403548;91;871261;18713;6457
16306;Saint-Christophe;194;3630428;125980;73;2402356;121;1228072;18714;6458
12040;Buzeins;108;2021087;58221;49;1326123;59;694964;18714;6459
65338;Orignac;142;2657378;60886;73;1937582;69;719796;18714;6460
54004;Affléville;95;1777839;10553;34;966249;61;811590;18714;6461
65237;Juncalas;112;2096042;69956;54;1549793;58;546249;18715;6462
09138;L'Herm;118;2208350;61103;63;1669642;55;538708;18715;6463
79352;Villiers-sur-Chizé;92;1721769;42721;48;1320847;44;400922;18715;6464
24122;Cladech;58;1085574;31902;28;746764;30;338810;18717;6465
35291;Saint-Marcan;252;4716640;126118;108;3105105;144;1611535;18717;6466
38243;Le Monestier-du-Percy;146;2732691;92431;67;1995023;79;737668;18717;6467
59099;Bousies;933;17463258;556438;410;12697041;523;4766217;18717;6468
48183;Saint-Sauveur-de-Peyre;159;2976056;56418;78;2102434;81;873622;18717;6469
79242;Saint-Clémentin;274;5128812;76393;135;3611633;139;1517179;18718;6470
40322;Uza;94;1759535;55449;43;1208023;51;551512;18718;6471
07189;Ribes;171;3200927;106368;75;2324433;96;876494;18719;6472
2B016;Antisanti;260;4866909;243593;110;3692754;150;1174155;18719;6473
25429;Novillars;801;14994722;561996;382;11888135;419;3106587;18720;6474
14457;Les Moutiers-en-Auge;66;1235527;39572;25;792061;41;443466;18720;6475
2B218;Piedicorte-di-Gaggio;58;1085773;68834;26;889944;32;195829;18720;6476
76216;Déville-lès-Rouen;6303;117993760;4369252;3461;92346447;2842;25647313;18720;6477
73204;Le Pont-de-Beauvoisin;1168;21866360;651872;519;15015463;649;6850897;18721;6478
21154;Châtillon-sur-Seine;3488;65299624;3095839;1589;48525712;1899;16773912;18721;6479
50569;Savigny;215;4025244;27068;105;2796351;110;1228893;18722;6480
39100;Champrougier;61;1142049;23351;29;823842;32;318207;18722;6481
19033;Bugeat;539;10091235;391527;231;6805948;308;3285287;18722;6482
29278;Spézet;1087;20351625;645672;485;14074708;602;6276917;18723;6483
59108;Briastre;343;6421941;109154;168;4516784;175;1905157;18723;6484
52169;Domblain;53;992313;17510;21;648969;32;343344;18723;6485
66048;Cerbère;791;14809874;659146;415;11480236;376;3329638;18723;6486
39084;Cernans;81;1516585;17992;36;994732;45;521853;18723;6487
89007;Andryes;266;4980460;185777;122;3498098;144;1482362;18724;6488
70476;Saponcourt;41;767678;23154;21;556917;20;210761;18724;6489
47099;Fongrave;336;6291343;176803;140;4258956;196;2032387;18724;6490
03229;Saint-Ennemond;362;6778313;172223;175;4810871;187;1967442;18725;6491
72255;Rouessé-Vassé;438;8201917;163700;218;5720423;220;2481494;18726;6492
47030;Blaymont;125;2340813;65533;56;1643539;69;697274;18727;6493
08318;La Neuville-aux-Joûtes;199;3726689;100538;96;2727815;103;998874;18727;6494
02623;Prisces;59;1104909;29327;23;719137;36;385772;18727;6495
03099;Deux-Chaises;235;4400977;146161;116;3160760;119;1240217;18728;6496
79254;Saint-Georges-de-Rex;237;4438559;109888;111;3169516;126;1269043;18728;6497
52308;Maranville;238;4457359;111591;105;2899122;133;1558237;18728;6498
23100;Jarnages;270;5056707;225603;104;3377174;166;1679533;18729;6499
50197;Gavray;853;15975621;509186;340;10819952;513;5155669;18729;6500
85080;Doix;531;9944972;261561;257;7057396;274;2887576;18729;6501
24442;Saint-Léon-sur-l'Isle;1168;21875245;620842;552;15425091;616;6450154;18729;6502
09293;Serres-sur-Arget;464;8690252;394393;212;6798906;252;1891346;18729;6503
64339;Lestelle-Bétharram;476;8915007;305736;223;6614876;253;2300131;18729;6504
33121;Cessac;112;2097764;44735;52;1498421;60;599343;18730;6505
10112;Coussegrey;110;2060377;56269;48;1488229;62;572148;18731;6506
30199;Pommiers;36;674306;22203;16;466623;20;207683;18731;6507
22283;Saint-Clet;512;9590154;242079;231;6755014;281;2835140;18731;6508
24215;Jayac;108;2022924;47014;44;1377635;64;645289;18731;6509
17016;Archiac;463;8672466;323637;189;5912767;274;2759699;18731;6510
23013;Auzances;805;15078665;511945;372;10972352;433;4106313;18731;6511
56122;Loyat;903;16915263;410567;406;11617203;497;5298060;18732;6512
02567;Ohis;168;3147071;68342;73;2081296;95;1065775;18733;6513
54017;Angomont;52;974107;8934;26;721894;26;252213;18733;6514
81138;Lasgraisses;258;4833280;98767;124;3522693;134;1310587;18734;6515
37061;Charnizay;286;5357853;140937;134;3762502;152;1595351;18734;6516
88267;Lerrain;263;4927047;133668;115;3305249;148;1621798;18734;6517
66117;Mont-Louis;124;2323040;114481;74;1837272;50;485768;18734;6518
63091;Charbonnier-les-Mines;525;9835465;241707;250;6905510;275;2929955;18734;6519
62649;Pas-en-Artois;444;8318106;238229;198;5801178;246;2516928;18734;6520
45252;Pithiviers;5189;97215072;4035953;2377;70176720;2812;27038352;18735;6521
59538;Saint-Momelin;226;4234140;108814;112;3008572;114;1225568;18735;6522
07285;Saint-Pierre-sur-Doux;45;843092;51442;17;575831;28;267261;18735;6523
61008;Aube;773;14482670;465872;388;10535061;385;3947609;18736;6524
2B301;San-Gavino-di-Tenda;31;580809;18919;15;421352;16;159457;18736;6525
25053;Belvoir;42;786905;3356;17;459917;25;326988;18736;6526
03298;Varennes-sur-Allier;2271;42552119;1670228;1110;31495825;1161;11056294;18737;6527
48190;Termes;111;2079900;73199;49;1525752;62;554148;18738;6528
80039;Ault;1123;21042732;1043245;513;15854234;610;5188498;18738;6529
15168;Ruynes-en-Margeride;388;7270569;198085;169;5039921;219;2230648;18739;6530
36095;Lignerolles;72;1349259;54226;30;855458;42;493801;18740;6531
07309;Satillieu;973;18234449;497007;454;12710304;519;5524145;18740;6532
07327;Uzer;252;4722710;139532;117;3380826;135;1341884;18741;6533
14027;Aunay-sur-Odon;1810;33921176;1043834;860;24492958;950;9428218;18741;6534
52359;Nully;87;1630500;32369;39;1148357;48;482143;18741;6535
52164;Damrémont;122;2286462;44025;57;1552326;65;734136;18741;6536
46193;Miers;266;4985253;117540;118;3336686;148;1648567;18742;6537
34106;Fozières;109;2042878;76834;47;1543053;62;499825;18742;6538
61161;Fel;154;2886326;59768;65;1796269;89;1090057;18742;6539
59045;Baives;78;1461938;46992;38;1076092;40;385846;18743;6540
17127;Courçon;964;18068322;505784;427;12612479;537;5455843;18743;6541
35077;Chelun;154;2886667;-15779;72;1866278;82;1020389;18745;6542
08321;Neuville-Day;103;1930744;54022;44;1225335;59;705409;18745;6543
15075;Girgols;48;899766;36579;17;648654;31;251112;18745;6544
70351;Mollans;152;2849307;61600;76;2080854;76;768453;18745;6545
10168;Les Granges;50;937284;30873;23;679735;27;257549;18746;6546
76065;Beaussault;223;4180369;146064;102;2903255;121;1277114;18746;6547
80184;Cerisy;272;5099047;134924;129;3696583;143;1402464;18746;6548
62538;Maintenay;228;4274211;117307;105;2986983;123;1287228;18747;6549
24016;Augignac;487;9129683;226527;216;6310419;271;2819264;18747;6550
55582;Wiseppe;68;1274787;54164;27;843045;41;431742;18747;6551
55343;Montblainville;39;731133;10371;21;538313;18;192820;18747;6552
31040;Bachos;25;468692;13750;13;353620;12;115072;18748;6553
80486;Long;367;6880583;192054;162;4750378;205;2130205;18748;6554
81109;Jonquières;279;5230853;125707;118;3625062;161;1605791;18749;6555
88406;Rugney;65;1218676;33613;30;826281;35;392395;18749;6556
62282;Éclimeux;93;1743755;25814;40;1167019;53;576736;18750;6557
2A021;Argiusta-Moriccio;55;1031268;65169;27;804828;28;226440;18750;6558
30025;Aumessas;133;2493818;91062;59;1763955;74;729863;18751;6559
31023;Aulon;208;3900129;113583;100;2865934;108;1034195;18751;6560
02544;Neuve-Maison;337;6319124;201174;159;4522380;178;1796744;18751;6561
24230;Larzac;72;1350096;74358;26;892735;46;457361;18751;6562
35083;Coglès;350;6563125;121149;154;4398421;196;2164704;18752;6563
2B184;Olcani;46;862622;29566;29;731629;17;130993;18753;6564
66099;Llauro;190;3563056;108629;79;2515524;111;1047532;18753;6565
85050;Le Champ-Saint-Père;1016;19053671;382508;456;12828199;560;6225472;18754;6566
61180;Fresnay-le-Samson;44;825216;13086;21;576747;23;248469;18755;6567
82148;Puylaroque;390;7314439;236059;171;5332652;219;1981787;18755;6568
17408;Saint-Sulpice-d'Arnoult;366;6864348;102746;165;4818055;201;2046293;18755;6569
16049;Bonnes;201;3769788;45044;83;2541832;118;1227956;18755;6570
48122;Quézac;198;3713580;103663;91;2671478;107;1042102;18755;6571
79142;Juillé;62;1162839;14992;27;851559;35;311280;18755;6572
32167;Laas;173;3244697;86950;82;2338051;91;906646;18755;6573
24552;Thonac;146;2738469;94810;57;1874158;89;864311;18757;6574
66105;Matemale;182;3413741;87912;96;2553973;86;859768;18757;6575
48177;Saint-Pierre-le-Vieux;162;3038620;57060;71;1978208;91;1060412;18757;6576
56136;Monteneuf;410;7690524;99483;203;5388074;207;2302450;18757;6577
57473;Moncourt;38;712781;-11173;13;331295;25;381486;18757;6578
22018;Brélidy;183;3432641;54222;90;2399475;93;1033166;18758;6579
03188;Montord;124;2326000;45930;61;1613650;63;712350;18758;6580
53208;Saint-Cyr-en-Pail;243;4558304;85257;116;3087425;127;1470879;18758;6581
49336;Somloire;501;9398633;140275;224;6372791;277;3025842;18760;6582
30212;Remoulins;1300;24388124;818174;635;17926981;665;6461143;18760;6583
06017;Bézaudun-les-Alpes;137;2570193;85470;63;1961105;74;609088;18761;6584
58127;Giry;128;2401366;57523;59;1648540;69;752826;18761;6585
86218;Saint-Clair;121;2270053;52430;47;1538384;74;731669;18761;6586
47165;Meilhan-sur-Garonne;740;13883047;498958;317;9568870;423;4314177;18761;6587
58116;Flez-Cuzy;82;1538415;48889;44;1134995;38;403420;18761;6588
76430;Mesnil-Follemprise;67;1256999;12750;26;787142;41;469857;18761;6589
61420;Sainte-Marie-la-Robert;49;919305;25576;24;608856;25;310449;18761;6590
23018;Bazelat;171;3208228;51746;71;1902183;100;1306045;18762;6591
72060;La Chapelle-aux-Choux;165;3095757;70751;86;2168829;79;926928;18762;6592
85066;Chavagnes-les-Redoux;413;7748825;43203;198;5091348;215;2657477;18762;6593
46321;Touzac;217;4071454;183862;92;2908147;125;1163307;18762;6594
66009;Arles-sur-Tech;1667;31277327;1339976;753;22900350;914;8376977;18763;6595
72303;Saint-Michel-de-Chavaignes;434;8143009;170487;227;5839580;207;2303429;18763;6596
66066;Enveitg;393;7373783;315435;179;5536360;214;1837423;18763;6597
50443;Sacey;282;5291217;116875;136;3763902;146;1527315;18763;6598
27009;Ambenay;317;5948090;132464;152;4225330;165;1722760;18764;6599
05091;Moydans;27;506627;15619;11;344216;16;162411;18764;6600
16284;Rouffiac;66;1238430;25326;30;874455;36;363975;18764;6601
17352;Saint-Laurent-de-la-Barrière;51;956973;11156;16;567613;35;389360;18764;6602
55245;Heudicourt-sous-les-Côtes;113;2120422;91000;48;1517817;65;602605;18765;6603
67201;Hirschland;175;3283848;57976;91;2372048;84;911800;18765;6604
16070;Chabanais;1088;20416161;750224;489;14458419;599;5957742;18765;6605
62242;Couin;57;1069638;36072;23;765645;34;303993;18766;6606
39468;Rothonay;76;1426258;27313;34;996481;42;429777;18767;6607
38204;Lalley;114;2139465;62039;49;1485793;65;653672;18767;6608
02178;Chermizy-Ailles;55;1032213;27817;25;759737;30;272476;18768;6609
80190;Chépy;690;12949627;434032;349;9977719;341;2971908;18768;6610
42245;Saint-Julien-la-Vêtre;213;3997508;122334;105;2882999;108;1114509;18768;6611
86161;Moncontour;561;10528712;400294;248;7459160;313;3069552;18768;6612
51053;Berzieux;40;750783;16536;14;460318;26;290465;18770;6613
53126;Larchamp;575;10792827;152020;269;7265080;306;3527747;18770;6614
59321;Inchy;411;7714605;323732;181;5710277;230;2004328;18770;6615
72235;Piacé;205;3847944;69062;120;2979539;85;868405;18770;6616
35170;Mecé;309;5800075;104278;146;4054248;163;1745827;18770;6617
03127;Hérisson;413;7752442;281496;183;5414716;230;2337726;18771;6618
02388;Iviers;115;2158686;53628;57;1494598;58;664088;18771;6619
80493;Louvencourt;145;2721868;59258;62;1824138;83;897730;18772;6620
81275;Salles;119;2233874;64868;52;1504232;67;729642;18772;6621
21260;Fain-lès-Moutiers;87;1633175;37342;39;1114847;48;518328;18772;6622
32018;Aurimont;107;2008670;32405;50;1361848;57;646822;18773;6623
47015;Astaffort;1183;22208037;680907;516;15527426;667;6680611;18773;6624
21417;Missery;67;1257769;33386;35;909168;32;348601;18773;6625
58046;Cercy-la-Tour;1166;21888978;925832;553;16134557;613;5754421;18773;6626
80062;Beaucamps-le-Vieux;774;14530659;480076;361;10429235;413;4101424;18773;6627
34136;Lézignan-la-Cèbe;819;15375644;467699;351;10777002;468;4598642;18774;6628
60407;Monceaux-l'Abbaye;99;1858663;39141;44;1311176;55;547487;18774;6629
46181;Lunegarde;53;995108;13418;22;693771;31;301337;18776;6630
46056;Carayac;51;957574;40296;26;744296;25;213278;18776;6631
31472;Saint-Bertrand-de-Comminges;165;3098095;111483;82;2363919;83;734176;18776;6632
46174;Linac;117;2196860;57444;51;1532690;66;664170;18777;6633
08055;Beaumont-en-Argonne;239;4487666;88001;116;3178240;123;1309426;18777;6634
71544;Toutenant;100;1877729;34010;47;1331542;53;546187;18777;6635
18014;Assigny;112;2103081;63951;51;1492169;61;610912;18778;6636
62055;Audrehem;247;4638068;91941;116;3188212;131;1449856;18778;6637
04120;Meyronnes;28;525774;15220;14;369662;14;156112;18778;6638
88103;Circourt;47;882583;18412;25;643929;22;238654;18778;6639
17114;Coivert;133;2497561;108063;53;1760801;80;736760;18779;6640
70255;Fresne-Saint-Mamès;285;5352214;136316;135;3788527;150;1563687;18780;6641
17074;Bussac-Forêt;535;10047398;225624;256;7168215;279;2879183;18780;6642
65184;Galez;99;1859240;41545;53;1342242;46;516998;18780;6643
03295;Valignat;43;807552;19369;22;596762;21;210790;18780;6644
07341;Villeneuve-de-Berg;1664;31250452;1011952;761;22676514;903;8573938;18780;6645
79013;Argenton-les-Vallées;934;17541149;518923;379;11943952;555;5597197;18781;6646
58225;Saincaize-Meauce;243;4563734;127256;138;3457479;105;1106255;18781;6647
71310;Montchanin;3100;58222521;1957045;1443;41273658;1657;16948863;18781;6648
33197;Guillos;228;4282250;111289;106;3099852;122;1182398;18782;6649
09116;Escosse;222;4169681;124991;106;3040951;116;1128730;18782;6650
70227;Faucogney-et-la-Mer;316;5935248;194623;139;4156982;177;1778266;18782;6651
47318;Vianne;647;12152403;357946;292;8438632;355;3713771;18783;6652
79202;Parthenay;6195;116360435;4654932;2776;84322718;3419;32037717;18783;6653
71541;Torpes;219;4113664;98028;106;3056319;113;1057345;18784;6654
44093;Maumusson;526;9880350;145933;256;7034661;270;2845689;18784;6655
43003;Allègre;554;10406705;287325;206;6519479;348;3887226;18785;6656
24261;Mauzens-et-Miremont;191;3587914;96811;82;2487722;109;1100192;18785;6657
36197;Saint-Hilaire-sur-Benaize;180;3381329;101645;85;2347161;95;1034168;18785;6658
12076;Conques;164;3080786;82406;64;1905591;100;1175195;18785;6659
52156;Curel;242;4546065;104178;116;3262984;126;1283081;18785;6660
17382;Saint-Pierre-d'Amilly;293;5504155;110952;159;4090475;134;1413680;18786;6661
29202;Plounéour-Ménez;706;13262703;281338;346;9341177;360;3921526;18786;6662
32157;L'Isle-Arné;78;1465295;29658;36;1014029;42;451266;18786;6663
18047;La Chapelle-d'Angillon;393;7382872;185984;169;4852610;224;2530262;18786;6664
59385;Marpent;1429;26846793;1096912;677;19853201;752;6993592;18787;6665
31469;Saint-Araille;79;1484203;38500;33;1035122;46;449081;18787;6666
43105;Javaugues;105;1972698;46686;50;1401156;55;571542;18788;6667
30284;Saint-Martin-de-Valgalgues;2449;46011667;1586509;1103;32995032;1346;13016635;18788;6668
24323;Petit-Bersac;109;2047889;58309;47;1392351;62;655538;18788;6669
60075;Blancfossé;74;1390323;41599;36;1042190;38;348133;18788;6670
05062;Le Glaizil;102;1916451;55488;46;1335000;56;581451;18789;6671
52289;Liffol-le-Petit;177;3325663;71940;77;2124819;100;1200844;18789;6672
57580;Riche;98;1841331;30338;46;1268060;52;573271;18789;6673
71563;Vaux-en-Pré;56;1052249;22978;27;680930;29;371319;18790;6674
80589;Neuilly-le-Dien;63;1183895;24052;34;848305;29;335590;18792;6675
63205;Manglieu;259;4867275;74865;132;3660479;127;1206796;18793;6676
62690;Raye-sur-Authie;122;2292698;82356;48;1465651;74;827047;18793;6677
45031;Bellegarde;971;18247648;642708;431;12279144;540;5968504;18793;6678
39350;Montbarrey;195;3664614;163785;90;2617160;105;1047454;18793;6679
43067;Chavaniac-Lafayette;169;3176090;98926;81;2266871;88;909219;18793;6680
39156;Cogna;138;2593590;68096;68;1818173;70;775417;18794;6681
81266;Saint-Paul-Cap-de-Joux;602;11314151;365415;257;7952214;345;3361937;18794;6682
57227;Forbach;12385;232768010;11733560;5196;170356680;7189;62411330;18794;6683
50564;Sainteny;449;8438740;189210;200;5696718;249;2742022;18795;6684
36067;Dunet;64;1202861;52609;26;786215;38;416646;18795;6685
24545;Teillots;65;1221712;36840;25;769580;40;452132;18796;6686
37013;Avrillé-les-Ponceaux;256;4811754;103137;138;3720459;118;1091295;18796;6687
58059;La Charité-sur-Loire;3276;61577751;2699610;1552;45991943;1724;15585808;18797;6688
65453;Troubat;30;563950;10382;12;386754;18;177196;18798;6689
32159;L'Isle-de-Noé;306;5752599;170216;137;4015478;169;1737121;18799;6690
50625;Vengeons;268;5038232;112001;139;3819772;129;1218460;18799;6691
22293;Saint-Gilles-les-Bois;220;4135913;105267;100;2773959;120;1361954;18800;6692
87172;Saint-Ouen-sur-Gartempe;125;2349953;51463;60;1738797;65;611156;18800;6693
17459;Varaize;345;6486280;181354;166;4741442;179;1744838;18801;6694
25031;Audincourt;8135;152947576;5832554;3918;111218284;4217;41729292;18801;6695
11363;Saint-Pierre-des-Champs;100;1880183;31820;47;1314850;53;565333;18802;6696
02645;Reuilly-Sauvigny;113;2124612;40087;62;1639854;51;484758;18802;6697
11206;Limoux;5915;111215264;4771291;2551;81492708;3364;29722556;18802;6698
54560;Veney;30;564081;14166;15;360351;15;203730;18803;6699
88444;Le Saulcy;178;3346888;86255;92;2476370;86;870518;18803;6700
88398;Les Rouges-Eaux;48;902560;21555;23;639758;25;262802;18803;6701
72153;Jupilles;341;6412014;168475;163;4518782;178;1893232;18804;6702
65341;Oroix;59;1109456;27197;28;854615;31;254841;18804;6703
26315;Saint-Martin-en-Vercors;216;4061739;75370;94;2764988;122;1296751;18804;6704
08155;Étalle;50;940250;34466;24;725069;26;215181;18805;6705
88135;Docelles;510;9590764;359869;236;6890976;274;2699788;18805;6706
24211;Issac;226;4250091;169444;94;3034547;132;1215544;18806;6707
70510;Vadans;81;1523284;37710;36;1020982;45;502302;18806;6708
19078;Estivaux;208;3911658;85547;106;2808159;102;1103499;18806;6709
70047;Baignes;54;1015565;24057;26;683015;28;332550;18807;6710
61209;Joué-du-Bois;226;4250342;98042;106;3090696;120;1159646;18807;6711
64289;La Bastide-Clairence;540;10155966;249005;246;7269138;294;2886828;18807;6712
47123;Lacapelle-Biron;233;4382265;107387;102;2990129;131;1392136;18808;6713
62534;Lumbres;2045;38463037;1210042;911;26852189;1134;11610848;18808;6714
24381;Saint-Barthélemy-de-Bussière;143;2689599;108578;55;1816829;88;872770;18808;6715
70561;Villersexel;879;16532890;820392;368;11749687;511;4783203;18809;6716
17253;Muron;665;12507962;242688;320;9175771;345;3332191;18809;6717
43165;Rosières;877;16495512;558600;386;11514273;491;4981239;18809;6718
58150;Lys;66;1241400;27754;37;941433;29;299967;18809;6719
50094;Camprond;214;4025156;60592;108;2894609;106;1130547;18809;6720
17071;La Brousse;308;5793402;171080;134;4083114;174;1710288;18810;6721
34203;Pinet;783;14728545;479416;352;10448973;431;4279572;18810;6722
39382;Nantey;31;583136;24192;13;434575;18;148561;18811;6723
56072;Gueltas;293;5511580;184877;153;4015285;140;1496295;18811;6724
76211;Dancourt;130;2445434;86700;49;1698774;81;746660;18811;6725
71319;Montret;435;8182922;295011;183;5682837;252;2500085;18811;6726
55526;Vadonville;144;2708897;52019;73;1974524;71;734373;18812;6727
05031;Champcella;114;2144562;74763;55;1544233;59;600329;18812;6728
58313;Vitry-Laché;64;1203972;53166;29;872935;35;331037;18812;6729
02503;Mont-d'Origny;473;8898244;318771;220;6491133;253;2407111;18812;6730
65027;Armenteule;34;639626;8530;16;443217;18;196409;18813;6731
29129;Locmaria-Berrien;141;2652633;90345;62;1808621;79;844012;18813;6732
23248;Saint-Victor-en-Marche;216;4063616;119453;100;2815735;116;1247881;18813;6733
17357;Saint-Maigrin;314;5907368;233707;129;4062288;185;1845080;18813;6734
32386;Saint-Lizier-du-Planté;79;1486310;48300;39;1096456;40;389854;18814;6735
46309;Souillac;2162;40676975;1482562;988;29490278;1174;11186697;18815;6736
17163;Fontaines-d'Ozillac;249;4684860;88193;120;3364364;129;1320496;18815;6737
31298;Lez;33;620898;22721;15;430496;18;190402;18815;6738
24410;Saint-Front-la-Rivière;316;5945954;185383;158;4379453;158;1566501;18816;6739
21149;Charrey-sur-Seine;93;1749943;44769;42;1201640;51;548303;18817;6740
46231;Puy-l'Évêque;1282;24123796;856100;561;17083817;721;7039979;18817;6741
62034;Annequin;1217;22901128;589590;561;16222520;656;6678608;18818;6742
33350;Rauzan;707;13304593;472217;305;9371894;402;3932699;18818;6743
76276;Forges-les-Eaux;2230;41970559;1879881;983;30023821;1247;11946738;18821;6744
11210;Luc-sur-Orbieu;620;11668945;319095;292;8394889;328;3274056;18821;6745
47295;Savignac-sur-Leyze;169;3180740;73692;81;2178014;88;1002726;18821;6746
34229;Riols;451;8488328;226861;219;6239354;232;2248974;18821;6747
02020;Any-Martin-Rieux;260;4893652;152265;112;3462912;148;1430740;18822;6748
50372;Neufmesnil;94;1769255;38880;41;1264352;53;504903;18822;6749
61063;Briouze;963;18125630;675029;399;12377115;564;5748515;18822;6750
22245;Pluzunet;595;11199271;266029;259;7586858;336;3612413;18822;6751
50511;Saint-Martin-d'Audouville;77;1449327;34682;34;1054958;43;394369;18822;6752
52346;Mussey-sur-Marne;195;3670502;53199;98;2594835;97;1075667;18823;6753
63152;Espinasse;185;3482276;132645;74;2477777;111;1004499;18823;6754
60039;Bacouël;249;4687130;96451;125;3466247;124;1220883;18824;6755
10006;Arcis-sur-Aube;1784;33582922;1361039;851;24871683;933;8711239;18825;6756
40167;Luxey;393;7398196;322729;158;4971462;235;2426734;18825;6757
71358;Pressy-sous-Dondin;54;1016555;30848;23;705435;31;311120;18825;6758
16336;Saint-Mary;216;4066322;137156;87;2711609;129;1354713;18826;6759
65262;Larreule;233;4386489;225033;105;3412983;128;973506;18826;6760
48160;Saint-Jean-la-Fouillouse;87;1637894;32897;37;1130386;50;507508;18826;6761
09038;La Bastide-de-Besplas;199;3746620;91112;85;2545401;114;1201219;18827;6762
17099;Chepniers;399;7512090;178019;172;5160307;227;2351783;18827;6763
50311;Le Mesnil-Garnier;121;2278208;44543;48;1433749;73;844459;18828;6764
70046;Les Aynans;186;3502047;79527;92;2504407;94;997640;18828;6765
54391;Moutiers;957;18018996;473758;441;12274417;516;5744579;18829;6766
61091;Champsecret;579;10901887;309463;265;7881837;314;3020050;18829;6767
22063;Gommenec'h;304;5723962;100982;151;4218556;153;1505406;18829;6768
55095;Cesse;72;1355679;40907;34;934130;38;421549;18829;6769
2A038;Bilia;29;546052;15128;14;393425;15;152627;18829;6770
39512;Sergenon;37;696689;20246;25;593837;12;102852;18829;6771
02616;Pont-Saint-Mard;109;2052462;46989;49;1385215;60;667247;18830;6772
21681;Vieux-Château;66;1242787;66115;31;904777;35;338010;18830;6773
51640;Ville-sur-Tourbe;115;2165470;37336;56;1512959;59;652511;18830;6774
09017;Arrien-en-Bethmale;57;1073355;44825;32;902067;25;171288;18831;6775
37082;Continvoir;263;4952500;169201;121;3466321;142;1486179;18831;6776
10265;Les Noës-près-Troyes;1868;35176251;1229049;913;25648733;955;9527518;18831;6777
56138;Monterrein;211;3973439;77856;103;2789410;108;1184029;18831;6778
47062;Cauzac;242;4557275;144991;117;3412556;125;1144719;18832;6779
39209;Val-d'Épy;88;1657211;32971;48;1207148;40;450063;18832;6780
12231;Saint-Jean-du-Bruel;404;7608116;211651;179;5486241;225;2121875;18832;6781
53185;Pré-en-Pail;1164;21921143;566796;542;15489449;622;6431694;18833;6782
57762;Zimming;357;6723407;98698;183;4856829;174;1866578;18833;6783
35145;Langon;791;14897045;400118;338;10387793;453;4509252;18833;6784
52275;Lavernoy;47;885197;19591;19;648294;28;236903;18834;6785
36012;Baraize;198;3729158;114172;96;2636782;102;1092376;18834;6786
62840;Vélu;79;1487901;19552;39;999373;40;488528;18834;6787
14065;Bernières-le-Patry;292;5499612;96050;141;3761861;151;1737751;18834;6788
25177;Crosey-le-Grand;97;1826985;68573;49;1421798;48;405187;18835;6789
76110;Bois-Himont;256;4821792;147610;107;3618860;149;1202932;18835;6790
2A040;Bocognano;269;5066667;244428;138;4027232;131;1039435;18835;6791
65358;Peyret-Saint-André;37;696916;32015;18;497111;19;199805;18836;6792
22229;Plounévez-Quintin;639;12036826;389267;297;8636984;342;3399842;18837;6793
82092;Lapenche;125;2354716;63734;55;1596294;70;758422;18838;6794
16196;Luxé;457;8608882;298582;205;5964860;252;2644022;18838;6795
16257;Péreuil;253;4766004;174878;96;3222753;157;1543251;18838;6796
64330;Lées-Athas;152;2863404;98140;71;2044550;81;818854;18838;6797
07274;Saint-Maurice-en-Chalencon;116;2185258;30107;46;1436849;70;748409;18838;6798
81163;Mazamet;6170;116233899;4888676;2610;82317033;3560;33916866;18839;6799
12236;Saint-Laurent-de-Lévézou;87;1638960;23964;43;1129690;44;509270;18839;6800
64085;Aydius;57;1073802;38376;31;870580;26;203222;18839;6801
16020;Aubeterre-sur-Dronne;180;3391074;224630;53;2346467;127;1044607;18839;6802
33482;Saint-Sulpice-de-Pommiers;137;2581000;100140;55;1851701;82;729299;18839;6803
01017;Argis;267;5030183;130609;139;3748993;128;1281190;18840;6804
33001;Abzac;1074;20234263;698096;488;14456031;586;5778232;18840;6805
44161;Saint-Gildas-des-Bois;2007;37812114;954100;928;26644273;1079;11167841;18840;6806
63421;Singles;103;1940547;71970;44;1316025;59;624522;18840;6807
36123;Mézières-en-Brenne;665;12528964;536282;270;8471841;395;4057123;18841;6808
70264;Georfans;39;734782;21090;23;594765;16;140017;18841;6809
59632;Wallers;2994;56409081;1850121;1356;40318989;1638;16090092;18841;6810
59191;Élincourt;335;6311776;177555;143;4270062;192;2041714;18841;6811
88076;Brouvelieures;244;4597353;114884;105;3140852;139;1456501;18842;6812
03205;Périgny;259;4880167;122868;131;3564359;128;1315808;18842;6813
55374;Nant-le-Petit;55;1036330;30511;28;737114;27;299216;18842;6814
44147;La Rouxière;547;10306851;166847;253;6893870;294;3412981;18843;6815
82016;Belvèze;111;2091573;71634;41;1351239;70;740334;18843;6816
50410;Pontorson;2523;47541285;1733137;1136;34517501;1387;13023784;18843;6817
01186;Hostiaz;46;866800;20892;21;563058;25;303742;18843;6818
89098;Cheney;175;3297672;113616;79;2538411;96;759261;18844;6819
32426;Seissan;661;12456076;399190;305;8874212;356;3581864;18844;6820
14600;Saint-Julien-le-Faucon;351;6614712;179730;151;4508667;200;2106045;18845;6821
34031;Bessan;2681;50524506;1672344;1193;36293519;1488;14230987;18845;6822
61452;Saint-Roch-sur-Égrenne;111;2091971;47867;53;1466448;58;625523;18847;6823
14501;Pierrefitte-en-Cinglais;144;2713946;94488;67;1961190;77;752756;18847;6824
57224;Folschviller;2212;41690254;1175334;994;28608619;1218;13081635;18847;6825
23154;Pionnat;424;7991922;274041;192;5830771;232;2161151;18849;6826
09039;La Bastide-de-Bousignac;190;3581317;59137;87;2467921;103;1113396;18849;6827
30338;Vallérargues;78;1470234;37742;34;1061811;44;408423;18849;6828
52101;Champigneulles-en-Bassigny;30;565483;16685;12;363452;18;202031;18849;6829
47314;Trémons;189;3562553;75706;84;2403193;105;1159360;18849;6830
79180;Montalembert;167;3147913;113870;77;2283374;90;864539;18850;6831
21392;Martrois;37;697458;34543;18;520294;19;177164;18850;6832
64513;Sauveterre-de-Béarn;834;15721418;478215;369;11017183;465;4704235;18851;6833
22029;Canihuel;221;4166010;112683;100;3057324;121;1108686;18851;6834
59063;Beauvois-en-Cambrésis;1173;22112144;731270;542;15982762;631;6129382;18851;6835
25058;Beure;1041;19624389;1047934;506;16368305;535;3256084;18851;6836
50448;Saint-Aubin-de-Terregatte;385;7257899;150862;182;5119067;203;2138832;18852;6837
24336;Prats-de-Carlux;305;5749823;131804;149;4292736;156;1457087;18852;6838
05166;Serres;761;14346634;491916;322;9766799;439;4579835;18852;6839
46310;Soulomès;64;1206556;58685;30;922660;34;283896;18852;6840
86225;Saint-Jean-de-Sauves;775;14610763;553651;325;9907643;450;4703120;18853;6841
87112;Pageas;352;6636313;157999;173;4883340;179;1752973;18853;6842
76645;Saint-Riquier-en-Rivière;76;1432866;34213;36;1049341;40;383525;18854;6843
41215;Saint-Jacques-des-Guérets;55;1036967;23152;29;802030;26;234937;18854;6844
36173;Rosnay;306;5769499;201230;149;4185551;157;1583948;18855;6845
80658;Quivières;83;1564969;68674;36;1114414;47;450555;18855;6846
89125;Courson-les-Carrières;526;9917805;264093;254;7159642;272;2758163;18855;6847
49052;Broc;181;3412793;111870;79;2404593;102;1008200;18855;6848
61491;Tourouvre;980;18478632;675921;421;12928282;559;5550350;18856;6849
56033;Carentoir;1631;30754080;1036778;748;22008934;883;8745146;18856;6850
65228;Ilhet;76;1433067;36094;40;1052287;36;380780;18856;6851
59140;Caullery;226;4261545;83385;112;2996985;114;1264560;18856;6852
24328;Piégut-Pluviers;767;14463761;518726;319;9781525;448;4682236;18858;6853
17356;Saint-Loup;182;3432184;95216;76;2417051;106;1015133;18858;6854
03067;Châtelperron;83;1565241;36095;38;1043956;45;521285;18858;6855
80679;Ronssoy;311;5865061;176110;148;4150492;163;1714569;18859;6856
2B343;Venzolasca;911;17180314;1365672;360;12444702;551;4735612;18859;6857
64391;Moncayolle-Larrory-Mendibieu;190;3583179;159146;90;2627835;100;955344;18859;6858
35106;Ercé-en-Lamée;771;14540392;184341;351;9656836;420;4883556;18859;6859
33067;Bourg;1281;24159274;963341;578;17634592;703;6524682;18860;6860
43234;Saugues;1106;20859181;909681;436;14775495;670;6083686;18860;6861
16033;Bayers;72;1357950;45678;37;970430;35;387520;18860;6862
72325;Saint-Vincent-du-Lorouër;502;9467995;222120;217;6356703;285;3111292;18861;6863
47001;Agen;20466;386000607;21438076;9511;295852222;10955;90148385;18861;6864
32149;Gondrin;687;12957513;484652;299;9444253;388;3513260;18861;6865
52228;Grandchamp;44;829925;23770;19;569664;25;260261;18862;6866
88380;Rehaupal;113;2131531;41251;57;1476200;56;655331;18863;6867
32284;Montégut-Savès;37;697945;6858;16;471982;21;225963;18863;6868
65119;Caixon;222;4187674;132905;93;3015211;129;1172463;18863;6869
49116;Cuon;328;6187205;85711;166;4308989;162;1878216;18863;6870
47204;Peyrière;150;2829535;75156;72;2081497;78;748038;18864;6871
86034;Bouresse;328;6187353;181757;143;4387592;185;1799761;18864;6872
62518;Linzeux;88;1660066;5027;46;1197808;42;462258;18864;6873
62053;Audincthun;339;6395270;167652;138;4283810;201;2111460;18865;6874
07045;Burzet;322;6074932;398874;116;4419008;206;1655924;18866;6875
14705;Tournières;87;1641367;31927;42;1140278;45;501089;18866;6876
72109;Crissé;310;5848565;141301;156;4203018;154;1645547;18866;6877
52118;Chatonrupt-Sommermont;176;3320491;85999;96;2532817;80;787674;18866;6878
65460;Vic-en-Bigorre;3028;57127867;2094646;1353;41430733;1675;15697134;18867;6879
88153;Domptail;174;3282807;93135;76;2291805;98;991002;18867;6880
62215;Carvin;9334;176102250;6387092;4233;127143530;5101;48958720;18867;6881
11079;Caudebronde;101;1905546;39927;51;1394784;50;510762;18867;6882
27375;Louviers;10801;203786238;8974446;5098;152854119;5703;50932119;18867;6883
29269;Saint-Thurien;569;10735729;256033;273;7664263;296;3071466;18868;6884
64128;Bilhères;97;1830179;72428;41;1317808;56;512371;18868;6885
43120;Lempdes-sur-Allagnon;793;14962739;427328;389;10807866;404;4154873;18869;6886
49248;Pouancé;1789;33756728;1003834;768;23483361;1021;10273367;18869;6887
14514;Pont-l'Évêque;2814;53097975;2081584;1322;38477034;1492;14620941;18869;6888
49136;La Ferrière-de-Flée;188;3547441;41274;92;2528691;96;1018750;18869;6889
16014;Angeduc;70;1320916;28049;31;944663;39;376253;18870;6890
12297;Le Vibal;279;5264913;60337;136;3523788;143;1741125;18871;6891
08347;Puilly-et-Charbeaux;138;2604156;74062;56;1715378;82;888778;18871;6892
19248;Saint-Ybard;364;6869362;139049;185;4983206;179;1886156;18872;6893
61097;La Chapelle-Montligeon;401;7567953;244184;185;5342236;216;2225717;18873;6894
76392;Londinières;718;13550601;481944;311;9398202;407;4152399;18873;6895
41242;Selles-sur-Cher;2625;49541098;1601812;1240;35393265;1385;14147833;18873;6896
93031;Épinay-sur-Seine;26866;507039776;19894508;12833;374822343;14033;132217433;18873;6897
72337;Sougé-le-Ganelon;492;9285491;228590;230;6417722;262;2867769;18873;6898
36138;Néret;121;2283762;66879;56;1698943;65;584819;18874;6899
2A345;Vero;236;4454300;155163;109;3245967;127;1208333;18874;6900
83045;Correns;464;8757672;272490;208;6258673;256;2498999;18874;6901
10035;Bayel;506;9550492;286774;247;6752699;259;2797793;18874;6902
12164;Mur-de-Barrez;472;8908810;419618;200;6282583;272;2626227;18875;6903
48186;La Salle-Prunet;104;1963030;39353;45;1308764;59;654266;18875;6904
24509;Saint-Vincent-de-Connezac;313;5908032;101528;127;3632578;186;2275454;18876;6905
80244;Dominois;100;1887584;41824;46;1357719;54;529865;18876;6906
50350;Montpinchon;289;5455233;103152;129;3925527;160;1529706;18876;6907
37103;Esves-le-Moutier;93;1755541;42044;51;1300829;42;454712;18877;6908
64063;Arzacq-Arraziguet;597;11269911;344211;265;7937803;332;3332108;18878;6909
59447;Onnaing;4702;88763463;2908261;2033;64401048;2669;24362415;18878;6910
03313;Le Vilhain;148;2793990;63251;69;1923628;79;870362;18878;6911
56006;Augan;826;15593765;301798;409;11103317;417;4490448;18879;6912
14144;Caumont-sur-Orne;44;830664;19967;20;595624;24;235040;18879;6913
34096;Faugères;325;6135931;285464;151;4510886;174;1625045;18880;6914
31131;Cazaunous;36;679680;14427;19;556654;17;123026;18880;6915
49061;Challain-la-Potherie;440;8307406;149109;195;5694881;245;2612525;18880;6916
34074;Cessenon-sur-Orb;1236;23336520;903783;511;16403533;725;6932987;18881;6917
36046;La Châtre;2826;53356816;2362890;1239;38418397;1587;14938419;18881;6918
51250;Fismes;3078;58115083;1946117;1423;42035130;1655;16079953;18881;6919
58133;Héry;47;887405;48607;19;658170;28;229235;18881;6920
66065;Elne;4746;89614361;3345665;2083;64665667;2663;24948694;18882;6921
04133;Moriez;127;2398036;92856;51;1565164;76;832872;18882;6922
35046;Les Brulais;251;4739434;84685;127;3406446;124;1332988;18882;6923
50463;Saint-Denis-le-Gast;301;5683749;118703;148;3979298;153;1704451;18883;6924
05011;Avançon;217;4097589;76528;109;2981254;108;1116335;18883;6925
19020;Beaumont;72;1359569;44651;36;1031277;36;328292;18883;6926
37223;Saint-Laurent-de-Lin;170;3210115;64461;83;2194611;87;1015504;18883;6927
31208;Ganties;186;3512321;148160;94;2693593;92;818728;18883;6928
2B238;Poggio-di-Venaco;108;2039476;112056;53;1592717;55;446759;18884;6929
52335;Montot-sur-Rognon;60;1133064;17374;28;771023;32;362041;18884;6930
72314;Saint-Pierre-du-Lorouër;208;3927956;123385;91;2705494;117;1222462;18884;6931
83060;Fox-Amphoux;273;5155444;168049;125;3663917;148;1491527;18884;6932
31373;Montesquieu-Guittaut;85;1605182;17987;32;897205;53;707977;18884;6933
80074;Becquigny;61;1151960;39580;29;857139;32;294821;18885;6934
08455;Tourcelles-Chaumont;43;812065;41157;20;639062;23;173003;18885;6935
49335;Soeurdres;182;3437125;32345;83;2384260;99;1052865;18885;6936
56229;Saint-Martin-sur-Oust;770;14542050;321416;390;10353886;380;4188164;18886;6937
48059;La Fage-Saint-Julien;143;2700747;37817;73;1952307;70;748440;18886;6938
52110;Charmes-la-Grande;91;1718674;42554;46;1257972;45;460702;18887;6939
36141;Neuvy-Saint-Sépulchre;1009;19056761;586654;488;13712593;521;5344168;18887;6940
18178;La Perche;138;2606383;59827;78;2013831;60;592552;18887;6941
46087;Dégagnac;368;6950449;179234;147;4732577;221;2217872;18887;6942
02728;Sorbais;144;2719747;63747;71;1999081;73;720666;18887;6943
43016;Auzon;559;10558258;307161;299;7639981;260;2918277;18888;6944
62336;Fléchin;266;5024172;187855;112;3470720;154;1553452;18888;6945
72039;Bonnétable;2370;44765100;1378501;1120;31246831;1250;13518269;18888;6946
21665;Vernois-lès-Vesvres;86;1624420;29033;36;1110688;50;513732;18889;6947
46054;Caniac-du-Causse;165;3116644;34972;70;2058957;95;1057687;18889;6948
52277;Lavilleneuve;39;736664;13323;20;515886;19;220778;18889;6949
37036;Braye-sur-Maulne;109;2058911;45043;52;1467974;57;590937;18889;6950
33511;Sendets;194;3664586;117357;90;2563165;104;1101421;18890;6951
14429;Meulles;206;3891490;105905;92;2704504;114;1186986;18891;6952
57446;Marimont-lès-Bénestroff;26;491164;10095;14;383553;12;107611;18891;6953
11077;Castelnau-d'Aude;261;4930615;108893;119;3482286;142;1448329;18891;6954
80620;Péronne;4984;94155163;4920086;2011;68589042;2973;25566121;18891;6955
70015;Amoncourt;182;3438314;67443;117;2641665;65;796649;18892;6956
53211;Saint-Denis-de-Gastines;893;16870495;322052;393;11326769;500;5543726;18892;6957
16131;Esse;296;5592072;171016;140;4096537;156;1495535;18892;6958
86229;Saint-Léger-de-Montbrillais;225;4250796;167850;104;3042495;121;1208301;18892;6959
03032;Blomard;122;2304905;51797;57;1566499;65;738406;18893;6960
57497;Nelling;149;2815287;82519;72;2063549;77;751738;18895;6961
34332;Vias;3396;64167361;2622767;1538;46825495;1858;17341866;18895;6962
03185;Montluçon;23686;447553713;20753945;11399;338355476;12287;109198237;18895;6963
55088;Burey-en-Vaux;82;1549475;38930;38;1079505;44;469970;18896;6964
54243;Hablainville;105;1984109;24116;50;1401315;55;582794;18896;6965
29003;Audierne;1489;28136726;1016306;691;20024027;798;8112699;18896;6966
60233;Feuquières;829;15665296;740079;372;11628383;457;4036913;18897;6967
87037;La Chapelle-Montbrandeix;144;2721157;102238;58;1925013;86;796144;18897;6968
32218;Loussous-Débat;30;566918;20075;14;418867;16;148051;18897;6969
53267;Vaiges;642;12132163;220741;297;8333924;345;3798239;18897;6970
79139;Les Groseillers;31;585822;3069;13;401927;18;183895;18897;6971
09020;Artigues;26;491335;9414;11;299723;15;191612;18898;6972
16248;Oradour;116;2192124;78310;48;1456940;68;735184;18898;6973
81146;Livers-Cazelles;138;2607905;107318;59;1864443;79;743462;18898;6974
89206;Joigny;5374;101557923;4461327;2359;74386432;3015;27171491;18898;6975
33460;Saint-Pey-de-Castets;363;6860518;162815;167;5011860;196;1848658;18899;6976
14450;Montviette;119;2249055;89624;63;1682772;56;566283;18900;6977
03300;Vaumas;304;5745600;203541;128;3884076;176;1861524;18900;6978
09193;Mijanès;29;548140;26852;14;373483;15;174657;18901;6979
62481;Labroye;92;1738929;43985;48;1316658;44;422271;18901;6980
14427;Le Mesnil-Villement;158;2986451;63022;81;2172452;77;813999;18902;6981
26143;Le Grand-Serre;498;9413058;287665;231;6865811;267;2547247;18902;6982
70416;Pomoy;107;2022530;60991;60;1550100;47;472430;18902;6983
07009;Andance;660;12475477;349294;326;9052440;334;3423037;18902;6984
65111;Bulan;44;831714;47070;19;637214;25;194500;18903;6985
12050;Canet-de-Salars;234;4423237;34829;93;2727865;141;1695372;18903;6986
23246;Saint-Sulpice-les-Champs;227;4290978;167328;91;2922999;136;1367979;18903;6987
2A240;Poggiolo;47;888478;50925;25;724997;22;163481;18904;6988
48176;Saint-Pierre-des-Tripiers;46;869582;19691;20;593961;26;275621;18904;6989
35201;Muel;459;8677049;131806;220;6022958;239;2654091;18904;6990
53036;Bouère;572;10813301;255069;256;7233550;316;3579751;18904;6991
52456;Saint-Urbain-Maconcourt;370;6994727;175061;188;5057665;182;1937062;18905;6992
25574;Uzelle;89;1682521;20934;49;1253498;40;429023;18905;6993
73163;Montaimont;80;1512387;76398;37;1101328;43;411059;18905;6994
56043;Concoret;429;8110282;206786;198;5651606;231;2458676;18905;6995
19071;Davignac;154;2911415;125831;77;2174879;77;736536;18905;6996
62329;Ferques;881;16655662;367550;374;11186652;507;5469010;18905;6997
70100;Broye-les-Loups-et-Verfontaine;54;1020957;22923;23;665453;31;355504;18907;6998
37269;Verneuil-sur-Indre;304;5747775;160385;153;4285736;151;1462039;18907;6999
65212;Guchen;222;4197448;93258;96;2663337;126;1534111;18907;7000
09051;Bénaix;86;1626052;34246;37;1108403;49;517649;18908;7001
17053;Bords;722;13651328;423639;314;9604176;408;4047152;18908;7002
2B257;Rapale;93;1758424;80076;44;1351797;49;406627;18908;7003
52227;Graffigny-Chemin;125;2363480;62291;57;1664876;68;698604;18908;7004
22386;Le Vieux-Bourg;399;7544569;118950;167;4970097;232;2574472;18909;7005
24364;Saint-Amand-de-Coly;201;3800661;79664;94;2725801;107;1074860;18909;7006
48130;Rousses;58;1096710;56638;20;656885;38;439825;18909;7007
22119;Lanvellec;329;6221030;155899;154;4386440;175;1834590;18909;7008
15007;Anterrieux;66;1248044;33930;24;782605;42;465439;18910;7009
32464;Villecomtal-sur-Arros;471;8906795;275153;219;6252239;252;2654556;18910;7010
46012;Aynac;350;6618660;177821;172;4813602;178;1805058;18910;7011
30194;Peyremale;196;3706463;152080;92;2669833;104;1036630;18911;7012
70230;Fédry;61;1153562;38860;31;860547;30;293015;18911;7013
03275;Souvigny;1176;22239308;794378;527;15876715;649;6362593;18911;7014
63104;La Chaulme;80;1512942;44109;38;1066333;42;446609;18912;7015
62040;Arques;5480;103640542;3633923;2574;74773898;2906;28866644;18913;7016
32311;Pergain-Taillac;167;3158428;108797;72;2253672;95;904756;18913;7017
32419;Sauviac;74;1399586;68729;36;1044425;38;355161;18913;7018
58267;Saint-Saulge;484;9154101;330421;229;6636219;255;2517882;18913;7019
63001;Aigueperse;1496;28294616;1160076;659;20194023;837;8100593;18914;7020
07096;Gluiras;225;4255559;126632;88;2629519;137;1626040;18914;7021
61316;Ommoy;71;1342910;8917;34;905195;37;437715;18914;7022
34204;Plaissan;549;10384130;389750;237;7378184;312;3005946;18915;7023
23049;Champsanglard;144;2723807;95504;79;2140483;65;583324;18915;7024
12098;Estaing;342;6469063;313464;150;4700389;192;1768674;18915;7025
36053;Ciron;328;6204297;203449;158;4531521;170;1672776;18916;7026
44011;Belligné;980;18537653;315333;457;12783465;523;5754188;18916;7027
31009;Antichan-de-Frontignes;47;889081;47660;24;697485;23;191596;18917;7028
71571;Verosvres;232;4388705;94099;112;2987885;120;1400820;18917;7029
61041;Bellou-le-Trichard;142;2686382;76621;73;2094516;69;591866;18918;7030
62711;Rinxent;1545;29230168;1189405;645;20493089;900;8737079;18919;7031
43086;Domeyrat;99;1873044;59762;48;1438928;51;434116;18920;7032
64377;Mendionde;419;7927422;151632;198;5584832;221;2342590;18920;7033
34261;Saint-Guilhem-le-Désert;163;3083976;148089;77;2264683;86;819293;18920;7034
49342;Tancoigné;158;2989400;22211;81;2123049;77;866351;18920;7035
05049;Esparron;26;491934;24817;15;417270;11;74664;18921;7036
12027;Bessuéjouls;134;2535367;69384;58;1825413;76;709954;18921;7037
25269;Germondans;42;794668;15765;20;521841;22;272827;18921;7038
43185;Sainte-Florine;1896;35873678;1075200;954;26358702;942;9514976;18921;7039
37055;Channay-sur-Lathan;413;7814351;154511;183;5251215;230;2563136;18921;7040
34121;Joncels;165;3122032;51946;72;2024364;93;1097668;18921;7041
33543;Verdelais;585;11069282;334069;261;7972117;324;3097165;18922;7042
09124;Le Fossat;632;11958841;361749;251;8207820;381;3751021;18922;7043
60635;Thiverny;605;11447942;341681;330;8798348;275;2649594;18922;7044
38333;Rencurel;184;3481944;106678;81;2455357;103;1026587;18924;7045
21629;Thoisy-la-Berchère;177;3349503;72464;80;2314247;97;1035256;18924;7046
66127;Opoul-Périllos;539;10199943;293879;232;7310994;307;2888949;18924;7047
04058;Claret;132;2498070;51597;64;1901753;68;596317;18925;7048
09229;Le Peyrat;272;5147756;146320;122;3497353;150;1650403;18926;7049
62648;Parenty;258;4882825;63318;105;3110678;153;1772147;18926;7050
88487;Le Val-d'Ajol;2410;45613618;1247007;1087;31277991;1323;14335627;18927;7051
50627;Vergoncey;108;2044102;31504;54;1508758;54;535344;18927;7052
47068;Cocumont;579;10959015;253261;262;7703912;317;3255103;18927;7053
22227;Plounérin;414;7836021;193368;189;5426089;225;2409932;18928;7054
34188;Olmet-et-Villecun;85;1608900;48522;35;1129563;50;479337;18928;7055
61252;Mardilly;76;1438580;41408;37;1112883;39;325697;18929;7056
50111;Cerisy-la-Salle;548;10373082;309326;216;7000036;332;3373046;18929;7057
59490;Rainsars;105;1987583;42051;45;1254380;60;733203;18929;7058
12232;Saint-Jean-et-Saint-Paul;159;3009827;60969;74;2070355;85;939472;18930;7059
21305;Grancey-sur-Ource;131;2479803;80871;54;1621536;77;858267;18930;7060
64006;Accous;227;4297196;139998;103;3097811;124;1199385;18930;7061
76629;Saint-Ouen-le-Mauger;132;2498812;6449;65;1696244;67;802568;18930;7062
70418;Le Pont-de-Planches;108;2044626;42069;54;1472828;54;571798;18932;7063
88425;Saint-Maurice-sur-Mortagne;88;1666036;27883;48;1247218;40;418818;18932;7064
53265;Torcé-Viviers-en-Charnie;401;7591963;155844;174;5283003;227;2308960;18933;7065
37218;Saint-Flovier;360;6815832;239233;156;4849372;204;1966460;18933;7066
21066;Bessey-la-Cour;41;776264;20953;21;563760;20;212504;18933;7067
33442;Saint-Martin-de-Laye;293;5547576;165776;139;4128145;154;1419431;18934;7068
97210;Le François;11182;211720152;8747736;3405;154238990;7777;57481162;18934;7069
13063;Miramas;13975;264611291;8764355;6718;193129539;7257;71481752;18935;7070
04204;Senez;85;1609453;65601;31;1092822;54;516631;18935;7071
47037;Bournel;129;2442612;55490;47;1558714;82;883898;18935;7072
76025;Argueil;173;3275894;107779;80;2369926;93;905968;18936;7073
07297;Saint-Sylvestre;242;4582719;66045;100;2995464;142;1587255;18937;7074
07263;Saint-Laurent-sous-Coiron;74;1401358;64628;35;1001565;39;399793;18937;7075
29064;Goulven;257;4866891;100207;119;3404753;138;1462138;18937;7076
37107;Ferrière-Larçon;158;2992113;91160;79;2132385;79;859728;18937;7077
55507;Thillot;129;2442952;61023;60;1700903;69;742049;18938;7078
07011;Antraigues-sur-Volane;363;6874360;497568;143;4981265;220;1893095;18938;7079
19045;La Chapelle-Saint-Géraud;135;2556581;79539;63;1715510;72;841071;18938;7080
71438;Saint-Léger-du-Bois;301;5700434;117388;144;3915400;157;1785034;18938;7081
58246;Saint-Honoré-les-Bains;463;8768817;309999;200;5988866;263;2779951;18939;7082
03235;Saint-Gérand-le-Puy;574;10871202;413623;253;7684913;321;3186289;18939;7083
65438;Talazac;50;947023;25280;28;723770;22;223253;18940;7084
59322;Iwuy;1785;33809039;1130396;816;24017556;969;9791483;18941;7085
73046;Bonneval;70;1325891;47056;46;1129934;24;195957;18941;7086
32272;Monlaur-Bernet;98;1856362;75603;33;1242466;65;613896;18942;7087
56089;Inguiniel;1177;22295445;512541;572;15908200;605;6387245;18943;7088
34225;Puisserguier;1694;32089117;1161178;708;22049302;986;10039815;18943;7089
62652;Pernes;896;16973088;660280;372;11978836;524;4994252;18943;7090
58092;Crux-la-Ville;257;4868448;132400;113;3305165;144;1563283;18943;7091
32236;Marguestau;33;625137;9074;14;425140;19;199997;18944;7092
34281;Saint-Pargoire;1174;22240586;610110;491;15491285;683;6749301;18944;7093
22378;Trévérec;106;2008238;20617;47;1356374;59;651864;18946;7094
70430;La Quarte;37;700989;23712;17;480078;20;220911;18946;7095
71018;Bantanges;312;5911318;119519;157;4208386;155;1702932;18947;7096
69002;Aigueperse;141;2671510;71831;64;1868557;77;802953;18947;7097
62328;Ferfay;480;9094518;268181;206;6279126;274;2815392;18947;7098
66035;Campoussy;29;549464;35422;12;407094;17;142370;18947;7099
56045;Le Cours;338;6404103;144436;163;4554435;175;1849668;18947;7100
35222;Pleine-Fougères;1057;20027614;458799;482;13826811;575;6200803;18948;7101
15071;Fournoulès;34;644226;21027;12;418724;22;225502;18948;7102
22318;Saint-Michel-de-Plélan;167;3164292;81117;73;2162754;94;1001538;18948;7103
50351;Montrabot;43;814783;18265;18;533076;25;281707;18948;7104
42067;Colombier;162;3069729;62192;74;2016977;88;1052752;18949;7105
14433;Mittois;87;1648614;31287;37;1190025;50;458589;18950;7106
23232;Saint-Pierre-Bellevue;134;2539311;92994;63;1847670;71;691641;18950;7107
62142;Blingel;71;1345464;24230;28;876142;43;469322;18950;7108
62552;Maresquel-Ecquemicourt;528;10005778;386579;254;7278113;274;2727665;18950;7109
80742;Surcamps;46;871717;38439;24;677362;22;194355;18950;7110
32290;Montréal;733;13890782;803638;299;10024419;434;3866363;18951;7111
39418;Picarreau;56;1061240;16246;25;708506;31;352734;18951;7112
08367;Rocroi;1346;25507867;1031408;576;17968146;770;7539721;18951;7113
66073;Estoher;82;1554005;69007;31;1067412;51;486593;18951;7114
65110;Bugard;48;909690;39936;19;639604;29;270086;18952;7115
36208;Sainte-Sévère-sur-Indre;522;9893054;366403;208;6848258;314;3044796;18952;7116
70052;Bassigney;82;1554083;45026;39;1165279;43;388804;18952;7117
11048;Boutenac;391;7410360;219917;172;5063251;219;2347109;18952;7118
50606;Tribehou;306;5799560;187489;132;3971781;174;1827779;18953;7119
85059;La Châtaigneraie;1535;29093297;1226787;671;20853652;864;8239645;18953;7120
14167;Colombelles;3242;61446656;2032289;1552;44994912;1690;16451744;18953;7121
66192;Sauto;53;1004527;28176;29;755109;24;249418;18953;7122
17180;Gourvillette;61;1156166;47802;24;786375;37;369791;18954;7123
22238;Plufur;300;5686102;156558;138;3945699;162;1740403;18954;7124
71007;Ameugny;87;1648987;70533;42;1356102;45;292885;18954;7125
76139;Bradiancourt;99;1876477;9027;41;1180828;58;695649;18954;7126
97213;Le Lamentin;22685;429981656;14645536;8561;304754592;14124;125227064;18954;7127
53189;Rennes-en-Grenouilles;60;1137289;9108;32;832692;28;304597;18955;7128
71469;Saint-Pierre-le-Vieux;206;3904807;99191;94;2670667;112;1234140;18955;7129
31226;Gouzens;53;1004636;27325;24;773070;29;231566;18955;7130
18240;Sancergues;422;7999424;334088;194;5866184;228;2133240;18956;7131
39435;Pont-de-Poitte;388;7355470;156344;201;5290472;187;2064998;18957;7132
21058;Belan-sur-Ource;158;2995296;88345;78;2275481;80;719815;18958;7133
53002;Alexain;296;5611529;56517;144;3944782;152;1666747;18958;7134
18154;Mornay-Berry;118;2237041;81966;59;1686975;59;550066;18958;7135
61340;Rabodanges;82;1554566;29664;49;1180637;33;373929;18958;7136
34264;Saint-Jean-de-Buèges;104;1971683;95566;44;1385732;60;585951;18958;7137
07018;Astet;28;530852;10744;13;382769;15;148083;18959;7138
35124;Grand-Fougeray;1287;24401322;645938;574;17197097;713;7204225;18960;7139
34109;Gabian;472;8949259;398978;192;6263431;280;2685828;18960;7140
02308;Fesmy-le-Sart;263;4986560;202569;115;3371828;148;1614732;18960;7141
70310;Lure;4890;92716239;4502845;2165;68182080;2725;24534159;18960;7142
03223;Saint-Christophe;264;5005729;122212;126;3621453;138;1384276;18961;7143
47078;Damazan;803;15225808;569427;294;10561152;509;4664656;18961;7144
02783;Grand-Verly;76;1441052;42781;28;881248;48;559804;18961;7145
65059;Bagnères-de-Bigorre;5050;95754851;4069636;2424;71119136;2626;24635715;18961;7146
47199;Pardaillan;165;3128650;108486;63;2127736;102;1000914;18962;7147
70069;Betoncourt-Saint-Pancras;26;493008;15464;15;401884;11;91124;18962;7148
19172;Rilhac-Treignac;69;1308376;53208;29;949355;40;359021;18962;7149
48139;Saint-Bonnet-de-Montauroux;71;1346304;29077;32;944742;39;401562;18962;7150
02350;Goudelancourt-lès-Pierrepont;83;1573889;47685;34;1069492;49;504397;18963;7151
80145;Brucamps;78;1479095;40670;40;1169529;38;309566;18963;7152
07168;Orgnac-l'Aven;295;5594035;132117;127;3858981;168;1735054;18963;7153
19212;Saint-Hilaire-Taurieux;54;1024015;31531;24;731018;30;292997;18963;7154
62111;Berlencourt-le-Cauroy;137;2598043;71940;65;1950938;72;647105;18964;7155
85154;Mouilleron-en-Pareds;683;12952472;259077;363;9632177;320;3320295;18964;7156
52187;Épizon;72;1365425;30622;26;808080;46;557345;18964;7157
30215;Rivières;205;3887683;133763;86;2711236;119;1176447;18964;7158
17185;Le Gua;1204;22834154;824665;569;16933537;635;5900617;18965;7159
15079;Jaleyrac;216;4096517;87159;98;2814517;118;1282000;18965;7160
34062;Caussiniojouls;69;1308629;29292;28;810636;41;497993;18966;7161
04202;Sausses;72;1365538;49771;37;1019991;35;345547;18966;7162
30200;Pompignan;476;9028098;461240;198;6812366;278;2215732;18967;7163
49282;Saint-Georges-sur-Layon;387;7340201;84568;171;5007308;216;2332893;18967;7164
87022;Breuilaufa;83;1574277;28818;42;1103609;41;470668;18967;7165
61001;Alençon;15532;294603896;13526546;7142;223430375;8390;71173521;18968;7166
02690;Sainte-Preuve;56;1062228;31156;23;690383;33;371845;18968;7167
53098;Fontaine-Couverte;208;3945532;-3143;99;2643635;109;1301897;18969;7168
62401;Haisnes;2243;42547377;1075228;1101;31070919;1142;11476458;18969;7169
11189;Laprade;52;986389;28657;22;712800;30;273589;18969;7170
03283;Thiel-sur-Acolin;607;11514202;274279;286;8267456;321;3246746;18969;7171
81135;Laparrouquial;57;1081260;28651;21;730907;36;350353;18969;7172
35167;Martigné-Ferchaud;1497;28398018;672775;670;19936066;827;8461952;18970;7173
17197;Jonzac;2297;43575338;2257271;1008;32907904;1289;10667434;18971;7174
12220;Sainte-Eulalie-de-Cernon;154;2921575;57353;68;1924945;86;996630;18971;7175
50495;Saint-Jean-du-Corail-des-Bois;41;777834;31247;14;480087;27;297747;18972;7176
52253;Juzennecourt;116;2200863;58492;58;1633923;58;566940;18973;7177
43123;Lorlanges;181;3434251;73327;94;2479995;87;954256;18974;7178
19056;Clergoux;265;5028062;156035;127;3517078;138;1510984;18974;7179
48163;Saint-Julien-des-Points;67;1271261;42001;33;928372;34;342889;18974;7180
54528;Toul;9075;172191471;7160518;4278;129065204;4797;43126267;18974;7181
63287;Les Pradeaux;197;3738096;89583;95;2743870;102;994226;18975;7182
15054;Condat;618;11726633;516134;268;8572347;350;3154286;18975;7183
79218;Pressigny;106;2011402;42891;58;1522849;48;488553;18975;7184
39129;Chaux-des-Crotenay;216;4098713;80677;101;2887507;115;1211206;18976;7185
33138;Coutras;4908;93135195;3348284;2220;67072106;2688;26063089;18976;7186
50427;Ravenoville;173;3282920;101208;78;2354303;95;928617;18976;7187
71534;Le Tartre;63;1195565;39053;32;886989;31;308576;18977;7188
08336;Osnes;123;2334243;46426;61;1614371;62;719872;18978;7189
05173;Upaix;264;5010151;151136;127;3613826;137;1396325;18978;7190
56047;Crédin;809;15353124;329851;391;11184446;418;4168678;18978;7191
16285;Rougnac;262;4972301;165847;124;3545698;138;1426603;18978;7192
58136;Jailly;37;702209;13095;17;481147;20;221062;18979;7193
71326;Mouthier-en-Bresse;242;4593082;144774;108;3321186;134;1271896;18980;7194
31090;Brignemont;220;4175603;112105;94;2827909;126;1347694;18980;7195
11380;Sonnac-sur-l'Hers;87;1651324;36234;43;1262098;44;389226;18981;7196
61455;Saint-Siméon;144;2733230;75465;52;1776173;92;957057;18981;7197
14752;Villers-Bocage;1805;34260638;1108933;848;24082344;957;10178294;18981;7198
71553;Vareilles;136;2581411;89410;63;1800352;73;781059;18981;7199
87135;Saint-Auvent;541;10268742;280570;263;7592335;278;2676407;18981;7200
55427;Revigny-sur-Ornain;1727;32780681;1334771;779;23470573;948;9310108;18981;7201
47049;Casseneuil;1307;24808833;864325;565;17182825;742;7626008;18982;7202
76575;Saint-Étienne-du-Rouvray;14453;274344062;10217551;7075;206602720;7378;67741342;18982;7203
12049;Campuac;224;4251932;95118;98;2944176;126;1307756;18982;7204
54078;Blémerey;30;569462;-1010;12;360622;18;208840;18982;7205
42006;Apinac;234;4441872;96425;107;3097721;127;1344151;18982;7206
50055;Biniville;56;1063032;11493;32;730385;24;332647;18983;7207
29274;Scaër;3179;60346091;1711664;1543;43420045;1636;16926046;18983;7208
38406;Saint-Julien-de-l'Herms;81;1537636;19168;34;997142;47;540494;18983;7209
82110;Mirabel;574;10896344;329303;268;7821482;306;3074862;18983;7210
02469;Marly-Gomont;247;4689073;140258;111;3378672;136;1310401;18984;7211
58212;Poiseux;191;3626212;103514;103;2635372;88;990840;18985;7212
02727;Sons-et-Ronchères;130;2468106;109276;61;1833034;69;635072;18985;7213
01139;Curciat-Dongalon;274;5202088;139437;120;3635515;154;1566573;18986;7214
18133;Lunery;868;16479651;580982;430;12133997;438;4345654;18986;7215
54406;Ogéviller;132;2506141;19130;62;1701351;70;804790;18986;7216
03219;Saint-Bonnet-de-Four;129;2449236;82827;64;1865679;65;583557;18986;7217
08080;Bouvellemont;52;987290;17910;27;702069;25;285221;18986;7218
16109;Courbillac;372;7062992;173671;185;5316079;187;1746913;18987;7219
50188;Folligny;551;10461897;150691;256;7057955;295;3403942;18987;7220
24477;Saint-Pardoux-de-Drône;129;2449347;87963;55;1695939;74;753408;18987;7221
07178;Pont-de-Labeaume;321;6095090;198645;146;4391879;175;1703211;18988;7222
40109;Gaujacq;258;4898914;159139;108;3342739;150;1556175;18988;7223
11190;La Redorte;655;12437175;430482;254;8575203;401;3861972;18988;7224
01305;Pont-de-Vaux;1453;27590097;1120704;695;20135176;758;7454921;18988;7225
46151;Lamothe-Cassel;66;1253261;38784;29;858176;37;395085;18989;7226
59061;Beaurepaire-sur-Sambre;134;2544520;32232;59;1660255;75;884265;18989;7227
57717;Viller;109;2069866;39130;60;1553366;49;516500;18990;7228
81013;Andouque;203;3855091;50796;84;2551641;119;1303450;18991;7229
33484;Saint-Symphorien;1076;20434106;802185;460;13865705;616;6568401;18991;7230
81134;Lamontélarié;42;797618;28386;18;550455;24;247163;18991;7231
25604;Verne;66;1253400;21886;33;858820;33;394580;18991;7232
31425;Le Plan;265;5032660;143569;134;3818558;131;1214102;18991;7233
49215;Montreuil-Bellay;2242;42579223;1278344;1029;29721383;1213;12857840;18992;7234
72324;Saint-Vincent-des-Prés;268;5089779;120039;132;3614183;136;1475596;18992;7235
62036;Anvin;423;8033528;323063;164;5508590;259;2524938;18992;7236
31103;Canens;36;683712;24497;17;532480;19;151232;18992;7237
33525;Tauriac;742;14092271;430450;350;10217356;392;3874915;18992;7238
53237;Saint-Mars-sur-Colmont;226;4292295;59448;105;2926772;121;1365523;18992;7239
02655;Ronchères;72;1367462;23760;37;919166;35;448296;18993;7240
2B123;Ghisonaccia;2060;39124796;1847121;851;28243406;1209;10881390;18993;7241
80290;Estrées-lès-Crécy;207;3931509;74676;97;2744763;110;1186746;18993;7242
76101;Blangy-sur-Bresle;1858;35291125;1558316;834;25559442;1024;9731683;18994;7243
65454;Trouley-Labarthe;56;1063674;44101;28;793745;28;269929;18994;7244
10182;Juvancourt;76;1443567;48638;35;1010708;41;432859;18994;7245
58104;Dornes;730;13866016;425319;341;9912243;389;3953773;18995;7246
36110;Maillet;149;2830223;109760;56;1812827;93;1017396;18995;7247
31172;Esparron;34;645827;19480;16;440013;18;205814;18995;7248
82043;Comberouger;152;2887314;52085;74;2088321;78;798993;18995;7249
62090;Béalencourt;70;1329719;20036;29;786198;41;543521;18996;7250
66121;Néfiach;681;12936357;475238;313;9449590;368;3486767;18996;7251
79219;Priaires;71;1348760;24101;38;1060460;33;288300;18997;7252
81259;Saint-Julien-Gaulène;124;2355613;69153;56;1647435;68;708178;18997;7253
19004;Albussac;408;7750864;209723;196;5610643;212;2140221;18997;7254
56216;Saint-Gorgon;202;3837521;90712;102;2602037;100;1235484;18998;7255
06074;Lantosque;644;12234520;364702;313;9044890;331;3189630;18998;7256
43259;Vernassal;217;4122514;96922;91;2787425;126;1335089;18998;7257
30068;Cardet;459;8719997;250366;194;6035773;265;2684224;18998;7258
49008;Angrie;441;8378205;98430;167;5054279;274;3323926;18998;7259
93070;Saint-Ouen;27710;526471539;27909631;13831;415461861;13879;111009678;18999;7260
16346;Saint-Quentin-de-Chalais;151;2868957;88308;70;2132970;81;735987;19000;7261
60506;Pont-l'Évêque;403;7656886;298915;199;5466449;204;2190437;19000;7262
23059;La Chaussade;59;1121015;44823;21;762189;38;358826;19000;7263
2B251;Prunelli-di-Fiumorbo;1979;37601640;1815083;827;26100747;1152;11500893;19000;7264
03116;Fourilles;132;2508054;76541;65;1764540;67;743514;19000;7265
21043;Baigneux-les-Juifs;130;2470087;81460;58;1767022;72;703065;19001;7266
40079;Cazalis;81;1539133;48459;38;1109633;43;429500;19002;7267
17012;Annezay;91;1729179;15380;39;1167816;52;561363;19002;7268
23168;Sardent;481;9140013;349409;221;6625442;260;2514571;19002;7269
02797;Viel-Arcy;82;1558209;42535;41;1117549;41;440660;19003;7270
64111;Bentayou-Sérée;59;1121171;32830;26;755534;33;365637;19003;7271
27041;La Barre-en-Ouche;528;10034074;369774;236;7139498;292;2894576;19004;7272
24568;Vélines;621;11801572;440340;265;8129245;356;3672327;19004;7273
85040;La Caillère-Saint-Hilaire;646;12277474;379777;275;8666883;371;3610591;19005;7274
15045;Chaudes-Aigues;535;10167905;385407;247;7225692;288;2942213;19005;7275
82112;Moissac;7350;139694152;5398855;3163;101230112;4187;38464040;19006;7276
62201;Camiers;1665;31645605;1250823;855;24627257;810;7018348;19006;7277
22308;Saint-Juvat;379;7203644;116358;192;5170254;187;2033390;19007;7278
56056;Évriguet;105;1995760;85792;44;1418785;61;576975;19007;7279
53047;Carelles;145;2756083;14581;62;1831985;83;924098;19007;7280
16374;Soyaux;5513;104790637;4772326;2479;79435221;3034;25355416;19008;7281
48027;Le Bleymard;229;4352903;135017;104;3075378;125;1277525;19008;7282
42106;Grézolles;159;3022426;121065;70;2126813;89;895613;19009;7283
88062;Blevaincourt;65;1235591;40391;36;964448;29;271143;19009;7284
32219;Lupiac;165;3136515;76860;66;2168886;99;967629;19009;7285
84005;Aurel;111;2110020;79827;48;1504527;63;605493;19009;7286
41192;Les Roches-l'Évêque;163;3098506;66858;95;2371566;68;726940;19009;7287
18197;Saint-Amand-Montrond;6536;124246022;5158632;3022;91980391;3514;32265631;19009;7288
63243;Moureuille;162;3079711;60948;75;2192049;87;887662;19011;7289
35310;Saint-Sauveur-des-Landes;769;14619385;223984;375;11336035;394;3283350;19011;7290
23238;Saint-Quentin-la-Chabanne;225;4277486;128989;99;3117245;126;1160241;19011;7291
01396;Sault-Brénaz;574;10912751;341149;292;8255162;282;2657589;19012;7292
38269;La Mure;3275;62264783;2403628;1563;45035308;1712;17229475;19012;7293
33058;Blaye;3030;57606984;2732545;1329;43792091;1701;13814893;19012;7294
23235;Saint-Priest-la-Feuille;426;8099339;241114;214;6022841;212;2076498;19013;7295
52256;Lafauche;44;836561;15910;22;598773;22;237788;19013;7296
24308;Négrondes;480;9126650;224902;238;6568893;242;2557757;19014;7297
56227;Saint-Malo-des-Trois-Fontaines;305;5799229;214504;123;3959329;182;1839900;19014;7298
53253;Saint-Saturnin-du-Limet;273;5190848;114402;125;3662884;148;1527964;19014;7299
63050;Brassac-les-Mines;1963;37326092;1145602;998;27440547;965;9885545;19015;7300
39396;Orchamps;619;11770355;292658;286;8510957;333;3259398;19015;7301
61421;Saint-Mars-d'Égrenne;380;7226011;172208;177;5165187;203;2060824;19016;7302
09266;Saint-Julien-de-Gras-Capou;31;589494;16664;12;402395;19;187099;19016;7303
55356;Moranville;59;1121972;29213;28;801478;31;320494;19016;7304
18087;Dun-sur-Auron;2530;48112100;1898175;1166;36962665;1364;11149435;19017;7305
38041;Bessins;71;1350219;30957;36;940050;35;410169;19017;7306
57379;Landroff;155;2947676;49852;71;1945191;84;1002485;19017;7307
40223;Peyre;123;2339200;33439;51;1596482;72;742718;19018;7308
24547;Terrasson-Lavilledieu;3467;65936225;2293970;1543;45997744;1924;19938481;19018;7309
70489;Servance;518;9851541;345626;241;6988966;277;2862575;19018;7310
85199;Saint-Aubin-la-Plaine;259;4925784;97222;120;3183014;139;1742770;19018;7311
31176;Esténos;115;2187157;82129;53;1512359;62;674798;19019;7312
62404;Halloy;122;2320294;41858;53;1528182;69;792112;19019;7313
71357;Pourlans;126;2396396;114466;59;1763377;67;633019;19019;7314
72354;Thoigné;88;1673781;30633;42;1146920;46;526861;19020;7315
63364;Saint-Jean-d'Heurs;346;6581034;115880;154;4480458;192;2100576;19020;7316
17288;Poursay-Garnaud;158;3005255;70449;76;2147377;82;857878;19021;7317
04166;Riez;1198;22786732;1260282;484;16480833;714;6305899;19021;7318
79054;Brie;118;2244540;71945;48;1567986;70;676554;19022;7319
21593;Savilly;58;1103269;39207;30;817014;28;286255;19022;7320
33020;Auriolles;75;1426683;44070;36;1040973;39;385710;19022;7321
39267;Ivory;49;932103;18740;21;667894;28;264209;19023;7322
88041;Bazegney;52;989227;20928;20;630832;32;358395;19024;7323
53069;Chevaigné-du-Maine;114;2168696;80711;58;1649766;56;518930;19024;7324
22391;Yvignac-la-Tour;651;12384401;279590;322;8908000;329;3476401;19024;7325
03254;Saint-Pourçain-sur-Sioule;3125;59450357;2520652;1423;43001425;1702;16448932;19024;7326
52336;Montreuil-sur-Blaise;86;1636077;25903;46;1182524;40;453553;19024;7327
70064;Belverne;74;1407830;46113;37;1032045;37;375785;19025;7328
05021;Le Bersac;82;1560044;51240;37;1142850;45;417194;19025;7329
17133;Cravans;412;7838539;202339;173;5193196;239;2645343;19026;7330
67448;Schirmeck;1310;24923922;821844;630;17561837;680;7362085;19026;7331
18191;Raymond;109;2073862;74486;56;1551370;53;522492;19026;7332
39235;Fraisans;676;12862086;311144;338;9095819;338;3766267;19027;7333
21658;Vauchignon;24;456654;17944;13;349958;11;106696;19027;7334
2B265;Rutali;182;3462976;177351;75;2450454;107;1012522;19027;7335
02738;Tergnier;7918;150659566;4727494;3318;109006806;4600;41652760;19027;7336
67136;Eywiller;144;2740052;49007;76;2111121;68;628931;19028;7337
08362;Rethel;4718;89779104;4172389;2120;67104472;2598;22674632;19029;7338
30238;Saint-Bresson;48;913401;31654;16;725086;32;188315;19029;7339
39091;Les Chalesmes;49;932434;23927;21;620739;28;311695;19029;7340
30318;Servas;109;2074364;78689;50;1477017;59;597347;19031;7341
76034;Auffay;1091;20762746;696122;511;14940708;580;5822038;19031;7342
31121;Castéra-Vignoles;39;742216;28461;15;461763;24;280453;19031;7343
46294;Saint-Sulpice;75;1427348;39897;35;1026816;40;400532;19031;7344
76122;Callengeville;266;5062427;126485;134;3654976;132;1407451;19032;7345
21671;Vertault;33;628060;21703;16;437626;17;190434;19032;7346
22189;Plésidy;329;6261840;181593;137;4178113;192;2083727;19033;7347
31296;Lestelle-de-Saint-Martory;251;4777292;135831;124;3349839;127;1427453;19033;7348
19139;Millevaches;49;932622;43170;22;624628;27;307994;19033;7349
33095;Captieux;837;15930770;676222;350;11161779;487;4768991;19033;7350
76332;Grumesnil;238;4529969;145564;121;3404491;117;1125478;19033;7351
62842;Vendin-le-Vieil;3995;76039566;2066126;1937;56204178;2058;19835388;19034;7352
80413;Hancourt;54;1027823;27952;20;622082;34;405741;19034;7353
48062;Fontanes;78;1484640;12910;33;866460;45;618180;19034;7354
52413;Rachecourt-Suzémont;60;1142032;31102;34;863775;26;278257;19034;7355
61387;Saint-Fraimbault;341;6490674;263634;136;4254278;205;2236396;19034;7356
02457;Marchais;198;3768849;65734;105;2732984;93;1035865;19035;7357
64461;Puyoô;611;11630259;337881;276;8215842;335;3414417;19035;7358
11312;Ribouisse;52;989820;15530;26;685873;26;303947;19035;7359
11015;Arques;120;2284342;74366;53;1618065;67;666277;19036;7360
70237;Fleurey-lès-Lavoncourt;65;1237378;27546;26;758521;39;478857;19037;7361
70061;Belfahy;62;1180310;52953;31;907714;31;272596;19037;7362
24359;Sadillac;59;1123212;40998;26;800434;33;322778;19037;7363
58241;Saint-Germain-Chassenay;199;3788503;143532;101;2952212;98;836291;19038;7364
16283;Ronsenac;327;6225548;195090;150;4471498;177;1754050;19038;7365
49172;Landemont;912;17363144;238979;457;12334286;455;5028858;19039;7366
52353;Nogent;2362;44969083;1424328;1154;32598112;1208;12370971;19039;7367
63285;Pontgibaud;450;8567429;352298;216;6455225;234;2112204;19039;7368
43121;Léotoing;142;2703556;73640;66;1880292;76;823264;19039;7369
43212;Saint-Pal-de-Chalencon;606;11537729;347911;266;8201083;340;3336646;19039;7370
61257;Méhoudin;67;1275634;23045;29;891123;38;384511;19039;7371
07319;Le Teil;4888;93065803;3153195;2280;67355489;2608;25710314;19040;7372
89386;Sennevoy-le-Haut;55;1047197;31772;25;699982;30;347215;19040;7373
79149;Lhoumois;81;1542312;75067;35;1112477;46;429835;19041;7374
03014;Avrilly;86;1637552;36612;38;1127173;48;510379;19041;7375
12046;Camjac;328;6245692;143754;154;4572000;174;1673692;19042;7376
37127;Le Liège;185;3522872;100596;87;2399644;98;1123228;19043;7377
87108;Nouic;290;5522567;226873;114;3778843;176;1743724;19043;7378
32268;Monferran-Savès;456;8683851;361554;224;7077181;232;1606670;19044;7379
12282;Tournemire;228;4341977;89140;115;3133362;113;1208615;19044;7380
21180;Cléry;73;1390205;23021;35;1017249;38;372956;19044;7381
36226;Tranzault;212;4037395;99886;110;3017694;102;1019701;19044;7382
51460;Rieux;91;1733036;48415;46;1252585;45;480451;19044;7383
04035;Brunet;135;2570994;52162;63;1813300;72;757694;19044;7384
58095;Decize;3562;67837585;2646835;1739;50049433;1823;17788152;19045;7385
02504;Montescourt-Lizerolles;835;15902552;388735;403;11180232;432;4722320;19045;7386
17305;Rouffignac;245;4666088;162034;115;3333727;130;1332361;19045;7387
14621;Saint-Martin-de-Bienfaite-la-Cressonnière;279;5313663;142475;143;3910280;136;1403383;19045;7388
32031;Bascous;92;1752208;28676;39;1201342;53;550866;19046;7389
14171;Combray;68;1295142;8517;30;830859;38;464283;19046;7390
66089;Joch;156;2971305;83341;70;2105267;86;866038;19047;7391
12284;Le Truel;180;3428493;71048;87;2439628;93;988865;19047;7392
64490;Saint-Martin-d'Arrossa;257;4895128;134490;120;3592051;137;1303077;19047;7393
19060;Condat-sur-Ganaveix;393;7485582;312499;186;5705301;207;1780281;19047;7394
62138;Blangy-sur-Ternoise;418;7962414;278602;182;5570972;236;2391442;19049;7395
57160;Creutzwald;7824;149038953;5511806;3647;106466237;4177;42572716;19049;7396
19254;Ségur-le-Château;118;2247786;119428;49;1644889;69;602897;19049;7397
04130;Montlaux;99;1885858;56617;47;1384539;52;501319;19049;7398
87146;Saint-Germain-les-Belles;674;12839377;423001;311;9399628;363;3439749;19050;7399
17377;Saint-Ouen;66;1257288;27046;29;830484;37;426804;19050;7400
33168;Flaujagues;347;6610343;251225;164;4881156;183;1729187;19050;7401
24301;Nadaillac;191;3638580;105554;84;2623827;107;1014753;19050;7402
65375;Rabastens-de-Bigorre;855;16288386;553827;362;11122561;493;5165825;19051;7403
59032;Aulnoy-lez-Valenciennes;3659;69708209;2543658;1674;50462221;1985;19245988;19051;7404
24305;Nanthiat;163;3105474;94228;79;2230577;84;874897;19052;7405
34199;Pézenas;5202;99112234;5018462;2077;72045630;3125;27066604;19053;7406
64029;Aramits;365;6954249;254747;157;4947130;208;2007119;19053;7407
62171;Boyaval;65;1238436;30991;23;782943;42;455493;19053;7408
80748;Templeux-le-Guérard;115;2191091;109918;49;1585435;66;605656;19053;7409
59272;Grand-Fort-Philippe;2987;56912055;1933951;1470;42194719;1517;14717336;19053;7410
24391;Saint-Crépin-de-Richemont;128;2438871;108025;62;1863331;66;575540;19054;7411
14764;Pont-d'Ouilly;574;10936989;323835;264;7752436;310;3184553;19054;7412
70180;Courchaton;250;4763630;98845;138;3491093;112;1272537;19055;7413
16293;Saint-Adjutory;246;4687554;117557;114;3348545;132;1339009;19055;7414
14502;Pierrepont;50;952759;7528;22;642866;28;309893;19055;7415
80648;Pys;59;1124262;45271;25;786417;34;337845;19055;7416
61410;Saint-Jean-des-Bois;95;1810256;39261;51;1352580;44;457676;19055;7417
63077;Chambon-sur-Lac;222;4230382;134205;103;3004110;119;1226272;19056;7418
55407;Pont-sur-Meuse;82;1562595;29792;43;1128533;39;434062;19056;7419
80280;Ercourt;74;1410177;45697;41;1059642;33;350535;19056;7420
33173;Francs;105;2000991;40835;53;1470767;52;530224;19057;7421
72143;Le Grand-Lucé;1129;21515716;858142;489;14941941;640;6573775;19057;7422
24548;Teyjat;164;3125516;155333;73;2217110;91;908406;19058;7423
59059;Beaumont-en-Cambrésis;249;4745598;163968;105;3309815;144;1435783;19059;7424
29219;Le Ponthou;90;1715277;38952;50;1310985;40;404292;19059;7425
62497;Leforest;3545;67564524;1639447;1606;46886513;1939;20678011;19059;7426
35070;Châteauneuf-d'Ille-et-Vilaine;807;15380860;269667;400;11033783;407;4347077;19059;7427
79257;Saint-Hilaire-la-Palud;905;17248956;564078;413;12124418;492;5124538;19060;7428
61384;Saint-Ellier-les-Bois;135;2573167;47828;68;1735218;67;837949;19060;7429
61168;La Ferté-Macé;3333;63529370;2268108;1512;46374171;1821;17155199;19061;7430
80118;Boufflers;63;1200855;19072;29;833496;34;367359;19061;7431
10221;Maizières-lès-Brienne;101;1925199;43207;53;1425498;48;499701;19061;7432
35153;Lillemer;168;3202360;52793;93;2338879;75;863481;19062;7433
25046;Battenans-Varin;42;800607;17528;19;575946;23;224661;19062;7434
33126;Civrac-de-Blaye;414;7891758;158430;182;5266745;232;2625013;19062;7435
72028;Beaumont-Pied-de-Boeuf;275;5242179;112715;132;3840233;143;1401946;19062;7436
29246;Saint-Eloy;123;2344688;38788;56;1577841;67;766847;19063;7437
56062;Gâvres;487;9283468;410497;218;6627370;269;2656098;19063;7438
55217;Goussaincourt;68;1296255;36050;34;935354;34;360901;19063;7439
55329;Mécrin;135;2573456;50472;59;1682091;76;891365;19063;7440
08446;Thénorgues;53;1010359;20467;24;691143;29;319216;19063;7441
46304;Séniergues;74;1410696;70370;31;987771;43;422925;19063;7442
58065;Châtillon-en-Bazois;555;10580439;440760;251;7524740;304;3055699;19064;7443
33315;Les Peintures;896;17081343;547589;411;12258269;485;4823074;19064;7444
86039;Brux;406;7740014;251718;174;5383843;232;2356171;19064;7445
65295;Luz-Saint-Sauveur;677;12906685;581215;325;9371184;352;3535501;19065;7446
65412;Sauveterre;97;1849274;47638;47;1370439;50;478835;19065;7447
73047;Bonneval-sur-Arc;150;2859799;82796;76;2065361;74;794438;19065;7448
63310;Sainte-Agathe;129;2459432;89494;49;1688046;80;771386;19065;7449
21166;Chenôve;7715;147089658;4941182;3738;107088110;3977;40001548;19065;7450
55291;Ligny-en-Barrois;2525;48141412;1756384;1227;36012724;1298;12128688;19066;7451
11286;Peyriac-Minervois;570;10867890;446605;249;7876980;321;2990910;19066;7452
21476;Painblanc;95;1811318;86617;43;1221901;52;589417;19067;7453
52223;Gilley;37;705474;19071;15;486244;22;219230;19067;7454
33446;Saint-Martin-du-Puy;115;2192722;65966;46;1451353;69;741369;19067;7455
15242;Le Trioulou;62;1182216;60643;26;892215;36;290001;19068;7456
44157;Saint-Étienne-de-Mer-Morte;788;15025832;171418;373;10391924;415;4633908;19068;7457
79066;Champdeniers-Saint-Denis;993;18935298;578835;423;12976369;570;5958929;19069;7458
86193;Pleumartin;691;13176703;476675;314;9466727;377;3709976;19069;7459
53270;Vieuvy;65;1239512;3584;26;817859;39;421653;19069;7460
16417;Viville;71;1353932;25815;33;968732;38;385200;19069;7461
46135;Labastide-du-Haut-Mont;30;572092;15305;12;407307;18;164785;19070;7462
73123;La Giettaz;250;4767692;132795;120;3409736;130;1357956;19071;7463
48111;Pelouse;100;1907102;25286;57;1473212;43;433890;19071;7464
34287;Saint-Saturnin-de-Lucian;163;3108642;129834;62;2081765;101;1026877;19071;7465
34196;Pégairolles-de-l'Escalette;95;1811830;53778;38;1238899;57;572931;19072;7466
60643;Tricot;814;15524629;499607;387;11142866;427;4381763;19072;7467
21705;Villotte-Saint-Seine;41;781959;23006;20;531652;21;250307;19072;7468
71524;Sivignon;108;2059853;84381;43;1338659;65;721194;19073;7469
71316;Montmelard;191;3642925;109127;91;2588317;100;1054608;19073;7470
28218;Lucé;9684;184702102;6632520;5240;142884757;4444;41817345;19073;7471
43170;Saint-Beauzire;189;3604843;70537;83;2490965;106;1113878;19073;7472
79007;Allonne;341;6503980;153415;156;4556942;185;1947038;19073;7473
32132;Fleurance;3936;75072491;2994081;1792;53965371;2144;21107120;19073;7474
31468;Saint-André;119;2269730;69372;52;1591666;67;678064;19073;7475
32233;Marciac;776;14800934;595657;321;10428196;455;4372738;19073;7476
11193;Lasserre-de-Prouille;133;2536848;88441;66;1894964;67;641884;19074;7477
16267;Poullignac;49;934661;45073;22;659917;27;274744;19075;7478
07094;Gilhac-et-Bruzac;82;1564153;48162;38;1111980;44;452173;19075;7479
56203;Saint-Aignan;362;6905489;246508;163;4862323;199;2043166;19076;7480
70398;Ormoiche;39;744003;29103;16;468997;23;275006;19077;7481
61329;Le Pin-la-Garenne;404;7707130;250834;170;5285987;234;2421143;19077;7482
09080;Carla-de-Roquefort;89;1697884;64567;37;1252926;52;444958;19077;7483
63464;Vitrac;202;3853670;91115;94;2648663;108;1205007;19078;7484
82033;Castelsarrasin;7644;145829316;5074363;3447;105731373;4197;40097943;19078;7485
31315;Mane;628;11980801;456579;280;8204661;348;3776140;19078;7486
88004;Ainvelle;91;1736073;47249;44;1238264;47;497809;19078;7487
82169;Saint-Nicolas-de-la-Grave;1226;23389789;666971;553;16485243;673;6904546;19078;7488
17442;Thaims;193;3682258;96956;89;2571909;104;1110349;19079;7489
64356;Luc-Armau;60;1144761;18846;29;837747;31;307014;19079;7490
35064;La Chapelle-de-Brain;561;10704105;439853;257;7680483;304;3023622;19080;7491
50223;Guéhébert;58;1106703;11339;27;715749;31;390954;19081;7492
2B087;Cervione;943;17993684;821031;413;13414259;530;4579425;19081;7493
57591;Rombas;5534;105598929;3074991;2430;70927753;3104;34671176;19082;7494
08011;Anchamps;122;2327990;57954;60;1662708;62;665282;19082;7495
30304;Salazac;116;2213539;57151;50;1596894;66;616645;19082;7496
57414;Lorquin;737;14063633;543134;345;10912826;392;3150807;19082;7497
36055;Clion;657;12537089;386256;282;8710136;375;3826953;19082;7498
63016;Augerolles;546;10419177;404922;248;7234566;298;3184611;19083;7499
56196;Rochefort-en-Terre;399;7614100;364935;174;5672154;225;1941946;19083;7500
31347;Molas;93;1774752;69428;37;1257844;56;516908;19083;7501
33258;Lugasson;171;3263306;99567;78;2193592;93;1069714;19084;7502
81111;Labarthe-Bleys;43;820604;30981;18;583762;25;236842;19084;7503
42318;Usson-en-Forez;800;15267223;413098;327;10467029;473;4800194;19084;7504
25313;Hyèvre-Paroisse;110;2099277;74767;58;1563845;52;535432;19084;7505
46247;Saillac;94;1793940;50545;40;1269041;54;524899;19084;7506
27283;Gisay-la-Coudre;150;2862715;91812;76;2142171;74;720544;19085;7507
36237;Vicq-sur-Nahon;469;8950761;244611;239;6414270;230;2536491;19085;7508
61364;Saint-Aubert-sur-Orne;66;1259598;18921;28;877004;38;382594;19085;7509
25315;L'Isle-sur-le-Doubs;1866;35613015;1279326;935;26476098;931;9136917;19085;7510
79119;Fenioux;389;7424283;227155;169;5084369;220;2339914;19086;7511
52212;Fronville;183;3492735;103459;86;2461377;97;1031358;19086;7512
01219;Lompnas;93;1775027;68999;41;1305755;52;469272;19086;7513
63238;Montfermy;113;2156761;44039;58;1534801;55;621960;19086;7514
86244;Saint-Sauvant;767;14639304;463555;351;10561637;416;4077667;19086;7515
76257;Fallencourt;102;1946824;64575;44;1347098;58;599726;19087;7516
21091;Bouhey;30;572606;30911;18;461207;12;111399;19087;7517
19067;Curemonte;131;2500443;104347;65;1890712;66;609731;19087;7518
82132;Montricoux;635;12120573;389903;314;8920003;321;3200570;19088;7519
64268;Idaux-Mendy;133;2538718;43065;69;1876693;64;662025;19088;7520
89233;Lucy-sur-Cure;125;2386016;88030;60;1787748;65;598268;19088;7521
22057;Le Faouët;187;3569508;85859;94;2579581;93;989927;19088;7522
61133;Courtomer;420;8017531;183801;195;5841694;225;2175837;19089;7523
50130;Chérencé-le-Héron;225;4295186;148590;108;3085194;117;1209992;19090;7524
82058;Fajolles;57;1088119;46021;28;782999;29;305120;19090;7525
22199;Pleumeur-Gautier;693;13229447;332749;310;9099085;383;4130362;19090;7526
16079;Chantillac;173;3302590;120449;75;2306423;98;996167;19090;7527
88268;Lesseux;87;1660956;8156;41;1180791;46;480165;19091;7528
30323;Soustelle;83;1584610;67814;36;1194034;47;390576;19092;7529
80600;Noyelles-sur-Mer;454;8667941;359171;203;6267332;251;2400609;19092;7530
54477;Saint-Julien-lès-Gorze;102;1947551;58970;46;1381637;56;565914;19094;7531
07338;Vernoux-en-Vivarais;1104;21079497;708392;506;15225799;598;5853698;19094;7532
10226;Marolles-lès-Bailly;60;1145628;23427;29;814476;31;331152;19094;7533
66161;Ria-Sirach;718;13709948;511243;339;10226264;379;3483684;19095;7534
22046;Collinée;495;9452027;460862;218;6450081;277;3001946;19095;7535
47136;Laperche;75;1432140;52316;36;1085714;39;346426;19095;7536
36118;Méobecq;221;4220206;131807;98;3024622;123;1195584;19096;7537
76523;Rétonval;107;2043273;52246;57;1482751;50;560522;19096;7538
24325;Peyrillac-et-Millac;134;2558883;92207;58;1817854;76;741029;19096;7539
59528;Saint-Aubert;840;16040969;459663;378;11331058;462;4709911;19096;7540
77051;Bray-sur-Seine;1390;26544010;1082711;637;19019051;753;7524959;19096;7541
19029;Branceilles;158;3017237;84511;70;2127761;88;889476;19096;7542
46061;Cassagnes;106;2024253;40553;52;1568782;54;455471;19097;7543
65249;Lalanne;48;916646;25541;21;590780;27;325866;19097;7544
87093;Masléon;184;3513993;111060;90;2539279;94;974714;19098;7545
09044;Baulou;92;1757011;58969;42;1356777;50;400234;19098;7546
49253;Le Puy-Notre-Dame;687;13120314;349938;292;8831461;395;4288853;19098;7547
14632;Saint-Martin-Don;132;2520935;62036;73;1914813;59;606122;19098;7548
17433;Sousmoulins;125;2387284;73006;56;1678237;69;709047;19098;7549
50060;La Bloutière;234;4469004;83077;116;3216240;118;1252764;19098;7550
57376;Lambach;279;5328458;135048;130;3729278;149;1599180;19098;7551
37019;Barrou;265;5061486;197490;114;3564204;151;1497282;19100;7552
87066;Flavignac;601;11479217;316094;312;8448400;289;3030817;19100;7553
84022;Buisson;173;3304346;150833;77;2386452;96;917894;19100;7554
60621;Solente;61;1165122;37048;26;797057;35;368065;19100;7555
19237;Saint-Privat;671;12816705;443163;317;9391592;354;3425113;19101;7556
39016;Arinthod;651;12435136;448332;304;8732274;347;3702862;19102;7557
08208;Hannappes;77;1470917;53215;37;1078798;40;392119;19103;7558
63048;Bourg-Lastic;569;10869688;386080;270;7718260;299;3151428;19103;7559
02435;Logny-lès-Aubenton;47;897873;30104;19;582519;28;315354;19104;7560
37187;Ports;205;3916401;122963;94;2794215;111;1122186;19104;7561
88432;Saint-Pierremont;88;1681214;30915;42;1111981;46;569233;19105;7562
72364;Vaas;936;17882430;572087;432;12790401;504;5092029;19105;7563
23107;Lépinas;108;2063385;121389;47;1491420;61;571965;19105;7564
32409;Samaran;48;917066;33108;23;706930;25;210136;19106;7565
01388;Saint-Trivier-de-Courtes;666;12724374;390172;302;9041899;364;3682475;19106;7566
54003;Aboncourt;67;1280120;47741;24;803987;43;476133;19106;7567
41198;Saint-Aignan;1890;36111211;1373020;864;26406434;1026;9704777;19106;7568
16371;Sonneville;133;2541270;85456;64;1819707;69;721563;19107;7569
76484;Oissel;6215;118755526;4177733;3233;91244159;2982;27511367;19108;7570
79159;Luché-Thouarsais;223;4261238;22329;100;2844597;123;1416641;19109;7571
62871;Wambercourt;129;2465037;65256;65;1863427;64;601610;19109;7572
16325;Saint-Gourson;78;1490508;76818;32;1068707;46;421801;19109;7573
26175;Marignac-en-Diois;113;2159391;49861;60;1625679;53;533712;19110;7574
63047;La Bourboule;1152;22015345;923061;583;16633633;569;5381712;19111;7575
62161;Bouquehault;346;6612420;103900;165;4542068;181;2070352;19111;7576
59433;Nieurlet;508;9708503;242439;232;6729485;276;2979018;19111;7577
30130;Génolhac;561;10721514;358404;249;7505164;312;3216350;19111;7578
14722;La Vacquerie;154;2943184;73449;79;2181073;75;762111;19112;7579
24470;Sainte-Mondane;151;2885939;52623;72;2084221;79;801718;19112;7580
81055;Les Cammazes;177;3382857;126990;86;2535208;91;847649;19112;7581
03237;Saint-Germain-de-Salles;256;4892774;117986;121;3419022;135;1473752;19112;7582
55051;Biencourt-sur-Orge;72;1376093;46862;39;1029608;33;346485;19112;7583
71417;Saint-Gengoux-le-National;647;12365971;420801;268;8563960;379;3802011;19113;7584
09225;Pamiers;9243;176660529;7946761;4271;134638625;4972;42021904;19113;7585
16397;Verdille;211;4032830;138708;90;2892002;121;1140828;19113;7586
12051;Cantoin;186;3555085;142567;74;2281763;112;1273322;19113;7587
65141;Cazaux-Fréchet-Anéran-Camors;37;707208;15903;22;553155;15;154053;19114;7588
79340;Vausseroux;182;3478703;86110;78;2429085;104;1049618;19114;7589
27117;Broglie;636;12156517;525517;296;9203401;340;2953116;19114;7590
29159;Peumérit;470;8983694;197285;240;6592033;230;2391661;19114;7591
81260;Saint-Lieux-Lafenasse;258;4931502;102269;122;3390866;136;1540636;19114;7592
54211;Frémonville;125;2389391;128180;62;1804394;63;584997;19115;7593
06158;Villars-sur-Var;406;7761854;294814;193;5638150;213;2123704;19118;7594
80093;Berteaucourt-les-Dames;640;12235869;365131;319;9026900;321;3208969;19119;7595
33540;Vendays-Montalivet;1591;30418360;1166756;744;22064461;847;8353899;19119;7596
09142;Ilhat;70;1338348;31599;29;920205;41;418143;19119;7597
17331;Saint-Genis-de-Saintonge;672;12848252;573039;296;9554919;376;3293333;19119;7598
83109;La Roque-Esclapon;124;2370816;78251;63;1806788;61;564028;19119;7599
53032;Blandouet;95;1816357;23491;49;1293410;46;522947;19120;7600
67274;Lorentzen;138;2638538;77669;67;1908489;71;730049;19120;7601
22083;Illifaut;375;7169989;154806;167;4733837;208;2436152;19120;7602
85235;Saint-Juire-Champgillon;240;4588831;145635;107;3244912;133;1343919;19120;7603
05143;Saint-Genis;26;497124;10332;12;356705;14;140419;19120;7604
70128;La Chapelle-lès-Luxeuil;239;4569825;121403;126;3385275;113;1184550;19121;7605
33427;Saint-Laurent-du-Bois;132;2524016;64677;57;1836049;75;687967;19121;7606
04156;Puimichel;137;2619625;100356;59;1825070;78;794555;19121;7607
71133;La Clayette;1168;22335061;946953;538;15869569;630;6465492;19122;7608
03244;Saint-Marcel-en-Marcillat;93;1778424;52267;41;1201278;52;577146;19123;7609
31357;Montastruc-de-Salies;172;3289240;127651;79;2319215;93;970025;19123;7610
51355;Massiges;33;631149;40750;14;437585;19;193564;19126;7611
40208;Onard;219;4188609;71303;103;3005542;116;1183067;19126;7612
27275;Gaillon;4200;80330755;3413624;2164;61223668;2036;19107087;19126;7613
2B075;Casevecchie;23;439910;17790;12;367749;11;72161;19127;7614
2A092;Conca;569;10883003;535611;246;7920374;323;2962629;19127;7615
88003;Aingeville;45;860719;24410;22;672332;23;188387;19127;7616
09261;Saint-Girons;4202;80374628;3881575;1926;60127978;2276;20246650;19128;7617
21038;Auxonne;4311;82460426;2424902;2142;60369525;2169;22090901;19128;7618
64082;Auterrive;72;1377221;50230;32;1024144;40;353077;19128;7619
05070;Laragne-Montéglin;2227;42598336;1490157;1061;31246062;1166;11352274;19128;7620
24240;Limeuil;203;3883011;148201;82;2690527;121;1192484;19128;7621
62560;Marquise;2692;51493165;1534754;1195;36362905;1497;15130260;19128;7622
31109;Cassagnabère-Tournas;258;4935308;178816;114;3483442;144;1451866;19129;7623
80753;Thiepval;58;1109497;43291;24;779356;34;330141;19129;7624
19094;Juillac;697;13333317;450122;331;9758793;366;3574524;19130;7625
63371;Saint-Just;116;2219055;75318;55;1574224;61;644831;19130;7626
57418;Loudrefing;171;3271260;101786;72;2120317;99;1150943;19130;7627
29113;Lanmeur;1301;24889642;696640;613;18208876;688;6680766;19131;7628
62569;Merck-Saint-Liévin;325;6217805;186472;139;4141701;186;2076104;19132;7629
61293;Mortagne-au-Perche;2414;46184532;1993110;1091;34409123;1323;11775409;19132;7630
02206;Colonfay;38;727030;19974;18;534341;20;192689;19132;7631
53264;Thorigné-en-Charnie;89;1702833;25564;38;1051298;51;651535;19133;7632
81227;Roquecourbe;1340;25638369;579737;626;17866384;714;7771985;19133;7633
48075;Ispagnac;538;10293792;403522;253;7498789;285;2795003;19133;7634
40318;Toulouzette;161;3080524;115398;70;2191674;91;888850;19134;7635
61018;Avernes-Saint-Gourgon;37;707953;8972;16;462655;21;245298;19134;7636
86107;Gouex;283;5415011;159530;134;3726758;149;1688253;19134;7637
38489;Siévoz;83;1588176;31635;44;1157567;39;430609;19135;7638
12044;Camarès;580;11098424;283305;255;7867710;325;3230714;19135;7639
62344;Fontaine-lès-Hermans;52;995066;10765;28;721270;24;273796;19136;7640
07100;Gravières;259;4956463;220176;116;3668964;143;1287499;19137;7641
86103;Gençay;1045;19998157;613382;494;14655553;551;5342604;19137;7642
22192;Plessix-Balisson;58;1109984;22308;31;755227;27;354757;19138;7643
51507;Sainte-Menehould;2652;50753711;2000369;1240;37543724;1412;13209987;19138;7644
50166;Doville;158;3023822;75931;75;2159126;83;864696;19138;7645
62165;Bournonville;113;2162611;49192;53;1601063;60;561548;19138;7646
43115;Laussonne;603;11540436;293975;291;8261883;312;3278553;19138;7647
54421;Petitmont;190;3636292;68720;81;2317655;109;1318637;19138;7648
12093;Le Fel;90;1722551;93538;34;1242167;56;480384;19139;7649
08105;Charleville-Mézières;29031;555639052;29388473;13301;426074211;15730;129564841;19140;7650
21357;Louesme;71;1358906;34032;33;992780;38;366126;19140;7651
50642;Vindefontaine;166;3177218;68982;79;2191069;87;986149;19140;7652
21704;Villiers-le-Duc;56;1071835;33318;27;810891;29;260944;19140;7653
22248;Pommerit-le-Vicomte;1045;20001764;685063;469;14064490;576;5937274;19140;7654
21519;Recey-sur-Ource;231;4421455;177276;92;2976257;139;1445198;19140;7655
58102;Donzy;1029;19695589;720620;450;14199618;579;5495971;19141;7656
59360;Loos;11416;218508592;8249317;6002;167073847;5414;51434745;19141;7657
11343;Saint-Gaudéric;53;1014452;40274;27;781548;26;232904;19141;7658
61265;Ménil-Gondouin;97;1856712;40296;48;1325033;49;531679;19141;7659
76460;Nesle-Normandeuse;334;6393238;209673;193;5066121;141;1327117;19141;7660
36139;Neuillay-les-Bois;393;7523031;203838;210;5636798;183;1886233;19143;7661
52107;Chantraines;131;2507708;62691;79;1950181;52;557527;19143;7662
63251;Neuf-Église;176;3369240;90335;92;2492921;84;876319;19143;7663
65400;Salles;118;2258939;71374;59;1634498;59;624441;19144;7664
35285;Saint-Just;578;11064976;241815;285;7788375;293;3276601;19144;7665
80274;Eppeville;1051;20120400;750977;507;14973726;544;5146674;19144;7666
18042;La Celle;203;3886244;95711;102;2788864;101;1097380;19144;7667
54430;Pompey;2787;53354785;1749516;1388;39499080;1399;13855705;19144;7668
02551;Neuville-sur-Margival;60;1148753;10221;28;775197;32;373556;19146;7669
87013;Bersac-sur-Rivalier;382;7313917;279492;170;5265711;212;2048206;19146;7670
70357;Montbozon;293;5609935;113566;136;3817223;157;1792712;19147;7671
36191;Saint-Florentin;288;5514303;124579;145;3901238;143;1613065;19147;7672
95280;Goussainville;15690;300425303;9371264;7637;221247644;8053;79177659;19148;7673
38299;Pellafol;89;1704203;73228;40;1174133;49;530070;19148;7674
64186;Charre;134;2565886;93693;64;1800764;70;765122;19148;7675
88182;Frapelle;117;2240396;17544;62;1569437;55;670959;19149;7676
70251;Francourt;61;1168133;38269;29;823330;32;344803;19150;7677
89266;Montillot;168;3217162;93391;85;2335736;83;881426;19150;7678
50622;Vaudrimesnil;207;3964088;118159;93;2830525;114;1133563;19150;7679
70141;Châtenois;67;1283064;35495;35;995841;32;287223;19150;7680
24271;Milhac-de-Nontron;334;6396189;221497;139;4356620;195;2039569;19150;7681
46114;Frayssinet-le-Gélat;236;4519688;163450;92;2994615;144;1525073;19151;7682
02511;Montigny-en-Arrouaise;153;2930309;97427;66;1947855;87;982454;19152;7683
33111;Caudrot;680;13024354;451591;297;9041164;383;3983190;19153;7684
60311;La Hérelle;126;2413351;73804;71;1866953;55;546398;19154;7685
79094;Clessé;482;9232081;110989;213;6138851;269;3093230;19154;7686
71520;Sevrey;719;13771685;622116;362;11413400;357;2358285;19154;7687
04004;Allemagne-en-Provence;300;5746243;159008;145;4178272;155;1567971;19154;7688
05127;Rousset;109;2087812;53664;56;1554257;53;533555;19154;7689
79326;Thénezay;825;15802427;389842;317;10904674;508;4897753;19154;7690
44076;Jans;627;12010748;176828;290;8350420;337;3660328;19156;7691
61227;Lignou;78;1494185;35829;44;1027064;34;467121;19156;7692
55586;Xivray-et-Marvoisin;65;1245165;52616;35;954425;30;290740;19156;7693
80591;Neuville-au-Bois;97;1858182;69811;51;1337178;46;521004;19157;7694
02160;Chaourse;286;5478830;186515;112;3719665;174;1759165;19157;7695
12195;Rebourguil;161;3084275;63659;68;2121917;93;962358;19157;7696
65342;Osmets;48;919546;14940;27;720596;21;198950;19157;7697
08311;Mouzon;1360;26053909;946554;639;18794125;721;7259784;19157;7698
64494;Saint-Pé-de-Léren;131;2509671;54958;63;1844338;68;665333;19158;7699
12259;Sanvensa;357;6839335;176733;167;4902009;190;1937326;19158;7700
21479;Pellerey;61;1168632;28981;37;864177;24;304455;19158;7701
80205;Condé-Folie;490;9387421;238454;243;6901522;247;2485899;19158;7702
63201;Luzillat;547;10479575;284358;272;7761685;275;2717890;19158;7703
70552;Villafans;103;1973342;31064;52;1386641;51;586701;19159;7704
31268;Lalouret-Laffiteau;85;1628508;53596;41;1233661;44;394847;19159;7705
65123;Campan;910;17435532;646003;460;13071415;450;4364117;19160;7706
10142;Estissac;1083;20750903;666924;552;15653732;531;5097171;19161;7707
63043;Blot-l'Église;242;4636986;121852;115;3300002;127;1336984;19161;7708
56163;Ploërdut;709;13585652;426705;325;9803888;384;3781764;19162;7709
62475;Ivergny;120;2299427;34064;57;1608314;63;691113;19162;7710
16144;Fouqueure;232;4445676;98450;113;3106996;119;1338680;19162;7711
76572;Saint-Denis-d'Aclon;92;1762951;46877;53;1399543;39;363408;19163;7712
80054;Barleux;172;3295956;122201;89;2590338;83;705618;19163;7713
32385;Saint-Léonard;93;1782214;52777;40;1224156;53;558058;19164;7714
61230;Longny-au-Perche;908;17400663;696401;401;12118610;507;5282053;19164;7715
46184;Marminiac;210;4024425;147248;85;2826433;125;1197992;19164;7716
55535;Vaudoncourt;36;689923;10382;15;452394;21;237529;19165;7717
89323;Roffey;90;1724831;70177;44;1275990;46;448841;19165;7718
32256;Mirande;2202;42200866;1746168;1024;30911672;1178;11289194;19165;7719
16253;Paizay-Naudouin-Embourie;201;3852328;114690;71;2407471;130;1444857;19166;7720
83012;Barjols;1816;34805271;1304126;823;25295175;993;9510096;19166;7721
12016;Auzits;488;9353003;227358;225;6656800;263;2696203;19166;7722
47058;Caubeyres;110;2108304;32996;58;1514735;52;593569;19166;7723
44068;Guenrouet;1792;34347173;923460;865;24416220;927;9930953;19167;7724
64477;Saint-Étienne-de-Baïgorry;857;16426934;736638;381;11996028;476;4430906;19168;7725
2B077;Castellare-di-Casinca;341;6536290;342095;148;4740689;193;1795601;19168;7726
03122;Gipcy;138;2645202;67253;61;1777108;77;868094;19168;7727
52438;Rougeux;65;1245937;12373;27;807013;38;438924;19168;7728
43157;Le Puy-en-Velay;11495;220350979;10978224;5369;166153124;6126;54197855;19169;7729
62250;Courrières;5644;108192178;3523876;2657;79489411;2987;28702767;19169;7730
50151;Créances;1235;23675438;735136;546;16345794;689;7329644;19170;7731
25092;La Bretenière;41;785996;13135;18;535418;23;250578;19171;7732
52421;Riaucourt;280;5367882;142062;132;3831939;148;1535943;19171;7733
79010;Arçais;379;7265858;260683;181;5336176;198;1929682;19171;7734
2A024;Aullène;99;1898064;78706;53;1417880;46;480184;19172;7735
11328;Routier;138;2645789;57716;63;1910100;75;735689;19172;7736
14653;Saint-Pierre-la-Vieille;198;3796197;90974;97;2760560;101;1035637;19173;7737
07301;Saint-Victor;548;10507023;280471;241;7362097;307;3144926;19173;7738
2A215;Pianottoli-Caldarello;476;9126590;402461;231;6771571;245;2355019;19174;7739
53050;Chammes;198;3796547;41316;104;2748002;94;1048545;19174;7740
05010;Aspres-sur-Buëch;485;9299628;304114;201;6269635;284;3029993;19174;7741
59094;Bourbourg;3969;76103683;2800728;1791;53659111;2178;22444572;19175;7742
81132;Guitalens-L'Albarède;483;9261412;239338;227;6443671;256;2817741;19175;7743
82173;Saint-Sardos;482;9242257;246308;224;6567109;258;2675148;19175;7744
80445;Humbercourt;143;2742049;91978;66;1966024;77;776025;19175;7745
21670;Verrey-sous-Salmaise;175;3355789;75333;79;2216609;96;1139180;19176;7746
27246;Fleury-sur-Andelle;1139;21841600;908272;584;16326618;555;5514982;19176;7747
47143;Lavardac;1309;25101572;819243;603;17566760;706;7534812;19176;7748
08425;Sommerance;27;517756;26906;13;438740;14;79016;19176;7749
08116;Le Chesne;546;10470438;413783;230;6974933;316;3495505;19177;7750
66022;Boule-d'Amont;32;613653;35543;13;513244;19;100409;19177;7751
61413;Saint-Lambert-sur-Dive;77;1476606;51857;40;1202620;37;273986;19177;7752
11111;Cruscades;342;6559015;108880;164;4744766;178;1814249;19178;7753
2B260;Riventosa;88;1687725;59067;45;1290841;43;396884;19179;7754
23067;La Courtine;485;9301729;589130;238;7335121;247;1966608;19179;7755
40254;Saint-Cricq-du-Gave;209;4008447;107491;101;2952780;108;1055667;19179;7756
52296;Louze;178;3413955;89275;92;2567355;86;846600;19180;7757
22383;Troguéry;131;2512581;32612;59;1636274;72;876307;19180;7758
40220;Pécorade;92;1764589;49942;49;1411902;43;352687;19180;7759
32002;Ansan;59;1131655;34500;28;804993;31;326662;19181;7760
62029;Amettes;280;5371099;148724;131;3873347;149;1497752;19182;7761
63342;Saint-Floret;146;2800692;78614;73;2049966;73;750726;19183;7762
76431;Le Mesnil-Lieubray;61;1170192;46224;30;863297;31;306895;19183;7763
42310;Thélis-la-Combe;94;1803248;35077;44;1285309;50;517939;19183;7764
17334;Saint-Georges-de-Longuepierre;136;2609083;42239;62;1741124;74;867959;19184;7765
81296;Terre-Clapier;128;2455623;44063;61;1772019;67;683604;19185;7766
56204;Saint-Allouestre;337;6465466;146518;171;4724966;166;1740500;19185;7767
88125;Darney-aux-Chênes;30;575567;13980;11;329760;19;245807;19186;7768
04018;Banon;587;11262032;407094;283;8254248;304;3007784;19186;7769
50484;Saint-Hilaire-du-Harcouët;2430;46621369;2103046;1070;33394399;1360;13226970;19186;7770
52171;Dommartin-le-Franc;127;2436596;43286;67;1790924;60;645672;19186;7771
55515;Trésauvaux;40;767441;15634;17;462105;23;305336;19186;7772
50504;Saint-Louet-sur-Vire;118;2263955;41454;70;1707769;48;556186;19186;7773
50153;Cretteville;132;2532570;56829;63;1727584;69;804986;19186;7774
53276;Voutré;459;8806479;173752;227;5989626;232;2816853;19186;7775
23021;Bénévent-l'Abbaye;501;9612414;388724;222;6849620;279;2762794;19186;7776
39056;Bletterans;883;16941652;665237;412;12098033;471;4843619;19186;7777
53230;Saint-Julien-du-Terroux;150;2877975;95232;73;2122396;77;755579;19187;7778
11337;Saint-Couat-d'Aude;235;4508848;122038;108;3382852;127;1125996;19187;7779
64275;Ispoure;369;7079911;377197;154;5277425;215;1802486;19187;7780
63415;Sauxillanges;704;13507489;345726;323;9512658;381;3994831;19187;7781
33344;Pujols;337;6466309;213737;153;4703234;184;1763075;19188;7782
03255;Saint-Priest-d'Andelot;86;1650195;58315;36;1076664;50;573531;19188;7783
70273;Grammont;35;671609;17130;15;442344;20;229265;19189;7784
83073;Le Luc;5625;107937614;4185475;2617;81218542;3008;26719072;19189;7785
03086;Coulanges;182;3492458;109460;86;2528096;96;964362;19189;7786
30341;Vauvert;6374;122313551;5177607;2839;88641022;3535;33672529;19189;7787
24455;Saint-Martin-de-Ribérac;412;7906188;216186;186;5458127;226;2448061;19190;7788
54529;Tramont-Émy;23;441366;1426;12;295670;11;145696;19190;7789
55068;Brabant-en-Argonne;59;1132249;35520;29;797232;30;335017;19191;7790
80340;Fourcigny;108;2072678;65892;51;1449724;57;622954;19191;7791
52099;Chamouilley;485;9307894;271160;257;7069585;228;2238309;19192;7792
25083;Bournois;94;1804042;28434;47;1326840;47;477202;19192;7793
30218;Rochegude;122;2341479;52968;52;1692983;70;648496;19192;7794
16408;Villebois-Lavalette;433;8310388;319333;169;5758418;264;2551970;19193;7795
23117;Maison-Feyne;185;3550709;112875;86;2530460;99;1020249;19193;7796
39377;Mutigney;86;1650609;27245;40;1154552;46;496057;19193;7797
19231;Saint-Pardoux-la-Croisille;101;1938507;56329;46;1343490;55;595017;19193;7798
71120;Chauffailles;2346;45027600;1537301;1081;31958894;1265;13068706;19193;7799
30239;Sainte-Cécile-d'Andorge;320;6141932;207946;136;4216556;184;1925376;19194;7800
47003;Agnac;264;5067121;164114;121;3621763;143;1445358;19194;7801
66024;Le Boulou;3472;66642383;2702272;1620;49126288;1852;17516095;19194;7802
82051;Durfort-Lacapelette;429;8234675;293794;175;5805345;254;2429330;19195;7803
18163;Neuvy-Deux-Clochers;184;3531891;181907;70;2388892;114;1142999;19195;7804
18021;Bannegon;157;3013696;82015;82;2230586;75;783110;19196;7805
59236;Flesquières;145;2783357;74255;65;1996581;80;786776;19196;7806
26331;Saint-Thomas-en-Royans;286;5490213;171060;131;4178335;155;1311878;19197;7807
59118;Busigny;1282;24609987;825405;543;17224616;739;7385371;19197;7808
61068;Bursard;118;2265217;46792;65;1760710;53;504507;19197;7809
52357;Noncourt-sur-le-Rongeant;104;1996510;50665;51;1355232;53;641278;19197;7810
2B088;Chiatra;131;2514860;159901;59;1992809;72;522051;19197;7811
55106;Chattancourt;102;1958147;64696;51;1504337;51;453810;19198;7812
80585;Nesle;1411;27087760;1095480;620;19257049;791;7830711;19198;7813
42197;Sainte-Agathe-la-Bouteresse;592;11365012;277287;302;8144680;290;3220332;19198;7814
32155;Le Houga;703;13495970;316395;344;10147563;359;3348407;19198;7815
97204;Le Carbet;2227;42753940;1481853;816;29706285;1411;13047655;19198;7816
24503;Saint-Sulpice-de-Mareuil;65;1247952;46139;29;917327;36;330625;19199;7817
64326;Lay-Lamidou;59;1132769;32090;22;747241;37;385528;19199;7818
72321;Saint-Symphorien;302;5798303;125561;153;4137731;149;1660572;19200;7819
30144;Lecques;223;4281630;68332;103;3008587;120;1273043;19200;7820
11122;Douzens;384;7372911;222893;164;5206618;220;2166293;19200;7821
11261;Moux;369;7084921;316141;163;5151680;206;1933241;19200;7822
70425;La Proiselière-et-Langle;85;1632030;43669;37;1185744;48;446286;19200;7823
82193;Vigueron;72;1382426;14015;34;915878;38;466548;19200;7824
12224;Saint-Geniez-d'Olt;1221;23444157;1000289;526;16811596;695;6632561;19201;7825
42159;Noirétable;952;18279211;588165;401;12556860;551;5722351;19201;7826
40147;Laurède;220;4224283;106151;99;3064313;121;1159970;19201;7827
24368;Saint-Antoine-Cumond;226;4339828;143202;106;3171900;120;1167928;19203;7828
40143;Lamothe;196;3763776;121379;100;2763347;96;1000429;19203;7829
24401;Sainte-Eulalie-d'Ans;177;3398934;102314;83;2369368;94;1029566;19203;7830
61371;Saint-Brice-sous-Rânes;80;1536256;45615;42;1170255;38;366001;19203;7831
21164;Chazilly;78;1497891;31261;41;1142760;37;355131;19204;7832
62335;Fillièvres;272;5223418;161871;118;3420895;154;1802523;19204;7833
24574;Veyrignac;197;3783288;101193;97;2747051;100;1036237;19205;7834
46134;Les Junies;149;2861516;106677;68;1992931;81;868585;19205;7835
24134;Corgnac-sur-l'Isle;506;9717654;329590;241;6795273;265;2922381;19205;7836
07184;Pranles;260;4993364;97415;120;3471622;140;1521742;19205;7837
44153;Saint-Aubin-des-Châteaux;884;16977972;389990;413;12077540;471;4900432;19206;7838
53106;Gesvres;290;5569749;162516;130;3915384;160;1654365;19206;7839
64187;Charritte-de-Bas;139;2669680;93920;61;1779451;78;890229;19206;7840
10159;Fralignes;49;941115;33655;27;721623;22;219492;19206;7841
86029;Blanzay;448;8604513;263066;193;5964917;255;2639596;19207;7842
27434;Noards;30;576198;7460;16;431463;14;144735;19207;7843
88218;Granges-sur-Vologne;1323;25410468;889632;622;18112797;701;7297671;19207;7844
79027;La Bataille;50;960336;24341;23;653471;27;306865;19207;7845
65397;Saint-Sever-de-Rustan;93;1786227;38526;54;1357520;39;428707;19207;7846
80186;Chaulnes;1104;21204255;841310;497;15211771;607;5992484;19207;7847
39094;Chamole;90;1728638;28865;43;1218792;47;509846;19207;7848
22005;Belle-Isle-en-Terre;649;12465580;615320;251;8540437;398;3925143;19207;7849
39408;Patornay;75;1440591;38042;32;917538;43;523053;19208;7850
50100;Carnet;261;5013271;83996;128;3598865;133;1414406;19208;7851
25215;L'Écouvotte;44;845150;-6440;20;544200;24;300950;19208;7852
14689;Thury-Harcourt;1121;21532674;698864;475;14547274;646;6985400;19208;7853
33400;Saint-Ferme;215;4129843;122419;90;2897250;125;1232593;19209;7854
02255;Cys-la-Commune;76;1459908;32783;38;1013359;38;446549;19209;7855
23086;Fransèches;164;3150346;111194;83;2340247;81;810099;19209;7856
52162;Dammartin-sur-Meuse;110;2113062;53005;37;1275975;73;837087;19210;7857
12238;Saint-Léons;197;3784312;99935;97;2818856;100;965456;19210;7858
35202;La Noë-Blanche;519;9969861;206997;279;7248638;240;2721223;19210;7859
14282;Foulognes;111;2132347;36611;56;1594784;55;537563;19210;7860
07313;Serrières;691;13274384;462802;370;10019133;321;3255251;19210;7861
03132;Jaligny-sur-Besbre;360;6915759;213959;162;5005682;198;1910077;19210;7862
24202;Granges-d'Ans;103;1978685;59412;46;1383995;57;594690;19211;7863
08468;Vaux-Villaine;105;2017114;55518;51;1528221;54;488893;19211;7864
79346;Le Vert;73;1402442;37310;31;926609;42;475833;19212;7865
54548;Vannes-le-Châtel;292;5609933;50694;128;3599502;164;2010431;19212;7866
72379;Viré-en-Champagne;119;2286368;43656;62;1675669;57;610699;19213;7867
02586;Parfondeval;87;1671580;40628;43;1192458;44;479122;19214;7868
47102;Francescas;424;8146622;380263;176;5785865;248;2360757;19214;7869
52190;Esnouveaux;196;3765970;95781;88;2471658;108;1294312;19214;7870
17397;Saint-Savinien;1506;28936866;890291;660;20556906;846;8379960;19214;7871
59274;La Groise;238;4573064;107314;106;3105463;132;1467601;19215;7872
18269;Vailly-sur-Sauldre;482;9261495;396436;196;5893369;286;3368126;19215;7873
60596;Saint-Samson-la-Poterie;142;2728508;70337;68;1933119;74;795389;19215;7874
44067;Guémené-Penfao;2955;56781563;1600881;1285;39859055;1670;16922508;19215;7875
06093;La Penne;110;2113713;62573;55;1647184;55;466529;19216;7876
62451;Heuchin;271;5207449;188182;109;3514292;162;1693157;19216;7877
22254;Prat;627;12048459;335730;290;8669910;337;3378549;19216;7878
61135;Couterne;592;11376372;314985;283;8163493;309;3212879;19217;7879
29062;Gouézec;641;12318265;245789;311;8501984;330;3816281;19217;7880
58001;Achun;93;1787222;69172;40;1261310;53;525912;19217;7881
71121;La Chaux;167;3209350;73269;77;2245309;90;964041;19218;7882
47008;Ambrus;63;1210738;31595;32;918613;31;292125;19218;7883
2B286;Sorbo-Ocagnano;505;9705251;506934;215;7252063;290;2453188;19218;7884
62251;Courset;261;5016063;86845;120;3465408;141;1550655;19219;7885
62781;Sauchy-Lestrée;247;4747108;149038;119;3417038;128;1330070;19219;7886
52400;Le Châtelet-sur-Meuse;87;1672066;38417;38;1036599;49;635467;19219;7887
21096;Boussenois;67;1287686;21493;38;991662;29;296024;19219;7888
21580;Salmaise;90;1729742;67180;39;1273750;51;455992;19219;7889
19148;Neuvic;970;18642891;729374;485;14126799;485;4516092;19219;7890
14035;Balleroy;528;10147971;290061;221;6852136;307;3295835;19220;7891
23079;Felletin;923;17740035;645743;409;12518283;514;5221752;19220;7892
40041;Beyries;64;1230080;38361;33;925058;31;305022;19220;7893
80135;Bray-lès-Mareuil;135;2594729;97661;57;1767776;78;826953;19220;7894
08192;Givron;53;1018678;27829;21;641390;32;377288;19220;7895
02231;Couvron-et-Aumencourt;616;11840042;381781;350;8988450;266;2851592;19221;7896
54249;Hannonville-Suzémont;160;3075338;60622;82;2158614;78;916724;19221;7897
02209;Condé-en-Brie;382;7342527;202425;188;5289366;194;2053161;19221;7898
58097;Diennes-Aubigny;67;1287867;53610;34;1011681;33;276186;19222;7899
88170;Ferdrupt;436;8381128;156055;208;5905435;228;2475693;19223;7900
56172;Plumelec;1485;28545936;794107;720;20771057;765;7774879;19223;7901
22006;Berhet;129;2479754;68834;57;1741137;72;738617;19223;7902
59428;Neuville-Saint-Rémy;2182;41944384;1490190;1045;30413043;1137;11531341;19223;7903
72348;Tassillé;75;1441789;33821;37;1080857;38;360932;19224;7904
85149;Moreilles;195;3748820;102411;87;2640180;108;1108640;19225;7905
17436;Taillebourg;417;8016827;201263;196;5784896;221;2231931;19225;7906
08052;Bayonville;57;1095854;27349;25;748822;32;347032;19226;7907
63196;Limons;391;7517311;186240;194;5325036;197;2192275;19226;7908
15244;Ussel;262;5037210;94860;114;3462672;148;1574538;19226;7909
80770;Tully;337;6479167;199592;178;4883623;159;1595544;19226;7910
02106;Bourg-et-Comin;422;8113420;224572;178;5493537;244;2619883;19226;7911
50147;Coutances;5329;102457149;4897459;2366;77053492;2963;25403657;19226;7912
33378;Saint-Avit-Saint-Nazaire;831;15977456;500435;398;11899871;433;4077585;19227;7913
63402;Saint-Victor-Montvianeix;163;3133968;148087;75;2418652;88;715316;19227;7914
31477;Saint-Élix-Séglan;26;499903;14901;12;374591;14;125312;19227;7915
51522;Sapignicourt;196;3768505;136099;100;2971219;96;797286;19227;7916
38034;Beaurepaire;2576;49529355;1666822;1115;35082732;1461;14446623;19227;7917
11348;Saint-Julien-de-Briola;43;826801;24850;24;654431;19;172370;19228;7918
08085;Brieulles-sur-Bar;103;1980514;31495;46;1365841;57;614673;19228;7919
32267;Monferran-Plavès;77;1480615;47771;35;1065551;42;415064;19229;7920
15230;Sourniac;108;2076736;18007;50;1391811;58;684925;19229;7921
30303;Saint-Victor-de-Malcap;445;8556934;224998;217;6194570;228;2362364;19229;7922
53041;Brains-sur-les-Marches;146;2807514;54047;73;2106438;73;701076;19230;7923
16127;Empuré;68;1307620;67830;29;978718;39;328902;19230;7924
02750;Trosly-Loire;332;6384366;178625;160;4663595;172;1720771;19230;7925
55346;Montfaucon-d'Argonne;173;3326822;74769;73;2094216;100;1232606;19230;7926
37140;Luzé;157;3019221;126719;71;2221542;86;797679;19231;7927
17284;Pont-l'Abbé-d'Arnoult;1041;20019232;498569;497;14462799;544;5556433;19231;7928
08374;La Sabotterie;52;1000011;29043;21;660049;31;339962;19231;7929
32050;Betplan;68;1307741;42764;31;929085;37;378656;19231;7930
39493;Saint-Maurice-Crillat;130;2500253;30792;70;1810409;60;689844;19233;7931
21023;Arnay-le-Duc;976;18771957;813056;459;13838170;517;4933787;19234;7932
72201;Moncé-en-Saosnois;130;2500403;51008;58;1699372;72;801031;19234;7933
22126;Le Leslay;74;1423321;14929;35;990840;39;432481;19234;7934
63343;Saint-Flour;157;3019762;87560;76;2124736;81;895026;19234;7935
84125;Savoillan;51;980953;42065;20;632761;31;348192;19234;7936
37112;Gizeux;242;4654742;179488;111;3376207;131;1278535;19234;7937
53154;Montaudin;478;9194249;212823;193;6217174;285;2977075;19235;7938
60362;Libermont;124;2385174;75507;68;1874041;56;511133;19235;7939
62461;Huby-Saint-Leu;567;10906506;387421;226;7103530;341;3802976;19235;7940
40151;Lesgor;221;4251111;67893;111;3055115;110;1195996;19236;7941
32463;Viella;324;6232525;210062;144;4497919;180;1734606;19236;7942
25553;Soye;187;3597197;92978;88;2572596;99;1024601;19236;7943
15265;Ydes;1111;21372312;851603;526;15246837;585;6125475;19237;7944
21709;Viserny;114;2193027;57301;60;1613321;54;579706;19237;7945
16341;Saint-Michel;1976;38013760;1538148;1038;29046298;938;8967462;19238;7946
81166;Milhavet;51;981137;29028;21;674592;30;306545;19238;7947
86075;Chouppes;424;8156968;210304;205;5911788;219;2245180;19238;7948
80556;Mons-Boubert;301;5790698;146412;156;4284696;145;1506002;19238;7949
16223;Montbron;1310;25202058;1038350;568;18249066;742;6952992;19238;7950
88249;Jainvillotte;46;884958;21773;18;602510;28;282448;19238;7951
44091;Marsac-sur-Don;773;14871339;310927;339;10210772;434;4660567;19238;7952
82086;Lafitte;125;2404866;61364;50;1407020;75;997846;19239;7953
14669;Sassy;103;1981685;53636;43;1348312;60;633373;19240;7954
02591;Pargny-les-Bois;78;1500703;30370;38;1052785;40;447918;19240;7955
2B252;Pruno;98;1885512;105105;53;1497835;45;387677;19240;7956
10026;Bailly-le-Franc;24;461771;17047;13;352256;11;109515;19240;7957
21444;Mosson;46;885068;31488;23;643184;23;241884;19241;7958
21009;Allerey;106;2039541;66053;43;1316522;63;723019;19241;7959
64311;Lannecaube;93;1789412;57102;45;1300918;48;488494;19241;7960
40243;Rion-des-Landes;1441;27726976;853973;697;20165880;744;7561096;19241;7961
18010;Ardenais;112;2155076;26236;53;1574293;59;580783;19242;7962
47057;Castillonnès;851;16374916;639851;357;11483820;494;4891096;19242;7963
33280;Mazion;295;5676404;179806;132;4027363;163;1649041;19242;7964
48049;Chirac;683;13142408;479233;341;10548749;342;2593659;19242;7965
80227;Croixrault;241;4637368;164032;122;3619109;119;1018259;19242;7966
70177;Corre;341;6561623;220218;174;4851876;167;1709747;19242;7967
87181;Saint-Sulpice-Laurière;521;10025398;400854;251;7225647;270;2799751;19243;7968
35323;La Selle-en-Coglès;315;6061519;57813;173;4375689;142;1685830;19243;7969
32071;Caillavet;105;2020582;64149;54;1529841;51;490741;19244;7970
08190;Givet;3768;72510509;2895176;1800;53882252;1968;18628257;19244;7971
34237;Roujan;1154;22208231;738411;484;15415001;670;6793230;19245;7972
21543;Saint-Broing-les-Moines;113;2174646;45326;51;1463396;62;711250;19245;7973
61040;Bellou-en-Houlme;587;11296871;217765;277;7682521;310;3614350;19245;7974
47293;Sauveterre-Saint-Denis;235;4522631;131688;111;3241062;124;1281569;19245;7975
86176;Nérignac;66;1270202;29253;31;852795;35;417407;19245;7976
24226;Lamothe-Montravel;752;14472988;599898;341;10531575;411;3941413;19246;7977
35307;Saint-Pern;483;9296000;171731;222;6887907;261;2408093;19246;7978
77257;Lizy-sur-Ourcq;2097;40362280;1459173;1096;30379434;1001;9982846;19248;7979
39398;Ougney;172;3310606;46237;87;2375548;85;935058;19248;7980
59394;Maurois;208;4003550;271644;83;2812231;125;1191319;19248;7981
09302;Suc-et-Sentenac;30;577451;25422;16;472100;14;105351;19248;7982
16259;La Péruse;286;5505093;128201;143;4115916;143;1389177;19249;7983
62070;Bailleul-aux-Cornailles;136;2617884;60061;55;1773288;81;844596;19249;7984
84120;Saint-Trinit;72;1385939;55278;39;1082777;33;303162;19249;7985
88447;Saulxures-sur-Moselotte;1612;31030648;845525;751;21453535;861;9577113;19250;7986
59336;Lécluse;794;15284985;500120;364;10868040;430;4416945;19251;7987
54238;Gripport;162;3118856;63913;91;2268275;71;850581;19252;7988
32004;Arblade-le-Bas;78;1501689;28152;37;1088439;41;413250;19252;7989
70165;Combeaufontaine;297;5718076;153893;141;4056176;156;1661900;19253;7990
80476;Liercourt;192;3696574;86017;98;2809478;94;887096;19253;7991
19035;Chabrignac;309;5949216;133424;149;4160732;160;1788484;19253;7992
49334;Sermaise;158;3042091;80201;81;2270878;77;771213;19254;7993
71554;Varenne-l'Arconce;72;1386296;37158;35;1008881;37;377415;19254;7994
76500;Pierrecourt;265;5102371;136385;131;3648169;134;1454202;19254;7995
85227;Saint-Hilaire-des-Loges;1059;20390387;483679;473;13877631;586;6512756;19254;7996
54227;Giraumont;730;14055753;261103;332;9306890;398;4748863;19254;7997
72100;Courcelles-la-Forêt;214;4120736;46618;114;2994649;100;1126087;19256;7998
08351;Quilly;48;924278;24948;23;629879;25;294399;19256;7999
03019;Beaulon;987;19005547;514814;477;13566283;510;5439264;19256;8000
37241;Savigné-sur-Lathan;709;13652506;299222;328;9229019;381;4423487;19256;8001
31509;Saint-Pé-d'Ardet;85;1636766;48366;43;1278352;42;358414;19256;8002
12172;Le Nayrac;310;5969482;259543;112;3845557;198;2123925;19256;8003
45052;Breteau;43;828036;23099;21;573169;22;254867;19257;8004
61145;Domfront;2335;44965395;1820082;1082;33458300;1253;11507095;19257;8005
12024;Belcastel;137;2638365;112512;67;2010838;70;627527;19258;8006
39057;Blois-sur-Seille;58;1117043;33135;28;812099;30;304944;19259;8007
70010;Alaincourt;59;1136317;34830;33;920084;26;216233;19260;8008
64022;Andrein;63;1213361;24353;29;848599;34;364762;19260;8009
71138;Clux;60;1155598;14316;36;888853;24;266745;19260;8010
04039;Castellane;913;17584716;728800;426;13100435;487;4484281;19260;8011
86162;Mondion;70;1348230;42402;39;1029017;31;319213;19260;8012
06135;Sigale;105;2022348;69627;51;1476023;54;546325;19260;8013
17224;Matha;1326;25539941;985695;552;17822104;774;7717837;19261;8014
2A323;Tavaco;176;3389930;107852;90;2529520;86;860410;19261;8015
52178;Doulevant-le-Château;214;4121862;97278;100;2826733;114;1295129;19261;8016
77333;Nemours;7294;140491198;6297314;3573;106694676;3721;33796522;19261;8017
21087;Bligny-sur-Ouche;490;9438460;265749;219;6533505;271;2904955;19262;8018
34214;Pouzolles;590;11365028;353222;263;8212489;327;3152539;19263;8019
51133;Le Châtelier;34;654964;28515;18;462910;16;192054;19264;8020
27680;Verneusses;129;2485016;92587;66;1937450;63;547566;19264;8021
56092;Kerfourn;443;8534015;175026;241;6421115;202;2112900;19264;8022
06028;Caille;224;4315177;113277;108;3071747;116;1243430;19264;8023
04240;Villars-Colmars;172;3313558;110978;94;2491128;78;822430;19265;8024
55204;Génicourt-sur-Meuse;135;2600758;66549;72;1905090;63;695668;19265;8025
03119;Gannay-sur-Loire;243;4681400;159819;111;3316784;132;1364616;19265;8026
57368;Knutange;1828;35216523;1027374;720;21184390;1108;14032133;19265;8027
25433;Orgeans-Blanchefontaine;29;558687;15624;14;408701;15;149986;19265;8028
65432;Soublecause;105;2022883;73954;44;1445122;61;577761;19266;8029
52240;Heuilley-le-Grand;120;2311901;58525;60;1689033;60;622868;19266;8030
65386;Saint-Créac;50;963301;19978;24;670711;26;292590;19266;8031
09283;Savignac-les-Ormeaux;231;4450569;120086;127;3351738;104;1098831;19267;8032
59332;Lannoy;1149;22137582;694602;622;16363399;527;5774183;19267;8033
04184;Saint-Jurs;91;1753332;59830;48;1378956;43;374376;19267;8034
36103;Luçay-le-Mâle;877;16897670;683808;402;11973754;475;4923916;19268;8035
72367;Vallon-sur-Gée;441;8497244;168191;206;5876351;235;2620893;19268;8036
2B316;Santa-Reparata-di-Balagna;552;10636246;461953;264;8071203;288;2565043;19269;8037
89020;Asnières-sous-Bois;86;1657113;81629;41;1269321;45;387792;19269;8038
37213;Saint-Christophe-sur-le-Nais;601;11580795;341134;270;8110493;331;3470302;19269;8039
22145;Mégrit;427;8227960;251683;208;5899631;219;2328329;19269;8040
46178;Loupiac;166;3198793;98845;74;2163559;92;1035234;19270;8041
31529;Samouillan;69;1329664;19474;30;854978;39;474686;19270;8042
50138;Colomby;267;5145270;100070;141;3856612;126;1288658;19271;8043
62134;Bimont;51;982806;-603;22;597020;29;385786;19271;8044
60178;Crèvecoeur-le-Grand;1932;37231218;1535031;873;26841118;1059;10390100;19271;8045
47156;Marcellus;443;8537027;249755;225;6325391;218;2211636;19271;8046
13078;Port-Saint-Louis-du-Rhône;4946;95314565;3812126;2347;71085526;2599;24229039;19271;8047
62827;Tournehem-sur-la-Hem;708;13643954;337180;328;9642463;380;4001491;19271;8048
57611;Saint-Georges;125;2408922;68005;67;1780200;58;628722;19271;8049
16384;Touvérac;355;6841396;226316;142;4504060;213;2337336;19272;8050
29227;Poullaouen;789;15205249;470080;385;11216610;404;3988639;19272;8051
14711;Trévières;532;10253073;369600;216;7022984;316;3230089;19273;8052
07334;Les Vans;1817;35018543;1597131;775;25210941;1042;9807602;19273;8053
50115;Champcervon;115;2216405;58494;56;1568222;59;648183;19273;8054
24085;La Cassagne;79;1522605;40008;38;1110670;41;411935;19273;8055
29063;Goulien;257;4953542;131603;115;3378550;142;1574992;19274;8056
53182;Port-Brillet;1055;20335178;491237;540;14581417;515;5753761;19275;8057
37184;Le Petit-Pressigny;190;3662328;111932;86;2661420;104;1000908;19275;8058
04144;La Palud-sur-Verdon;197;3797332;174065;85;2824788;112;972544;19276;8059
72229;Parennes;265;5108210;163629;115;3420670;150;1687540;19276;8060
22191;Plessala;1083;20876537;732218;498;15062650;585;5813887;19277;8061
12122;Lapanouse-de-Cernon;62;1195169;27518;24;758702;38;436467;19277;8062
04193;Saint-Paul-sur-Ubaye;124;2390369;105178;57;1785843;67;604526;19277;8063
89392;Sermizelles;173;3335158;107703;94;2408638;79;926520;19278;8064
65446;Tostat;280;5398187;139166;136;3945981;144;1452206;19279;8065
50289;Marchésieux;376;7249205;178142;169;4937312;207;2311893;19280;8066
29029;Cléden-Poher;652;12570719;358312;332;9209854;320;3360865;19280;8067
18110;Herry;628;12108008;398095;297;8655847;331;3452161;19280;8068
12127;Lédergues;415;8001432;312395;172;5680177;243;2321255;19281;8069
54381;Montreux;33;636278;11901;17;489656;16;146622;19281;8070
50422;Raids;109;2101662;38116;58;1579892;51;521770;19281;8071
24330;Plazac;398;7673976;321099;151;5355870;247;2318106;19281;8072
38379;Saint-Clair-sur-Galaure;147;2834391;64170;63;1946373;84;888018;19282;8073
26178;Menglon;270;5206111;172486;126;3880931;144;1325180;19282;8074
80821;Warlus;138;2661095;80929;64;1921392;74;739703;19283;8075
72265;Saint-Aignan;149;2873264;65916;87;2230323;62;642941;19284;8076
80139;Breuil;35;674928;23021;17;539348;18;135580;19284;8077
09137;Gudas;79;1523415;26857;39;1149325;40;374090;19284;8078
02032;Aubigny-aux-Kaisnes;131;2526199;114172;50;1706257;81;819942;19284;8079
23242;Saint-Silvain-Montaigut;121;2333425;93923;60;1740579;61;592846;19285;8080
16086;Chassenon;481;9276008;216293;239;6684202;242;2591806;19285;8081
46068;Cénevières;108;2082771;87010;51;1573005;57;509766;19285;8082
58163;Menou;125;2410645;105936;60;1812774;65;597871;19285;8083
50539;Saint-Pierre-Église;997;19227666;584175;459;13662960;538;5564706;19286;8084
88491;Les Vallois;59;1137846;15839;28;828307;31;309539;19286;8085
54471;Saint-Boingt;44;848572;16611;21;574913;23;273659;19286;8086
53040;Bourgon;307;5920819;61823;146;4004887;161;1915932;19286;8087
2B205;Patrimonio;480;9257558;492225;209;6853387;271;2404171;19287;8088
82059;Faudoas;156;3008788;77995;56;1914295;100;1094493;19287;8089
56212;Saint-Dolay;1306;25189581;536561;659;18130376;647;7059205;19288;8090
18266;Touchay;167;3221029;125869;76;2468504;91;752525;19288;8091
55081;Brizeaux;34;655787;21412;14;442866;20;212921;19288;8092
87096;La Meyze;509;9817964;252527;234;7126016;275;2691948;19289;8093
2B292;Sant'Andréa-di-Bozio;40;771578;29721;22;607328;18;164250;19289;8094
50592;Tessy-sur-Vire;869;16762880;551325;362;11389159;507;5373721;19290;8095
26288;Sahune;187;3607216;146031;82;2609731;105;997485;19290;8096
88027;Badménil-aux-Bois;75;1446775;11186;40;1034454;35;412321;19290;8097
07033;Bessas;112;2160563;147213;47;1596570;65;563993;19291;8098
60503;Le Ployron;67;1292495;41539;39;996748;28;295747;19291;8099
71323;Mornay;88;1697606;47574;39;1068010;49;629596;19291;8100
55026;Badonvilliers-Gérauvilliers;80;1543314;40232;40;1129940;40;413374;19291;8101
72031;Beillé;267;5150976;96846;160;4022057;107;1128919;19292;8102
50267;Lessay;1105;21318002;769351;486;14570627;619;6747375;19292;8103
61469;Sept-Forges;158;3048253;73856;76;2192867;82;855386;19293;8104
50356;Moon-sur-Elle;440;8489540;135641;207;5952920;233;2536620;19294;8105
70473;Saint-Sauveur;1044;20143435;668249;533;14788797;511;5354638;19294;8106
07016;Asperjoc;244;4707859;173419;132;3642107;112;1065752;19295;8107
33300;Naujac-sur-Mer;571;11017285;340461;263;7887808;308;3129477;19295;8108
19245;Saint-Sylvain;76;1466421;46517;33;1043808;43;422613;19295;8109
68231;Neuf-Brisach;1159;22363102;840633;606;16651997;553;5711105;19295;8110
27165;Conches-en-Ouche;2911;56170238;2329522;1356;41007703;1555;15162535;19296;8111
18139;Marseilles-lès-Aubigny;409;7892059;293994;209;5876813;200;2015246;19296;8112
71389;Saint-Aubin-sur-Loire;174;3357510;82341;87;2435038;87;922472;19296;8113
33354;Riocaud;98;1891021;57350;43;1424400;55;466621;19296;8114
43158;Queyrières;167;3222471;53806;70;2140961;97;1081510;19296;8115
02078;Besmé;77;1485825;28106;36;1039862;41;445963;19296;8116
70295;La Lanterne-et-les-Armonts;108;2084114;47585;52;1440816;56;643298;19297;8117
09077;Capoulet-et-Junac;111;2142035;74063;67;1725004;44;417031;19298;8118
32228;Manent-Montané;58;1119311;40635;23;802469;35;316842;19298;8119
63242;Moriat;208;4014158;92678;108;2858741;100;1155417;19299;8120
52025;Audeloncourt;53;1022840;36648;24;707820;29;315020;19299;8121
39353;Montfleur;106;2045688;90925;49;1495925;57;549763;19299;8122
37221;Saint-Hippolyte;386;7449405;278769;182;5555197;204;1894208;19299;8123
63065;Ceilloux;93;1794836;65629;42;1304208;51;490628;19299;8124
61072;Canapville;126;2431750;89501;64;1820218;62;611532;19300;8125
14192;Courson;230;4439269;81204;102;3017832;128;1421437;19301;8126
86291;Villemort;58;1119484;14813;32;874265;26;245219;19301;8127
37062;Château-la-Vallière;961;18548704;653136;427;13186607;534;5362097;19301;8128
72233;Peray;39;752761;23651;18;519524;21;233237;19302;8129
05022;Bréziers;125;2412697;69153;52;1671010;73;741687;19302;8130
87128;Roussac;269;5192170;161479;119;3712941;150;1479229;19302;8131
42268;Saint-Paul-de-Vézelin;170;3281333;55384;74;2174833;96;1106500;19302;8132
29139;Lopérec;446;8608712;187130;219;6329656;227;2279056;19302;8133
59405;Moeuvres;230;4439529;116815;103;3109691;127;1329838;19302;8134
17169;La Frédière;35;675586;10402;16;460590;19;214996;19302;8135
09194;Mirepoix;1976;38142337;1763670;855;28032499;1121;10109838;19303;8136
71153;Le Creusot;13302;256770004;11080322;6434;189374401;6868;67395603;19303;8137
72103;Courdemanche;366;7064998;197899;162;4909020;204;2155978;19303;8138
35303;Saint-Ouen-la-Rouërie;444;8570933;259843;196;5931048;248;2639885;19304;8139
51132;Les Charmontois;73;1409197;39358;37;1041702;36;367495;19304;8140
24525;Savignac-de-Nontron;117;2258593;55566;60;1730568;57;528025;19304;8141
39455;Reithouse;37;714266;20107;19;500781;18;213485;19304;8142
55447;Rupt-aux-Nonains;211;4073286;105087;115;3081162;96;992124;19305;8143
55237;Haudiomont;128;2471015;67060;63;1781735;65;689280;19305;8144
49310;Saint-Paul-du-Bois;310;5984511;94639;135;3923246;175;2061265;19305;8145
58293;Toury-Lurcy;265;5115935;188838;130;3758370;135;1357565;19305;8146
35082;Coësmes;675;13031189;113299;313;8683814;362;4347375;19305;8147
02805;Villeneuve-Saint-Germain;1356;26178330;826490;680;19330758;676;6847572;19306;8148
17405;Saint-Sorlin-de-Conac;118;2278071;110448;46;1559472;72;718599;19306;8149
55061;Le Bouchon-sur-Saulx;126;2432537;38054;56;1612960;70;819577;19306;8150
35103;Eancé;202;3899843;28429;92;2655576;110;1244267;19306;8151
19154;Orgnac-sur-Vézère;176;3398011;101651;86;2511623;90;886388;19307;8152
30099;Cros;151;2915390;155796;61;2129111;90;786279;19307;8153
64272;Ilharre;74;1428744;63053;33;1053167;41;375577;19307;8154
52230;Gudmont-Villiers;174;3359519;81784;93;2510926;81;848593;19308;8155
30147;Lézan;827;15967861;600558;355;11479130;472;4488731;19308;8156
55062;Bouconville-sur-Madt;68;1312985;29665;34;928797;34;384188;19309;8157
86190;Persac;430;8302920;217046;175;5626331;255;2676589;19309;8158
55430;Ribeaucourt;59;1139248;27705;26;784747;33;354501;19309;8159
73101;Doucy-en-Bauges;62;1197212;40391;32;973600;30;223612;19310;8160
88412;Saint-Benoît-la-Chipotte;236;4557151;117315;114;3087378;122;1469773;19310;8161
72370;Vernie;192;3707573;55679;92;2572751;100;1134822;19310;8162
47046;Calonges;318;6140682;145781;141;4200890;177;1939792;19310;8163
52302;Maizières;96;1853827;52342;49;1355924;47;497903;19311;8164
2A114;Figari;795;15353315;810735;344;11005997;451;4347318;19312;8165
52550;Wassy;1725;33313993;1347969;836;24814696;889;8499297;19312;8166
18103;Graçay;913;17632892;809894;384;12704396;529;4928496;19313;8167
56049;Croixanvec;92;1776872;38242;48;1340209;44;436663;19314;8168
08205;Hagnicourt;32;618047;7418;13;376937;19;241110;19314;8169
24031;Beauregard-et-Bassac;150;2897163;105070;58;2005859;92;891304;19314;8170
23155;Pontarion;234;4519576;170479;114;3373675;120;1145901;19314;8171
64456;Pouliacq;28;540820;5629;14;391761;14;149059;19315;8172
02203;Coincy;670;12941174;409084;330;9926870;340;3014304;19315;8173
54084;Mont-Bonvillers;522;10082621;180053;201;5700404;321;4382217;19315;8174
46034;Le Bourg;160;3090460;86035;72;2107618;88;982842;19315;8175
22139;Magoar;59;1139640;45393;31;926432;28;213208;19316;8176
42128;Machézal;206;3979142;60638;106;2734576;100;1244566;19316;8177
24449;Saint-Martial-d'Artenset;570;11010250;328154;296;8226116;274;2784134;19316;8178
08142;Donchery;1310;25304388;736414;630;18075518;680;7228870;19316;8179
02762;Vassens;88;1699852;53483;47;1243000;41;456852;19317;8180
33461;Saint-Philippe-d'Aiguille;232;4481442;177093;107;3364387;125;1117055;19317;8181
21296;Gevrolles;103;1989669;65180;46;1313034;57;676635;19317;8182
09176;Luzenac;347;6703146;230281;175;4857394;172;1845752;19317;8183
08418;Sévigny-Waleppe;127;2453326;102773;56;1790799;71;662527;19318;8184
32305;Panjas;220;4250067;168600;94;3004818;126;1245249;19318;8185
62485;Laires;181;3496755;105494;75;2374406;106;1122349;19319;8186
80002;Ablaincourt-Pressoir;152;2936572;117722;76;2331696;76;604876;19320;8187
88094;Châtel-sur-Moselle;942;18199032;625232;485;13928884;457;4270148;19320;8188
71519;Serrigny-en-Bresse;97;1874028;56233;44;1298741;53;575287;19320;8189
54379;Mont-l'Étroit;59;1139876;29731;29;820049;30;319827;19320;8190
71231;La Guiche;361;6974553;564714;161;4969410;200;2005143;19320;8191
43007;Araules;322;6221164;198857;134;4169383;188;2051781;19320;8192
49143;Fougeré;428;8269219;204594;205;5914212;223;2355007;19321;8193
76154;Campneuseville;285;5506784;167524;153;4214359;132;1292425;19322;8194
25089;Bremondans;42;811542;18581;15;479452;27;332090;19322;8195
53196;Saint-Aignan-de-Couptrain;213;4115691;106765;95;2830251;118;1285440;19322;8196
55575;Vouthon-Haut;44;850230;23224;18;520422;26;329808;19323;8197
69018;Beaujeu;1148;22183290;725209;551;15739888;597;6443402;19323;8198
02252;Cuissy-et-Geny;37;714996;24188;12;484567;25;230429;19324;8199
47159;Le Mas-d'Agenais;846;16348846;580341;380;11785731;466;4563115;19325;8200
61500;La Ventrouze;76;1468724;43423;43;1150015;33;318709;19325;8201
53139;Loupfougères;219;4232279;87554;107;2977969;112;1254310;19325;8202
52542;Vivey;34;657106;18401;15;415170;19;241936;19327;8203
62212;Capelle-lès-Hesdin;232;4483793;72351;110;3158309;122;1325484;19327;8204
52287;Levécourt;58;1120977;11937;29;833385;29;287592;19327;8205
54251;Harbouey;68;1314287;43915;37;1015299;31;298988;19328;8206
84031;Carpentras;16785;324424523;14863961;7067;234584669;9718;89839854;19328;8207
26035;Beaufort-sur-Gervanne;257;4967441;124863;111;3439518;146;1527923;19329;8208
11332;Saint-André-de-Roquelongue;667;12892437;355589;302;9354624;365;3537813;19329;8209
14635;Saint-Omer;102;1971643;53317;50;1396085;52;575558;19330;8210
19165;Peyrissac;89;1720377;76981;45;1315060;44;405317;19330;8211
29271;Saint-Vougay;474;9162716;155280;227;6482483;247;2680233;19331;8212
82180;Sérignac;268;5180736;163986;129;3751975;139;1428761;19331;8213
51336;Maffrécourt;32;618598;3693;16;452763;16;165835;19331;8214
70389;Noiron;38;734587;22997;20;536591;18;197996;19331;8215
89237;Mailly-la-Ville;326;6302278;210276;156;4549587;170;1752691;19332;8216
31200;Frontignan-de-Comminges;41;792631;23105;21;553827;20;238804;19332;8217
41075;Droué;617;11928221;447981;282;8255824;335;3672397;19333;8218
71395;Saint-Bonnet-de-Vieille-Vigne;104;2010616;30775;49;1467269;55;543347;19333;8219
24205;Grignols;342;6611961;166067;174;4795501;168;1816460;19333;8220
71242;Joncy;318;6147977;218382;124;4245169;194;1902808;19333;8221
07328;Vagnas;315;6090110;219410;146;4580362;169;1509748;19334;8222
67488;Thal-Drulingen;107;2068746;40742;55;1510674;52;558072;19334;8223
52415;Rançonnières;69;1334083;35057;30;840637;39;493446;19335;8224
03294;Ussel-d'Allier;97;1875513;54166;44;1280224;53;595289;19335;8225
80362;Frettemeule;165;3190358;65796;79;2209206;86;981152;19336;8226
36131;Mosnay;281;5433321;138886;144;3887798;137;1545523;19336;8227
60001;Abancourt;333;6438789;170200;174;4871144;159;1567645;19336;8228
63258;Olliergues;458;8855767;309705;216;6351479;242;2504288;19336;8229
37174;Nouâtre;484;9358589;276124;243;6689504;241;2669085;19336;8230
2B335;Valle-di-Campoloro;225;4350803;177832;100;3370057;125;980746;19337;8231
44210;Trignac;4346;84042652;2279211;2353;63999465;1993;20043187;19338;8232
49103;Combrée;1512;29239210;641543;711;19903424;801;9335786;19338;8233
32058;Blousson-Sérian;24;464119;8666;13;370653;11;93466;19338;8234
22305;Saint-Jouan-de-l'Isle;237;4583244;65081;118;3278819;119;1304425;19339;8235
82127;Montesquieu;413;7986938;223722;165;5415467;248;2571471;19339;8236
50639;Villedieu-les-Poêles;2293;44344081;1651814;1051;31621881;1242;12722200;19339;8237
01452;Virieu-le-Grand;620;11990188;320412;301;8559770;319;3430418;19339;8238
08289;Messincourt;317;6130481;160128;139;4122695;178;2007786;19339;8239
04227;Vachères;169;3268312;102507;72;2264575;97;1003737;19339;8240
71237;Igornay;295;5705053;138734;147;3851826;148;1853227;19339;8241
11167;Gramazie;58;1121689;45467;28;831435;30;290254;19339;8242
30305;Salindres;1890;36552321;1286884;908;26743945;982;9808376;19340;8243
49098;Chigné;158;3055826;45764;74;2060653;84;995173;19341;8244
51226;Écury-le-Repos;40;773634;15849;21;536668;19;236966;19341;8245
23240;Saint-Silvain-Bas-le-Roc;258;4990014;145519;124;3641871;134;1348143;19341;8246
47063;Cavarc;83;1605369;73402;37;1134815;46;470554;19342;8247
25554;Surmont;66;1276562;27388;30;867284;36;409278;19342;8248
36182;Saint-Benoît-du-Sault;422;8162265;403522;175;5882384;247;2279881;19342;8249
23143;Noth;275;5319084;168309;130;3819393;145;1499691;19342;8250
55578;Warcq;97;1876212;48275;45;1318937;52;557275;19342;8251
54539;Vacqueville;142;2746655;49490;66;1945266;76;801389;19343;8252
47301;Seyches;570;11025550;365139;265;7991194;305;3034356;19343;8253
72015;Les Aulneaux;60;1160599;23774;27;823356;33;337243;19343;8254
60163;Cormeilles;201;3888053;104082;98;2910124;103;977929;19344;8255
86205;Ranton;108;2089161;77613;55;1602512;53;486649;19344;8256
40130;Labastide-Chalosse;75;1450839;28808;35;1018582;40;432257;19345;8257
40313;Tartas;1898;36716496;1194509;929;27287135;969;9429361;19345;8258
87182;Saint-Sulpice-les-Feuilles;757;14644138;593863;305;10203187;452;4440951;19345;8259
79145;Lageon;184;3559564;37026;93;2530070;91;1029494;19345;8260
65090;Betpouy;46;889907;29201;27;719207;19;170700;19346;8261
12094;Entraygues-sur-Truyère;700;13542151;562011;293;9435979;407;4106172;19346;8262
06146;Tournefort;73;1412301;36238;44;1126198;29;286103;19347;8263
02460;Marcy-sous-Marle;113;2186280;77219;56;1602708;57;583572;19348;8264
24502;Saint-Séverin-d'Estissac;55;1064198;7565;33;835660;22;228538;19349;8265
22321;Saint-Nicolas-du-Pélem;1026;19852281;620038;457;13669023;569;6183258;19349;8266
53128;Laubrières;149;2883071;29168;61;1768939;88;1114132;19349;8267
18155;Mornay-sur-Allier;271;5243841;142734;136;3853035;135;1390806;19350;8268
17476;Villexavier;152;2941222;77130;68;2126848;84;814374;19350;8269
58171;Montapas;170;3289581;155946;87;2544882;83;744699;19350;8270
51144;Cheminon;361;6985545;172142;179;4838569;182;2146976;19351;8271
17344;Saint-Hilaire-de-Villefranche;665;12868204;383805;324;9472308;341;3395896;19351;8272
21222;Cussy-le-Châtel;71;1373924;14956;34;957449;37;416475;19351;8273
61038;Bellême;987;19099543;830735;424;13685989;563;5413554;19351;8274
29151;Morlaix;9769;189041791;8915392;4726;146283487;5043;42758304;19351;8275
81039;Briatexte;1130;21867204;658707;504;15100142;626;6767062;19352;8276
80117;Bouchon;89;1722317;64617;48;1315679;41;406638;19352;8277
53097;Évron;4142;80159661;2660494;2025;58805689;2117;21353972;19353;8278
2A254;Quenza;133;2573980;128352;60;1866971;73;707009;19353;8279
70276;Granges-la-Ville;102;1974103;24818;55;1433853;47;540250;19354;8280
87162;Sainte-Marie-de-Vaux;104;2012819;41533;50;1430873;54;581946;19354;8281
63397;Saint-Sauves-d'Auvergne;686;13276998;513800;339;9738868;347;3538130;19354;8282
58224;Ruages;69;1335477;40502;42;1008489;27;326988;19355;8283
02543;Neuilly-Saint-Front;1164;22529819;692907;571;16020933;593;6508886;19356;8284
61419;Sainte-Marguerite-de-Carrouges;122;2361440;44369;44;1444491;78;916949;19356;8285
02722;Soissons;16917;327446926;18289410;7353;244400412;9564;83046514;19356;8286
19201;Saint-Exupéry-les-Roches;337;6523200;160587;176;4953645;161;1569555;19357;8287
51062;Binarville;62;1200142;34568;35;922008;27;278134;19357;8288
64051;Arraute-Charritte;202;3910142;131775;80;2508412;122;1401730;19357;8289
62294;Enguinegatte;232;4490883;106741;113;3187358;119;1303525;19357;8290
87027;Bussière-Galant;805;15583111;537234;362;11107125;443;4475986;19358;8291
11240;Montazels;345;6678514;202113;192;5116796;153;1561718;19358;8292
35357;Villamée;166;3213448;50307;75;2332160;91;881288;19358;8293
04157;Puimoisson;439;8498360;478960;205;6321134;234;2177226;19358;8294
07134;Laurac-en-Vivarais;538;10414957;286599;262;7496198;276;2918759;19359;8295
80154;Bussu;120;2323159;61134;67;1787196;53;535963;19360;8296
70484;Secenans;91;1761735;25593;50;1364155;41;397580;19360;8297
73175;Montsapey;52;1006714;40836;30;799557;22;207157;19360;8298
25052;Belmont;33;638912;4832;18;480340;15;158572;19361;8299
07171;Payzac;276;5343798;213682;121;3776943;155;1566855;19362;8300
08426;Son;53;1026177;27955;28;730227;25;295950;19362;8301
63170;La Goutelle;360;6970474;212018;185;5282782;175;1687692;19362;8302
46258;Saint-Cirq-Souillaguet;88;1703929;74380;34;1143114;54;560815;19363;8303
50389;Ouville;228;4414733;84971;110;3110175;118;1304558;19363;8304
31238;Huos;283;5479901;173681;147;4041478;136;1438423;19364;8305
25199;Déservillers;171;3311209;45451;78;2153065;93;1158144;19364;8306
56253;Tréal;386;7474446;232639;165;5137014;221;2337432;19364;8307
23176;La Souterraine;3179;61559038;2781682;1409;45171863;1770;16387175;19364;8308
49109;Coron;819;15859443;249632;378;10652183;441;5207260;19364;8309
55144;Dammarie-sur-Saulx;245;4744335;136379;120;3424254;125;1320081;19365;8310
40160;Lourquen;109;2110754;48065;46;1377602;63;733152;19365;8311
24383;Saint-Capraise-d'Eymet;77;1491125;57840;28;1000764;49;490361;19365;8312
66234;Le Vivier;58;1123194;49812;25;851687;33;271507;19365;8313
35247;Roz-sur-Couesnon;550;10651006;340069;248;7516189;302;3134817;19365;8314
42027;Bully;211;4086247;80823;105;3004017;106;1082230;19366;8315
71206;La Frette;145;2808274;73089;75;2040744;70;767530;19367;8316
80451;Irles;64;1239577;44697;35;981753;29;257824;19368;8317
48089;Le Malzieu-Forain;259;5016464;117994;126;3631890;133;1384574;19369;8318
64476;Saint-Esteben;204;3951215;112685;97;2761510;107;1189705;19369;8319
07305;Les Salelles;193;3738178;131693;87;2725746;106;1012432;19369;8320
54418;Parroy;100;1936882;61435;56;1446369;44;490513;19369;8321
14063;Bernesq;115;2227556;63183;61;1659505;54;568051;19370;8322
25029;Aubonne;130;2518137;50599;58;1705925;72;812212;19370;8323
14329;Heuland;43;832935;50475;22;671791;21;161144;19371;8324
31241;Izaut-de-l'Hôtel;170;3293128;77202;89;2495296;81;797832;19371;8325
58242;Saint-Germain-des-Bois;67;1297882;35026;34;953316;33;344566;19371;8326
02334;Fresnoy-le-Grand;1655;32059666;1408504;751;23214906;904;8844760;19371;8327
03021;Bègues;135;2615155;80069;51;1685238;84;929917;19372;8328
17058;Bourcefranc-le-Chapus;2103;40741243;1605543;951;28809282;1152;11931961;19373;8329
40072;Castelnau-Tursan;114;2208564;45273;60;1695322;54;513242;19373;8330
36007;Argy;388;7516999;256179;179;5240343;209;2276656;19374;8331
31135;Cazères;2874;55681781;2396285;1306;40785308;1568;14896473;19374;8332
23051;La Chapelle-Saint-Martial;60;1162479;45092;26;801680;34;360799;19375;8333
54501;Seranville;51;988116;24975;26;765009;25;223107;19375;8334
39303;Louvenne;63;1220622;25653;34;902408;29;318214;19375;8335
46233;Quissac;74;1433747;57724;35;1111428;39;322319;19375;8336
27229;Évreux;28715;556356538;28206669;13738;428755059;14977;127601479;19375;8337
49205;Miré;560;10850288;372721;233;7438866;327;3411422;19376;8338
58227;Saint-Amand-en-Puisaye;770;14919728;571675;363;10934374;407;3985354;19376;8339
76469;Nolléval;224;4340473;88212;99;2860758;125;1479715;19377;8340
50258;Joganville;51;988252;12269;26;757661;25;230591;19377;8341
14576;Sainte-Foy-de-Montgommery;99;1918404;44100;49;1323709;50;594695;19378;8342
51533;Servon-Melzicourt;59;1143302;32457;31;856981;28;286321;19378;8343
85265;Saint-Pierre-le-Vieux;512;9921605;162076;249;6892326;263;3029279;19378;8344
40267;Saint-Justin;542;10503054;317484;271;7795441;271;2707613;19378;8345
63008;Arconsat;365;7073130;226490;164;5113506;201;1959624;19378;8346
07156;Meyras;518;10038157;323082;251;7249812;267;2788345;19379;8347
89419;Toucy;1681;32575583;1266461;759;23302100;922;9273483;19379;8348
89288;Paroy-en-Othe;118;2286708;86396;63;1774814;55;511894;19379;8349
58038;Breugnon;94;1821620;37514;45;1256109;49;565511;19379;8350
88430;Saint-Ouen-lès-Parey;269;5213093;132383;141;3884023;128;1329070;19380;8351
57506;Niederstinzel;143;2771314;36281;78;1995817;65;775497;19380;8352
17212;Louzignac;95;1841127;69503;50;1401185;45;439942;19380;8353
31112;Castagnède;100;1938030;81399;49;1417651;51;520379;19380;8354
59194;Englefontaine;720;13953904;429907;339;10144918;381;3808986;19380;8355
55146;Dannevoux;120;2325657;90196;53;1593139;67;732518;19380;8356
61183;Gâprée;69;1337268;30465;30;977940;39;359328;19381;8357
31375;Montesquieu-Volvestre;1765;34207729;1023783;828;24983423;937;9224306;19381;8358
86013;Aulnay;65;1259785;38965;30;890852;35;368933;19381;8359
55252;Iré-le-Sec;85;1647417;48728;37;1141305;48;506112;19381;8360
33161;Eyrans;429;8314699;225349;202;5937270;227;2377429;19382;8361
55450;Rupt-sur-Othain;31;600832;8322;12;374392;19;226440;19382;8362
55057;Boinville-en-Woëvre;36;697759;5016;13;372263;23;325496;19382;8363
50398;Le Perron;106;2054517;11111;53;1441480;53;613037;19382;8364
19127;Marc-la-Tour;96;1860695;72208;52;1425752;44;434943;19382;8365
02344;Gernicourt;34;658997;34035;17;524468;17;134529;19382;8366
58115;Fleury-sur-Loire;138;2674757;76782;74;2106750;64;568007;19382;8367
64124;Bidarray;346;6706333;207762;164;4749845;182;1956488;19382;8368
40309;Souprosse;604;11707320;313443;288;8276501;316;3430819;19383;8369
31584;Villemur-sur-Tarn;3383;65574863;2142635;1613;47867944;1770;17706919;19384;8370
70225;Fahy-lès-Autrey;65;1259952;19529;29;917257;36;342695;19384;8371
46325;Vaillac;55;1066120;54824;26;818758;29;247362;19384;8372
01269;Nantua;1903;36891725;1573334;910;26849672;993;10042053;19386;8373
50565;Sartilly;904;17525245;441755;443;12457733;461;5067512;19386;8374
17439;Taugon;405;7851619;184379;180;5309736;225;2541883;19387;8375
55083;Brouennes;84;1628516;41023;46;1194781;38;433735;19387;8376
42078;Le Crozet;155;3005038;92536;77;2097642;78;907396;19387;8377
04040;Le Castellard-Mélan;40;775508;38223;17;561467;23;214041;19388;8378
21491;Poiseul-lès-Saulx;36;697969;9876;18;516182;18;181787;19388;8379
55516;Tréveray;359;6960430;205745;170;4703852;189;2256578;19388;8380
88266;Lépanges-sur-Vologne;507;9829944;358650;246;7196828;261;2633116;19388;8381
12196;Recoules-Prévinquières;267;5176756;136372;134;3800612;133;1376144;19389;8382
64202;Domezain-Berraute;249;4827771;106191;114;3503101;135;1324670;19389;8383
69158;Pont-Trambouze;279;5409567;160711;145;3879955;134;1529612;19389;8384
79256;Saint-Germier;123;2384871;89738;50;1585557;73;799314;19389;8385
50387;Orglandes;188;3645202;65860;96;2648212;92;996990;19389;8386
70339;Mélisey;999;19370246;605015;484;13701463;515;5668783;19390;8387
32249;Mauvezin;1277;24760800;919646;584;17653433;693;7107367;19390;8388
22185;Plénée-Jugon;1341;26002105;701526;603;18425277;738;7576828;19390;8389
44062;Le Gâvre;846;16404148;306239;412;11686433;434;4717715;19390;8390
24319;Paussac-et-Saint-Vivien;274;5312946;144745;128;3771218;146;1541728;19390;8391
34283;Saint-Pierre-de-la-Fage;69;1337973;38418;26;886150;43;451823;19391;8392
67278;Mackwiller;340;6592922;151546;169;4767179;171;1825743;19391;8393
22341;Tramain;377;7310595;117913;199;5197521;178;2113074;19391;8394
58099;Dommartin;103;1997363;56569;41;1315905;62;681458;19392;8395
27068;Bois-Anzeray;89;1725889;68004;40;1245491;49;480398;19392;8396
47313;Tourtrès;68;1318669;36512;29;894224;39;424445;19392;8397
53073;Congrier;477;9250285;163509;228;6493667;249;2756618;19393;8398
53090;Denazé;71;1376897;6667;37;1015336;34;361561;19393;8399
63085;Chapdes-Beaufort;594;11519553;274908;315;8441138;279;3078415;19393;8400
16258;Pérignac;285;5527104;133801;137;3963126;148;1563978;19393;8401
17195;La Jarrie-Audouin;160;3102960;48210;81;2278196;79;824764;19394;8402
89320;Quincerot;44;853329;53393;15;537927;29;315402;19394;8403
80248;Dompierre-sur-Authie;227;4402409;139314;95;3038810;132;1363599;19394;8404
87173;Saint-Pardoux;311;6031509;123082;149;4297945;162;1733564;19394;8405
07010;Annonay;10463;202925469;8588504;4995;149931942;5468;52993527;19395;8406
86140;Lussac-les-Châteaux;1366;26493476;803793;623;18849106;743;7644370;19395;8407
54323;Longwy;8492;164702579;5109376;3052;93877661;5440;70824918;19395;8408
24210;Hautefort;528;10240636;406504;233;7348589;295;2892047;19395;8409
66004;Les Angles;409;7932778;329689;220;6038969;189;1893809;19396;8410
33242;Les Lèves-et-Thoumeyragues;326;6323280;206018;161;4703198;165;1620082;19397;8411
65158;Esbareich;44;853449;28301;23;679294;21;174155;19397;8412
63125;Courpière;2769;53709629;1868910;1245;38165637;1524;15543992;19397;8413
19166;Pierrefitte;47;911661;23329;20;653906;27;257755;19397;8414
51219;Drosnay;121;2347095;76503;63;1676533;58;670562;19397;8415
70427;Purgerot;203;3937711;94794;98;2636299;105;1301412;19398;8416
52444;Saint-Blin;209;4054267;169658;90;2916847;119;1137420;19398;8417
21068;Beurey-Bauguay;63;1222107;28366;32;864027;31;358080;19399;8418
32286;Montestruc-sur-Gers;411;7972917;243809;199;5849621;212;2123296;19399;8419
24501;Saint-Seurin-de-Prats;281;5451191;178921;120;3815567;161;1635624;19399;8420
58277;Sermages;116;2250335;69435;53;1582665;63;667670;19399;8421
35219;Pipriac;1992;38644635;1110962;962;28016750;1030;10627885;19400;8422
38212;Livet-et-Gavet;725;14064947;379669;364;9821780;361;4243167;19400;8423
88081;Bussang;917;17789918;597328;451;12730452;466;5059466;19400;8424
58003;Alligny-en-Morvan;400;7760182;277604;170;5580921;230;2179261;19400;8425
65112;Bun;82;1590838;28851;35;1019248;47;571590;19400;8426
80806;Villers-sur-Authie;230;4462463;127200;112;3450448;118;1012015;19402;8427
11197;Lauraguel;328;6364120;155969;149;4375287;179;1988833;19403;8428
79039;Boisserolles;36;698501;31854;13;431265;23;267236;19403;8429
37116;Les Hermites;312;6053720;164069;161;4686516;151;1367204;19403;8430
55577;Waly;35;679112;22116;16;434959;19;244153;19403;8431
80525;Meigneux;97;1882156;60202;51;1509928;46;372228;19404;8432
79222;Pugny;112;2173299;36906;49;1454875;63;718424;19404;8433
56174;Plumelin;1382;26816972;602492;689;19974440;693;6842532;19404;8434
62642;Ourton;401;7781410;191786;187;5554148;214;2227262;19405;8435
79299;Saint-Varent;1392;27011801;689545;627;18679911;765;8331890;19405;8436
16198;Magnac-Lavalette-Villars;245;4754328;136570;122;3565868;123;1188460;19405;8437
88117;Courcelles-sous-Châtenois;49;950866;27507;25;700351;24;250515;19405;8438
32075;Cassaigne;115;2231651;68263;58;1708796;57;522855;19406;8439
31483;Saint-Gaudens;7429;144165163;7274685;3455;109647197;3974;34517966;19406;8440
50071;Braffais;101;1960026;78859;44;1395903;57;564123;19406;8441
62300;Équihen-Plage;1496;29032934;799521;710;20954963;786;8077971;19407;8442
88313;Moriville;218;4230981;61793;110;2998383;108;1232598;19408;8443
67133;Eschbourg;283;5492545;98524;138;3839630;145;1652915;19408;8444
24234;Les Lèches;215;4172976;149908;94;2864667;121;1308309;19409;8445
55481;Senon;150;2911392;44188;63;1818672;87;1092720;19409;8446
2B111;Felce;25;485239;24225;12;372595;13;112644;19410;8447
34197;Péret;520;10093002;256604;240;7242650;280;2850352;19410;8448
82080;Labastide-du-Temple;541;10500807;203972;253;7536299;288;2964508;19410;8449
27433;Neuville-sur-Authou;92;1785738;73605;49;1394002;43;391736;19410;8450
17432;Souméras;186;3610340;88032;88;2658087;98;952253;19410;8451
37279;Villiers-au-Bouin;366;7104474;104684;180;5083701;186;2020773;19411;8452
87056;Dinsac;144;2795215;83648;82;2218859;62;576356;19411;8453
64026;Anhaux;176;3416380;71812;83;2449320;93;967060;19411;8454
28356;Saint-Pellerin;209;4057016;147658;111;3100135;98;956881;19412;8455
21584;Saulieu;1593;30923264;1368082;754;22898202;839;8025062;19412;8456
21693;Villedieu;44;854141;15996;25;597641;19;256500;19412;8457
40154;Lévignacq;194;3766036;129617;90;2684712;104;1081324;19413;8458
33004;Ambès;1544;29973419;809627;777;21917638;767;8055781;19413;8459
42164;Palogneux;40;776516;30080;17;530873;23;245643;19413;8460
16273;Raix;86;1669515;58499;47;1312387;39;357128;19413;8461
24553;Tocane-Saint-Apre;1041;20208901;733337;461;14438482;580;5770419;19413;8462
02386;Iron;125;2426638;76298;58;1809732;67;616906;19413;8463
85287;Tallud-Sainte-Gemme;239;4639836;52808;115;3301382;124;1338454;19414;8464
41049;Chémery;548;10638713;320854;277;7859267;271;2779446;19414;8465
36230;Vatan;1222;23723702;786784;558;16872312;664;6851390;19414;8466
21647;Trugny;80;1553116;57878;43;1235884;37;317232;19414;8467
33367;Saint-André-du-Bois;236;4581821;115673;122;3434069;114;1147752;19414;8468
54075;Bionville;89;1727908;77396;47;1317534;42;410374;19415;8469
71484;Saint-Usuge;719;13960173;301664;354;10107855;365;3852318;19416;8470
71458;Saint-Martin-la-Patrouille;36;699030;30542;16;515399;20;183631;19418;8471
53107;Gorron;1596;30991593;881642;656;21051004;940;9940589;19418;8472
50452;Saint-Brice-de-Landelles;347;6738222;100425;174;4813192;173;1925030;19419;8473
86195;Port-de-Piles;293;5689636;150328;148;4019075;145;1670561;19419;8474
79263;Saint-Laurs;283;5495453;79252;136;3682808;147;1812645;19419;8475
24042;Biras;336;6524738;148933;176;4832504;160;1692234;19419;8476
40302;Sindères;102;1980772;43300;55;1523952;47;456820;19419;8477
17182;La Grève-sur-Mignon;268;5204407;115778;123;3507004;145;1697403;19419;8478
79310;Secondigné-sur-Belle;287;5573403;156608;128;3891704;159;1681699;19420;8479
31020;Aspet;610;11846375;528516;282;8590790;328;3255585;19420;8480
63102;Châteldon;480;9322043;318289;248;7000255;232;2321788;19421;8481
70527;Vaux-le-Moncelot;39;757424;14585;16;437594;23;319830;19421;8482
57410;Lhor;81;1573119;90103;37;1220343;44;352776;19421;8483
49053;Brossay;167;3243361;34069;73;2072278;94;1171083;19421;8484
02819;Vincy-Reuil-et-Magny;68;1320675;53585;25;943384;43;377291;19422;8485
24212;Issigeac;456;8856839;271634;203;6294111;253;2562728;19423;8486
54567;Villacourt;233;4525574;95643;115;3238525;118;1287049;19423;8487
19222;Saint-Martin-la-Méanne;223;4331579;155828;100;3122669;123;1208910;19424;8488
19026;Bilhac;125;2428064;85243;56;1754600;69;673464;19425;8489
02833;Wimy;243;4720192;108306;123;3464035;120;1256157;19425;8490
32294;Mourède;49;951823;36480;22;728903;27;222920;19425;8491
32447;Tirent-Pontéjac;47;912994;27283;21;656708;26;256286;19425;8492
30201;Ponteils-et-Brésis;175;3399464;125070;78;2358211;97;1041253;19426;8493
34292;Salasc;182;3535452;145525;81;2563853;101;971599;19426;8494
59314;Hornaing;1746;33918053;862109;769;23769568;977;10148485;19426;8495
04154;Pontis;55;1068450;47368;27;794977;28;273473;19426;8496
24168;Plaisance;259;5031536;203966;110;3441381;149;1590155;19427;8497
70092;Bresilley;104;2020428;63032;61;1665124;43;355304;19427;8498
61082;Le Chalange;43;835385;20414;21;639474;22;195911;19428;8499
88407;Ruppes;80;1554216;31898;41;1155711;39;398505;19428;8500
32310;Perchède;55;1068558;12133;29;781446;26;287112;19428;8501
08276;Margut;411;7985063;262534;187;5548715;224;2436348;19428;8502
35042;Brielles;339;6586543;67918;170;4578131;169;2008412;19429;8503
22049;Créhen;1022;19857056;715096;474;14820876;548;5036180;19430;8504
72193;Melleray;266;5168342;122046;122;3551347;144;1616995;19430;8505
08459;Tremblois-lès-Carignan;68;1321246;34989;34;954133;34;367113;19430;8506
48125;Le Recoux;72;1398971;32894;30;982902;42;416069;19430;8507
71321;Morey;106;2059642;26033;45;1264584;61;795058;19431;8508
36029;Buxeuil;129;2506683;84192;57;1793925;72;712758;19432;8509
55359;Morley;125;2428957;75927;64;1867934;61;561023;19432;8510
65046;Aulon;44;854993;33871;23;693630;21;161363;19432;8511
71589;Vitry-sur-Loire;221;4294489;104954;109;3053621;112;1240868;19432;8512
63177;Isserteaux;238;4624925;121887;108;3203016;130;1421909;19432;8513
70329;Malvillers;45;874478;38569;19;587898;26;286580;19433;8514
86129;Lésigny;308;5985343;194246;144;4262432;164;1722911;19433;8515
89464;Villeneuve-sur-Yonne;3390;65877877;2636262;1679;48835511;1711;17042366;19433;8516
46261;Sainte-Croix;41;796759;21760;18;579328;23;217431;19433;8517
76496;Penly;214;4158742;127511;103;2917176;111;1241566;19433;8518
65481;Barèges;122;2370890;82698;75;1946521;47;424369;19434;8519
37271;Villaines-les-Rochers;562;10921874;218791;272;7685487;290;3236387;19434;8520
08391;Saint-Menges;543;10552742;354738;261;7655896;282;2896846;19434;8521
48142;Sainte-Colombe-de-Peyre;117;2273859;73704;53;1628449;64;645410;19435;8522
34018;Autignac;489;9503825;278022;234;6868029;255;2635796;19435;8523
04074;Entrages;74;1438218;44981;43;1057662;31;380556;19435;8524
79250;Sainte-Gemme;199;3867648;36533;102;2748062;97;1119586;19435;8525
39461;Rix;41;796864;16250;23;590603;18;206261;19436;8526
43162;Retournac;1617;31427850;894239;760;22279163;857;9148687;19436;8527
24534;Sigoulès;464;9018296;314897;194;6277107;270;2741189;19436;8528
33533;Toulenne;1454;28259939;1142123;733;21603407;721;6656532;19436;8529
71364;La Racineuse;93;1807579;33383;42;1132482;51;675097;19436;8530
72176;Le Lude;2285;44414156;1461930;1103;32099602;1182;12314554;19437;8531
66108;Millas;2313;44959449;2057188;1015;33998724;1298;10960725;19438;8532
76315;Grainville-la-Teinturière;599;11643336;381234;264;8364971;335;3278365;19438;8533
58045;La Celle-sur-Nièvre;100;1943896;68918;49;1393565;51;550331;19439;8534
38132;Les Côtes-de-Corps;42;816480;31482;18;560509;24;255971;19440;8535
21570;Sainte-Sabine;123;2391150;125616;53;1890932;70;500218;19440;8536
93071;Sevran;24872;483519065;18414226;11937;358820312;12935;124698753;19440;8537
71165;Cussy-en-Morvan;249;4840644;186085;117;3529373;132;1311271;19440;8538
11273;Paraza;333;6473850;164040;159;4695446;174;1778404;19441;8539
02061;Becquigny;137;2663446;83482;57;1783399;80;880047;19441;8540
11298;Pradelles-en-Val;100;1944141;84224;39;1367551;61;576590;19441;8541
64066;Ascarat;181;3518905;104834;83;2485099;98;1033806;19441;8542
14132;Canchy;115;2235805;29779;51;1585095;64;650710;19442;8543
24206;Grives;73;1419274;43758;27;928917;46;490357;19442;8544
79329;Thouars;5842;113582760;5432279;2581;82950741;3261;30632019;19442;8545
21336;Laignes;476;9254647;293396;227;6640310;249;2614337;19443;8546
89336;Saint-Brancher;187;3635780;252085;83;2618212;104;1017568;19443;8547
08186;Germont;27;524954;10476;11;340476;16;184478;19443;8548
33136;Cours-de-Monségur;139;2702545;57163;55;1673788;84;1028757;19443;8549
50577;Sortosville-en-Beaumont;170;3305277;89317;81;2226619;89;1078658;19443;8550
26320;Saint-Nazaire-en-Royans;449;8729934;287205;225;6490657;224;2239277;19443;8551
62063;Avesnes-le-Comte;1081;21018146;640819;473;14892538;608;6125608;19443;8552
47065;Clairac;1427;27746414;885195;649;19999292;778;7747122;19444;8553
65187;Gaussan;69;1341636;82624;32;1029574;37;312062;19444;8554
72182;Mansigné;878;17072043;510930;405;12023540;473;5048503;19444;8555
46112;Francoulès;137;2663912;82979;66;1915841;71;748071;19445;8556
72094;Coudrecieux;355;6902959;228913;170;4888327;185;2014632;19445;8557
89247;Mélisey;171;3325117;115423;86;2457954;85;867163;19445;8558
40052;Bourdalat;116;2255667;44117;54;1620445;62;635222;19445;8559
21143;Channay;34;661151;20534;12;400180;22;260971;19446;8560
42274;Saint-Polgues;123;2391900;49668;54;1649419;69;742481;19446;8561
47226;Roumagne;324;6300703;177738;162;4627837;162;1672866;19447;8562
19149;Neuville;122;2372618;103810;49;1566589;73;806029;19448;8563
49305;Saint-Martin-du-Bois;444;8635371;154317;202;5885340;242;2750031;19449;8564
65006;Ancizan;170;3306480;91719;85;2373826;85;932654;19450;8565
43048;La Chaise-Dieu;418;8130174;325095;174;5674480;244;2455694;19450;8566
46256;Saint-Cirq-Lapopie;147;2859188;176504;71;2171495;76;687693;19450;8567
93010;Bondy;26579;516983231;21740070;12968;394240000;13611;122743231;19451;8568
80719;Sainte-Segrée;34;661365;18175;16;521803;18;139562;19452;8569
21449;Nan-sous-Thil;113;2198137;60452;53;1551981;60;646156;19453;8570
35214;Parcé;361;7022487;105355;174;5055662;187;1966825;19453;8571
34243;Saint-Bauzille-de-Putois;996;19375309;540920;472;13844914;524;5530395;19453;8572
22207;Plouaret;1338;26028396;785218;638;18930528;700;7097868;19453;8573
87077;Janailhac;270;5252410;127742;135;3828755;135;1423655;19453;8574
21465;Obtrée;44;855950;14889;24;649304;20;206646;19453;8575
50021;Audouville-la-Hubert;42;817065;9503;20;529147;22;287918;19454;8576
42049;Changy;323;6283671;131965;164;4631462;159;1652209;19454;8577
61386;Saint-Evroult-Notre-Dame-du-Bois;262;5096999;186891;138;3876759;124;1220240;19454;8578
24306;Nastringues;61;1186760;46274;30;890416;31;296344;19455;8579
69264;Villefranche-sur-Saône;20119;391431141;16311431;10381;296142047;9738;95289094;19456;8580
38424;Saint-Maurice-en-Trièves;102;1984514;84331;50;1533511;52;451003;19456;8581
02236;Crécy-au-Mont;170;3307524;86405;88;2448255;82;859269;19456;8582
70530;Vellechevreux-et-Courbenans;85;1653770;53656;42;1165201;43;488569;19456;8583
88095;Châtenois;976;18989730;922888;441;13936603;535;5053127;19457;8584
22326;Saint-Rieul;248;4825406;66194;125;3390596;123;1434810;19457;8585
47241;Saint-Eutrope-de-Born;341;6635076;145353;158;4873000;183;1762076;19458;8586
81089;Faussergues;84;1634513;44931;34;1149526;50;484987;19458;8587
25094;Bretigney-Notre-Dame;63;1225931;20523;33;890011;30;335920;19459;8588
02550;Neuville-sur-Ailette;62;1206485;43731;32;945335;30;261150;19459;8589
71168;Dampierre-en-Bresse;102;1984905;42815;49;1384588;53;600317;19460;8590
42116;Juré;137;2666069;98085;60;1936271;77;729798;19460;8591
25507;Rouhe;46;895177;19448;26;680236;20;214941;19460;8592
63352;Saint-Germain-Lembron;1082;21056271;668876;521;15399084;561;5657187;19461;8593
55519;Tronville-en-Barrois;895;17417243;489383;491;13225559;404;4191684;19461;8594
46199;Montcabrier;199;3872688;98811;88;2661514;111;1211174;19461;8595
66230;Vinça;1177;22905301;857969;522;16398188;655;6507113;19461;8596
85299;Velluire;351;6831022;161560;166;4870340;185;1960682;19462;8597
08103;Charbogne;120;2335550;49861;59;1697177;61;638373;19463;8598
34053;Carlencas-et-Levas;46;895297;23034;25;690006;21;205291;19463;8599
61506;Villers-en-Ouche;195;3795334;101528;92;2666742;103;1128592;19463;8600
37142;Maillé;354;6890317;192835;175;5035316;179;1855001;19464;8601
60240;Fontaine-Bonneleau;139;2705528;70823;69;2014442;70;691086;19464;8602
42288;Saint-Sixte;387;7532777;150462;185;5343959;202;2188818;19465;8603
80601;Nurlu;229;4457403;108883;115;3279705;114;1177698;19465;8604
27205;Douville-sur-Andelle;232;4515847;111987;132;3475772;100;1040075;19465;8605
83067;Gonfaron;2339;45528954;1578509;1104;34259433;1235;11269521;19465;8606
09306;Tarascon-sur-Ariège;1883;36652885;2062583;750;26237965;1133;10414920;19465;8607
31043;Balesta;89;1732418;77592;40;1315445;49;416973;19465;8608
80343;Framicourt;87;1693563;34265;43;1285273;44;408290;19466;8609
22056;Évran;981;19096481;615729;448;13843432;533;5253049;19466;8610
62513;Ligny-sur-Canche;103;2005037;57881;47;1436100;56;568937;19466;8611
81099;Gaillac;8445;164394263;6408200;3867;121379113;4578;43015150;19466;8612
85074;La Couture;108;2102381;52819;52;1579734;56;522647;19466;8613
83010;Bargème;74;1440559;81856;36;1035447;38;405112;19467;8614
60182;Le Crocq;93;1810450;53829;45;1362361;48;448089;19467;8615
71329;Navilly;239;4652688;109920;115;3190799;124;1461889;19467;8616
16302;Saint-Avit;111;2160937;68545;45;1614678;66;546259;19468;8617
33324;Pineuilh;2479;48262487;1825945;1154;34870409;1325;13392078;19469;8618
24073;Calès;221;4302684;109869;102;3006573;119;1296111;19469;8619
33389;Saint-Ciers-sur-Gironde;1773;34519707;1329460;771;25447968;1002;9071739;19470;8620
19174;La Roche-Canillac;91;1771760;63366;38;1253106;53;518654;19470;8621
40161;Lubbon;55;1070887;33164;24;703253;31;367634;19471;8622
26309;Saint-Julien-en-Vercors;132;2570148;60777;57;1764416;75;805732;19471;8623
07287;Saint-Pons;153;2979051;67660;76;2244017;77;735034;19471;8624
85014;Bazoges-en-Pareds;600;11682592;224979;271;7995953;329;3686639;19471;8625
30288;Saint-Nazaire;670;13046251;458185;329;9910216;341;3136035;19472;8626
36172;Rivarennes;321;6250552;187836;149;4515111;172;1735441;19472;8627
87127;La Roche-l'Abeille;333;6484267;200193;155;4709265;178;1775002;19472;8628
46239;Le Roc;136;2648273;82723;58;1780587;78;867686;19473;8629
34132;Lauroux;123;2395147;77192;63;1765889;60;629258;19473;8630
81308;Valence-d'Albigeois;719;14000915;610704;280;9683483;439;4317432;19473;8631
72361;Tresson;273;5316189;174201;128;3852254;145;1463935;19473;8632
17269;Orignolles;388;7555719;204617;169;5490990;219;2064729;19474;8633
11393;Tourouzelle;287;5589065;255355;127;4157422;160;1431643;19474;8634
62096;Beaumetz-lès-Cambrai;313;6095504;127962;151;4361810;162;1733694;19474;8635
18188;Primelles;141;2745954;69381;67;1890315;74;855639;19475;8636
23002;Ajain;631;12288978;389052;320;9198615;311;3090363;19475;8637
17348;Saint-Jean-d'Angle;369;7186671;282901;168;5009928;201;2176743;19476;8638
15251;Védrines-Saint-Loup;94;1830793;162414;31;1317872;63;512921;19477;8639
55246;Hévilliers;88;1713942;44739;52;1368299;36;345643;19477;8640
49127;Durtal;1907;37142399;872978;895;26173010;1012;10969389;19477;8641
16130;Les Essards;105;2045077;58622;49;1518981;56;526096;19477;8642
07215;Saint-Barthélemy-le-Meil;129;2512543;123535;54;1743650;75;768893;19477;8643
08247;Landrichamps;79;1538711;33006;48;1301445;31;237266;19477;8644
89232;Lucy-le-Bois;194;3778672;127830;97;2829201;97;949471;19478;8645
57590;Rolbing;149;2902189;86115;63;1931199;86;970990;19478;8646
57291;Hangviller;155;3019074;49662;82;2190111;73;828963;19478;8647
22073;La Harmoye;210;4090460;106489;94;2954514;116;1135946;19478;8648
08248;Launois-sur-Vence;355;6914853;212052;181;5187495;174;1727358;19478;8649
89408;Tannerre-en-Puisaye;183;3564669;129884;96;2752111;87;812558;19479;8650
02040;Autreppes;88;1714161;47203;37;1197811;51;516350;19479;8651
35335;Thourie;353;6876159;98587;171;4946548;182;1929611;19479;8652
36174;Roussines;209;4071159;130499;95;2832582;114;1238577;19479;8653
52131;Cirfontaines-en-Ornois;46;896046;47597;23;677325;23;218721;19479;8654
19075;Espagnac;222;4324477;130603;110;3114837;112;1209640;19480;8655
85207;Saint-Denis-du-Payré;238;4636219;132080;130;3596666;108;1039553;19480;8656
46290;Saint-Projet;222;4324577;131110;104;3018394;118;1306183;19480;8657
07303;Saint-Vincent-de-Durfort;146;2844102;74865;74;2116372;72;727730;19480;8658
22108;Lanleff;66;1285742;23388;30;873437;36;412305;19481;8659
29044;Dinéault;857;16695966;413329;438;12495825;419;4200141;19482;8660
31008;Anan;131;2552149;80249;57;1821936;74;730213;19482;8661
40058;Cachen;142;2766483;122147;68;2092682;74;673801;19482;8662
06080;Marie;29;565000;26212;15;441024;14;123976;19483;8663
06099;Puget-Théniers;1104;21509207;1132736;505;16106405;599;5402802;19483;8664
62119;Béthune;15114;294470742;17934673;6624;227091370;8490;67379372;19483;8665
04108;Malijai;1068;20808476;666891;493;14769896;575;6038580;19484;8666
16197;La Magdeleine;63;1227470;41616;26;844689;37;382781;19484;8667
82156;Saint-Arroumex;82;1597660;49425;34;1004624;48;593036;19484;8668
88043;Bazoilles-et-Ménil;77;1500267;47412;43;1168455;34;331812;19484;8669
56074;Guénin;835;16269206;267736;421;11773440;414;4495766;19484;8670
23093;Gouzon;972;18938587;725023;444;13719311;528;5219276;19484;8671
34150;Marseillan;5144;100227392;4954337;2395;75026673;2749;25200719;19484;8672
79015;Asnières-en-Poitou;121;2357611;76458;55;1626983;66;730628;19484;8673
59230;Ferrière-la-Grande;2888;56272996;2252122;1327;41838867;1561;14434129;19485;8674
47277;Saint-Sauveur-de-Meilhan;176;3429514;146155;81;2538752;95;890762;19486;8675
58284;Talon;25;487151;17771;12;339863;13;147288;19486;8676
52260;Lamancine;70;1364028;34083;38;1070561;32;293467;19486;8677
89238;Mailly-le-Château;369;7190426;264088;167;4930034;202;2260392;19486;8678
80223;Crémery;76;1481029;39141;39;1013550;37;467479;19487;8679
03310;Vichy;17475;340540294;19182611;8293;260530971;9182;80009323;19487;8680
79115;Exoudun;352;6859712;245856;161;4763476;191;2096236;19488;8681
31197;Franquevielle;208;4053490;136478;109;3116177;99;937313;19488;8682
42249;Saint-Just-la-Pendue;894;17422341;446219;449;12673282;445;4749059;19488;8683
58306;Verneuil;174;3391074;95451;82;2360023;92;1031051;19489;8684
06078;Malaussène;141;2747989;66505;82;2094166;59;653823;19489;8685
01280;Ordonnaz;94;1832025;71314;49;1365622;45;466403;19490;8686
39472;Rye;122;2377759;58103;67;1818274;55;559485;19490;8687
32113;Cravencères;62;1208386;58954;28;914502;34;293884;19490;8688
88210;Gorhey;87;1695668;20020;43;1266353;44;429315;19490;8689
05064;La Chapelle-en-Valgaudémar;67;1305860;41565;31;931209;36;374651;19490;8690
24338;Pressignac-Vicq;276;5379425;223892;118;3680879;158;1698546;19491;8691
22014;Bourseul;603;11752935;319574;299;8791914;304;2961021;19491;8692
12105;La Fouillade;606;11811691;370613;254;8071020;352;3740671;19491;8693
02333;Fresnes;86;1676367;48948;47;1247710;39;428657;19493;8694
2B096;Corte;3209;62552037;3096653;1580;48254850;1629;14297187;19493;8695
85105;Le Gué-de-Velluire;290;5652977;146855;135;3899695;155;1753282;19493;8696
26051;Bézaudun-sur-Bîne;47;916200;75047;15;663942;32;252258;19494;8697
46004;Anglars;119;2319809;55357;64;1701688;55;618121;19494;8698
09101;Coussa;147;2865666;109617;80;2271952;67;593714;19494;8699
16175;Jurignac;328;6394183;230313;159;4645454;169;1748729;19494;8700
57661;Sturzelbronn;98;1910470;61474;42;1284467;56;626003;19495;8701
14004;Aignerville;103;2008035;49548;50;1501763;53;506272;19495;8702
50581;Soulles;256;4990943;91911;136;3819646;120;1171297;19496;8703
70336;Mélecey;87;1696145;49101;41;1214447;46;481698;19496;8704
03189;Montvicq;418;8149390;163040;207;5724614;211;2424776;19496;8705
27088;Bosc-Renoult-en-Ouche;68;1325774;26031;33;882977;35;442797;19497;8706
63232;Mons;256;4991189;102912;124;3477671;132;1513518;19497;8707
46152;Lamothe-Fénelon;184;3587596;164137;80;2556418;104;1031178;19498;8708
71201;Fley;128;2495741;169786;48;2045909;80;449832;19498;8709
50049;Besneville;350;6824339;178401;155;4662555;195;2161784;19498;8710
24425;Saint-Jean-de-Côle;207;4036192;131931;93;2880228;114;1155964;19499;8711
22291;Saint-Gildas;164;3197781;107087;79;2322793;85;874988;19499;8712
81168;Mirandol-Bourgnounac;637;12421049;404385;282;8666065;355;3754984;19499;8713
12008;Anglars-Saint-Félix;405;7897235;190928;191;5681731;214;2215504;19499;8714
17292;Puy-du-Lac;242;4718908;86677;122;3409730;120;1309178;19500;8715
18168;Le Noyer;150;2925005;109704;72;2024695;78;900310;19500;8716
12290;Vaureilles;255;4972546;95671;115;3412044;140;1560502;19500;8717
49218;Montrevault;696;13572485;254146;341;9196545;355;4375940;19501;8718
38416;Saint-Marcellin;5016;97817028;4107613;2446;73217946;2570;24599082;19501;8719
82123;Montbartier;675;13163421;404942;338;9754134;337;3409287;19501;8720
12253;Salles-Curan;647;12617612;409687;280;8957010;367;3660602;19502;8721
07113;Labastide-de-Virac;138;2691312;68891;57;1770899;81;920413;19502;8722
70242;Fontenois-la-Ville;77;1501684;69369;30;1045221;47;456463;19502;8723
15202;Saint-Martin-Valmeroux;489;9536817;312270;200;6589753;289;2947064;19503;8724
43187;Saint-Geneys-près-Saint-Paulien;170;3315687;77476;81;2395615;89;920072;19504;8725
57537;Petite-Rosselle;3567;69572459;2294242;1696;50225029;1871;19347430;19504;8726
56032;Campénéac;1032;20128848;417510;528;14719934;504;5408914;19505;8727
89222;Levis;131;2555159;65404;60;1719155;71;836004;19505;8728
14334;L'Hôtellerie;158;3081818;50695;79;2212514;79;869304;19505;8729
64524;Simacourbe;190;3706140;76705;99;2826480;91;879660;19506;8730
58180;Montsauche-les-Settons;332;6476034;243132;139;4364298;193;2111736;19506;8731
24432;Saint-Julien-de-Lampon;379;7393075;297014;165;5351763;214;2041312;19507;8732
02547;La Neuville-Housset;32;624226;22485;11;393545;21;230681;19507;8733
21277;Fontaine-Française;519;10124417;372568;252;7687456;267;2436961;19508;8734
17244;Montpellier-de-Médillan;380;7412922;220960;184;5355845;196;2057077;19508;8735
57407;Lixheim;336;6554632;159678;180;4841157;156;1713475;19508;8736
24253;Mareuil;673;13129167;511819;317;9638851;356;3490316;19508;8737
08493;Vrizy;205;3999307;75436;98;2645306;107;1354001;19509;8738
57357;Kappelkinger;223;4350502;83265;123;3260776;100;1089726;19509;8739
03284;Thionne;191;3726299;164670;80;2588362;111;1137937;19509;8740
26325;Saint-Rambert-d'Albon;3109;60654930;1672289;1438;42370514;1671;18284416;19509;8741
33129;Cleyrac;88;1716845;39144;41;1180090;47;536755;19510;8742
88194;Gemmelaincourt;94;1833918;53005;48;1356253;46;477665;19510;8743
02352;Gouy;314;6126139;254598;142;4316821;172;1809318;19510;8744
51539;Sogny-en-l'Angle;32;624340;13705;17;476097;15;148243;19511;8745
06016;Beuil;217;4233818;128035;119;3250335;98;983483;19511;8746
52243;Huilliécourt;75;1463423;28233;39;1082621;36;380802;19512;8747
63057;Le Brugeron;155;3024414;118133;75;2242960;80;781454;19512;8748
07027;Beauchastel;1017;19844441;424817;518;14496080;499;5348361;19513;8749
19163;Le Pescher;154;3005339;76501;65;2068556;89;936783;19515;8750
22071;Guitté;348;6791504;132818;174;5020588;174;1770916;19516;8751
43191;Saint-Géron;137;2673850;49767;74;1943754;63;730096;19517;8752
26368;Vercheny;193;3766825;85449;91;2657637;102;1109188;19517;8753
55527;Varennes-en-Argonne;361;7045774;239955;159;4948990;202;2096784;19517;8754
21457;Noidan;47;917320;17246;20;626349;27;290971;19517;8755
42091;Estivareilles;366;7143390;141973;175;5012671;191;2130719;19517;8756
85141;Menomblet;320;6245725;95199;153;4285805;167;1959920;19518;8757
19011;Arnac-Pompadour;791;15438785;589345;400;11631726;391;3807059;19518;8758
26203;Montjoyer;162;3161993;121824;77;2461544;85;700449;19518;8759
33124;Chamadelle;362;7065743;195134;182;5230268;180;1835475;19519;8760
16421;Vouthon;237;4626242;125001;112;3242004;125;1384238;19520;8761
16064;Brigueuil;598;11673244;508896;284;8459848;314;3213396;19520;8762
86035;Bourg-Archambault;113;2205817;71236;51;1496358;62;709459;19521;8763
17250;Mosnac;279;5446254;193325;127;3743431;152;1702823;19521;8764
80481;Lihons;230;4489769;130007;113;3265114;117;1224655;19521;8765
40023;Baigts;185;3611339;119054;82;2574770;103;1036569;19521;8766
11041;Bize-Minervois;637;12434885;463781;282;8768039;355;3666846;19521;8767
73105;Les Échelles;698;13625773;462257;363;10274545;335;3351228;19521;8768
80692;Sailly-Flibeaucourt;543;10600067;317536;284;8063110;259;2536957;19521;8769
17039;Belluire;120;2342613;77680;64;1835558;56;507055;19522;8770
07130;Lanarce;112;2186482;83189;46;1621891;66;564591;19522;8771
31289;Lécussan;129;2518443;66617;62;1927535;67;590908;19523;8772
17241;Montguyon;892;17414443;624024;403;12454571;489;4959872;19523;8773
24009;Anlhiac;186;3631304;133278;85;2584288;101;1047016;19523;8774
89071;Chamoux;63;1229959;42670;32;974596;31;255363;19523;8775
31190;Fos;129;2518491;99817;57;1848681;72;669810;19523;8776
89046;Bléneau;849;16575204;720253;399;11877151;450;4698053;19523;8777
40142;Laluque;498;9722684;210334;245;6974154;253;2748530;19523;8778
72090;Connerré;1642;32057841;831619;873;23767866;769;8289975;19524;8779
21645;Trouhans;329;6423513;124700;175;4591336;154;1832177;19524;8780
76035;Aumale;1398;27295092;1286791;667;20079441;731;7215651;19524;8781
40071;Castelnau-Chalosse;314;6130897;221428;155;4740629;159;1390268;19525;8782
50614;Le Valdécie;78;1522969;35721;34;1091394;44;431575;19525;8783
18101;Germigny-l'Exempt;204;3983191;130466;96;2874775;108;1108416;19525;8784
58183;Mouron-sur-Yonne;63;1230105;46887;37;943847;26;286258;19525;8785
50550;Saint-Sauveur-Lendelin;890;17377679;497676;394;12132633;496;5245046;19525;8786
21203;Courcelles-Frémoy;76;1483979;42139;37;1042896;39;441083;19526;8787
33336;Préchac;632;12340607;485717;295;8819874;337;3520733;19526;8788
85175;Les Pineaux;326;6365743;104901;169;4709208;157;1656535;19527;8789
24370;Saint-Antoine-de-Breuilh;1029;20093142;687236;466;14526184;563;5566958;19527;8790
47194;Moustier;176;3436736;113628;68;2303449;108;1133287;19527;8791
71172;Dettey;48;937321;37582;29;717873;19;219448;19528;8792
32107;Condom;4224;82484459;3456626;1831;60066673;2393;22417786;19528;8793
22013;Bourbriac;1342;26206745;899870;557;18220054;785;7986691;19528;8794
15096;Lascelle;172;3358902;102322;73;2221926;99;1136976;19529;8795
71275;Marcigny;1138;22224038;869674;494;15825979;644;6398059;19529;8796
50064;La Bonneville;93;1816243;44379;42;1215468;51;600775;19529;8797
72098;Coulongé;295;5761300;121301;149;4106866;146;1654434;19530;8798
21239;Échenon;390;7616755;146248;191;5382249;199;2234506;19530;8799
32321;Polastron;132;2577983;64191;58;1736635;74;841348;19530;8800
19286;Vignols;322;6288744;227091;148;4492738;174;1796006;19530;8801
33204;Hure;282;5507618;245391;124;3909910;158;1597708;19531;8802
61260;Le Ménil-de-Briouze;307;5996002;135332;166;4544210;141;1451792;19531;8803
46168;Lentillac-Saint-Blaise;93;1816480;38828;48;1317195;45;499285;19532;8804
11145;Fleury;2428;47426345;2053692;1185;35105702;1243;12320643;19533;8805
89171;Foissy-sur-Vanne;162;3164396;83612;74;2177541;88;986855;19533;8806
22208;Plouasne;891;17405013;346517;409;12106658;482;5298355;19534;8807
42257;Saint-Martin-d'Estréaux;534;10431404;167604;210;7063253;324;3368151;19534;8808
62883;Wavrans-sur-Ternoise;109;2129335;41746;59;1579635;50;549700;19535;8809
06056;Entraunes;59;1152583;51599;33;923371;26;229212;19535;8810
2B341;Venaco;433;8458868;379047;225;6640272;208;1818596;19535;8811
15028;Carlat;215;4200155;136754;106;3090231;109;1109924;19536;8812
46025;Belmontet;88;1719155;70036;34;1158596;54;560559;19536;8813
39505;Saugeot;32;625157;25159;14;433226;18;191931;19536;8814
66182;Sainte-Marie;3047;59527067;2310047;1532;44452330;1515;15074737;19536;8815
38128;Corps;280;5470194;236940;135;4141611;145;1328583;19536;8816
71097;La Chapelle-Thècle;289;5646651;161127;134;3884476;155;1762175;19539;8817
88172;Fiménil;130;2540025;44106;71;1816897;59;723128;19539;8818
33319;Pessac-sur-Dordogne;279;5451420;277608;115;3868060;164;1583360;19539;8819
39555;Vers-sous-Sellières;122;2383777;36092;68;1785795;54;597982;19539;8820
72168;Loué;1222;23877379;715602;606;17492227;616;6385152;19540;8821
02379;Le Hérie-la-Viéville;138;2696511;129363;61;1978078;77;718433;19540;8822
36130;Montlevicq;65;1270141;44831;30;952754;35;317387;19541;8823
70289;Igny;100;1954068;41053;51;1387305;49;566763;19541;8824
40174;Mauries;43;840270;25156;18;584481;25;255789;19541;8825
50232;Hauteville-la-Guichard;220;4299065;48825;105;2957655;115;1341410;19541;8826
42154;Néronde;263;5139571;138260;132;3652091;131;1487480;19542;8827
03100;Diou;868;16962568;524594;408;12320429;460;4642139;19542;8828
35147;Lanhélin;477;9321648;159438;215;6318636;262;3003012;19542;8829
62155;Bonningues-lès-Ardres;328;6410129;165445;147;4472004;181;1938125;19543;8830
55288;Lérouville;783;15302321;448459;377;11124254;406;4178067;19543;8831
11074;Les Cassés;142;2775176;77080;76;2126310;66;648866;19543;8832
50279;Le Lorey;308;6019673;118818;151;4184174;157;1835499;19544;8833
93007;Le Blanc-Mesnil;26638;520625186;21399132;13298;393084041;13340;127541145;19544;8834
2B072;Casalta;27;527723;28934;16;458801;11;68922;19545;8835
52467;Savigny;36;703631;11895;15;514240;21;189391;19545;8836
43040;Brioude;4196;82014142;3283236;1986;60593394;2210;21420748;19546;8837
41001;Ambloy;111;2169637;53137;63;1720262;48;449375;19546;8838
70539;Vellexon-Queutrey-et-Vaudey;273;5336319;154961;134;3686147;139;1650172;19547;8839
57536;Petit-Tenquin;123;2404291;66270;52;1551597;71;852694;19547;8840
88426;Saint-Maurice-sur-Moselle;879;17181908;512302;451;12434744;428;4747164;19547;8841
61152;Écorches;51;996904;17147;26;765313;25;231591;19547;8842
27441;Notre-Dame-d'Épine;40;781904;26511;22;603363;18;178541;19548;8843
76686;Theuville-aux-Maillots;253;4945693;54703;128;3481970;125;1463723;19548;8844
10288;Plaines-Saint-Lange;183;3577330;119904;99;2720654;84;856676;19548;8845
97415;Saint-Paul;57574;1125481630;48425239;18694;808926156;38880;316555474;19548;8846
02405;Landouzy-la-Ville;290;5669090;162522;148;4354998;142;1314092;19549;8847
89192;Grandchamp;232;4535279;176145;115;3371092;117;1164187;19549;8848
39255;Gizia;122;2385035;71212;59;1749197;63;635838;19549;8849
18064;Chéry;126;2463261;51060;69;1742487;57;720774;19550;8850
83135;Tavernes;704;13763079;519238;335;10385541;369;3377538;19550;8851
44214;Vay;972;19002656;281587;494;13715319;478;5287337;19550;8852
12057;Cassagnes-Bégonhès;533;10420267;306898;247;7628027;286;2792240;19550;8853
25343;Longemaison;73;1427200;34749;36;1010623;37;416577;19551;8854
39054;Biefmorin;45;879797;19023;23;678491;22;201306;19551;8855
54396;Neufmaisons;103;2013767;40598;51;1385849;52;627918;19551;8856
54518;Thiaucourt-Regniéville;664;12981960;473705;314;9557071;350;3424889;19551;8857
55370;Naix-aux-Forges;124;2424369;52184;62;1691875;62;732494;19551;8858
35115;Fougères;12107;236711639;9421683;5876;176036741;6231;60674898;19552;8859
44099;Moisdon-la-Rivière;1048;20490123;587038;424;13419757;624;7070366;19552;8860
55561;Villers-devant-Dun;36;703864;20278;16;501986;20;201878;19552;8861
50078;Bretteville-sur-Ay;244;4770691;154863;129;3573344;115;1197347;19552;8862
24362;Sainte-Alvère;450;8798473;436414;190;6308720;260;2489753;19552;8863
08115;Chémery-sur-Bar;242;4731640;117750;122;3460001;120;1271639;19552;8864
91174;Corbeil-Essonnes;26338;514970221;23157869;14050;405984953;12288;108985268;19552;8865
72189;Marolles-les-Braults;1287;25164908;854982;507;17478871;780;7686037;19553;8866
18067;Clémont;402;7860575;260941;208;5973521;194;1887054;19554;8867
02513;Montigny-le-Franc;104;2033589;100362;47;1472162;57;561427;19554;8868
14099;Bretteville-sur-Dives;157;3069958;83335;76;2173239;81;896719;19554;8869
53192;La Rouaudière;158;3089592;16823;66;1773862;92;1315730;19554;8870
02538;Nanteuil-Notre-Dame;40;782178;41151;16;507282;24;274896;19554;8871
80543;Métigny;55;1075501;9372;23;670200;32;405301;19555;8872
33254;Loupiac-de-la-Réole;233;4556403;130204;101;3285435;132;1270968;19555;8873
21545;Sainte-Colombe-sur-Seine;517;10110562;297013;267;7413787;250;2696775;19556;8874
91228;Évry;27889;545409715;23461857;14361;423858254;13528;121551461;19556;8875
51421;Oyes;51;997436;28849;25;767035;26;230401;19558;8876
05002;Agnières-en-Dévoluy;156;3051057;92654;75;2169025;81;882032;19558;8877
52258;Laferté-sur-Aube;207;4048634;156590;93;2780544;114;1268090;19559;8878
02500;Montbrehain;435;8508209;272847;191;5985478;244;2522731;19559;8879
54191;Fenneviller;66;1290918;24498;38;991644;28;299274;19559;8880
61019;Avernes-sous-Exmes;43;841063;54671;21;620248;22;220815;19560;8881
42240;Saint-Jean-Soleymieux;474;9271446;272602;220;6496628;254;2774818;19560;8882
22004;Bégard;2752;53829875;1941902;1320;40578666;1432;13251209;19560;8883
47095;Fauillet;502;9819487;255686;247;7018554;255;2800933;19561;8884
08306;Mont-Laurent;40;782431;20583;17;517788;23;264643;19561;8885
31144;Cierp-Gaud;487;9526133;308597;242;6793263;245;2732870;19561;8886
43163;Riotord;701;13712393;410903;324;9648146;377;4064247;19561;8887
40246;Sabres;681;13321170;478013;315;9682280;366;3638890;19561;8888
61002;Almenêches;387;7570219;200517;186;5632686;201;1937533;19561;8889
21065;Bessey-en-Chaume;73;1427989;24110;37;1068157;36;359832;19561;8890
12055;La Capelle-Bonance;58;1134569;11241;20;780596;38;353973;19562;8891
65054;Avezac-Prat-Lahitte;334;6533611;219394;183;5083882;151;1449729;19562;8892
65470;Viger;75;1467204;30155;40;1099131;35;368073;19563;8893
88259;Landaville;182;3560430;94657;104;2770382;78;790048;19563;8894
58012;Arquian;357;6983938;254615;148;4723700;209;2260238;19563;8895
14165;Colleville-sur-Mer;108;2112887;69560;59;1664761;49;448126;19564;8896
47114;Grézet-Cavagnan;195;3814996;141255;89;2723340;106;1091656;19564;8897
58036;Bouhy;281;5497767;220545;155;4342047;126;1155720;19565;8898
04172;Roumoules;379;7415239;196127;186;5289385;193;2125854;19565;8899
62770;Saint-Venant;1826;35727642;1630471;863;28114359;963;7613283;19566;8900
95277;Gonesse;14005;274032422;11046137;7044;207493186;6961;66539236;19567;8901
52490;Thonnance-lès-Joinville;444;8687833;268471;217;6397404;227;2290429;19567;8902
52528;Ville-en-Blaisois;86;1682781;48770;40;1177012;46;505769;19567;8903
58182;Moulins-Engilbert;946;18511266;808775;423;13679751;523;4831515;19568;8904
24504;Saint-Sulpice-de-Roumagnac;137;2680815;106624;64;1956280;73;724535;19568;8905
71451;Saint-Martin-de-Lixy;57;1115376;64299;28;821679;29;293697;19568;8906
66164;Rivesaltes;4804;94009550;3796656;2212;69744346;2592;24265204;19569;8907
02401;Laigny;114;2230895;84510;56;1671350;58;559545;19569;8908
72294;Saint-Léonard-des-Bois;304;5949246;203983;145;4307391;159;1641855;19570;8909
53052;Champfrémont;176;3444303;84774;88;2594292;88;850011;19570;8910
39176;Cramans;272;5323058;106655;134;3844429;138;1478629;19570;8911
46029;Biars-sur-Cère;1213;23738648;791097;637;17792232;576;5946416;19570;8912
87141;Saint-Cyr;413;8082493;225241;204;5831682;209;2250811;19570;8913
97227;Sainte-Luce;5772;112959726;3913442;2117;77275196;3655;35684530;19570;8914
40141;Lahosse;166;3248707;76435;78;2289207;88;959500;19571;8915
76700;Tôtes;744;14560513;431622;352;10413571;392;4146942;19571;8916
16147;Gardes-le-Pontaroux;141;2759459;52507;66;1871473;75;887986;19571;8917
63247;Murol;352;6888886;243679;178;5072911;174;1815975;19571;8918
08238;Jonval;44;861130;20051;22;606589;22;254541;19571;8919
46332;Viazac;174;3405398;93978;83;2365429;91;1039969;19571;8920
34042;Brissac;328;6419384;153069;159;4715289;169;1704095;19571;8921
62365;Galametz;100;1957151;73311;45;1358818;55;598333;19572;8922
24314;Orliaguet;55;1076434;35602;28;836603;27;239831;19572;8923
2B165;Moncale;171;3346823;170458;69;2418598;102;928225;19572;8924
11170;Gruissan;3427;67076377;2836275;1713;51038215;1714;16038162;19573;8925
14378;Longueville;156;3053428;85840;77;2250297;79;803131;19573;8926
56142;Moustoir-Remungol;367;7183418;138471;169;4782093;198;2401325;19573;8927
64240;Gère-Bélesten;105;2055235;63115;51;1507474;54;547761;19574;8928
56066;Gourin;2403;47036983;1599318;1153;34517220;1250;12519763;19574;8929
32043;Belmont;95;1859603;65187;39;1332803;56;526800;19575;8930
33398;Saint-Exupéry;81;1585569;31977;39;1056668;42;528901;19575;8931
48021;La Bastide-Puylaurent;101;1977096;52368;48;1456479;53;520617;19575;8932
38275;Serre-Nerpol;153;2995104;78189;70;2106431;83;888673;19576;8933
76052;Bailleul-Neuville;97;1898901;36977;43;1231882;54;667019;19576;8934
61271;Le Ménil-Scelleur;58;1135443;10462;26;811021;32;324422;19577;8935
33329;Pompéjac;150;2936496;82870;74;2188823;76;747673;19577;8936
79120;La Ferrière-en-Parthenay;431;8437779;187992;195;5784385;236;2653394;19577;8937
52445;Saint-Broingt-le-Bois;36;704809;19014;16;494088;20;210721;19578;8938
03303;Venas;127;2486454;61184;59;1738299;68;748155;19578;8939
61484;Le Theil;1032;20205700;608946;555;15272791;477;4932909;19579;8940
70231;Ferrières-lès-Ray;25;489485;12968;13;355818;12;133667;19579;8941
52027;Aujeurres;48;939827;10131;22;643406;26;296421;19580;8942
88442;Sapois;341;6676727;141254;171;4677838;170;1998889;19580;8943
88296;Médonville;47;920270;41418;22;652448;25;267822;19580;8944
30202;Pont-Saint-Esprit;6177;120948933;4923421;2889;91405356;3288;29543577;19581;8945
80189;La Chavatte;36;704908;6533;17;495206;19;209702;19581;8946
88186;Frenelle-la-Petite;30;587427;14330;15;423648;15;163779;19581;8947
55109;Chauvency-le-Château;148;2897990;91213;64;1984793;84;913197;19581;8948
10189;Lassicourt;42;822411;32365;23;663093;19;159318;19581;8949
50282;Le Luot;135;2643464;76854;62;1849360;73;794104;19581;8950
64188;Chéraute;590;11553007;302189;283;8137175;307;3415832;19581;8951
60057;Beauvais;32645;639236928;32340037;16408;500522506;16237;138714422;19581;8952
25138;Les Terres-de-Chaux;82;1605693;56390;39;1102648;43;503045;19582;8953
49058;Les Cerqueux;421;8243992;94437;201;5753269;220;2490723;19582;8954
87076;Jabreilles-les-Bordes;151;2956894;115197;75;2223994;76;732900;19582;8955
07348;Vogüé;599;11729697;371334;289;8640018;310;3089679;19582;8956
14547;Rubercy;72;1409937;23142;36;997621;36;412316;19582;8957
19192;Saint-Chamant;302;5914007;172950;144;4283597;158;1630410;19583;8958
15121;Maurines;57;1116244;81692;16;647994;41;468250;19583;8959
36018;Le Blanc;3939;77139044;2975595;1841;56662265;2098;20476779;19583;8960
08006;Alland'Huy-et-Sausseuil;137;2682933;52666;69;1971252;68;711681;19583;8961
59122;Cambrai;19514;382154607;20161486;8846;290191210;10668;91963397;19584;8962
69210;Saint-Jacques-des-Arrêts;58;1135866;20959;29;792799;29;343067;19584;8963
49151;Gesté;1396;27339500;418204;702;19058844;694;8280656;19584;8964
31422;Plagne;53;1037975;26756;28;744890;25;293085;19584;8965
62608;Neuville-Bourjonval;108;2115136;79213;54;1624467;54;490669;19585;8966
14201;Crèvecoeur-en-Auge;261;5111733;255753;99;3613324;162;1498409;19585;8967
71340;Palinges;870;17039554;417270;425;12246163;445;4793391;19586;8968
29256;Saint-Nic;492;9636251;371609;255;7449248;237;2187003;19586;8969
80783;Vaux-Marquenneville;52;1018468;23145;26;744719;26;273749;19586;8970
18046;Chambon;86;1684394;89405;47;1315528;39;368866;19586;8971
65218;Hèches;369;7227236;272784;186;5477103;183;1750133;19586;8972
59148;Clairfayts;171;3349459;96571;78;2535324;93;814135;19587;8973
19180;Saint-Angel;406;7952567;218852;226;6056357;180;1896210;19588;8974
38318;Pont-Évêque;2765;54159798;2213782;1307;39613669;1458;14546129;19588;8975
70078;Bougey;49;959810;24990;28;733949;21;225861;19588;8976
80172;Cappy;311;6092011;189472;157;4524498;154;1567513;19588;8977
44057;Fégréac;1299;25445776;588284;635;18147068;664;7298708;19589;8978
62410;Haplincourt;107;2096072;47595;45;1437758;62;658314;19589;8979
34312;La Tour-sur-Orb;738;14457189;461437;350;10692833;388;3764356;19590;8980
52488;Thivet;166;3251975;84589;97;2472656;69;779319;19590;8981
12161;Mouret;280;5485349;160343;116;3739238;164;1746111;19591;8982
04203;Selonnet;259;5074025;163315;121;3490997;138;1583028;19591;8983
17198;Juicq;142;2781923;68899;64;1981821;78;800102;19591;8984
32417;La Sauvetat;216;4231675;150448;94;2971494;122;1260181;19591;8985
46164;Lavercantière;130;2546844;67924;58;1786871;72;759973;19591;8986
30335;Vabres;56;1097145;29966;21;767819;35;329326;19592;8987
24300;Nabirat;197;3859667;115040;90;2740738;107;1118929;19592;8988
02648;Ribemont;1138;22297146;986447;501;16265469;637;6031677;19593;8989
46235;Reilhac;105;2057298;78020;53;1575693;52;481605;19593;8990
79099;La Coudre;118;2312067;48554;50;1531603;68;780464;19594;8991
08083;Brévilly;211;4134387;205700;94;2804833;117;1329554;19594;8992
64398;Montaner;244;4781383;180626;117;3516945;127;1264438;19596;8993
01330;Ruffieu;99;1940027;94700;38;1370506;61;569521;19596;8994
02378;La Hérie;87;1704894;30336;37;1123019;50;581875;19596;8995
33500;Samonac;253;4957914;102110;118;3397352;135;1560562;19596;8996
53173;La Pallu;99;1940088;57326;45;1242297;54;697791;19597;8997
11052;Brousses-et-Villaret;184;3605937;79271;84;2574540;100;1031397;19597;8998
05176;Valserres;133;2606466;59246;61;1737570;72;868896;19597;8999
55196;Frémeréville-sous-les-Côtes;68;1332643;35024;40;1002097;28;330546;19598;9000
56098;Lanester;12848;251793738;7918734;6636;190612561;6212;61181177;19598;9001
70511;Vaite;114;2234169;52639;63;1647309;51;586860;19598;9002
44103;Montoir-de-Bretagne;3831;75080249;1833808;2133;57414062;1698;17666187;19598;9003
80122;Bouquemaison;277;5428708;114650;137;3888017;140;1540691;19598;9004
05008;Aspremont;187;3665000;141554;92;2772302;95;892698;19599;9005
62076;Bainghen;99;1940341;30636;46;1382878;53;557463;19599;9006
10358;Saint-Parres-lès-Vaudes;657;12877164;633852;336;10317063;321;2560101;19600;9007
59387;Marquette-en-Ostrevant;926;18150165;564356;449;13144348;477;5005817;19601;9008
08133;Coucy;258;5056984;137799;115;3486355;143;1570629;19601;9009
07333;Vanosc;506;9918378;281896;265;7322564;241;2595814;19602;9010
14727;Vaubadon;243;4763323;115144;126;3512112;117;1251211;19602;9011
32375;Saint-Élix-Theux;65;1274166;64369;30;961523;35;312643;19603;9012
54472;Saint-Clément;485;9507330;276867;254;6975716;231;2531614;19603;9013
09022;Arvigna;133;2607297;70872;67;1999100;66;608197;19604;9014
79338;Vanzay;116;2274136;105959;48;1626885;68;647251;19605;9015
62528;Loos-en-Gohelle;3553;69659041;2330752;1682;51351578;1871;18307463;19606;9016
03054;Chapeau;127;2489934;50579;66;1869893;61;620041;19606;9017
60201;Dompierre;140;2744866;71989;69;1981285;71;763581;19606;9018
60051;Beaudéduit;107;2097870;26342;50;1358396;57;739474;19606;9019
56024;Bréhan;1256;24626759;759149;636;18468100;620;6158659;19607;9020
93055;Pantin;31424;616139656;32863035;15437;481480165;15987;134659491;19607;9021
29123;Lennon;442;8666449;222879;225;6336567;217;2329882;19607;9022
61477;Survie;88;1725463;66200;41;1315268;47;410195;19608;9023
30035;Belvézet;141;2764683;164257;66;2176113;75;588570;19608;9024
32280;Mont-d'Astarac;61;1196074;69409;19;827689;42;368385;19608;9025
86252;Sammarçolles;343;6725647;171292;174;4917283;169;1808364;19608;9026
53163;Neau;374;7333637;128815;213;5587883;161;1745754;19609;9027
50646;Le Vrétot;302;5922170;67958;147;4101181;155;1820989;19610;9028
07014;Arlebosc;196;3843546;108414;77;2591242;119;1252304;19610;9029
61325;La Perrière;145;2843561;82279;68;2148801;77;694760;19611;9030
24371;Saint-Aquilin;279;5471508;168740;129;4075546;150;1395962;19611;9031
56207;Saint-Barthélemy;679;13316102;327032;324;9402002;355;3914100;19611;9032
80680;Rosières-en-Santerre;1678;32908712;1266780;776;24362476;902;8546236;19612;9033
54039;Baccarat;2625;51481179;1980089;1251;37809596;1374;13671583;19612;9034
12163;Murasson;118;2314208;142897;44;1638931;74;675277;19612;9035
64473;Sainte-Colome;187;3667461;137320;85;2702280;102;965181;19612;9036
64221;Etcharry;67;1314015;28618;36;958551;31;355464;19612;9037
58177;Montigny-en-Morvan;199;3902842;131145;92;2608120;107;1294722;19612;9038
21615;Sussey;147;2883005;73859;70;2047016;77;835989;19612;9039
07063;Cheminas;180;3530218;84201;81;2451013;99;1079205;19612;9040
79095;Clussais-la-Pommeraie;329;6452590;240679;147;4478292;182;1974298;19613;9041
35290;Saint-Malon-sur-Mel;304;5962315;110550;145;4235832;159;1726483;19613;9042
66014;Baixas;1447;28380005;1107692;702;21302190;745;7077815;19613;9043
54297;Laneuveville-aux-Bois;165;3236159;58486;83;2328588;82;907571;19613;9044
62537;Magnicourt-sur-Canche;55;1078772;19327;25;788162;30;290610;19614;9045
82054;Espalais;222;4354397;105552;107;3109922;115;1244475;19614;9046
07019;Aubenas;7551;148111273;7910437;3420;110413471;4131;37697802;19615;9047
47271;Saint-Pierre-sur-Dropt;149;2922701;52921;67;2011063;82;911638;19615;9048
64190;Claracq;110;2157710;38786;57;1567915;53;589795;19616;9049
32451;Tournan;110;2157717;79538;48;1657675;62;500042;19616;9050
07123;Lachapelle-sous-Chanéac;98;1922401;44534;48;1399080;50;523321;19616;9051
38291;Pajay;586;11495224;248656;283;8216800;303;3278424;19616;9052
50036;Baupte;232;4551092;130215;106;2950945;126;1600147;19617;9053
43257;Vergezac;249;4884641;117953;119;3390813;130;1493828;19617;9054
71151;Créot;39;765079;14242;14;405962;25;359117;19617;9055
22135;Louargat;1316;25816775;703469;632;18461920;684;7354855;19618;9056
57725;Vittersbourg;181;3550840;67253;83;2431564;98;1119276;19618;9057
29302;Pont-de-Buis-lès-Quimerch;2182;42806503;1036914;1130;31287082;1052;11519421;19618;9058
24420;Saint-Géry;129;2530753;131590;48;1866580;81;664173;19618;9059
03256;Saint-Priest-en-Murat;119;2334576;39589;57;1566504;62;768072;19618;9060
55124;Consenvoye;166;3256721;94450;77;2247099;89;1009622;19619;9061
56192;Remungol;519;10182200;269216;244;7076215;275;3105985;19619;9062
21608;Sincey-lès-Rouvray;68;1334118;23044;41;1021760;27;312358;19619;9063
39399;Ounans;200;3923909;128186;89;2819433;111;1104476;19620;9064
56112;Lizio;418;8201082;230521;211;5982648;207;2218434;19620;9065
02663;Rozières-sur-Crise;140;2746801;63231;78;2188696;62;558105;19620;9066
04139;Noyers-sur-Jabron;253;4964115;135762;110;3521494;143;1442621;19621;9067
34069;Cazouls-lès-Béziers;2557;50171905;2025279;1158;36369431;1399;13802474;19621;9068
07217;Saint-Barthélemy-le-Plain;454;8908394;233187;225;6572380;229;2336014;19622;9069
37074;Chouzé-sur-Loire;1165;22860291;812395;553;16872739;612;5987552;19623;9070
57089;Bitche;2768;54315634;1935926;1308;38932433;1460;15383201;19623;9071
11086;Caves;416;8163060;173754;207;6006263;209;2156797;19623;9072
33392;Sainte-Croix-du-Mont;486;9536676;280892;212;6375478;274;3161198;19623;9073
36151;Parpeçay;137;2688360;101545;73;2020174;64;668186;19623;9074
59225;Feignies;3675;72115707;2706914;1669;52365329;2006;19750378;19623;9075
21075;Billy-lès-Chanceaux;39;765314;30232;20;590064;19;175250;19623;9076
86126;Leignes-sur-Fontaine;321;6299163;134613;164;4709861;157;1589302;19624;9077
54416;Pannes;97;1903506;40169;48;1356012;49;547494;19624;9078
17187;Guitinières;256;5023804;136961;133;3759608;123;1264196;19624;9079
12244;Saint-Rome-de-Tarn;443;8693550;228172;212;6223072;231;2470478;19624;9080
81037;Brassac;808;15857012;503696;356;11075899;452;4781113;19625;9081
07315;La Souche;222;4357171;163103;106;3182855;116;1174316;19627;9082
70311;Luxeuil-les-Bains;4324;84868269;3983859;2022;63927294;2302;20940975;19627;9083
12213;Saint-Beauzély;297;5829296;136163;145;4247621;152;1581675;19627;9084
88255;Jubainville;45;883236;21236;19;612271;26;270965;19627;9085
04234;Venterol;132;2590833;119398;56;1884891;76;705942;19628;9086
15150;Pers;162;3179704;115881;74;2294999;88;884705;19628;9087
79294;Saint-Romans-des-Champs;95;1864647;28752;49;1440231;46;424416;19628;9088
70502;Tincey-et-Pontrebeau;51;1001045;29866;23;722557;28;278488;19628;9089
40121;Hauriet;131;2571332;53992;62;1908220;69;663112;19628;9090
85110;L'Hermenault;523;10265883;414025;224;7097405;299;3168478;19629;9091
07107;Jaujac;704;13818828;471188;320;9629639;384;4189189;19629;9092
82171;Saint-Porquier;699;13720748;361190;316;9665765;383;4054983;19629;9093
17080;Chambon;518;10167974;255316;255;7641525;263;2526449;19629;9094
27028;Authou;185;3631426;95878;96;2745805;89;885621;19629;9095
36088;Issoudun;7642;150007977;6482268;3857;113631813;3785;36376164;19629;9096
80574;Mouflers;51;1001124;28184;24;662941;27;338183;19630;9097
14285;Le Fournet;33;647787;15194;22;550083;11;97704;19630;9098
08013;Angecourt;216;4240064;86266;113;3143890;103;1096174;19630;9099
50030;Barfleur;435;8539031;376215;169;5811490;266;2727541;19630;9100
07118;Laboule;81;1590066;58351;39;1182980;42;407086;19630;9101
05158;Le Saix;69;1354606;38866;31;978125;38;376481;19632;9102
62487;Landrethun-le-Nord;601;11799059;239279;270;8146556;331;3652503;19632;9103
88209;Golbey;4908;96355845;3775123;2620;74300692;2288;22055153;19632;9104
24062;Bouteilles-Saint-Sébastien;97;1904352;23139;30;851551;67;1052801;19632;9105
69093;Grandris;678;13311503;395793;335;9585796;343;3725707;19633;9106
2B034;Belgodère;264;5183385;231465;122;3874163;142;1309222;19634;9107
22114;Lanrelas;462;9071197;303827;223;6739581;239;2331616;19635;9108
24516;Salignac-Eyvigues;690;13547943;539896;315;9682768;375;3865175;19635;9109
57651;Siersthal;382;7500539;173498;178;5405307;204;2095232;19635;9110
79118;Fénery;157;3082689;50047;78;2175981;79;906708;19635;9111
65395;Saint-Pé-de-Bigorre;713;13999792;509744;333;10106756;380;3893036;19635;9112
34221;Puéchabon;257;5046370;181290;113;3697687;144;1348683;19636;9113
11132;Fabrezan;704;13823982;706430;294;9758409;410;4065573;19636;9114
80786;Velennes;81;1590558;47100;44;1160470;37;430088;19637;9115
21346;Leuglay;211;4143372;142932;87;2672711;124;1470661;19637;9116
11067;Canet;866;17005503;591623;424;12655681;442;4349822;19637;9117
29071;Guilligomarc'h;395;7756554;193380;191;5688690;204;2067864;19637;9118
88180;Frain;69;1354945;21176;32;917712;37;437233;19637;9119
65028;Arné;122;2395708;115526;55;1893535;67;502173;19637;9120
22271;Saint-Adrien;195;3829287;112692;103;2843203;92;986084;19637;9121
03092;Cressanges;367;7206964;158103;191;5345212;176;1861752;19638;9122
62879;Warluzel;124;2435229;34254;61;1727474;63;707755;19639;9123
34339;Villespassans;86;1688977;47998;42;1237104;44;451873;19639;9124
23258;Vareilles;175;3436888;132072;79;2511775;96;925113;19639;9125
37255;Tavant;159;3122728;97373;86;2298734;73;823994;19640;9126
73117;Fourneaux;428;8406457;271664;246;6412264;182;1994193;19641;9127
54274;Jarville-la-Malgrange;5440;106848768;4726355;2750;82963526;2690;23885242;19641;9128
24048;Bonneville-et-Saint-Avit-de-Fumadières;158;3103488;79675;73;2150154;85;953334;19642;9129
73290;Termignon;269;5283801;190836;153;3986182;116;1297619;19642;9130
26357;Tulette;1129;22177260;797956;506;15753170;623;6424090;19643;9131
56135;Molac;783;15381733;288413;398;11204366;385;4177367;19645;9132
66070;Espira-de-Conflent;100;1964491;65701;38;1298538;62;665953;19645;9133
24346;Quinsac;218;4282622;151699;94;2982683;124;1299939;19645;9134
45323;Thou;137;2691381;100273;65;1944391;72;746990;19645;9135
30065;Canaules-et-Argentières;195;3830865;120915;81;2663809;114;1167056;19645;9136
26264;Rémuzat;192;3772070;150185;87;2647904;105;1124166;19646;9137
14345;Jort;166;3261297;109439;83;2409002;83;852295;19646;9138
80802;Villers-Faucon;357;7013834;213145;175;5078230;182;1935604;19647;9139
80551;Misery;72;1414576;25420;34;1017789;38;396787;19647;9140
47224;Romestaing;94;1846843;47828;44;1250852;50;595991;19647;9141
49150;Genneteil;187;3674052;136662;78;2586572;109;1087480;19647;9142
62868;Wail;137;2691732;58185;61;1741029;76;950703;19648;9143
88192;Gelvécourt-et-Adompt;59;1159229;29390;34;882519;25;276710;19648;9144
81080;Donnazac;39;766298;16940;14;479861;25;286437;19649;9145
08034;Autrecourt-et-Pourron;203;3988785;86655;104;2880527;99;1108258;19649;9146
18108;La Guerche-sur-l'Aubois;2024;39771204;1423161;1023;29677468;1001;10093736;19650;9147
46182;Luzech;1028;20200408;705356;461;14615510;567;5584898;19650;9148
76374;Incheville;740;14541756;626957;381;11235466;359;3306290;19651;9149
57393;Lengelsheim;112;2200957;49950;45;1397127;67;803830;19651;9150
47250;Saint-Léger;86;1690048;63823;38;1170125;48;519923;19652;9151
62422;Hébuterne;274;5384654;138267;121;3698322;153;1686332;19652;9152
79260;Saint-Jouin-de-Marnes;322;6327968;128839;164;4437419;158;1890549;19652;9153
29027;Châteauneuf-du-Faou;2158;42409308;1383582;1058;31361107;1100;11048201;19652;9154
63195;Lezoux;3336;65562775;2418979;1598;48892027;1738;16670748;19653;9155
24079;Cantillac;108;2122590;45668;54;1520049;54;602541;19654;9156
62169;Bouvelinghem;110;2161907;21309;58;1593025;52;568882;19654;9157
41096;Le Gault-Perche;178;3498397;117680;87;2561460;91;936937;19654;9158
88356;Les Poulières;126;2476499;49602;72;1850337;54;626162;19655;9159
53110;Grez-en-Bouère;521;10240339;233887;253;7342206;268;2898133;19655;9160
62663;Pommera;167;3282447;74331;72;2189596;95;1092851;19655;9161
47276;Saint-Sardos;175;3439821;141133;68;2433354;107;1006467;19656;9162
72104;Courgains;314;6172080;164890;154;4383860;160;1788220;19656;9163
84069;Malaucène;1648;32393685;1249338;782;23747817;866;8645868;19656;9164
56102;Lanouée;922;18123802;398081;475;13331041;447;4792761;19657;9165
85205;Saint-Cyr-des-Gâts;268;5268321;88864;121;3577160;147;1691161;19658;9166
50551;Saint-Sauveur-le-Vicomte;1257;24710190;599008;532;16911948;725;7798242;19658;9167
29230;Querrien;1005;19756613;633391;467;14104138;538;5652475;19658;9168
76384;Lillebonne;5299;104170222;4277167;2557;76632116;2742;27538106;19658;9169
61461;Le Sap-André;73;1435096;51642;33;1029059;40;406037;19659;9170
24198;La Gonterie-Boulouneix;139;2732592;75389;66;1921111;73;811481;19659;9171
22068;Grâce-Uzel;217;4266143;94901;109;3115346;108;1150797;19660;9172
22295;Saint-Gilles-Vieux-Marché;183;3597777;114256;82;2501304;101;1096473;19660;9173
11216;Malviès;222;4364555;120544;107;3208961;115;1155594;19660;9174
05056;Forest-Saint-Julien;153;3008032;110240;79;2300543;74;707489;19660;9175
64168;Carresse-Cassaber;338;6645440;224594;157;4661149;181;1984291;19661;9176
12191;Privezac;199;3912559;108067;97;2822763;102;1089796;19661;9177
11010;Antugnac;170;3342487;96682;84;2537225;86;805262;19662;9178
21344;Lechâtelet;134;2634678;73346;68;1899033;66;735645;19662;9179
58175;Mont-et-Marré;111;2182490;70749;53;1518862;58;663628;19662;9180
70305;Loeuilley;56;1101092;26224;26;711600;30;389492;19662;9181
29111;Lanhouarneau;621;12210427;192254;294;8681271;327;3529156;19663;9182
09094;Cérizols;93;1828643;68303;36;1243336;57;585307;19663;9183
35018;La Bazouge-du-Désert;584;11483692;283448;281;8115718;303;3367974;19664;9184
11410;Villalier;548;10775866;287622;254;7670205;294;3105661;19664;9185
36235;Veuil;209;4109799;125644;97;2751592;112;1358207;19664;9186
2B033;Bastia;22057;433742643;26208478;10041;338039661;12016;95702982;19665;9187
66210;Thuir;4264;83850707;3285374;2043;63197710;2221;20652997;19665;9188
18221;Saint-Loup-des-Chaumes;173;3402057;79604;89;2466942;84;935115;19665;9189
66075;Eyne;75;1474899;80189;33;1053761;42;421138;19665;9190
87058;Domps;80;1573279;88026;33;1177093;47;396186;19666;9191
44113;Nozay;2104;41377395;1061541;983;29921603;1121;11455792;19666;9192
43114;Lapte;888;17463662;377341;430;12333935;458;5129727;19666;9193
19023;Beynat;774;15221819;532965;370;11068694;404;4153125;19666;9194
80148;Buigny-lès-Gamaches;231;4542958;127368;111;3260053;120;1282905;19666;9195
85303;Vix;994;19548760;613590;449;13627223;545;5921537;19667;9196
19235;Saint-Paul;139;2733710;87963;73;1999330;66;734380;19667;9197
03072;Chazemais;260;5113428;129790;128;3654070;132;1459358;19667;9198
63136;Domaize;217;4267753;143831;97;3006759;120;1260994;19667;9199
80345;Franleu;284;5585498;125507;134;3926853;150;1658645;19667;9200
30327;Tharaux;34;668692;37282;14;477061;20;191631;19667;9201
31138;Charlas;138;2714107;95727;67;1985760;71;728347;19667;9202
84019;Bollène;8017;157675066;6211753;3771;116743365;4246;40931701;19668;9203
49056;Carbay;119;2340500;40654;63;1695223;56;645277;19668;9204
59178;Douai;24203;476026772;26449250;10791;366060320;13412;109966452;19668;9205
01121;Corlier;63;1239187;42789;32;898327;31;340860;19670;9206
02136;Burelles;79;1553931;71492;37;1137964;42;415967;19670;9207
69060;Claveisolles;356;7002591;179912;173;5056646;183;1945945;19670;9208
56086;Île-d'Houat;161;3166939;145055;71;2153033;90;1013906;19670;9209
32074;Cannet;28;550778;19326;14;399288;14;151490;19671;9210
53263;Thuboeuf;157;3088332;69781;84;2249288;73;839044;19671;9211
34119;Hérépian;887;17448749;695945;434;12961424;453;4487325;19672;9212
59333;Larouillies;143;2813067;61534;67;1987366;76;825701;19672;9213
80464;Lanchères;516;10150651;277344;261;7362311;255;2788340;19672;9214
24036;Berbiguières;101;1986913;57015;46;1510740;55;476173;19672;9215
70226;Fallon;167;3285320;91734;85;2375237;82;910083;19673;9216
55534;Vaudeville-le-Haut;26;511497;2613;11;324484;15;187013;19673;9217
03049;Cesset;212;4170711;98087;113;3121517;99;1049194;19673;9218
08315;Neufmaison;32;629544;11367;12;385417;20;244127;19673;9219
39109;Charézier;91;1790323;51514;49;1348343;42;441980;19674;9220
69104;Jullié;227;4466027;82129;123;3303184;104;1162843;19674;9221
34101;Florensac;2818;55444084;1932673;1329;40623192;1489;14820892;19675;9222
62292;Elnes;458;9011168;325664;220;6278966;238;2732202;19675;9223
53151;Méral;525;10329580;146590;237;6856154;288;3473426;19675;9224
15236;Thiézac;381;7496346;226168;180;5363001;201;2133345;19675;9225
65031;Arreau;497;9778710;373770;232;7146601;265;2632109;19675;9226
35328;Sixt-sur-Aff;1194;23492784;580502;621;17226837;573;6265947;19676;9227
79246;Sainte-Eanne;344;6768518;163065;184;4987935;160;1780583;19676;9228
32112;Crastes;131;2577584;89691;57;1756328;74;821256;19676;9229
55215;Gondrecourt-le-Château;689;13557379;496689;305;9735065;384;3822314;19677;9230
33218;Lagorce;897;17650421;496559;429;12854503;468;4795918;19677;9231
88228;Haillainville;95;1869341;44777;44;1350989;51;518352;19677;9232
33466;Saint-Quentin-de-Baron;1160;22825871;663879;621;17135158;539;5690713;19677;9233
65472;Villefranque;55;1082311;41713;20;702605;35;379706;19678;9234
24543;Sourzac;667;13125576;359447;345;10002282;322;3123294;19679;9235
09054;Betchat;202;3975065;189402;90;2991698;112;983367;19679;9236
65044;Aubarède;148;2912453;52790;70;2057204;78;855249;19679;9237
40307;Sore;611;12023845;440618;263;8561136;348;3462709;19679;9238
26281;Romans-sur-Isère;19904;391705605;16863324;9397;292397202;10507;99308403;19680;9239
59383;Marly;6342;124810031;4854747;2984;92803528;3358;32006503;19680;9240
38560;Virieu;572;11256997;302520;253;7622053;319;3634944;19680;9241
46267;Saint-Germain-du-Bel-Air;336;6612594;269710;155;4909436;181;1703158;19680;9242
39420;Pimorin;96;1889337;42453;53;1389900;43;499437;19681;9243
35010;Baguer-Pican;733;14425965;235188;369;10329047;364;4096918;19681;9244
44196;Sévérac;867;17063262;394815;446;12360631;421;4702631;19681;9245
59661;Willies;92;1810637;94243;51;1479517;41;331120;19681;9246
29033;Le Cloître-Pleyben;305;6002686;228168;140;4265030;165;1737656;19681;9247
24311;Nontron;2017;39696642;1688120;959;29009882;1058;10686760;19681;9248
30316;Sénéchas;138;2716096;83434;71;2086200;67;629896;19682;9249
02565;OEuilly;166;3267222;86533;88;2485458;78;781764;19682;9250
29184;Plouénan;1435;28244026;835152;695;20297286;740;7946740;19682;9251
56127;Mauron;1939;38165105;1435942;931;27817211;1008;10347894;19683;9252
71218;Gibles;365;7184341;195198;161;4877761;204;2306580;19683;9253
52395;Poinson-lès-Grancey;29;570824;12857;15;416745;14;154079;19684;9254
67426;Saint-Martin;217;4271385;149963;109;3038772;108;1232613;19684;9255
84129;Sorgues;10350;203727691;7891150;5000;152688369;5350;51039322;19684;9256
22243;Plusquellec;308;6062659;181513;131;4293197;177;1769462;19684;9257
40077;Cauneille;451;8877642;379064;213;7091312;238;1786330;19684;9258
88161;Escles;217;4271518;51594;99;2856809;118;1414709;19684;9259
14127;Campagnolles;242;4763709;50021;138;3594164;104;1169545;19685;9260
55378;Nettancourt;152;2992131;139227;70;2154665;82;837466;19685;9261
51531;Sermaize-les-Bains;1199;23602422;808842;582;16948404;617;6654018;19685;9262
30208;Puechredon;28;551184;22587;17;418109;11;133075;19685;9263
86274;Les Trois-Moutiers;596;11732463;452931;273;8404953;323;3327510;19685;9264
44051;Derval;1730;34055918;823326;810;23778016;920;10277902;19686;9265
30179;Montfrin;1761;34666680;1529386;786;25569808;975;9096872;19686;9266
24037;Bergerac;17561;345709365;17162485;8062;258399971;9499;87309394;19686;9267
05179;Veynes;1956;38507306;1298823;908;27327331;1048;11179975;19687;9268
02439;Longueval-Barbonval;271;5335134;162871;127;3910377;144;1424757;19687;9269
33167;Floirac;9049;178151570;6486881;4590;136375648;4459;41775922;19687;9270
40224;Peyrehorade;2062;40595973;1425435;951;29668869;1111;10927104;19688;9271
40173;Marpaps;86;1693167;93945;36;1190029;50;503138;19688;9272
24089;Cazoulès;283;5571734;193522;133;3973101;150;1598633;19688;9273
17342;Saint-Germain-du-Seudre;221;4351164;146774;114;3326345;107;1024819;19689;9274
57286;Halstroff;158;3110909;72769;58;1831681;100;1279228;19689;9275
81021;Aussillon;3465;68224475;2555834;1478;47645941;1987;20578534;19690;9276
55357;Morgemoulin;51;1004200;4517;19;618030;32;386170;19690;9277
61377;Saint-Cornier-des-Landes;355;6990122;187270;182;5175290;173;1814832;19690;9278
11335;Sainte-Colombe-sur-Guette;29;571034;27635;15;443500;14;127534;19691;9279
70146;Chaux-lès-Port;87;1713126;50221;55;1370519;32;342607;19691;9280
64318;Larreule;88;1732834;20184;42;1172557;46;560277;19691;9281
39492;Saint-Maur;126;2481130;92633;65;2043173;61;437957;19692;9282
44202;Teillé;909;17899768;272070;447;12592002;462;5307766;19692;9283
50523;Sainte-Mère-Église;961;18924055;785720;421;13401846;540;5522209;19692;9284
59223;Le Favril;243;4785202;75991;111;3389225;132;1395977;19692;9285
36016;Bélâbre;604;11894187;408171;286;8508083;318;3386104;19692;9286
65377;Réjaumont;113;2225244;48905;47;1459768;66;765476;19692;9287
57374;Lafrimbolle;116;2284439;72757;63;1743821;53;540618;19693;9288
53116;Le Horps;407;8015297;123364;201;5736525;206;2278772;19694;9289
47043;Buzet-sur-Baïse;761;14986869;655518;342;10728323;419;4258546;19694;9290
24457;Saint-Martin-l'Astier;86;1693678;79982;39;1278516;47;415162;19694;9291
33045;Belvès-de-Castillon;178;3505526;96171;83;2575112;95;930414;19694;9292
11269;Ouveillan;1262;24853889;898143;570;17745691;692;7108198;19694;9293
23263;Villard;215;4234305;168111;99;3077003;116;1157302;19694;9294
62295;Enquin-les-Mines;538;10595805;310190;243;7402120;295;3193685;19695;9295
67508;Voellerdingen;227;4470787;92918;109;3135009;118;1335778;19695;9296
24276;Monestier;219;4313268;135087;94;3019724;125;1293544;19695;9297
56171;Pluherlin;806;15874900;360548;394;11020043;412;4854857;19696;9298
80587;Neslette;52;1024195;39785;28;843875;24;180320;19696;9299
33089;Campugnan;256;5042199;159331;119;3760231;137;1281968;19696;9300
87142;Saint-Denis-des-Murs;314;6184621;193741;147;4466553;167;1718068;19696;9301
16261;Les Pins;268;5278595;118402;129;3814563;139;1464032;19696;9302
46074;Condat;204;4018100;105584;95;2949399;109;1068701;19697;9303
46337;Mayrac;145;2856008;79177;69;2086790;76;769218;19697;9304
40285;Saint-Yaguen;316;6224331;116850;152;4436459;164;1787872;19697;9305
19099;Lagleygeolle;119;2343983;47568;56;1708289;63;635694;19697;9306
2B112;Feliceto;117;2304606;123334;43;1521787;74;782819;19697;9307
37277;Villeloin-Coulangé;387;7622932;250607;148;5426015;239;2196917;19697;9308
37275;Villedômain;74;1457620;59436;35;1076398;39;381222;19698;9309
49180;Longué-Jumelles;3876;76349448;2239811;1815;54765773;2061;21583675;19698;9310
57012;Algrange;3557;70065874;1645294;1289;38384711;2268;31681163;19698;9311
81103;Gijounet;71;1398585;39718;33;996511;38;402074;19698;9312
70525;Vauconcourt-Nervezain;118;2324432;65829;53;1545519;65;778913;19699;9313
02366;Hannapes;160;3151813;99438;86;2344384;74;807429;19699;9314
12060;Castelmary;71;1398635;36744;26;893929;45;504706;19699;9315
62269;Diéval;410;8076767;248103;198;5863508;212;2213259;19699;9316
40219;Payros-Cazautets;54;1063775;28157;27;813431;27;250344;19700;9317
50146;Courtils;127;2501850;73815;62;1801904;65;699946;19700;9318
69174;Les Sauvages;393;7742131;281582;175;5814852;218;1927279;19700;9319
19143;Montaignac-Saint-Hippolyte;327;6442153;189759;171;4730213;156;1711940;19701;9320
39068;Les Bouchoux;193;3802292;132683;90;2721949;103;1080343;19701;9321
09183;Mauvezin-de-Prat;56;1103278;41741;28;812086;28;291192;19701;9322
64032;Araujuzon;97;1911071;40059;41;1138696;56;772375;19702;9323
76671;Sept-Meules;83;1635255;58892;31;1040532;52;594723;19702;9324
82170;Saint-Paul-d'Espis;306;6028777;196305;134;4214897;172;1813880;19702;9325
43194;Saint-Hostien;388;7644406;182846;197;5827573;191;1816833;19702;9326
49173;Lasse;150;2955360;104465;63;2025197;87;930163;19702;9327
49073;La Chapelle-Hullin;66;1300406;16885;34;994734;32;305672;19703;9328
09185;Mazères;2055;40491369;1474995;956;29488777;1099;11002592;19704;9329
86050;Chalandray;403;7941336;175771;187;5634079;216;2307257;19706;9330
05007;Arvieux;235;4630954;178308;114;3406901;121;1224053;19706;9331
50608;Troisgots;177;3488015;63039;99;2558587;78;929428;19706;9332
86091;Curzay-sur-Vonne;252;4966096;211854;120;3635090;132;1331006;19707;9333
47157;Marmande;10716;211179061;10266577;4920;157627841;5796;53551220;19707;9334
39465;Romange;116;2286071;53949;58;1659005;58;627066;19708;9335
31139;Chaum;110;2167845;60664;55;1491500;55;676345;19708;9336
81040;Brousse;207;4079509;83637;89;2730130;118;1349379;19708;9337
07294;Saint-Sauveur-de-Cruzières;282;5557596;223991;137;4237934;145;1319662;19708;9338
89362;Saint-Moré;115;2266426;83537;56;1673041;59;593385;19708;9339
03078;Chouvigny;160;3153345;136794;69;2231001;91;922344;19708;9340
88055;Bettegney-Saint-Brice;71;1399306;19099;31;960113;40;439193;19709;9341
26108;Crest;4908;96732733;4105116;2220;70686505;2688;26046228;19709;9342
29024;Carhaix-Plouguer;4592;90506262;3973096;2205;67811731;2387;22694531;19710;9343
37200;Rivarennes;510;10052179;213336;263;7277562;247;2774617;19710;9344
85049;Champagné-les-Marais;983;19375169;567715;482;14100108;501;5275061;19710;9345
72374;Villaines-la-Carelle;102;2010515;69868;56;1588570;46;421945;19711;9346
63004;Les Ancizes-Comps;984;19396263;607824;531;14570541;453;4825722;19712;9347
31482;Saint-Frajou;122;2404946;79049;49;1646207;73;758739;19713;9348
47182;Montastruc;140;2759832;103164;54;1863696;86;896136;19713;9349
38561;Viriville;863;17012478;482812;419;12235353;444;4777125;19713;9350
41214;Saint-Hilaire-la-Gravelle;405;7984034;216974;230;6143915;175;1840119;19714;9351
67013;Asswiller;152;2996485;68939;75;2122484;77;874001;19714;9352
65482;Cantaous;280;5519857;209546;143;4212763;137;1307094;19714;9353
55389;Nubécourt;148;2917794;110164;67;2129070;81;788724;19715;9354
39154;Clairvaux-les-Lacs;829;16343662;578549;405;11834213;424;4509449;19715;9355
32446;Tillac;154;3036171;104733;69;2169207;85;866964;19715;9356
07007;Alboussière;540;10646481;339480;233;7386351;307;3260130;19716;9357
22184;Plémy;895;17645648;511285;442;12891886;453;4753762;19716;9358
81174;Montdragon;336;6624603;279202;154;4893829;182;1730774;19716;9359
12279;La Terrisse;86;1695608;125491;32;1247078;54;448530;19716;9360
81048;Cagnac-les-Mines;1383;27268033;849466;710;20450071;673;6817962;19717;9361
2A326;Tolla;67;1321061;129263;38;1105887;29;215174;19717;9362
49157;Le Guédeniau;187;3687202;83784;97;2752359;90;934843;19718;9363
70537;Velleminfroy;150;2957696;66443;74;2112523;76;845173;19718;9364
21493;Poncey-lès-Athée;308;6073293;152539;168;4566533;140;1506760;19718;9365
70526;Vauvillers;411;8104402;338874;192;5928811;219;2175591;19719;9366
79286;Saint-Paul-en-Gâtine;242;4771995;91914;104;3177435;138;1594560;19719;9367
55002;Abaucourt-Hautecourt;57;1123999;28089;22;704842;35;419157;19719;9368
22045;Cohiniac;231;4555212;95842;129;3449894;102;1105318;19720;9369
54399;Neuviller-sur-Moselle;128;2524145;74581;73;1965440;55;558705;19720;9370
49181;Louerre;241;4752534;89554;104;3244428;137;1508106;19720;9371
27016;Les Andelys;4782;94302414;3975199;2394;71338595;2388;22963819;19720;9372
30168;Mialet;368;7257230;256108;164;5055916;204;2201314;19721;9373
39312;Marigna-sur-Valouse;67;1321324;34176;35;961962;32;359362;19721;9374
63458;Villeneuve;91;1794663;43376;51;1448475;40;346188;19722;9375
09217;Niaux;116;2287714;60959;61;1634616;55;653098;19722;9376
58239;Saint-Firmin;85;1676403;35567;39;1145372;46;531031;19722;9377
88088;La Chapelle-aux-Bois;385;7593248;278320;177;5420446;208;2172802;19723;9378
11017;Artigues;49;966469;15046;22;616356;27;350113;19724;9379
47107;Galapian;169;3333367;93581;77;2429048;92;904319;19724;9380
48080;Langogne;1794;35385251;1629247;800;25917266;994;9467985;19724;9381
31085;Boutx;175;3451788;223020;70;2496015;105;955773;19725;9382
32398;Saint-Mont;186;3668783;198932;83;2796025;103;872758;19725;9383
24558;Trémolat;325;6410513;264068;149;4659963;176;1750550;19725;9384
79239;Saint-Aubin-le-Cloud;968;19093631;505663;476;14048764;492;5044867;19725;9385
70077;Borey;139;2741757;68709;66;1983512;73;758245;19725;9386
40074;Castel-Sarrazin;262;5167961;89809;114;3434050;148;1733911;19725;9387
71178;Dompierre-les-Ormes;482;9507514;219465;222;6452240;260;3055274;19725;9388
70567;Villers-sur-Saulnot;76;1499125;27077;35;994336;41;504789;19725;9389
30146;Lédignan;797;15721508;564003;323;10709522;474;5011986;19726;9390
80241;Domart-en-Ponthieu;632;12466769;350953;299;9041411;333;3425358;19726;9391
2B261;Rogliano;318;6272857;352361;159;4935588;159;1337269;19726;9392
10117;Crespy-le-Neuf;82;1617534;36539;39;1149582;43;467952;19726;9393
11089;Cenne-Monestiés;205;4043869;85654;102;3004345;103;1039524;19726;9394
07133;Larnas;92;1814832;28323;52;1467723;40;347109;19726;9395
33468;Sainte-Radegonde;253;4990788;173542;131;3818040;122;1172748;19726;9396
24106;La Chapelle-Aubareil;258;5089438;149641;115;3487441;143;1601997;19727;9397
25270;Gevresin;59;1163869;18755;31;852216;28;311653;19727;9398
14113;Burcy;202;3985010;83465;106;2863127;96;1121883;19728;9399
50553;Saint-Senier-de-Beuvron;179;3531279;75833;79;2350625;100;1180654;19728;9400
21687;Villargoix;101;1992515;71329;48;1402624;53;589891;19728;9401
50441;Rouxeville;164;3235422;51880;93;2456530;71;778892;19728;9402
02801;Vigneux-Hocquet;164;3235522;134013;75;2347515;89;888007;19729;9403
36180;Saint-Août;511;10081598;345165;254;7387561;257;2694037;19729;9404
88289;Martigny-les-Bains;479;9450308;322401;233;6841905;246;2608403;19729;9405
03120;Garnat-sur-Engièvre;396;7812905;258643;205;5777448;191;2035457;19730;9406
17422;Seigné;54;1065412;57203;26;785778;28;279634;19730;9407
62834;Vacqueriette-Erquières;139;2742450;119289;60;1947625;79;794825;19730;9408
32086;Castex;54;1065424;43102;25;823881;29;241543;19730;9409
54349;Manonviller;106;2091451;39332;53;1535509;53;555942;19731;9410
50384;Octeville-l'Avenel;102;2012595;65365;41;1337490;61;675105;19731;9411
08015;Antheny;64;1262809;57120;34;953800;30;309009;19731;9412
52306;Manois;240;4735575;146329;123;3545326;117;1190249;19732;9413
19089;Gros-Chastang;100;1973183;93475;39;1370374;61;602809;19732;9414
04045;Céreste;721;14226933;598405;334;10547653;387;3679280;19732;9415
89397;Sommecaise;220;4341109;161744;121;3389920;99;951189;19732;9416
86096;Doussay;362;7143158;241431;171;5191571;191;1951587;19732;9417
31042;Bagnères-de-Luchon;1785;35222575;1572467;886;26347771;899;8874804;19733;9418
11416;Villarzel-Cabardès;110;2170582;41875;51;1551392;59;619190;19733;9419
88440;Sandaucourt;113;2229782;62549;54;1635972;59;593810;19733;9420
56144;Naizin;974;19219726;521992;492;14322402;482;4897324;19733;9421
62220;Cavron-Saint-Martin;240;4735927;120909;119;3484285;121;1251642;19733;9422
07031;Berrias-et-Casteljau;418;8248716;333936;184;5988886;234;2259830;19734;9423
08415;Sery;198;3907362;135283;93;2860149;105;1047213;19734;9424
80022;Andainville;131;2585220;77651;59;1889012;72;696208;19735;9425
58186;Murlin;48;947266;29403;26;725464;22;221802;19735;9426
50601;Torigni-sur-Vire;1410;27825948;1011223;668;20360899;742;7465049;19735;9427
22366;Trémel;245;4835052;152494;110;3364416;135;1470636;19735;9428
71472;Saint-Prix;121;2387981;86426;57;1740380;64;647601;19735;9429
24487;Saint-Pierre-d'Eyraud;904;17841126;520841;444;13088298;460;4752828;19736;9430
14043;Barou-en-Auge;48;947347;21071;25;687159;23;260188;19736;9431
60131;Catheux;67;1322343;31381;37;972786;30;349557;19736;9432
18018;Avord;1339;26427522;789410;783;20406489;556;6021033;19737;9433
52242;Haute-Amance;559;11032916;315618;276;8083338;283;2949578;19737;9434
08175;Foisches;126;2486847;57180;62;1762577;64;724270;19737;9435
37282;Yzeures-sur-Creuse;862;17013340;526738;389;12025795;473;4987545;19737;9436
55351;Montmédy;1176;23211160;1029203;522;17179454;654;6031706;19737;9437
27629;Thiberville;1077;21258433;785761;509;15421685;568;5836748;19739;9438
87180;Saint-Sornin-Leulac;346;6829651;253923;164;5064645;182;1765006;19739;9439
70143;Chauvirey-le-Châtel;66;1302787;34375;29;911054;37;391733;19739;9440
79316;Soudan;231;4559775;81982;128;3476220;103;1083555;19739;9441
24283;Monsec;105;2072637;78465;48;1440555;57;632082;19739;9442
70026;Arc-lès-Gray;1520;30004501;1012768;743;21831759;777;8172742;19740;9443
87131;Saillat-sur-Vienne;504;9948884;284047;254;7119819;250;2829065;19740;9444
64295;Labeyrie;62;1223878;48591;26;845693;36;378185;19740;9445
85251;Saint-Maurice-des-Noues;367;7244794;189159;166;5098716;201;2146078;19741;9446
02604;Pithon;46;908091;21217;24;609936;22;298155;19741;9447
37132;Loches;4074;80426815;3740749;1832;59492278;2242;20934537;19741;9448
69238;Saint-Symphorien-sur-Coise;2003;39542345;1066852;995;28185773;1008;11356572;19742;9449
21082;Blancey;36;710724;20562;19;544966;17;165758;19742;9450
84044;Entrechaux;615;12142009;411551;292;8920527;323;3221482;19743;9451
17265;Nieulle-sur-Seudre;621;12260593;316915;272;8323708;349;3936885;19743;9452
85029;Bouin;1296;25587755;871750;595;18401258;701;7186497;19744;9453
19276;Uzerche;1617;31925994;1571031;783;23918209;834;8007785;19744;9454
45245;Ouzouer-sur-Trézée;721;14235709;599020;351;10453927;370;3781782;19744;9455
02618;Prémont;384;7581898;232602;181;5486757;203;2095141;19745;9456
24119;Cherval;162;3198625;96313;73;2260042;89;938583;19745;9457
54480;Saint-Martin;38;750295;22689;17;553884;21;196411;19745;9458
06003;Andon;318;6278851;159662;138;4377974;180;1900877;19745;9459
80150;Buire-Courcelles;134;2645988;79368;64;1942575;70;703413;19746;9460
23214;Saint-Martial-le-Mont;145;2863222;120920;72;2199132;73;664090;19746;9461
65147;Cieutat;328;6476920;163003;170;4923686;158;1553234;19747;9462
30026;Avèze;649;12815854;428030;318;9714481;331;3101373;19747;9463
53064;Châtillon-sur-Colmont;545;10762471;277212;252;7412993;293;3349478;19748;9464
62846;Vermelles;2307;45563024;1387613;1077;32372100;1230;13190924;19750;9465
42029;Bussières;869;17162982;430076;393;12098598;476;5064384;19750;9466
71071;Céron;165;3258796;151372;61;2101080;104;1157716;19750;9467
05058;Freissinières;118;2330608;92211;57;1694274;61;636334;19751;9468
65036;Artalens-Souin;68;1343067;28393;32;935270;36;407797;19751;9469
24526;Savignac-Lédrier;399;7880772;246665;183;5692562;216;2188210;19751;9470
06151;Utelle;466;9204170;289123;247;7023811;219;2180359;19751;9471
08398;Sainte-Vaubourg;51;1007325;30027;23;707069;28;300256;19751;9472
52039;Baudrecourt;56;1106107;49077;26;787447;30;318660;19752;9473
23025;Bonnat;819;16177013;667146;358;11392883;461;4784130;19752;9474
12111;Goutrens;269;5313330;158757;129;3867975;140;1445355;19752;9475
41143;Mondoubleau;913;18033904;842595;381;12475315;532;5558589;19752;9476
66204;Taurinya;181;3575250;104085;80;2596480;101;978770;19753;9477
18265;Torteron;456;9007280;278779;225;6714548;231;2292732;19753;9478
19037;Chamboulive;744;14696916;558554;357;10790377;387;3906539;19754;9479
62773;Samer;2029;40082073;1071302;1005;29383133;1024;10698940;19755;9480
26186;Miscon;29;572901;9552;14;375112;15;197789;19755;9481
14142;Castilly;156;3081856;80630;71;2185887;85;895969;19755;9482
18172;Orval;1140;22521443;808564;595;16848218;545;5673225;19756;9483
57703;Veckersviller;135;2667215;70037;69;1919790;66;747425;19757;9484
55173;Épiez-sur-Meuse;28;553202;19546;14;400322;14;152880;19757;9485
39155;Clucy;41;810047;13394;14;464171;27;345876;19757;9486
01147;Domsure;243;4801012;68119;124;3455772;119;1345240;19757;9487
2B318;Taglio-Isolaccio;308;6085256;223259;150;4498919;158;1586337;19757;9488
34301;Sète;27534;544003420;31743467;12612;415143262;14922;128860158;19758;9489
86121;Latillé;832;16438256;553108;386;11636187;446;4802069;19758;9490
57347;Insviller;109;2153611;58814;54;1532965;55;620646;19758;9491
49240;La Plaine;486;9602457;77394;249;6510750;237;3091707;19758;9492
66056;Corbère-les-Cabanes;596;11775943;358774;294;8933545;302;2842398;19758;9493
64509;Sauguis-Saint-Étienne;80;1580673;45010;41;1235690;39;344983;19758;9494
62735;Sailly-Labourse;1098;21695076;558950;527;15853845;571;5841231;19759;9495
09199;Montaut;436;8614824;325873;213;6501019;223;2113805;19759;9496
39454;Recanoz;46;908914;23154;23;700071;23;208843;19759;9497
49321;Saint-Sigismond;194;3833285;70031;89;2531169;105;1302116;19759;9498
82052;Escatalens;512;10116802;275943;237;7309286;275;2807516;19759;9499
64298;Lacarry-Arhan-Charritte-de-Haut;59;1165819;35164;30;911480;29;254339;19760;9500
70005;Aillevans;73;1442496;13766;36;1019972;37;422524;19760;9501
43244;Tence;1829;36141992;1203785;832;25712280;997;10429712;19761;9502
18063;Chavannes;103;2035336;68200;59;1578887;44;456449;19761;9503
38224;Mayres-Savel;74;1462362;49467;45;1219803;29;242559;19762;9504
47229;Saint-Astier;100;1976235;34603;48;1389576;52;586659;19762;9505
86085;Coussay;153;3023651;129659;80;2279821;73;743830;19762;9506
08202;Gué-d'Hossus;282;5573041;142017;149;4155807;133;1417234;19763;9507
88408;Rupt-sur-Moselle;1984;39210306;1161044;993;28577291;991;10633015;19763;9508
52151;Cour-l'Évêque;106;2094922;76627;52;1558656;54;536266;19763;9509
62219;Caumont;111;2193765;93383;45;1487669;66;706096;19764;9510
25607;Vernois-lès-Belvoir;41;810325;32481;25;623973;16;186352;19764;9511
69025;Bourg-de-Thizy;1479;29232677;995700;708;21237513;771;7995164;19765;9512
17379;Saint-Palais-de-Phiolin;126;2490412;101942;54;1805507;72;684905;19765;9513
61463;La Sauvagère;530;10475754;296839;284;7714737;246;2761017;19766;9514
70558;La Villeneuve-Bellenoye-et-la-Maize;85;1680096;60915;46;1324452;39;355644;19766;9515
02374;Lehaucourt;495;9784623;311484;262;7462473;233;2322150;19767;9516
22172;Plancoët;1870;36967681;1306459;895;27251837;975;9715844;19769;9517
37113;Le Grand-Pressigny;543;10735027;411891;257;7810646;286;2924381;19770;9518
11156;Fraisse-Cabardès;67;1324594;38773;38;1025024;29;299570;19770;9519
39390;Nogna;143;2827180;59212;78;2086754;65;740426;19770;9520
32436;Solomiac;255;5041488;183754;122;3682694;133;1358794;19771;9521
18080;Croisy;82;1621230;48327;38;1138695;44;482535;19771;9522
81219;Puylaurens;1806;35707102;1243731;819;25938458;987;9768644;19771;9523
33435;Saint-Macaire;1102;21788163;834644;565;16794346;537;4993817;19771;9524
64161;Came;429;8482094;167922;198;5825919;231;2656175;19772;9525
58185;Moux-en-Morvan;376;7434422;319416;184;5660155;192;1774267;19772;9526
38470;La Salle-en-Beaumont;182;3598610;71483;92;2636527;90;962083;19773;9527
04207;Sigoyer;43;850239;59900;19;705585;24;144654;19773;9528
04164;Revest-Saint-Martin;44;870021;64091;16;554525;28;315496;19773;9529
72369;Verneil-le-Chétif;305;6030968;136091;158;4482185;147;1548783;19774;9530
57676;Tragny;53;1048013;13849;28;779387;25;268626;19774;9531
71317;Montmort;103;2036762;59864;43;1374202;60;662560;19774;9532
31535;Sauveterre-de-Comminges;402;7949365;305221;190;5855553;212;2093812;19775;9533
03311;Vicq;188;3717617;120180;92;2806849;96;910768;19775;9534
16113;La Couronne;4229;83630843;3098720;2171;65399894;2058;18230949;19776;9535
41151;Montrichard;2154;42597061;1704495;1046;31011955;1108;11585106;19776;9536
58042;Bulcy;84;1661186;53564;41;1196836;43;464350;19776;9537
62238;Conteville-en-Ternois;40;791059;23823;19;605156;21;185903;19776;9538
57144;Cocheren;1988;39316278;1036835;976;27716690;1012;11599588;19777;9539
85094;Foussais-Payré;649;12835195;317977;298;9119513;351;3715682;19777;9540
60164;Le Coudray-Saint-Germer;448;8860165;265554;208;6140725;240;2719440;19777;9541
12223;Sainte-Geneviève-sur-Argence;579;11450989;446940;249;8021296;330;3429693;19777;9542
35321;Saulnières;368;7278090;138694;198;5298906;170;1979184;19777;9543
24232;Lavaur;39;771343;17570;15;496150;24;275193;19778;9544
31440;Proupiary;31;613124;18610;17;474722;14;138402;19778;9545
39230;Fontenu;38;751578;18737;20;546420;18;205158;19778;9546
85181;Pouillé;326;6447802;108295;153;4464156;173;1983646;19779;9547
54246;Halloville;37;731826;1170;16;448182;21;283644;19779;9548
19040;Champagnac-la-Prune;104;2057123;53435;40;1410099;64;647024;19780;9549
22001;Allineuc;294;5815392;79284;156;4204829;138;1610563;19780;9550
06081;Le Mas;59;1167050;44510;29;862265;30;304785;19781;9551
49104;Concourson-sur-Layon;281;5558412;87934;139;3968580;142;1589832;19781;9552
34114;Gignac;2910;57565320;1833343;1338;42057668;1572;15507652;19782;9553
55225;Halles-sous-les-Côtes;78;1543042;53594;37;1092536;41;450506;19783;9554
08164;Falaise;186;3679633;89864;102;2837441;84;842192;19783;9555
2A141;Letia;74;1463944;137779;35;1219583;39;244361;19783;9556
02530;Moulins;46;910023;34727;20;629994;26;280029;19783;9557
50363;Moyon;579;11454517;251304;276;8096243;303;3358274;19783;9558
51130;Charmont;121;2393823;81921;56;1754673;65;639150;19784;9559
24505;Saint-Sulpice-d'Excideuil;191;3778707;133991;86;2688984;105;1089723;19784;9560
15031;Celles;128;2532397;62971;61;1808735;67;723662;19784;9561
54404;Noviant-aux-Prés;126;2492831;39068;61;1721347;65;771484;19784;9562
59556;Sassegnies;159;3145721;130539;75;2302578;84;843143;19784;9563
56093;Kergrist;384;7597256;192440;216;5798705;168;1798551;19785;9564
37220;Saint-Germain-sur-Vienne;230;4550466;151288;108;3318693;122;1231773;19785;9565
57671;Thimonville;80;1582904;22529;36;1045326;44;537578;19786;9566
56035;Caro;654;12940440;317330;331;9531841;323;3408599;19787;9567
16090;Châteauneuf-sur-Charente;2116;41869663;1588501;1019;31338150;1097;10531513;19787;9568
44104;Montrelais;437;8647125;163658;218;6054563;219;2592562;19787;9569
38112;Clavans-en-Haut-Oisans;48;949846;27675;30;793224;18;156622;19788;9570
58146;Lucenay-lès-Aix;603;11932612;798617;272;8825601;331;3107011;19789;9571
39166;Cornod;131;2592332;51464;60;1764083;71;828249;19789;9572
31309;Lussan-Adeilhac;132;2612200;125085;63;2033237;69;578963;19789;9573
02414;Lavaqueresse;115;2275819;92707;49;1549679;66;726140;19790;9574
04025;Beauvezer;229;4531980;159547;123;3383498;106;1148482;19790;9575
11344;Saint-Hilaire;449;8885929;329070;201;6201651;248;2684278;19790;9576
09167;Lézat-sur-Lèze;1336;26441347;813540;647;19208514;689;7232833;19791;9577
19090;Gumond;58;1147967;22087;27;740163;31;407804;19793;9578
62709;Riencourt-lès-Cagnicourt;162;3206421;79058;73;2246062;89;960359;19793;9579
02780;Venizel;739;14627102;540729;385;11012819;354;3614283;19793;9580
34241;Saint-Bauzille-de-la-Sylve;465;9203927;250572;218;6627344;247;2576583;19793;9581
86246;Saint-Savin;508;10055561;399111;224;7105299;284;2950262;19794;9582
52089;Celles-en-Bassigny;40;791854;16142;20;540096;20;251758;19796;9583
12032;Boussac;293;5800362;157482;129;4163994;164;1636368;19796;9584
34201;Pierrerue;170;3365412;106603;72;2287593;98;1077819;19797;9585
35261;Saint-Christophe-de-Valains;112;2217229;39600;61;1646769;51;570460;19797;9586
62247;Coupelle-Vieille;290;5741055;157249;131;4049169;159;1691886;19797;9587
54466;Royaumeix;192;3801046;91300;98;2771138;94;1029908;19797;9588
43021;Beaulieu;564;11165891;302908;272;7970262;292;3195629;19798;9589
36232;Vendoeuvres;665;13165480;456234;307;9398560;358;3766920;19798;9590
61044;Berjou;262;5187009;143290;132;3795142;130;1391867;19798;9591
23222;Saint-Michel-de-Veisse;103;2039177;97019;42;1553981;61;485196;19798;9592
55545;Verdun;10705;211937683;10881943;4991;164106230;5714;47831453;19798;9593
22266;Rostrenen;2055;40685300;1816637;843;30090538;1212;10594762;19798;9594
17363;Saint-Martial-de-Vitaterne;299;5919672;223124;131;4479664;168;1440008;19798;9595
81119;Laboutarie;249;4929866;166873;125;3642316;124;1287550;19799;9596
46139;Labathude;108;2138284;38986;50;1538479;58;599805;19799;9597
46079;Cras;53;1049360;41991;29;814671;24;234689;19799;9598
66055;Corbère;370;7325826;202185;190;5426454;180;1899372;19800;9599
17298;Rioux;502;9939430;388273;232;7207336;270;2732094;19800;9600
24324;Peyrignac;296;5860822;185654;156;4403411;140;1457411;19800;9601
72358;Thorigné-sur-Dué;888;17582537;508857;440;12965145;448;4617392;19800;9602
30349;Vic-le-Fesq;244;4831406;182859;108;3428812;136;1402594;19801;9603
52330;Montheries;35;693033;11669;14;429556;21;263477;19801;9604
89448;Vignes;58;1148459;40041;30;860887;28;287572;19801;9605
89417;Tissey;73;1445490;45483;42;1072088;31;373402;19801;9606
88505;Vienville;69;1366327;38378;36;1078258;33;288069;19802;9607
33087;Camiran;246;4871322;177258;124;3842459;122;1028863;19802;9608
41042;Châteauvieux;333;6594392;234348;152;4641823;181;1952569;19803;9609
49017;Baracé;250;4950898;80802;139;3736095;111;1214803;19804;9610
92078;Villeneuve-la-Garenne;12695;251407353;11110848;6426;190842683;6269;60564670;19804;9611
10185;Lagesse;110;2178404;67199;55;1636297;55;542107;19804;9612
24536;Singleyrac;127;2515099;44414;54;1600994;73;914105;19804;9613
39058;Blye;82;1623934;31859;41;1168663;41;455271;19804;9614
47193;Moulinet;110;2178467;64043;50;1585215;60;593252;19804;9615
50033;Baubigny;96;1901209;67277;47;1454206;49;447003;19804;9616
80098;Bettembos;52;1029847;29043;27;750445;25;279402;19805;9617
39314;Marnézia;44;871432;5099;22;593622;22;277810;19805;9618
81249;Sainte-Gemme;470;9308512;231043;234;6773269;236;2535243;19805;9619
40215;Ousse-Suzan;161;3188665;63931;85;2218954;76;969711;19805;9620
63349;Saint-Georges-de-Mons;1210;23964623;748001;625;17689430;585;6275193;19805;9621
86077;Civaux;593;11744658;336366;288;8349598;305;3395060;19805;9622
88360;Provenchères-lès-Darney;103;2039984;68115;57;1593867;46;446117;19806;9623
70007;Ailloncourt;162;3208592;86313;85;2437765;77;770827;19806;9624
26343;Souspierre;57;1128988;35204;22;774800;35;354188;19807;9625
62464;Hulluch;1636;32404085;1280058;734;23741664;902;8662421;19807;9626
85143;Mervent;597;11824777;403979;288;8589821;309;3234956;19807;9627
47140;Laugnac;359;7110850;194407;173;5366182;186;1744668;19807;9628
70298;Lavigney;65;1287527;11281;30;880297;35;407230;19808;9629
81293;Tauriac;143;2832605;48688;73;2080158;70;752447;19808;9630
08343;Pouru-Saint-Remy;620;12281338;289351;304;8696262;316;3585076;19809;9631
76364;Hodeng-Hodenger;154;3050570;55980;77;2251116;77;799454;19809;9632
59485;Quiévy;951;18838444;499118;459;13644255;492;5194189;19809;9633
28404;Vernouillet;5975;118361222;4105491;2866;85744381;3109;32616841;19809;9634
45121;Dammarie-sur-Loing;305;6041982;299743;140;4514732;165;1527250;19810;9635
26314;Saint-Martin-d'Août;207;4100688;132417;98;3061108;109;1039580;19810;9636
71142;La Comelle;109;2159310;140667;46;1529350;63;629960;19810;9637
63423;Sugères;341;6755338;195079;173;5054648;168;1700690;19810;9638
76322;Le Grand-Quevilly;15042;297987882;10689328;8565;229748522;6477;68239360;19810;9639
18117;Jars;286;5665809;205208;149;4248225;137;1417584;19811;9640
43232;Salzuit;210;4160330;155309;94;2920550;116;1239780;19811;9641
02266;Dolignon;30;594337;12391;12;386107;18;208230;19811;9642
56222;Saint-Jean-Brévelay;1467;29063181;726525;758;21538126;709;7525055;19811;9643
88513;Vincey;1234;24447313;785925;610;18081570;624;6365743;19811;9644
88353;Pont-lès-Bonfays;53;1050074;32312;26;745141;27;304933;19813;9645
88115;Corcieux;891;17653299;521104;434;12772258;457;4881041;19813;9646
10388;Turgy;30;594399;19667;16;457028;14;137371;19813;9647
46166;Lebreil;89;1763409;35969;26;1022152;63;741257;19814;9648
11417;Villarzel-du-Razès;63;1248269;62279;25;943177;38;305092;19814;9649
40088;Dax;13813;273688051;14843395;6686;209004382;7127;64683669;19814;9650
71561;Vauban;143;2833391;67990;64;1811499;79;1021892;19814;9651
67552;Wolfskirchen;197;3903351;94709;93;2571870;104;1331481;19814;9652
03090;Couzon;154;3051375;60166;73;2188010;81;863365;19814;9653
72220;Nogent-le-Bernard;526;10422494;358592;257;7511499;269;2910995;19815;9654
58061;Chasnay;73;1446468;35330;35;1040684;38;405784;19815;9655
31274;Larcan;100;1981480;21704;49;1370104;51;611376;19815;9656
27359;Juignettes;99;1961727;80339;49;1491424;50;470303;19815;9657
55424;Remennecourt;32;634111;11667;11;343606;21;290505;19816;9658
82081;Labourgade;90;1783450;91929;36;1239505;54;543945;19816;9659
36031;Buzançais;2678;53067725;1789113;1297;38699480;1381;14368245;19816;9660
21539;Saint-Anthot;38;753016;27000;20;549022;18;203994;19816;9661
16420;Voulgézac;162;3210273;90311;83;2387807;79;822466;19817;9662
32243;Mauléon-d'Armagnac;185;3666141;160998;77;2754507;108;911634;19817;9663
24194;Gardonne;824;16329395;649179;405;12134880;419;4194515;19817;9664
50499;Saint-Laurent-de-Cuves;254;5033612;99363;135;3638356;119;1395256;19817;9665
22348;Trédias;270;5350788;137302;134;3860966;136;1489822;19818;9666
81239;Saint-Amans-Valtoret;544;10780924;292022;240;7362700;304;3418224;19818;9667
49108;La Cornuaille;486;9631690;146868;211;6590330;275;3041360;19818;9668
29001;Argol;522;10345681;237340;268;7634542;254;2711139;19819;9669
70171;Corbenay;711;14091569;408815;335;10180611;376;3910958;19819;9670
70157;Clairegoutte;238;4717051;154154;123;3438153;115;1278898;19820;9671
60623;Songeons;633;12545932;457372;298;9143423;335;3402509;19820;9672
08275;Margny;94;1863082;44487;43;1286956;51;576126;19820;9673
71454;Saint-Martin-du-Mont;102;2021662;19072;48;1367307;54;654355;19820;9674
02309;Festieux;320;6342627;175268;159;4687834;161;1654793;19821;9675
16307;Saint-Ciers-sur-Bonnieure;176;3488496;92710;82;2548441;94;940055;19821;9676
22175;Plédéliac;737;14608171;408173;360;10549672;377;4058499;19821;9677
76145;Brunville;121;2398496;94285;55;1706240;66;692256;19822;9678
46132;Issendolus;267;5292708;114971;131;3766117;136;1526591;19823;9679
26202;Montjoux;201;3984530;161633;96;3155865;105;828665;19824;9680
80211;Conty;960;19031530;708913;432;14065814;528;4965716;19825;9681
43142;Montregard;332;6581766;191768;161;4754496;171;1827270;19825;9682
79277;Saint-Martin-de-Sanzay;538;10665683;272892;259;7670562;279;2995121;19825;9683
88465;Thaon-les-Vosges;4629;91772530;3474437;2317;68264355;2312;23508175;19826;9684
52183;Ecot-la-Combe;32;634427;33760;13;471376;19;163051;19826;9685
55364;Mouzay;416;8247576;259022;204;5899814;212;2347762;19826;9686
76372;Illois;197;3905754;98436;93;2754649;104;1151105;19826;9687
25171;Courcelles;40;793049;20487;23;605931;17;187118;19826;9688
62291;Éleu-dit-Leauwette;1569;31107773;1014283;800;23265653;769;7842120;19826;9689
04124;Montagnac-Montpezat;264;5234243;215038;116;3763092;148;1471151;19827;9690
01306;Pont-de-Veyle;936;18558058;750362;501;13961651;435;4596407;19827;9691
86213;Rouillé;1364;27044220;754630;664;19481541;700;7562679;19827;9692
48078;Lachamp;106;2101704;54289;50;1481969;56;619735;19827;9693
24270;Milhac-d'Auberoche;305;6047381;130237;150;4334023;155;1713358;19827;9694
34070;Cébazan;295;5849147;191182;143;4385098;152;1464049;19828;9695
64149;Bugnein;118;2339692;54392;53;1577587;65;762105;19828;9696
39263;Grozon;243;4818296;72305;131;3488455;112;1329841;19828;9697
66218;Ur;189;3747568;102798;94;2760342;95;987226;19828;9698
57712;Vic-sur-Seille;737;14613769;505298;362;10794624;375;3819145;19829;9699
85062;Châteauneuf;492;9755752;195231;249;7011478;243;2744274;19829;9700
54306;Lay-Saint-Remy;178;3529666;91296;95;2711458;83;818208;19830;9701
61179;La Fresnaye-au-Sauvage;114;2260634;50946;52;1545128;62;715506;19830;9702
79062;Cerizay;2558;50727192;1676363;1255;36773987;1303;13953205;19831;9703
89359;Saint-Maurice-aux-Riches-Hommes;282;5592296;209657;134;3911443;148;1680853;19831;9704
66034;Campôme;56;1110528;24399;30;863219;26;247309;19831;9705
16015;Angoulême;25249;500712065;28685605;12306;397478706;12943;103233359;19831;9706
05053;Eyguians;146;2895417;90116;78;2162211;68;733206;19832;9707
85041;Cezais;171;3391317;75234;83;2418289;88;973028;19832;9708
03207;Pierrefitte-sur-Loire;277;5493694;174373;135;3917013;142;1576681;19833;9709
12270;Sévérac-le-Château;1464;29035280;783478;739;21289886;725;7745394;19833;9710
15019;Bassignac;119;2360138;70863;53;1629812;66;730326;19833;9711
62359;Fressin;318;6307089;339200;138;4562544;180;1744545;19834;9712
53076;Cossé-en-Champagne;165;3272554;48374;83;2373076;82;899478;19834;9713
22101;Langoat;644;12772908;331724;318;9232583;326;3540325;19834;9714
36242;Villegongis;68;1348763;30659;35;969885;33;378878;19835;9715
03036;Bourbon-l'Archambault;1558;30904661;1236304;738;22966559;820;7938102;19836;9716
64192;Conchez-de-Béarn;56;1110823;22097;24;759139;32;351684;19836;9717
80618;Pendé;584;11584659;317879;286;8315238;298;3269421;19837;9718
76051;Bacqueville-en-Caux;1031;20452321;630956;501;14986295;530;5466026;19837;9719
01190;Innimond;66;1309312;30578;34;1096154;32;213158;19838;9720
22303;Saint-Jacut-du-Mené;410;8133612;248627;215;6012729;195;2120883;19838;9721
65250;Lalanne-Trie;62;1229966;51506;25;869502;37;360464;19838;9722
59021;Assevent;1008;19996900;617479;529;15116655;479;4880245;19838;9723
25333;Laviron;183;3630437;73938;79;2501656;104;1128781;19838;9724
61427;Saint-Martin-l'Aiguillon;124;2459992;88371;70;1933183;54;526809;19839;9725
32320;Plieux;100;1983888;68564;43;1435376;57;548512;19839;9726
50275;Les Loges-sur-Brécey;73;1448241;17421;31;946444;42;501797;19839;9727
48185;Les Salelles;93;1845073;49116;53;1405829;40;439244;19839;9728
37037;Brèches;146;2896612;42828;69;2048828;77;847784;19840;9729
25585;Vanclans;114;2261787;53074;61;1705869;53;555918;19840;9730
29241;Rosporden;4354;86386260;2299403;2252;63340495;2102;23045765;19841;9731
06042;Clans;325;6448471;231446;156;4707145;169;1741326;19841;9732
93029;Drancy;36552;725304822;32288612;18577;562982208;17975;162322614;19843;9733
03216;Ronnet;110;2182745;80927;53;1630885;57;551860;19843;9734
70004;Adelans-et-le-Val-de-Bithaine;164;3254375;43151;89;2418778;75;835597;19844;9735
82001;Albefeuille-Lagarde;349;6925626;207869;180;5289392;169;1636234;19844;9736
02127;Bruyères-sur-Fère;111;2202715;58482;52;1535224;59;667491;19844;9737
08469;Vendresse;273;5417510;129574;142;4054691;131;1362819;19844;9738
11247;Monthaut;23;456423;21830;11;350363;12;106060;19844;9739
06057;L'Escarène;1450;28774517;1100113;769;21915609;681;6858908;19844;9740
33418;Saint-Hilaire-de-la-Noaille;208;4127695;173414;103;3158236;105;969459;19845;9741
55511;Thonnelle;86;1706659;71139;42;1178934;44;527725;19845;9742
26289;Saillans;757;15022987;560249;370;11124855;387;3898132;19845;9743
19136;Meymac;1412;28021840;1233159;652;20654422;760;7367418;19845;9744
11106;Coursan;3354;66563059;2386524;1647;49693193;1707;16869866;19846;9745
86170;Moulismes;222;4405884;93373;115;3286429;107;1119455;19846;9746
46104;Flaujac-Gare;56;1111422;20877;29;814151;27;297271;19847;9747
05020;Bénévent-et-Charbillac;163;3235104;91663;80;2258000;83;977104;19847;9748
65322;Montoussé;143;2838217;93413;82;2202340;61;635877;19848;9749
61398;Saint-Germain-le-Vieux;30;595440;6760;14;379577;16;215863;19848;9750
25621;Villeneuve-d'Amont;126;2500913;89748;62;2013700;64;487213;19849;9751
40029;Bats;146;2897995;46934;73;2061882;73;836113;19849;9752
80810;Vitz-sur-Authie;75;1488714;79672;39;1175702;36;313012;19850;9753
12287;Vailhourles;364;7225251;373338;155;4895424;209;2329827;19850;9754
60113;Bucamps;94;1865874;50092;51;1378385;43;487489;19850;9755
72271;Saint-Célerin;389;7721678;121330;192;5581244;197;2140434;19850;9756
55267;Lachaussée;152;3017300;96004;69;2231577;83;785723;19851;9757
61366;Saint-Aubin-de-Bonneval;68;1349848;11321;30;853697;38;496151;19851;9758
46306;Sonac;52;1032251;26798;26;767803;26;264448;19851;9759
27323;La Haye-Saint-Sylvestre;147;2918122;138611;64;2124306;83;793816;19851;9760
62339;Fleury;53;1052116;19726;21;656728;32;395388;19851;9761
25384;Mondon;49;972722;17638;23;715692;26;257030;19851;9762
26117;Échevis;32;635250;18496;11;425763;21;209487;19852;9763
72179;Malicorne-sur-Sarthe;1049;20824855;513224;519;15010012;530;5814843;19852;9764
50048;Beslon;294;5836676;141870;150;4203860;144;1632816;19853;9765
72175;Luché-Pringé;919;18244649;586793;461;13206064;458;5038585;19853;9766
88008;Anglemont;94;1866198;84995;42;1366705;52;499493;19853;9767
03285;Tortezais;108;2144195;52586;58;1711775;50;432420;19854;9768
19118;Le Lonzac;499;9907054;338233;230;7139731;269;2767323;19854;9769
62804;Sus-Saint-Léger;187;3712695;106316;80;2531394;107;1181301;19854;9770
33353;Rimons;116;2303169;91348;50;1644353;66;658816;19855;9771
65367;Poumarous;79;1568575;29791;44;1233873;35;334702;19855;9772
57258;Gréning;78;1548724;98998;37;1160858;41;387866;19855;9773
54331;Magnières;174;3454867;102354;85;2453090;89;1001777;19856;9774
71466;Saint-Nizier-sur-Arroux;56;1111930;13279;23;719851;33;392079;19856;9775
58002;Alligny-Cosne;542;10761931;357000;303;8285581;239;2476350;19856;9776
34115;Gorniès;83;1648070;67182;38;1270301;45;377769;19856;9777
11119;La Digne-d'Amont;177;3514572;117945;91;2623247;86;891325;19856;9778
80804;Villers-sous-Ailly;104;2065203;64164;49;1502480;55;562723;19858;9779
72027;Beaumont-sur-Dême;200;3971556;122683;104;2980324;96;991232;19858;9780
19129;Masseret;437;8677904;368024;196;6176810;241;2501094;19858;9781
81066;Caucalières;189;3753285;73846;104;2788484;85;964801;19859;9782
40086;Coudures;256;5083940;142103;128;3832907;128;1251033;19859;9783
08443;Terron-sur-Aisne;66;1310707;40722;32;960477;34;350230;19859;9784
55168;Duzey;24;476624;6352;11;341534;13;135090;19859;9785
39021;Arthenas;87;1727789;45247;47;1318451;40;409338;19860;9786
36229;Varennes-sur-Fouzon;397;7884348;193160;205;5698996;192;2185352;19860;9787
19217;Saint-Julien-Maumont;95;1886702;47461;40;1267811;55;618891;19860;9788
70299;Lavoncourt;188;3733686;163026;83;2778618;105;955068;19860;9789
71229;Les Guerreaux;133;2641396;105863;61;1957222;72;684174;19860;9790
42156;Neulise;726;14419122;347776;343;10105036;383;4314086;19861;9791
62234;Conchy-sur-Canche;112;2224444;54719;51;1473778;61;750666;19861;9792
19059;Concèze;247;4905697;166439;116;3428817;131;1476880;19861;9793
57448;Marsal;150;2979232;94832;77;2226175;73;753057;19862;9794
59051;La Bassée;3675;72991858;2696070;1838;55094042;1837;17897816;19862;9795
26249;Pont-de-Barret;357;7090659;194698;155;4946484;202;2144175;19862;9796
25544;Servin;91;1807453;20689;37;1142861;54;664592;19862;9797
65269;Lescurry;101;2006094;43255;49;1487606;52;518488;19862;9798
14726;Vassy;1014;20140913;596695;496;14851476;518;5289437;19863;9799
76146;Buchy;833;16545763;556874;404;12288776;429;4256987;19863;9800
88418;Sainte-Hélène;254;5045200;166317;124;3644967;130;1400233;19863;9801
53071;Colombiers-du-Plessis;250;4965772;93897;117;3511611;133;1454161;19863;9802
49209;Montigné-lès-Rairies;195;3873407;130088;86;2748610;109;1124797;19864;9803
44189;Sainte-Reine-de-Bretagne;1146;22763727;447016;606;16487546;540;6276181;19864;9804
89318;Quarré-les-Tombes;424;8422241;293704;192;5718942;232;2703299;19864;9805
55388;Noyers-Auzécourt;142;2820760;85500;72;2107354;70;713406;19865;9806
11059;Cailhavel;73;1450113;56102;36;1075543;37;374570;19865;9807
28373;Senonches;1882;37385622;1499505;897;27369904;985;10015718;19865;9808
62302;Ergny;120;2383798;82661;55;1747198;65;636600;19865;9809
64226;Fichous-Riumayou;91;1807745;47205;37;1274726;54;533019;19865;9810
62253;Couturelle;46;913813;9883;22;606633;24;307180;19866;9811
22297;Saint-Gouéno;379;7529186;207818;197;5538775;182;1990411;19866;9812
80042;Autheux;67;1331022;44999;28;940696;39;390326;19866;9813
89042;Bierry-les-Belles-Fontaines;114;2264727;67745;53;1641421;61;623306;19866;9814
33025;Baigneaux;197;3913666;48877;110;3058171;87;855495;19866;9815
21434;Montlay-en-Auxois;94;1867507;63059;43;1317165;51;550342;19867;9816
31415;Peyrouzet;53;1053006;45882;27;832869;26;220137;19868;9817
02638;Remies;144;2861028;115016;71;2209589;73;651439;19868;9818
53233;Saint-Loup-du-Dorat;186;3695521;58650;110;2848274;76;847247;19868;9819
62375;Gommecourt;67;1331204;77245;28;1035375;39;295829;19869;9820
51475;Saint-Chéron;45;894096;35715;25;714584;20;179512;19869;9821
50175;Éroudeville;123;2443966;32094;62;1777277;61;666689;19870;9822
71230;Gueugnon;4450;88420913;2993694;2281;65262813;2169;23158100;19870;9823
88369;Ramonchamp;1088;21618729;590700;566;15861369;522;5757360;19870;9824
22212;Plouëc-du-Trieux;634;12597783;407406;302;9181573;332;3416210;19870;9825
71335;Ouroux-sous-le-Bois-Sainte-Marie;34;675606;43673;16;457678;18;217928;19871;9826
49175;Linières-Bouton;44;874317;23731;17;493136;27;381181;19871;9827
81201;Pampelonne;443;8802818;336740;205;6238038;238;2564780;19871;9828
27284;Gisors;6924;137591193;6021950;3607;105692653;3317;31898540;19872;9829
64104;Bedous;319;6339064;256248;166;4919722;153;1419342;19872;9830
38050;Le Bouchage;335;6657115;136994;176;4984736;159;1672379;19872;9831
10108;Courtaoult;54;1073104;31968;28;833353;26;239751;19872;9832
59113;Bruille-lez-Marchiennes;641;12738153;305519;309;9393389;332;3344764;19872;9833
54014;Ancerviller;136;2702695;52682;58;1968959;78;733736;19873;9834
42254;Saint-Marcel-de-Félines;414;8227386;192909;211;6067595;203;2159791;19873;9835
59047;Banteux;188;3736151;106496;90;2685185;98;1050966;19873;9836
22221;Plouguiel;1081;21484116;732285;495;15437951;586;6046165;19874;9837
67043;Bischheim;9855;195868847;7972348;5258;152377417;4597;43491430;19875;9838
70303;Liévans;70;1391295;-9987;37;993558;33;397737;19876;9839
63044;Bongheat;211;4193830;115710;103;3107011;108;1086819;19876;9840
03242;Saint-Loup;317;6300764;154145;170;4637195;147;1663569;19876;9841
61502;Vidai;52;1033570;23608;28;771128;24;262442;19876;9842
09021;Artix;64;1272102;7669;37;1001898;27;270204;19877;9843
65378;Ricaud;36;715579;18477;17;511188;19;204391;19877;9844
67424;Saint-Blaise-la-Roche;141;2802698;76589;77;2201543;64;601155;19877;9845
17103;Chervettes;83;1649919;48233;41;1218300;42;431619;19879;9846
26083;Châteauneuf-de-Galaure;905;17990785;584876;382;12277352;523;5713433;19879;9847
24379;Saint-Avit-Sénieur;261;5188549;185067;120;3705578;141;1482971;19879;9848
49373;Vihiers;2308;45881947;1169922;1051;31884158;1257;13997789;19880;9849
22255;La Prénessaye;471;9363518;270088;232;6706087;239;2657431;19880;9850
45155;Gien;8512;169220983;8000630;4148;129780747;4364;39440236;19880;9851
11379;Sigean;3089;61410220;2185079;1458;45445127;1631;15965093;19880;9852
80162;Caix;413;8210767;341866;191;5961354;222;2249413;19881;9853
63055;Bromont-Lamothe;541;10755883;320501;270;7938306;271;2817577;19881;9854
47017;Auradou;192;3817254;79094;98;2843604;94;973650;19882;9855
02696;Saint-Thomas;53;1053733;44308;21;755655;32;298078;19882;9856
17316;Saint-Ciers-Champagne;231;4592858;167269;107;3353977;124;1238881;19883;9857
32208;Lectoure;2250;44736081;1842776;1023;33111551;1227;11624530;19883;9858
17131;Cozes;1263;25112175;929225;598;18110095;665;7002080;19883;9859
53226;Saint-Hilaire-du-Maine;416;8271353;121993;201;5687574;215;2583779;19883;9860
09274;Saint-Quentin-la-Tour;170;3380147;84606;89;2535151;81;844996;19883;9861
80569;Morcourt;157;3121676;100862;68;2024361;89;1097315;19883;9862
02055;Beaumé;56;1113472;35844;29;846091;27;267381;19883;9863
33493;Saint-Yzans-de-Médoc;236;4692520;151697;122;3680786;114;1011734;19884;9864
27170;Cormeilles;726;14435532;527612;290;10499206;436;3936326;19884;9865
66180;Saint-Laurent-de-la-Salanque;5758;114491408;4436104;2817;86197576;2941;28293832;19884;9866
23075;Dun-le-Palestel;706;14038413;659864;310;9954736;396;4083677;19884;9867
12185;Pont-de-Salars;888;17657660;570399;421;13013669;467;4643991;19885;9868
61056;Le Bouillon;94;1869214;26538;51;1397053;43;472161;19885;9869
11255;Montredon-des-Corbières;799;15888393;463379;388;11501132;411;4387261;19885;9870
61163;La Ferrière-aux-Étangs;926;18413976;689572;439;13275758;487;5138218;19886;9871
52293;Longeville-sur-la-Laines;256;5090979;158202;127;3671309;129;1419670;19887;9872
43047;Chadron;152;3022785;69011;88;2345769;64;677016;19887;9873
12197;Réquista;1209;24044370;1009752;525;17372358;684;6672012;19888;9874
60395;Méru;7137;141945958;5004243;3560;106864578;3577;35081380;19889;9875
21575;Saint-Symphorien-sur-Saône;193;3838547;100912;104;2861310;89;977237;19889;9876
39222;Fay-en-Montagne;46;914919;14232;21;673813;25;241106;19890;9877
72170;Louvigny;109;2168000;55080;54;1558039;55;609961;19890;9878
37051;Champigny-sur-Veude;514;10223416;396892;229;7044687;285;3178729;19890;9879
17237;Moëze;312;6205666;190930;153;4448766;159;1756900;19890;9880
66138;Peyrestortes;792;15753057;601434;385;11829394;407;3923663;19890;9881
71073;Chagny;3265;64942193;2260538;1684;48485849;1581;16456344;19890;9882
14444;Monteille;88;1750381;55023;42;1296778;46;453603;19891;9883
07053;Chandolas;293;5828118;213181;160;4488457;133;1339661;19891;9884
60692;Villers-Vicomte;91;1810099;68587;42;1334878;49;475221;19891;9885
50015;Annoville;389;7737697;229650;179;5448271;210;2289426;19891;9886
19012;Astaillac;143;2844520;108085;65;2108903;78;735617;19892;9887
24137;Coulaures;407;8096033;243487;200;5839616;207;2256417;19892;9888
30264;Saint-Jean-de-Ceyrargues;97;1929551;56648;50;1449692;47;479859;19892;9889
47094;Fauguerolles;378;7519310;293393;174;5327544;204;2191766;19892;9890
31305;Loudet;111;2208069;59227;62;1657773;49;550296;19893;9891
64281;Jasses;86;1710804;34122;33;1059895;53;650909;19893;9892
07142;Lespéron;177;3521074;101655;90;2645478;87;875596;19893;9893
55446;Rumont;44;875300;8499;23;632306;21;242994;19893;9894
53152;Meslay-du-Maine;1533;30496306;799711;730;21586568;803;8909738;19893;9895
02624;Proisy;178;3541055;146136;87;2628727;91;912328;19894;9896
24436;Saint-Laurent-des-Hommes;590;11737421;411069;318;9010963;272;2726458;19894;9897
08117;Chesnois-Auboncourt;86;1710901;17669;48;1345278;38;365623;19894;9898
53083;Courcité;486;9668583;146872;246;7146613;240;2521970;19894;9899
86151;Maulay;103;2049106;78174;37;1279916;66;769190;19894;9900
50393;Percy;1320;26260805;789745;520;17817116;800;8443689;19895;9901
87158;Saint-Laurent-sur-Gorre;854;16989971;613501;380;12208347;474;4781624;19895;9902
62224;Chocques;1551;30856552;860424;767;22208476;784;8648076;19895;9903
47325;Villeton;300;5968404;286890;145;4483088;155;1485316;19895;9904
40089;Doazit;470;9350567;288670;209;6642955;261;2707612;19895;9905
62837;Vaudringhem;254;5053496;111892;127;3711560;127;1341936;19896;9906
33387;Saint-Ciers-d'Abzac;676;13449750;386866;308;10005271;368;3444479;19896;9907
10437;Virey-sous-Bar;350;6963935;245980;186;5215744;164;1748191;19897;9908
17070;Brizambourg;495;9849064;350158;224;7143288;271;2705776;19897;9909
39484;Saint-Jean-d'Étreux;89;1770846;55907;50;1341385;39;429461;19897;9910
17095;Chatenet;136;2706034;103999;55;1857197;81;848837;19897;9911
54205;Foug;1504;29926108;911157;779;22415908;725;7510200;19898;9912
28359;Saint-Rémy-sur-Avre;2027;40332825;1075559;1115;30705009;912;9627816;19898;9913
28416;Villeneuve-Saint-Nicolas;71;1412755;37469;41;1091582;30;321173;19898;9914
36070;Éguzon-Chantôme;833;16575042;656274;386;11455351;447;5119691;19898;9915
38454;Saint-Sauveur;1150;22883556;952534;532;17735120;618;5148436;19899;9916
14369;Litteau;157;3124257;63635;89;2341364;68;782893;19900;9917
03018;Bayet;380;7562260;210157;191;5455789;189;2106471;19901;9918
62556;Marles-sur-Canche;157;3124442;85324;83;2510237;74;614205;19901;9919
88061;Bleurville;211;4199119;153160;108;3157556;103;1041563;19901;9920
19234;Saint-Pardoux-l'Ortigier;273;5433086;156530;134;3900173;139;1532913;19901;9921
50390;Ozeville;86;1711536;64149;46;1250466;40;461070;19902;9922
47174;Moncrabeau;434;8637289;418854;187;6311805;247;2325484;19902;9923
89003;Aillant-sur-Tholon;908;18070731;895595;435;13520294;473;4550437;19902;9924
64422;Oloron-Sainte-Marie;7050;140307750;6160867;3447;106035979;3603;34271771;19902;9925
08113;Chaumont-Porcien;259;5154576;197740;116;3687121;143;1467455;19902;9926
29072;Guilvinec;1953;38869019;1437670;998;28550260;955;10318759;19902;9927
52337;Montreuil-sur-Thonnance;43;855803;13767;18;447235;25;408568;19902;9928
70560;Villers-Bouton;73;1452875;28865;37;997863;36;455012;19902;9929
25189;Dammartin-les-Templiers;108;2149496;52596;55;1533069;53;616427;19903;9930
71106;Charolles;1620;32242753;1248460;754;24137459;866;8105294;19903;9931
64086;Ayherre;507;10091132;251916;254;7499040;253;2592092;19904;9932
34184;Nizas;354;7045960;250100;174;5310446;180;1735514;19904;9933
34207;Pomérols;1263;25139246;917790;605;18515709;658;6623537;19904;9934
62517;Linghem;115;2289040;75186;53;1706416;62;582624;19905;9935
32360;Saint-Arailles;75;1492856;44840;27;1039675;48;453181;19905;9936
36068;Dun-le-Poëlier;279;5553492;217556;129;3986052;150;1567440;19905;9937
24462;Saint-Médard-de-Mussidan;955;19009526;576536;481;13819628;474;5189898;19905;9938
14265;Fervaques;347;6907270;168000;170;4782685;177;2124585;19906;9939
11202;Leucate;2883;57392150;2786608;1477;44161289;1406;13230861;19907;9940
14124;La Cambe;329;6549492;226451;158;4711432;171;1838060;19907;9941
24088;Cause-de-Clérans;196;3901931;124720;98;2847470;98;1054461;19908;9942
32261;Monblanc;200;3981569;125498;105;2911429;95;1070140;19908;9943
62669;Pressy;153;3046015;108486;77;2202805;76;843210;19909;9944
87035;Champnétery;316;6291120;201977;159;4696740;157;1594380;19909;9945
53271;Villaines-la-Juhel;1725;34343269;1088891;853;25421557;872;8921712;19909;9946
09060;Bonnac;441;8780065;361133;213;6474861;228;2305204;19909;9947
04182;Saint-Julien-d'Asse;119;2369234;101497;65;1872764;54;496470;19910;9948
25430;Ollans;23;457921;13170;12;320882;11;137039;19910;9949
97207;Ducos;9444;188030434;6001792;3708;130613213;5736;57417221;19910;9950
77284;Meaux;30128;599855475;28775663;15621;469919406;14507;129936069;19910;9951
57237;Frémestroff;173;3444496;82646;94;2588169;79;856327;19910;9952
30097;Courry;172;3424709;118029;89;2641653;83;783056;19911;9953
39586;Aresches;26;517690;25694;13;403482;13;114208;19911;9954
79236;Saint-André-sur-Sèvre;360;7168133;86190;187;5157781;173;2010352;19911;9955
62803;Surques;267;5316421;95812;146;3901567;121;1414854;19912;9956
33171;Fossès-et-Baleyssac;113;2250068;92858;51;1584769;62;665299;19912;9957
08008;Amagne;381;7586551;182430;188;5495669;193;2090882;19912;9958
54398;Neuviller-lès-Badonviller;49;975709;19371;26;733487;23;242222;19912;9959
80529;Mérélessart;100;1991243;41268;48;1359233;52;632010;19912;9960
05154;Saint-Pierre-d'Argençon;99;1971382;68454;47;1476586;52;494796;19913;9961
89161;Étivey;142;2827689;101621;70;1938402;72;889287;19913;9962
24580;Villac;149;2967217;103547;77;2227363;72;739854;19914;9963
50470;Saint-Georges-de-Bohon;220;4381154;46493;120;3240165;100;1140989;19914;9964
41095;Fréteval;617;12287367;320013;320;9052920;297;3234447;19915;9965
56121;Lorient;35661;710206167;34117472;17980;551475419;17681;158730748;19915;9966
64383;Mialos;57;1135183;49263;24;789519;33;345664;19915;9967
42071;Le Coteau;4478;89183488;3422570;2294;67036808;2184;22146680;19916;9968
21488;Poinçon-lès-Larrey;126;2509432;106196;57;1709806;69;799626;19916;9969
42011;Balbigny;1532;30512341;868125;694;21038400;838;9473941;19917;9970
15169;Saignes;556;11073808;501545;251;7962301;305;3111507;19917;9971
33412;Saint-Germain-d'Esteuil;677;13484060;428225;338;9848775;339;3635285;19917;9972
32341;Réjaumont;124;2469759;56522;60;1821080;64;648679;19917;9973
35191;Montours;534;10636023;159608;261;7518005;273;3118018;19918;9974
26188;Mollans-sur-Ouvèze;625;12448558;534940;294;9387327;331;3061231;19918;9975
51441;Ponthion;71;1414161;30573;33;918989;38;495172;19918;9976
31155;Couret;115;2290582;60143;69;1928072;46;362510;19918;9977
32100;Cazeneuve;74;1473992;58608;40;1180221;34;293771;19919;9978
32158;L'Isle-Bouzon;132;2629303;69404;57;1763863;75;865440;19919;9979
21142;Chanceaux;116;2310612;52367;53;1619085;63;691527;19919;9980
33050;Bieujac;268;5338438;172879;125;3976529;143;1361909;19920;9981
24219;Labouquerie;119;2370431;111269;49;1642449;70;727982;19920;9982
65022;Arcizans-Dessus;70;1394406;35379;38;1040879;32;353527;19920;9983
46120;Gindou;185;3685252;129222;96;2914951;89;770301;19920;9984
61211;Juvigny-sous-Andaine;579;11534116;424036;293;8708209;286;2825907;19921;9985
02067;Bergues-sur-Sambre;116;2310846;52657;55;1584741;61;726105;19921;9986
85276;Saint-Vincent-Sterlanges;405;8068053;157800;218;5926135;187;2141918;19921;9987
88401;Rouvres-la-Chétive;246;4900649;81074;127;3637613;119;1263036;19921;9988
38317;Le Pont-de-Claix;6006;119647716;3891473;3437;92672978;2569;26974738;19921;9989
32440;Tasque;134;2669477;76180;58;1789381;76;880096;19921;9990
89290;Pasilly;28;557811;17562;14;427604;14;130207;19922;9991
63202;Madriat;69;1374645;48907;37;1097323;32;277322;19922;9992
57210;Fénétrange;453;9025028;539429;209;6958868;244;2066160;19923;9993
58236;Sainte-Colombe-des-Bois;73;1454388;47878;36;1041298;37;413090;19923;9994
09068;Burret;26;518004;25870;13;422834;13;95170;19923;9995
32143;Gazaupouy;162;3227612;113089;62;2292364;100;935248;19924;9996
70347;Mignavillers;200;3984751;97620;100;2801446;100;1183305;19924;9997
16268;Poursac;115;2291242;98866;48;1665633;67;625609;19924;9998
12277;Taussac;273;5439418;197948;128;3981611;145;1457807;19925;9999
61274;Les Menus;111;2211760;41493;65;1766495;46;445265;19926;10000
69224;Saint-Mamert;34;677482;40709;14;479369;20;198113;19926;10001
84018;Blauvac;274;5459729;160859;121;3898518;153;1561211;19926;10002
2A191;Olmiccia;62;1235415;62652;24;873857;38;361558;19926;10003
61167;La Ferté-Frênel;357;7113710;275958;173;5207131;184;1906579;19926;10004
02274;Ébouleau;111;2211826;70497;50;1609672;61;602154;19926;10005
57663;Talange;4128;82257227;2155062;1981;56477000;2147;25780227;19927;10006
80621;Pertain;202;4025266;93308;94;2787746;108;1237520;19927;10007
64371;Mauléon-Licharre;1915;38162523;1279502;907;27794061;1008;10368462;19928;10008
40330;Villenave;174;3467543;117585;85;2537133;89;930410;19928;10009
81197;Noailles;113;2251914;71318;48;1616681;65;635233;19928;10010
11408;Verzeille;243;4842690;144718;127;3669789;116;1172901;19929;10011
18116;Jalognes;182;3627216;150701;93;2810812;89;816404;19930;10012
30160;Maruéjols-lès-Gardon;123;2451404;57511;53;1822401;70;629003;19930;10013
89101;Chéu;290;5779753;182553;162;4482929;128;1296824;19930;10014
14129;Campeaux;323;6437525;192865;167;4912917;156;1524608;19930;10015
35022;Bécherel;419;8351007;329606;188;6074095;231;2276912;19931;10016
37064;Chaumussay;138;2750483;83420;68;2103882;70;646601;19931;10017
12036;Brommat;400;7972474;280762;185;5804131;215;2168343;19931;10018
62465;Humbercamps;129;2571136;72648;60;1766987;69;804149;19931;10019
52298;Maâtz;45;896909;23857;24;633639;21;263270;19931;10020
86223;Saint-Germain;578;11520394;314386;271;7867899;307;3652495;19931;10021
40232;Poudenx;124;2471565;77443;54;1818143;70;653422;19932;10022
40316;Tilh;423;8431723;284142;221;6464649;202;1967074;19933;10023
32354;Sabazan;80;1594678;64652;40;1191958;40;402720;19933;10024
51272;Givry-en-Argonne;272;5421952;227714;130;4043694;142;1378258;19934;10025
33277;Massugas;138;2750847;62630;63;1986106;75;764741;19934;10026
02730;Soupir;152;3029952;127901;64;2099162;88;930790;19934;10027
46287;Saint-Paul-de-Loubressac;316;6299111;191886;155;4711566;161;1587545;19934;10028
17165;Fontenet;224;4465228;113246;111;3357297;113;1107931;19934;10029
76164;Caudebec-en-Caux;1456;29024117;1423563;673;21422072;783;7602045;19934;10030
55421;Reffroy;36;717634;32180;15;524667;21;192967;19934;10031
32225;Malabat;55;1096394;16840;28;791590;27;304804;19934;10032
16286;Rouillac;1107;22067686;919110;506;16015249;601;6052437;19935;10033
65182;Gaillagos;68;1355558;41195;31;991554;37;364004;19935;10034
22133;Loscouët-sur-Meu;355;7076879;115690;193;5294237;162;1782642;19935;10035
64155;Bustince-Iriberry;47;936961;53860;22;749056;25;187905;19935;10036
88344;Pargny-sous-Mureau;101;2013513;39577;58;1513218;43;500295;19936;10037
62731;Ruyaulcourt;176;3508705;131301;78;2508902;98;999803;19936;10038
64280;Izeste;263;5243389;235740;123;3652901;140;1590488;19937;10039
26332;Saint-Uze;1030;20535035;535664;517;15126965;513;5408070;19937;10040
71076;Chalon-sur-Saône;27262;543528781;29089518;13983;422505790;13279;121022991;19937;10041
57253;Gondrexange;272;5423016;118795;150;4075151;122;1347865;19938;10042
88514;Viocourt;89;1774475;46004;40;1194029;49;580446;19938;10043
39497;Saizenay;55;1096587;12938;24;760524;31;336063;19938;10044
29281;Tourch;562;11205127;286265;288;8047469;274;3157658;19938;10045
34180;Nébian;760;15153288;415165;348;10896710;412;4256578;19939;10046
88301;Ménil-sur-Belvitte;165;3289901;67648;85;2435228;80;854673;19939;10047
83075;Les Mayons;379;7556911;278170;200;5903732;179;1653179;19939;10048
70478;Saulx;470;9371521;426250;221;7108720;249;2262801;19939;10049
68199;Malmerspach;297;5922082;199335;157;4500477;140;1421605;19940;10050
47113;Grayssas;79;1575247;66966;37;1121098;42;454149;19940;10051
02103;Boué;731;14576243;569764;366;11136986;365;3439257;19940;10052
12063;La Cavalerie;518;10329008;224211;261;7426603;257;2902405;19940;10053
47086;Duras;783;15613405;658880;319;11189551;464;4423854;19940;10054
33294;Morizès;281;5603294;173135;131;4015749;150;1587545;19941;10055
70040;Autrey-lès-Cerre;114;2273236;72704;56;1617002;58;656234;19941;10056
72355;Thoiré-sous-Contensor;47;937227;24661;24;656584;23;280643;19941;10057
55355;Montzéville;94;1874472;45761;48;1340699;46;533773;19941;10058
61013;Aunay-les-Bois;81;1615274;34857;40;1168531;41;446743;19942;10059
46297;Salviac;689;13740007;531279;293;9519959;396;4220048;19942;10060
42040;La Chamba;25;498563;13438;11;320096;14;178467;19943;10061
60299;Hardivillers;287;5723521;175685;131;3878660;156;1844861;19943;10062
32266;Moncorneil-Grazan;78;1555598;32183;32;1055291;46;500307;19944;10063
06070;Gréolières;361;7199668;287636;169;5348965;192;1850703;19944;10064
50354;Montsurvent;190;3789347;91546;86;2643297;104;1146050;19944;10065
30255;Saint-Geniès-de-Malgoirès;1443;28779539;1005696;674;21239356;769;7540183;19944;10066
33216;Lados;86;1715213;68402;37;1204604;49;510609;19944;10067
44138;Puceul;501;9992475;68098;250;7079447;251;2913028;19945;10068
79195;Nueil-les-Aubiers;2930;58439528;1292527;1371;41471108;1559;16968420;19945;10069
64176;Castetbon;88;1755203;62277;40;1316208;48;438995;19945;10070
55339;Mogeville;43;857674;18746;21;632280;22;225394;19946;10071
44118;Pannecé;677;13503468;245143;339;9544161;338;3959307;19946;10072
72223;Noyen-sur-Sarthe;1483;29580438;794787;766;21730621;717;7849817;19946;10073
70154;Cirey;181;3610299;112706;91;2563957;90;1046342;19946;10074
05101;Pelvoux;307;6123692;214982;165;4652484;142;1471208;19947;10075
49030;Blou;498;9933872;204829;263;7493009;235;2440863;19948;10076
52055;Blécourt;63;1256697;28888;29;864007;34;392690;19948;10077
24483;Saint-Perdoux;72;1436266;52174;29;1006214;43;430052;19948;10078
12219;Sainte-Eulalie-d'Olt;225;4488375;172498;98;3142853;127;1345522;19948;10079
76597;Saint-Laurent-en-Caux;433;8637730;376502;202;6198392;231;2439338;19949;10080
32382;Saint-Jean-Poutge;186;3710443;154545;94;2826425;92;884018;19949;10081
49225;Neuvy-en-Mauges;402;8019499;88958;202;5561111;200;2458388;19949;10082
61217;La Lande-de-Lougé;31;618436;15887;14;390524;17;227912;19950;10083
36148;Oulches;223;4448782;165567;102;3169701;121;1279081;19950;10084
16323;Saint-Germain-de-Montbron;300;5984922;317742;154;4600113;146;1384809;19950;10085
21505;Précy-sous-Thil;450;8977480;374988;214;6544335;236;2433145;19950;10086
54229;Glonville;208;4149642;77725;110;3017570;98;1132072;19950;10087
84015;Beaumont-du-Ventoux;155;3092453;128489;78;2398925;77;693528;19951;10088
22310;Saint-Laurent;268;5346964;104304;139;3983366;129;1363598;19951;10089
39429;Pleure;238;4748490;181529;112;3437151;126;1311339;19952;10090
11148;Fontcouverte;292;5825968;222282;124;4083299;168;1742669;19952;10091
07065;Chirols;154;3072613;127581;75;2339240;79;733373;19952;10092
18127;Lignières;887;17697504;754460;415;12788659;472;4908845;19952;10093
50207;Golleville;88;1755794;48327;39;1237360;49;518434;19952;10094
36034;Chabris;1698;33878965;1225545;901;25256380;797;8622585;19952;10095
49054;Candé;1518;30287848;747355;636;20940121;882;9347727;19952;10096
22116;Lanrodec;612;12211058;259024;310;9205418;302;3005640;19953;10097
16106;Confolens;1624;32403363;1532183;766;24465294;858;7938069;19953;10098
37268;Verneuil-le-Château;74;1476577;48918;37;1042098;37;434479;19954;10099
84003;Apt;6780;135291459;5596547;2982;99152623;3798;36138836;19954;10100
62179;Brunembert;182;3631723;55184;85;2606565;97;1025158;19955;10101
04049;Château-Arnoux-Saint-Auban;3141;62679298;2332223;1655;47772215;1486;14907083;19955;10102
80716;Saint-Riquier;736;14687672;669531;358;11252683;378;3434989;19956;10103
22309;Saint-Launeuc;115;2294952;98773;56;1733566;59;561386;19956;10104
32414;Sarragachies;150;2993421;72916;73;2049763;77;943658;19956;10105
56111;Limerzel;746;14887456;420584;378;10729840;368;4157616;19956;10106
58033;Bitry;196;3911531;143856;104;3013508;92;898023;19957;10107
42278;Saint-Priest-la-Vêtre;88;1756256;32785;53;1323503;35;432753;19957;10108
34144;Lunas;350;6985113;259080;155;5063974;195;1921139;19957;10109
21636;Thury;165;3293029;118117;70;2221613;95;1071416;19958;10110
85157;Moutiers-sur-le-Lay;404;8063112;235054;199;5980393;205;2082719;19958;10111
09284;Ségura;99;1975883;69154;47;1532771;52;443112;19958;10112
02101;Bosmont-sur-Serre;103;2055749;88225;51;1526035;52;529714;19959;10113
07050;Chambonas;401;8003648;321093;188;5972109;213;2031539;19959;10114
33388;Saint-Ciers-de-Canesse;418;8343124;223131;193;6008523;225;2334601;19960;10115
63066;Celles-sur-Durolle;996;19879797;598894;484;14181313;512;5698484;19960;10116
61451;Saint-Quentin-les-Chardonnets;184;3672621;86598;97;2678418;87;994203;19960;10117
82082;Lacapelle-Livron;108;2155753;62098;52;1535165;56;620588;19961;10118
72049;La Bruère-sur-Loir;136;2714670;41241;65;1970643;71;744027;19961;10119
19121;Lubersac;1387;27686533;1047748;679;20315206;708;7371327;19961;10120
16309;Sainte-Colombe;108;2155847;108717;46;1493383;62;662464;19962;10121
63291;Puy-Guillaume;1620;32337812;1338262;791;23864283;829;8473529;19962;10122
17359;Saint-Mard;634;12656050;325418;320;9480801;314;3175249;19962;10123
08141;Dommery;100;1996223;47087;47;1436696;53;559527;19962;10124
61376;Saint-Clair-de-Halouze;485;9681777;168823;266;7178452;219;2503325;19962;10125
30251;Saint-Étienne-des-Sorts;315;6288173;196458;167;4812378;148;1475795;19962;10126
37012;Avon-les-Roches;307;6128481;194202;154;4493309;153;1635172;19962;10127
52431;Rochetaillée;83;1656914;35160;43;1211966;40;444948;19963;10128
42121;Lérigneux;80;1597051;34438;37;1145674;43;451377;19963;10129
70012;Amance;380;7586015;235259;197;5530897;183;2055118;19963;10130
24335;Port-Sainte-Foy-et-Ponchapt;1483;29605785;1366732;659;21575051;824;8030734;19963;10131
88324;La Neuveville-sous-Châtenois;212;4232258;96906;116;3154516;96;1077742;19963;10132
63031;Beaulieu;260;5190566;147860;144;4058729;116;1131837;19964;10133
35169;Maxent;730;14573519;376062;361;10459532;369;4113987;19964;10134
58032;Billy-sur-Oisy;237;4731512;159219;120;3436390;117;1295122;19964;10135
71243;Joudes;215;4292371;103335;121;3205442;94;1086929;19965;10136
35026;Bléruais;53;1058133;8609;28;744980;25;313153;19965;10137
39093;Chamblay;234;4671814;131715;108;3230716;126;1441098;19965;10138
22390;Yvias;407;8126017;224318;197;5888871;210;2237146;19966;10139
51284;Haussignémont;151;3014829;58992;80;2183630;71;831199;19966;10140
14347;Jurques;357;7127896;171179;188;5233892;169;1894004;19966;10141
76029;Aubermesnil-aux-Érables;109;2176338;67616;51;1517825;58;658513;19966;10142
24150;Daglan;344;6868463;273731;162;5132219;182;1736244;19966;10143
60053;Beaulieu-les-Fontaines;319;6369730;254680;154;4837537;165;1532193;19968;10144
70463;Saint-Gand;64;1277961;9790;32;857913;32;420048;19968;10145
49314;Saint-Quentin-en-Mauges;530;10583476;154721;246;6934325;284;3649151;19969;10146
45030;Beaune-la-Rolande;1234;24642915;999307;604;18157074;630;6485841;19970;10147
87033;Chamboret;426;8507202;199963;230;6411778;196;2095424;19970;10148
16247;Nonaville;111;2216679;100187;51;1590182;60;626497;19970;10149
11278;Pech-Luna;57;1138301;44112;26;915529;31;222772;19970;10150
02008;Aizy-Jouy;149;2975625;61492;65;1999948;84;975677;19971;10151
87106;Nexon;1487;29696665;1036362;732;22666547;755;7030118;19971;10152
79156;Louin;419;8367891;168172;218;5956875;201;2411016;19971;10153
35113;La Fontenelle;280;5591918;125795;139;4075234;141;1516684;19971;10154
34130;Laurens;820;16376845;620944;348;11491115;472;4885730;19972;10155
26347;Tain-l'Hermitage;3510;70101137;2770489;1824;53829049;1686;16272088;19972;10156
85065;Chavagnes-en-Paillers;1864;37227615;656774;955;27114888;909;10112727;19972;10157
19081;Eyrein;324;6470958;213732;166;4764747;158;1706211;19972;10158
36080;Frédille;39;778921;16815;20;530246;19;248675;19972;10159
62432;Herbinghen;206;4114320;93492;97;2855441;109;1258879;19972;10160
44180;Saint-Mars-la-Jaille;1324;26443846;807001;609;18584825;715;7859021;19973;10161
45199;Melleroy;309;6171874;196526;183;4824714;126;1347160;19974;10162
80005;Agenville;49;978727;24263;18;597156;31;381571;19974;10163
29162;Pleyben;2047;40887317;1116724;970;29376839;1077;11510478;19974;10164
45079;Le Charme;93;1857654;67865;46;1442206;47;415448;19975;10165
21474;Pagny-la-Ville;218;4354527;106775;117;3274197;101;1080330;19975;10166
17278;Pisany;335;6691660;157712;165;5036369;170;1655291;19975;10167
57488;Moussey;330;6591893;212230;164;4826067;166;1765826;19975;10168
88024;Avrainville;53;1058705;20024;27;775609;26;283096;19976;10169
53113;Hambers;325;6492120;233829;158;4774627;167;1717493;19976;10170
88334;Oëlleville;155;3096358;82635;74;2228500;81;867858;19977;10171
33348;Queyrac;832;16620521;789147;380;12328886;452;4291635;19977;10172
56117;Locminé;2404;48025071;1872595;1250;36903121;1154;11121950;19977;10173
40024;Banos;143;2856760;49784;71;2107241;72;749519;19977;10174
61320;Orville;57;1138710;35016;33;919102;24;219608;19977;10175
40140;Lagrange;117;2337411;58216;48;1485052;69;852359;19978;10176
40042;Biarrotte;153;3056626;73993;94;2497939;59;558687;19978;10177
52371;Oudincourt;84;1678192;39831;35;1134420;49;543772;19978;10178
50161;Le Dézert;292;5833752;200859;129;4049210;163;1784542;19979;10179
33355;Rions;922;18420714;691549;466;14031048;456;4389666;19979;10180
85204;Saint-Christophe-du-Ligneron;1337;26713144;529357;657;18925474;680;7787670;19980;10181
39415;Petit-Noir;597;11928048;480479;286;8707908;311;3220140;19980;10182
71478;Saint-Romain-sous-Versigny;53;1058951;33441;25;731534;28;327417;19980;10183
58209;Perroy;99;1978044;69539;51;1505074;48;472970;19980;10184
09188;Mercus-Garrabet;665;13287145;391751;341;9743384;324;3543761;19981;10185
71548;Tronchy;132;2637484;59511;67;1895978;65;741506;19981;10186
18054;Charly;147;2937210;131788;68;2186757;79;750453;19981;10187
72112;Dangeul;272;5434863;134754;149;4163489;123;1271374;19981;10188
70240;Fontaine-lès-Luxeuil;765;15285678;393202;403;11150176;362;4135502;19981;10189
62530;Lottinghen;274;5474952;144485;123;3738928;151;1736024;19982;10190
30162;Massillargues-Attuech;382;7633096;247360;171;5432503;211;2200593;19982;10191
60497;Le Plessier-sur-Bulles;103;2058145;41222;64;1616587;39;441558;19982;10192
59269;Gouzeaucourt;735;14686901;344799;340;10188249;395;4498652;19982;10193
62421;Havrincourt;207;4136331;85615;92;2705293;115;1431038;19982;10194
36033;Celon;221;4416099;195221;115;3326874;106;1089225;19982;10195
39160;Commenailles;446;8912241;260329;210;6414554;236;2497687;19983;10196
55474;Sauvigny;148;2957524;110890;72;2146313;76;811211;19983;10197
82063;Garganvillar;331;6614482;148163;153;4633616;178;1980866;19983;10198
36162;Poulaines;525;10491409;326894;259;7785504;266;2705905;19984;10199
89387;Sens;15490;309551541;16657705;7419;238406203;8071;71145338;19984;10200
33472;Saint-Sauveur-de-Puynormand;203;4057024;84682;111;3052471;92;1004553;19985;10201
49367;Vern-d'Anjou;1107;22124082;348514;504;15043362;603;7080720;19986;10202
35092;Cuguen;420;8393986;204109;222;6217832;198;2176154;19986;10203
29152;Motreff;390;7794470;276274;198;5783933;192;2010537;19986;10204
46312;Strenquels;162;3237798;109776;78;2343471;84;894327;19986;10205
33327;Podensac;1612;32218404;1180239;770;23822466;842;8395938;19987;10206
35172;Meillac;932;18627792;346609;485;13465302;447;5162490;19987;10207
82055;Esparsac;139;2778292;97130;67;2013000;72;765292;19988;10208
54230;Gogney;31;619624;17814;18;494474;13;125150;19988;10209
58270;Saint-Vérain;216;4317508;155126;122;3437246;94;880262;19988;10210
86073;Cherves;309;6176439;227889;133;4322906;176;1853533;19988;10211
50019;Aucey-la-Plaine;235;4697294;101621;125;3440650;110;1256644;19988;10212
53100;Fougerolles-du-Plessis;724;14471910;447756;329;10152310;395;4319600;19989;10213
21232;Dompierre-en-Morvan;120;2398678;86553;56;1651616;64;747062;19989;10214
40237;Préchacq-les-Bains;385;7695789;176136;195;5574274;190;2121515;19989;10215
49038;Bourg-l'Évêque;119;2378751;38617;62;1741316;57;637435;19990;10216
80775;Valines;395;7896357;331473;213;6059894;182;1836463;19991;10217
18286;Villequiers;284;5677413;209631;139;4241023;145;1436390;19991;10218
42213;Saint-Cyr-de-Valorges;168;3358506;58781;85;2423060;83;935446;19991;10219
24104;Chantérac;336;6717042;204974;183;5167211;153;1549831;19991;10220
88141;Dombrot-sur-Vair;140;2798818;65772;78;2206804;62;592014;19992;10221
89296;Perrigny-sur-Armançon;78;1559383;62542;35;1149527;43;409856;19992;10222
42002;Ailleux;93;1859278;57354;48;1405265;45;454013;19992;10223
17434;Surgères;3870;77372018;3126331;1851;57842484;2019;19529534;19993;10224
49204;Le Mesnil-en-Vallée;742;14834774;178803;361;10378150;381;4456624;19993;10225
43130;Mazet-Saint-Voy;631;12615821;407243;272;8750664;359;3865157;19993;10226
76520;Réalcamp;367;7337678;221973;187;5442688;180;1894990;19994;10227
73181;Moûtiers;2222;44428408;2251335;1098;33239737;1124;11188671;19995;10228
73171;Montmélian;2232;44629217;1492900;1229;33970447;1003;10658770;19995;10229
31327;Mauran;92;1839580;51125;47;1324708;45;514872;19995;10230
02398;Juvigny;148;2959337;37567;70;1976341;78;982996;19996;10231
70421;Port-sur-Saône;1719;34372593;1166847;935;26574223;784;7798370;19996;10232
46160;Latronquière;286;5718773;201750;119;4109640;167;1609133;19996;10233
47323;Villeneuve-sur-Lot;14310;286142898;13097555;6418;211402429;7892;74740469;19996;10234
14513;Pont-Farcy;279;5579047;70553;118;3985994;161;1593053;19997;10235
24004;Ajat;193;3859479;123964;94;2940721;99;918758;19997;10236
02109;La Bouteille;281;5619318;225022;129;4155369;152;1463949;19998;10237
39028;Aumont;251;5019414;134167;133;3711240;118;1308174;19998;10238
03097;Deneuille-les-Mines;196;3919546;90751;100;2827686;96;1091860;19998;10239
57692;Vannecourt;41;819909;30427;20;632882;21;187027;19998;10240
34157;Mèze;6514;130265846;5294985;3101;97414105;3413;32851741;19998;10241
87161;Saint-Léonard-de-Noblat;2859;57175089;2284986;1354;42012622;1505;15162467;19998;10242
49268;Sainte-Christine;376;7519419;81381;182;5037571;194;2481848;19998;10243
86137;Loudun;4218;84353569;4007192;1944;62759019;2274;21594550;19998;10244
58120;Gâcogne;162;3239754;107585;72;2405383;90;834371;19998;10245
30289;Saint-Nazaire-des-Gardies;44;879935;37746;17;640557;27;239378;19999;10246
35071;Le Châtellier;215;4299693;120563;96;2966776;119;1332917;19999;10247
60291;Guiscard;977;19538863;652491;469;14182768;508;5356095;19999;10248
56154;Peillac;1043;20858789;586735;528;15370846;515;5487943;19999;10249
24474;Saint-Pancrace;93;1859994;57597;56;1485646;37;374348;20000;10250
21683;Viévy;201;4020068;128078;95;2872887;106;1147181;20000;10251
72221;Nogent-sur-Loir;209;4180111;104272;106;3178919;103;1001192;20001;10252
58089;Couloutre;135;2700122;130736;69;2123631;66;576491;20001;10253
86123;Lavausseau;436;8720400;215555;199;6106824;237;2613576;20001;10254
24170;Eyvirat;156;3120204;60983;70;2255445;86;864759;20001;10255
12052;Capdenac-Gare;2713;54263630;1908946;1405;40713810;1308;13549820;20001;10256
21528;La Roche-Vanneau;76;1520115;44137;38;1043162;38;476953;20002;10257
22107;Laniscat;488;9760750;293597;225;7023218;263;2737532;20002;10258
24352;Ribérac;2473;49463850;2521888;1115;37028878;1358;12434972;20002;10259
21674;Veuxhaulles-sur-Aube;147;2940263;141983;71;2132506;76;807757;20002;10260
02293;Étaves-et-Bocquiaux;307;6140592;179563;140;4189715;167;1950877;20002;10261
34212;Poujols;98;1960221;61447;54;1514531;44;445690;20002;10262
08179;Francheval;340;6800796;221384;173;5007907;167;1792889;20002;10263
26220;Nyons;4392;87851091;4134561;1982;64212750;2410;23638341;20003;10264
02332;Fresnes-en-Tardenois;146;2920394;93126;76;2200595;70;719799;20003;10265
49252;Le Puiset-Doré;585;11701732;159272;297;8273437;288;3428295;20003;10266
61350;La Roche-Mabile;90;1800270;62483;42;1333166;48;467104;20003;10267
70544;La Vergenne;65;1300197;37408;30;883981;35;416216;20003;10268
42209;Sainte-Colombe-sur-Gand;210;4200770;82832;99;2817987;111;1382783;20004;10269
70265;Germigney;86;1720365;41277;43;1223109;43;497256;20004;10270
70234;Filain;117;2340513;54792;61;1739054;56;601459;20004;10271
58053;Champlemy;220;4401014;200432;105;3238009;115;1163005;20005;10272
24281;Monsac;110;2200519;78726;52;1548397;58;652122;20005;10273
11324;Roubia;259;5181525;202215;107;3575939;152;1605586;20006;10274
27198;Damville;1181;23626980;1036277;603;17970560;578;5656420;20006;10275
38521;La Valette;40;800257;26200;23;640089;17;160168;20006;10276
52163;Dampierre;195;3901329;88582;110;3035803;85;865526;20007;10277
71543;Tournus;3609;72204868;3325927;1733;54063205;1876;18141663;20007;10278
14116;Le Bû-sur-Rouvres;67;1340468;39984;41;1080263;26;260205;20007;10279
46067;Cazillac;218;4361534;100857;104;3032883;114;1328651;20007;10280
12012;Asprières;417;8343022;286040;214;6188562;203;2154460;20007;10281
79076;La Chapelle-Saint-Laurent;1042;20847784;492113;473;14767643;569;6080141;20007;10282
50098;Carantilly;339;6782826;113696;185;4983739;154;1799087;20008;10283
33346;Puybarban;214;4281897;173807;90;2961616;124;1320281;20009;10284
46048;Calviac;97;1940879;95045;35;1321927;62;618952;20009;10285
62102;Bécourt;128;2561166;50776;57;1697657;71;863509;20009;10286
80477;Ligescourt;129;2581181;95989;58;1792880;71;788301;20009;10287
62715;Rocquigny;148;2961364;65801;70;2006928;78;954436;20009;10288
03129;Hyds;190;3801773;126690;109;3024888;81;776885;20009;10289
52504;Varennes-sur-Amance;249;4982387;260382;120;3633209;129;1349178;20010;10290
29067;Guerlesquin;784;15687665;550366;391;11411048;393;4276617;20010;10291
57417;Lostroff;36;720354;13636;23;578126;13;142228;20010;10292
26226;Le Pègue;233;4662321;149701;133;3622764;100;1039557;20010;10293
31059;Belbèze-en-Comminges;56;1120590;39195;30;874398;26;246192;20011;10294
37226;Sainte-Maure-de-Touraine;2454;49106029;1896161;1178;35803820;1276;13302209;20011;10295
36201;Saint-Martin-de-Lamps;97;1941062;55060;50;1434773;47;506289;20011;10296
19140;Monceaux-sur-Dordogne;389;7784389;277446;181;5668712;208;2115677;20011;10297
61307;Neuville-sur-Touques;148;2961672;94539;78;2371240;70;590432;20011;10298
29185;Plouescat;2170;43424705;1595299;997;31595203;1173;11829502;20011;10299
70462;Saint-Ferjeux;45;900521;27231;20;622806;25;277715;20012;10300
72218;Neuvillette-en-Charnie;160;3201883;69477;79;2293530;81;908353;20012;10301
70371;Montureux-et-Prantigny;120;2401432;73950;64;1704169;56;697263;20012;10302
55462;Saint-Maurice-sous-les-Côtes;204;4082535;85758;109;2982845;95;1099690;20012;10303
24418;Saint-Germain-du-Salembre;504;10086401;236430;263;7552614;241;2533787;20013;10304
71271;Mailly;99;1981327;75311;45;1499928;54;481399;20013;10305
55375;Nantillois;38;760521;28672;18;583880;20;176641;20014;10306
52325;Millières;70;1401000;45001;40;1048153;30;352847;20014;10307
31454;Rieumes;1974;39508527;1481311;924;29342713;1050;10165814;20014;10308
54536;Tucquegnieux;1509;30202597;911080;588;18293167;921;11909430;20015;10309
15235;Les Ternes;312;6244715;161937;143;4381576;169;1863139;20015;10310
18056;Chassy;145;2902342;115419;75;2215453;70;686889;20016;10311
86072;Chenevelles;256;5124140;153797;121;3715630;135;1408510;20016;10312
28018;Authon-du-Perche;721;14431799;533164;325;10072808;396;4358991;20016;10313
88156;Doncières;78;1561345;35852;47;1224337;31;337008;20017;10314
43258;Vergongheon;1025;20517922;620671;536;15309425;489;5208497;20017;10315
18183;Le Pondy;81;1621446;63206;43;1253121;38;368325;20018;10316
50476;Saint-Germain-d'Elle;111;2221986;29442;48;1500474;63;721512;20018;10317
22220;Plouguernével;1019;20398479;756925;534;15880294;485;4518185;20018;10318
46036;Le Bouyssou;75;1501365;42678;36;1022497;39;478868;20018;10319
15194;Saint-Julien-de-Toursac;68;1361302;45795;27;893064;41;468238;20019;10320
40104;Gamarde-les-Bains;641;12832599;404510;317;9742276;324;3090323;20020;10321
27643;Tillières-sur-Avre;658;13173265;534614;341;10227480;317;2945785;20020;10322
80298;Étricourt-Manancourt;275;5505687;152630;129;4050768;146;1454919;20021;10323
25264;Gémonval;47;940999;31459;22;661379;25;279620;20021;10324
32182;Lahas;101;2022206;98666;48;1543261;53;478945;20022;10325
61058;Bréel;77;1541697;70091;35;1094548;42;447149;20022;10326
21093;Bouix;96;1922133;60535;57;1465137;39;456996;20022;10327
41043;Châtillon-sur-Cher;936;18740978;528961;468;13619307;468;5121671;20022;10328
10319;Rigny-le-Ferron;214;4284805;146401;109;3087137;105;1197668;20022;10329
29183;Plouégat-Moysan;348;6967818;126278;183;5007036;165;1960782;20022;10330
71025;Beaubery;204;4084751;83037;97;2941493;107;1143258;20023;10331
11434;Villepinte;625;12514924;411350;304;9144612;321;3370312;20024;10332
24411;Saint-Front-sur-Nizonne;93;1862258;54927;53;1477823;40;384435;20024;10333
24395;Saint-Cybranet;220;4405369;119098;118;3220144;102;1185225;20024;10334
82134;Nègrepelisse;2855;57172705;2137195;1306;42065959;1549;15106746;20025;10335
57405;Lindre-Haute;31;620810;19443;19;475975;12;144835;20026;10336
38329;Quet-en-Beaumont;36;720974;21150;16;478653;20;242321;20027;10337
50515;Saint-Martin-de-Landelles;646;12937500;468718;307;9316238;339;3621262;20027;10338
88467;Thiéfosse;344;6889471;139969;187;5058906;157;1830565;20028;10339
46093;Espagnac-Sainte-Eulalie;45;901286;53576;17;667614;28;233672;20029;10340
89129;Crain;242;4846960;182802;134;3764581;108;1082379;20029;10341
62789;Senlecques;122;2443561;25056;65;1747641;57;695920;20029;10342
88477;Trampot;66;1321937;62319;28;865620;38;456317;20029;10343
21419;Molesme;142;2844181;86383;70;1958403;72;885778;20029;10344
41263;Tréhet;63;1261863;33680;32;946068;31;315795;20030;10345
28327;Saint-Bomer;120;2403591;80994;65;1922058;55;481533;20030;10346
40100;Le Frêche;212;4246366;168691;104;3152232;108;1094134;20030;10347
37177;Orbigny;412;8252537;284227;191;5895628;221;2356909;20030;10348
11233;Mirepeisset;404;8092311;238820;193;5856459;211;2235852;20030;10349
31193;Le Fousseret;1027;20573411;676471;467;14795977;560;5777434;20033;10350
31502;Saint-Marcet;235;4707698;221659;114;3492453;121;1215245;20033;10351
02831;Watigny;199;3986563;100220;91;2782272;108;1204291;20033;10352
87100;Montrol-Sénard;163;3265412;139373;74;2423099;89;842313;20033;10353
08496;Wagnon;65;1302181;27580;28;919367;37;382814;20034;10354
08280;Marvaux-Vieux;43;861461;18997;20;614525;23;246936;20034;10355
31372;Montespan;277;5549511;212352;146;4296428;131;1253083;20034;10356
59068;Berlaimont;1782;35701594;1674136;836;26748122;946;8953472;20035;10357
47231;Saint-Avit;93;1863218;51823;41;1320504;52;542714;20035;10358
60544;Rocquencourt;103;2063647;55986;57;1590799;46;472848;20035;10359
19251;Sarran;163;3265795;112769;82;2421864;81;843931;20036;10360
21328;Juillenay;27;540970;18820;16;465892;11;75078;20036;10361
17445;Thézac;184;3686700;158230;85;2725223;99;961477;20036;10362
60011;Amy;208;4167578;126340;111;3229399;97;938179;20036;10363
24068;Le Buisson-de-Cadouin;1257;25185800;957996;580;18570546;677;6615254;20036;10364
07332;Valvignères;244;4888893;113194;118;3463519;126;1425374;20036;10365
59410;Mons-en-Baroeul;11235;225111038;9855912;5433;171704055;5802;53406983;20037;10366
62411;Haravesnes;27;540996;14791;11;343133;16;197863;20037;10367
79345;Verruyes;491;9838123;270002;222;6904502;269;2933621;20037;10368
72256;Rouez;397;7954763;183453;208;5927431;189;2027332;20037;10369
08007;Les Alleux;42;841563;23958;24;668840;18;172723;20037;10370
07023;Balazuc;216;4328091;153386;103;3269863;113;1058228;20037;10371
26113;Die;2893;57969772;2557728;1327;42104777;1566;15864995;20038;10372
17104;Chevanceaux;573;11481742;559641;257;8537251;316;2944491;20038;10373
21562;Saint-Maurice-sur-Vingeanne;124;2484707;85129;56;1728924;68;755783;20038;10374
40182;Mézos;517;10359697;394377;248;7541490;269;2818207;20038;10375
37199;Rilly-sur-Vienne;259;5189876;133271;139;3854344;120;1335532;20038;10376
62551;Marenla;127;2544859;54651;66;1847666;61;697193;20038;10377
49237;La Pellerine;86;1723317;98900;36;1195324;50;527993;20039;10378
34149;Margon;287;5751074;154160;145;4164698;142;1586376;20039;10379
63253;Noalhat;128;2564968;58784;73;1979926;55;585042;20039;10380
63353;Saint-Germain-l'Herm;293;5871406;237038;138;4291385;155;1580021;20039;10381
70466;Saint-Loup-Nantouard;68;1362690;30137;41;1061750;27;300940;20040;10382
22020;Broons;1668;33425999;976359;748;24208098;920;9217901;20040;10383
15120;Mauriac;2332;46733057;2231287;1049;33482520;1283;13250537;20040;10384
02758;Vailly-sur-Aisne;1247;24990863;1073499;575;18050516;672;6940347;20041;10385
19155;Orliac-de-Bar;143;2865875;65901;74;2046036;69;819839;20041;10386
52053;Blaisy;45;901850;27871;24;679882;21;221968;20041;10387
40090;Donzacq;232;4649602;124835;112;3287408;120;1362194;20041;10388
63080;Champeix;755;15131475;598074;363;11451250;392;3680225;20042;10389
52235;Hallignicourt;155;3106475;104788;79;2248928;76;857547;20042;10390
61439;Saint-Ouen-le-Brisoult;65;1302725;55847;28;809587;37;493138;20042;10391
55255;Jametz;130;2605468;51402;59;1635395;71;970073;20042;10392
08114;Chéhéry;64;1282708;19247;36;970002;28;312706;20042;10393
86116;Jazeneuil;465;9319873;266073;237;7349198;228;1970675;20043;10394
40144;Larbey;144;2886163;114510;71;2161394;73;724769;20043;10395
24322;Périgueux;19052;381857865;20527581;9471;300546973;9581;81310892;20043;10396
48022;Bédouès;162;3247019;81191;80;2372518;82;874501;20043;10397
24155;Douville;254;5091096;180661;119;3703875;135;1387221;20044;10398
61327;Pervenchères;181;3627951;177348;70;2517597;111;1110354;20044;10399
70002;Aboncourt-Gesincourt;124;2485500;77800;61;1730059;63;755441;20044;10400
53257;Saulges;170;3407558;99322;90;2544041;80;863517;20044;10401
2B029;Barbaggio;141;2826305;100170;65;2060091;76;766214;20045;10402
17160;Floirac;183;3668280;77200;80;2485617;103;1182663;20045;10403
71300;Le Miroir;318;6374493;170503;171;4864041;147;1510452;20046;10404
71291;Melay;509;10203222;260678;247;7155363;262;3047859;20046;10405
21281;Fontenelle;84;1683855;40310;42;1265149;42;418706;20046;10406
33361;Ruch;302;6053945;167440;143;4435928;159;1618017;20046;10407
71529;Suin;169;3387813;85133;66;2233985;103;1153828;20046;10408
40201;Mugron;800;16037076;641644;368;11517503;432;4519573;20046;10409
70122;Champlitte;1038;20808233;905014;490;15107733;548;5700500;20046;10410
46122;Gintrac;62;1242936;21845;35;962994;27;279942;20047;10411
02227;Courmont;75;1503553;43255;36;1138714;39;364839;20047;10412
02110;Braine;1254;25139647;1145128;574;18140432;680;6999215;20048;10413
62522;Loison-sur-Créquoise;135;2706441;86070;69;2019391;66;687050;20048;10414
58132;Guipy;147;2947032;92848;78;2210834;69;736198;20048;10415
24544;Tamniès;210;4210090;140723;101;3055397;109;1154693;20048;10416
30008;Allègre-les-Fumades;480;9623130;403692;216;6966360;264;2656770;20048;10417
62020;Alembon;299;5994451;132544;143;4377664;156;1616787;20048;10418
58194;Nevers;21345;427932251;22680567;10707;335672947;10638;92259304;20048;10419
24444;Saint-Louis-en-l'Isle;142;2846902;78782;71;2097284;71;749618;20049;10420
51311;Jussecourt-Minecourt;113;2265513;49844;57;1668851;56;596662;20049;10421
32340;Réans;157;3147823;108180;77;2366638;80;781185;20050;10422
97401;Les Avirons;5715;114585449;4150616;1875;76956586;3840;37628863;20050;10423
80678;Rollot;397;7960084;249996;205;5827316;192;2132768;20051;10424
53266;Trans;126;2526402;68015;61;1790324;65;736078;20051;10425
49002;Allonnes;1560;31279386;678857;722;21995649;838;9283737;20051;10426
37180;Parçay-sur-Vienne;343;6877491;136053;181;5091062;162;1786429;20051;10427
23228;Saint-Pardoux-le-Neuf;109;2185604;68308;57;1675400;52;510204;20051;10428
25591;Vaufrey;86;1724431;70410;42;1360225;44;364206;20052;10429
51104;Cernay-en-Dormois;63;1263262;52719;27;902774;36;360488;20052;10430
61415;Saint-Léger-sur-Sarthe;178;3569240;83519;80;2476275;98;1092965;20052;10431
11232;Miraval-Cabardes;23;461198;23740;12;354177;11;107021;20052;10432
08063;La Besace;76;1523976;47100;41;1191834;35;332142;20052;10433
58123;Germenay;83;1664379;30971;39;1179016;44;485363;20053;10434
54228;Giriviller;33;661761;18171;15;439585;18;222176;20053;10435
02409;Lappion;166;3328886;93165;77;2373700;89;955186;20054;10436
79309;Scillé;211;4231445;128448;103;3105641;108;1125804;20054;10437
53161;Montsûrs;1167;23404390;751349;528;16370041;639;7034349;20055;10438
77260;Longueville;957;19193427;608330;493;14179542;464;5013885;20056;10439
36078;Fougerolles;188;3770532;79907;89;2484714;99;1285818;20056;10440
35309;Saint-Rémy-du-Plain;388;7781738;107587;181;5312958;207;2468780;20056;10441
88342;Pallegney;95;1905324;57420;53;1486996;42;418328;20056;10442
68274;Rimbach-près-Guebwiller;111;2226257;106748;51;1675695;60;550562;20056;10443
14122;La Caine;62;1243505;9397;28;813406;34;430099;20057;10444
22247;Pommerit-Jaudy;580;11633228;347198;282;8472541;298;3160687;20057;10445
67386;Rauwiller;127;2547331;59933;62;1888786;65;658545;20058;10446
24377;Saint-Avit-de-Vialard;79;1584620;34767;37;1197017;42;387603;20058;10447
61012;Auguaise;91;1825324;47861;55;1456074;36;369250;20059;10448
14688;Thiéville;157;3149221;104505;83;2394297;74;754924;20059;10449
17446;Thors;250;5014741;147237;119;3749804;131;1264937;20059;10450
16189;Londigny;143;2868439;105060;57;1948790;86;919649;20059;10451
80826;Woignarue;470;9427944;269665;252;7003425;218;2424519;20059;10452
40096;Estigarde;53;1063161;28289;24;768535;29;294626;20060;10453
21101;Braux;98;1965851;79896;50;1469324;48;496527;20060;10454
2B086;Centuri;119;2387145;158766;45;1667899;74;719246;20060;10455
47232;Saint-Barthélemy-d'Agenais;295;5917775;343537;124;4396056;171;1521719;20060;10456
86139;Lusignan;1531;30712776;1178464;719;22624239;812;8088537;20061;10457
02217;Coucy-le-Château-Auffrique;570;11435223;459882;256;8358239;314;3076984;20062;10458
80790;Verpillières;105;2106491;82929;52;1640734;53;465757;20062;10459
86066;Châtellerault;19509;391398631;20241347;9281;304887078;10228;86511553;20062;10460
63459;Villeneuve-les-Cerfs;252;5055801;113062;116;3773361;136;1282440;20063;10461
65442;Thermes-Magnoac;119;2387479;97412;54;1723064;65;664415;20063;10462
54033;Avillers;50;1003161;11508;19;543499;31;459662;20063;10463
35084;Comblessac;332;6661003;164505;164;4766493;168;1894510;20063;10464
50154;La Croix-Avranchin;237;4755149;75863;115;3385733;122;1369416;20064;10465
38553;Villefontaine;9142;183427873;5538610;4590;135858390;4552;47569483;20064;10466
25441;Ouvans;40;802573;26339;18;525404;22;277169;20064;10467
11398;Treilles;117;2347547;146652;46;1734226;71;613321;20065;10468
64062;Arudy;1318;26445050;890113;662;19384621;656;7060429;20065;10469
16375;Suaux;205;4113365;208882;76;2729204;129;1384161;20065;10470
57032;Ars-sur-Moselle;2775;55680971;2022646;1519;43180651;1256;12500320;20065;10471
54125;Chenevières;250;5016307;88325;140;3773846;110;1242461;20065;10472
57108;Breidenbach;194;3892732;139676;91;2754333;103;1138399;20066;10473
64040;Arette;553;11096328;424469;271;8313903;282;2782425;20066;10474
85095;Froidfond;842;16895573;266662;461;12522329;381;4373244;20066;10475
52365;Orges;221;4434620;140771;120;3255036;101;1179584;20066;10476
76083;Bertheauville;51;1023396;14942;27;793020;24;230376;20067;10477
27372;Longchamps;321;6441409;175041;168;4750970;153;1690439;20067;10478
59409;Monchecourt;1278;25645614;821765;634;18989529;644;6656085;20067;10479
36006;Argenton-sur-Creuse;3169;63593144;2789555;1463;46463017;1706;17130127;20067;10480
04208;Simiane-la-Rotonde;361;7244658;390812;161;5297886;200;1946772;20068;10481
43099;Frugerès-les-Mines;329;6602555;210798;191;5070000;138;1532555;20069;10482
59290;Haut-Lieu;264;5298167;218959;111;3804436;153;1493731;20069;10483
42084;Débats-Rivière-d'Orpra;97;1946696;81285;40;1353939;57;592757;20069;10484
16047;Blanzaguet-Saint-Cybard;140;2809686;83958;68;2043403;72;766283;20069;10485
58311;Ville-Langy;166;3331506;96970;91;2526269;75;805237;20069;10486
71047;Bourbon-Lancy;3170;63620682;2233575;1653;47527579;1517;16093103;20070;10487
36093;Levroux;1698;34078406;1304999;813;24548262;885;9530144;20070;10488
71542;Toulon-sur-Arroux;943;18926011;670102;444;13689113;499;5236898;20070;10489
22066;Le Gouray;639;12825062;331865;306;9196302;333;3628760;20071;10490
56123;Malansac;1227;24626749;759343;600;17689458;627;6937291;20071;10491
54285;Juvrecourt;34;682405;28182;14;470076;20;212329;20071;10492
88244;La Houssière;312;6262126;184736;162;4557557;150;1704569;20071;10493
65315;Monléon-Magnoac;222;4456018;189765;105;3331218;117;1124800;20072;10494
70035;Augicourt;88;1766417;33745;42;1303889;46;462528;20073;10495
07346;Viviers;2222;44602543;1450945;1088;32954675;1134;11647868;20073;10496
24497;Sainte-Sabine-Born;211;4235455;169828;76;2924758;135;1310697;20073;10497
88485;La Vacheresse-et-la-Rouillie;76;1525607;45075;41;1134321;35;391286;20074;10498
79113;Étusson;184;3693715;50600;82;2570862;102;1122853;20075;10499
47275;Saint-Salvy;102;2047605;50100;45;1396075;57;651530;20075;10500
18055;Chârost;625;12547124;454741;319;9357629;306;3189495;20075;10501
70572;Vitrey-sur-Mance;168;3372675;131775;82;2473530;86;899145;20075;10502
60112;Brunvillers-la-Motte;184;3693959;127989;97;2841057;87;852902;20076;10503
71136;Clessy;145;2911038;75306;77;2164417;68;746621;20076;10504
50248;Le Hommet-d'Arthenay;166;3332688;70771;81;2388377;85;944311;20076;10505
52295;Louvières;66;1325047;51492;35;990087;31;334960;20076;10506
71093;La Chapelle-Saint-Sauveur;387;7770133;289302;177;5849214;210;1920919;20078;10507
62044;Attin;373;7489094;175594;195;5703018;178;1786076;20078;10508
02606;Le Plessier-Huleu;49;983868;37241;23;710971;26;272897;20079;10509
39266;Les Hays;188;3775039;136709;96;2831228;92;943811;20080;10510
89317;Prunoy;186;3734950;149483;102;2976831;84;758119;20080;10511
70001;Abelcourt;175;3514113;77151;93;2660949;82;853164;20081;10512
17078;Chadenac;240;4819416;218437;107;3477612;133;1341804;20081;10513
25567;Tournans;72;1445829;53522;38;1124990;34;320839;20081;10514
63331;Saint-Clément-de-Valorgue;131;2630644;51692;65;1926925;66;703719;20081;10515
34324;Valras-Plage;3316;66589979;3035433;1630;51162230;1686;15427749;20081;10516
03169;Meillard;156;3132792;124038;78;2420283;78;712509;20082;10517
39511;Sergenaux;30;602469;13655;16;422452;14;180017;20082;10518
51380;Montmirail;2138;42935974;1972666;1038;32164546;1100;10771428;20082;10519
72118;Dollon;814;16347076;369999;452;12347879;362;3999197;20082;10520
32033;Bazian;61;1225029;53549;30;994042;31;230987;20082;10521
36106;Luzeret;89;1787346;139593;27;1196263;62;591083;20083;10522
07190;Rochecolombe;124;2490299;82731;70;1919714;54;570585;20083;10523
54343;Mandres-aux-Quatre-Tours;96;1928026;40056;47;1367129;49;560897;20084;10524
61393;Saint-Germain-de-Clairefeuille;97;1948115;50208;48;1444182;49;503933;20084;10525
63019;Aulnat;2375;47699310;1503111;1330;36860602;1045;10838708;20084;10526
63040;Billom;2842;57079373;2130288;1408;43118845;1434;13960528;20084;10527
52384;Perrogney-les-Fontaines;83;1667106;60433;43;1274474;40;392632;20086;10528
05181;Villar-d'Arêne;165;3314193;110024;77;2412603;88;901590;20086;10529
05095;Le Noyer;157;3153574;124638;74;2338415;83;815159;20086;10530
50150;Crasville;147;2952744;57644;75;2129934;72;822810;20087;10531
36149;Palluau-sur-Indre;462;9280142;266233;224;6813802;238;2466340;20087;10532
14589;Saint-Germain-le-Vasson;522;10485535;269788;281;7972803;241;2512732;20087;10533
42094;Feurs;4751;95436114;3884062;2282;70812260;2469;24623854;20088;10534
56091;Josselin;1435;28825711;1123190;674;21438543;761;7387168;20088;10535
65117;Cadeilhan-Trachère;30;602642;22066;17;493366;13;109276;20088;10536
52199;Ferrière-et-Lafolie;33;662923;18823;18;499379;15;163544;20089;10537
36210;Sarzay;189;3796753;102200;94;2795695;95;1001058;20089;10538
62260;Croix-en-Ternois;165;3314679;80856;76;2267530;89;1047149;20089;10539
53134;Livet;77;1546880;50303;40;1129188;37;417692;20089;10540
02826;Voulpaix;202;4058118;97629;102;2989999;100;1068119;20090;10541
38092;Châtelus;53;1064793;23733;28;782572;25;282221;20090;10542
2A279;Serriera;70;1406343;59006;35;1010631;35;395712;20091;10543
25489;Reugney;148;2973511;56873;66;1999877;82;973634;20091;10544
56200;Ruffiac;769;15450216;342963;395;11353830;374;4096386;20091;10545
16222;Montboyer;237;4761681;239383;99;3415621;138;1346060;20091;10546
64251;Guinarthe-Parenties;130;2611901;79014;61;1742014;69;869887;20092;10547
52213;Genevrières;85;1707789;57769;40;1205181;45;502608;20092;10548
33184;Générac;309;6208478;298943;131;4561170;178;1647308;20092;10549
02050;Barzy-en-Thiérache;154;3094399;59977;86;2305576;68;788823;20094;10550
17139;Doeuil-sur-le-Mignon;197;3958464;91362;97;2793486;100;1164978;20094;10551
03104;Doyet;727;14608276;592644;360;10659961;367;3948315;20094;10552
82091;Lamothe-Cumont;62;1245824;25308;29;943066;33;302758;20094;10553
31321;Marsoulas;78;1567329;52460;39;1156770;39;410559;20094;10554
11069;Carcassonne;28117;564983022;30756391;13211;440210381;14906;124772641;20094;10555
28364;Sancheville;452;9082612;280070;215;6499580;237;2583032;20094;10556
80606;Oisemont;661;13282363;768376;305;9997312;356;3285051;20094;10557
57353;Juvelize;55;1105243;37943;29;853276;26;251967;20095;10558
40244;Rivière-Saas-et-Gourby;759;15252423;531861;384;12293897;375;2958526;20095;10559
61453;Saint-Sauveur-de-Carrouges;149;2994371;118110;75;2237713;74;756658;20096;10560
39090;Chaînée-des-Coupis;95;1909163;45207;45;1383019;50;526144;20096;10561
54273;Jarny;4917;98814530;3859650;2359;71689845;2558;27124685;20097;10562
31108;Cardeilhac;151;3034581;141271;69;2288375;82;746206;20097;10563
09150;Lagarde;115;2311223;95765;50;1621607;65;689616;20098;10564
02342;Gergny;76;1527440;36529;39;1123023;37;404417;20098;10565
35008;Availles-sur-Seiche;325;6532121;54930;167;4804165;158;1727956;20099;10566
08073;Bossus-lès-Rumigny;60;1205938;41494;27;898751;33;307187;20099;10567
89220;Lavau;283;5688082;267642;127;3961362;156;1726720;20099;10568
47112;Grateloup-Saint-Gayrand;244;4904269;129212;124;3617986;120;1286283;20099;10569
24372;Saint-Astier;3201;64340364;2459722;1583;48170954;1618;16169410;20100;10570
62839;Vaulx-Vraucourt;625;12562809;418079;290;9001123;335;3561686;20100;10571
62843;Verchin;137;2753775;90652;69;2049387;68;704388;20101;10572
02453;Maizy;219;4402176;80123;112;3210627;107;1191549;20101;10573
30214;Ribaute-les-Tavernes;1024;20583736;597873;463;14522134;561;6061602;20101;10574
12250;Saint-Symphorien-de-Thénières;117;2351941;85547;51;1753635;66;598306;20102;10575
79201;Pamproux;956;19217609;608079;450;13907060;506;5310549;20102;10576
28012;Arrou;1021;20524694;876731;482;14870500;539;5654194;20103;10577
63020;Aurières;174;3497843;81185;92;2723926;82;773917;20103;10578
33513;Sillas;71;1427286;61047;31;1107955;40;319331;20103;10579
57183;Donnelay;116;2331994;67149;61;1742431;55;589563;20103;10580
60509;Pont-Sainte-Maxence;6914;139003056;5857445;3673;109326483;3241;29676573;20105;10581
50035;Baudreville;54;1085693;32751;31;810539;23;275154;20105;10582
60405;Moliens;585;11761790;423961;301;8923950;284;2837840;20106;10583
31204;Fustignac;39;784129;12836;18;524429;21;259700;20106;10584
55362;Moulins-Saint-Hubert;97;1950330;42553;47;1333767;50;616563;20106;10585
68224;Mulhouse;58255;1171413149;70249105;25744;878912773;32511;292500376;20108;10586
02205;Colligis-Crandelain;97;1950547;31163;43;1324047;54;626500;20109;10587
86181;Nueil-sous-Faye;136;2734818;114778;51;1811180;85;923638;20109;10588
56189;Radenac;528;10618089;315709;272;7936821;256;2681268;20110;10589
80759;Tilloloy;218;4384024;120108;76;3317882;142;1066142;20110;10590
32131;Flamarens;83;1669152;64539;37;1250389;46;418763;20110;10591
44060;Le Fresne-sur-Loire;544;10940299;266715;256;7760155;288;3180144;20111;10592
82035;Caumont;173;3479230;105571;74;2392323;99;1086907;20111;10593
39326;Mesnois;108;2172051;50991;57;1602431;51;569620;20112;10594
71401;Sainte-Croix;357;7179876;201188;189;5370221;168;1809655;20112;10595
32283;Montégut-Arros;177;3559789;198875;87;2705996;90;853793;20112;10596
14672;Sept-Vents;208;4183288;91770;93;2839294;115;1343994;20112;10597
24255;Marquay;324;6516365;223612;170;5046831;154;1469534;20112;10598
38012;Aoste;1402;28197838;713470;740;20395029;662;7802809;20113;10599
57528;Oron;52;1045859;4233;29;738771;23;307088;20113;10600
55381;Neuville-lès-Vaucouleurs;93;1870492;24938;54;1412120;39;458372;20113;10601
30233;Saint-Bauzély;277;5571261;128051;134;4096035;143;1475226;20113;10602
17172;Gémozac;1617;32523088;1312856;736;23538041;881;8985047;20113;10603
21628;Thoires;42;844776;38159;20;633384;22;211392;20114;10604
25583;Valonne;120;2413665;46546;62;1713513;58;700152;20114;10605
53274;Vimarcé;135;2715381;114837;60;1831993;75;883388;20114;10606
41201;Saint-Arnoult;192;3862051;122543;102;2965205;90;896846;20115;10607
44218;Villepot;378;7603464;193842;189;5511440;189;2092024;20115;10608
47306;Le Temple-sur-Lot;551;11083427;305998;258;7885386;293;3198041;20115;10609
33296;Mouliets-et-Villemartin;595;11968664;477404;295;9183119;300;2785545;20115;10610
43264;Villeneuve-d'Allier;172;3459850;131209;70;2431049;102;1028801;20115;10611
35014;Bais;1188;23897139;536314;584;16975794;604;6921345;20115;10612
17023;Aujac;193;3882342;176609;90;2874633;103;1007709;20116;10613
61024;Banvou;340;6839454;173790;180;4963593;160;1875861;20116;10614
11049;Bram;1870;37617259;1358949;872;28029495;998;9587764;20116;10615
49356;Trémont;205;4123881;66583;100;2956916;105;1166965;20116;10616
33508;Savignac;314;6316635;144970;155;4592170;159;1724465;20117;10617
21502;Pouilly-sur-Saône;364;7322536;213387;182;5221230;182;2101306;20117;10618
85193;Rosnay;309;6216178;125118;156;4517755;153;1698423;20117;10619
88256;Jussarupt;151;3037814;85140;79;2180960;72;856854;20118;10620
03263;Saint-Voir;107;2152634;78125;52;1610309;55;542325;20118;10621
35192;Montreuil-des-Landes;131;2635497;101378;59;1795777;72;839720;20118;10622
14622;Saint-Martin-de-Blagny;76;1529032;59211;40;1208317;36;320715;20119;10623
86112;L'Isle-Jourdain;785;15793388;880003;320;11242040;465;4551348;20119;10624
59631;Walincourt-Selvigny;1133;22794899;826480;509;16397456;624;6397443;20119;10625
55496;Sorcy-Saint-Martin;568;11427657;238513;292;7945202;276;3482455;20119;10626
66212;Torreilles;2207;44402897;1733484;1142;34276460;1065;10126437;20119;10627
59623;Villers-Guislain;386;7766041;288437;181;5577848;205;2188193;20119;10628
81015;Appelle;38;764550;28753;15;535871;23;228679;20120;10629
64401;Mont-Disse;37;744485;20047;13;491500;24;252985;20121;10630
58248;Saint-Laurent-l'Abbaye;131;2635901;85738;71;1907082;60;728819;20121;10631
39571;Villers-Robert;125;2515300;82528;63;1961932;62;553368;20122;10632
07024;Banne;399;8028911;323806;187;5902790;212;2126121;20123;10633
50142;Cosqueville;336;6761373;211749;179;5117835;157;1643538;20123;10634
52536;Villiers-lès-Aprey;24;482964;8868;13;354031;11;128933;20124;10635
70187;Crevans-et-la-Chapelle-lès-Granges;142;2857595;69801;80;2195905;62;661690;20124;10636
36129;Montipouret;337;6781779;285015;170;5144607;167;1637172;20124;10637
02588;Pargnan;36;724481;17210;18;532127;18;192354;20124;10638
35157;Le Loroux;322;6480125;106561;159;4484848;163;1995277;20125;10639
85138;Martinet;477;9599679;157894;248;7150771;229;2448908;20125;10640
80764;Toeufles;176;3542021;139007;82;2688751;94;853270;20125;10641
70164;Colombotte;30;603788;-1417;15;390811;15;212977;20126;10642
11439;Villespy;205;4125896;134571;94;3012911;111;1112985;20126;10643
25449;Péseux;57;1147223;20461;26;799453;31;347770;20127;10644
88321;Neufchâteau;4217;84878139;4114009;1946;64669804;2271;20208335;20128;10645
16105;Condéon;317;6380501;201140;140;4485743;177;1894758;20128;10646
24067;Le Bugue;1731;34841609;1582329;777;25868735;954;8972874;20128;10647
80089;Berneuil;142;2858213;65104;72;2145003;70;713210;20128;10648
57532;Pagny-lès-Goin;140;2817973;80703;69;2064933;71;753040;20128;10649
50396;Les Perques;87;1751178;25101;40;1183152;47;568026;20128;10650
04132;Montsalier;66;1328484;42972;35;1031438;31;297046;20129;10651
25367;Mandeure;2859;57548027;1918592;1544;43219012;1315;14329015;20129;10652
83044;Comps-sur-Artuby;149;2999243;117128;76;2307600;73;691643;20129;10653
66130;Osséja;690;13889368;726640;356;10985293;334;2904075;20130;10654
40171;Mano;73;1469475;54275;38;1093825;35;375650;20130;10655
01380;Saint-Nizier-le-Bouchoux;367;7388152;259396;183;5593992;184;1794160;20131;10656
21537;Saffres;78;1570234;45132;39;1156497;39;413737;20131;10657
26021;Autichamp;74;1489790;52620;33;1074620;41;415170;20132;10658
62274;Dourges;2956;59511448;1875403;1438;43435564;1518;16075884;20132;10659
32119;Eauze;2441;49143826;2186425;1065;35676252;1376;13467574;20133;10660
59157;Cousolre;1344;27058617;1266967;670;20560619;674;6497998;20133;10661
04076;Entrevaux;515;10368610;509289;231;7630060;284;2738550;20133;10662
59547;Saint-Vaast-en-Cambrésis;473;9523191;320605;226;6810046;247;2713145;20134;10663
64388;Momy;68;1369089;41995;24;914729;44;454360;20134;10664
63154;Espirat;186;3744944;91413;90;2652937;96;1092007;20134;10665
49144;Freigné;573;11536910;246594;274;8096506;299;3440404;20134;10666
85252;Saint-Maurice-le-Girard;306;6161105;107028;152;4390317;154;1770788;20134;10667
01059;Brénaz;53;1067122;22473;26;775583;27;291539;20134;10668
62126;Beuvry;4904;98739655;3869500;2337;74187166;2567;24552489;20135;10669
08215;Harricourt;25;503366;9595;12;357408;13;145958;20135;10670
09331;Le Vernet;355;7148060;251518;188;5569018;167;1579042;20135;10671
62014;Aire-sur-la-Lys;5620;113164079;4924826;2542;84363795;3078;28800284;20136;10672
63414;Sauviat;304;6121438;182816;164;4629296;140;1492142;20136;10673
22200;Pléven;299;6020778;147436;135;3952693;164;2068085;20136;10674
81083;Durfort;142;2859374;93931;73;2131444;69;727930;20136;10675
04008;Annot;620;12484768;551761;315;9456977;305;3027791;20137;10676
89367;Saints;350;7047888;325751;153;4832382;197;2215506;20137;10677
57761;Zilling;147;2960148;73673;75;2164596;72;795552;20137;10678
57702;Vaxy;89;1792200;67614;38;1180988;51;611212;20137;10679
27462;Le Planquay;88;1772109;56727;47;1327210;41;444899;20138;10680
47162;Massoulès;115;2315855;112178;50;1639855;65;676000;20138;10681
89131;Cruzy-le-Châtel;157;3161659;77159;79;2260455;78;901204;20138;10682
51162;Conflans-sur-Seine;382;7692864;262065;194;5614388;188;2078476;20138;10683
57623;Saint-Quirin;462;9304098;306409;230;6832476;232;2471622;20139;10684
12198;Rieupeyroux;1133;22817541;889192;495;16294390;638;6523151;20139;10685
39202;Dournon;59;1188226;10367;32;875194;27;313032;20139;10686
73109;Épierre;429;8640043;284662;233;6620412;196;2019631;20140;10687
46314;Terrou;103;2074422;65635;52;1609153;51;465269;20140;10688
61093;Chanu;723;14561960;488333;343;10639114;380;3922846;20141;10689
59467;Pont-sur-Sambre;1346;27109839;998235;690;20593345;656;6516494;20141;10690
89405;Taingy;184;3705989;120277;97;2736911;87;969078;20141;10691
32156;Idrac-Respaillès;118;2376678;90958;52;1709486;66;667192;20141;10692
62725;Royon;69;1389753;28760;28;988812;41;400941;20141;10693
31427;Pointis-Inard;509;10251979;375744;273;7991630;236;2260349;20141;10694
02583;Pancy-Courtecon;36;725091;13838;17;552173;19;172918;20141;10695
02705;La Selve;107;2155172;53926;52;1566687;55;588485;20142;10696
31041;Bagiry;53;1067517;36824;24;741008;29;326509;20142;10697
47258;Sainte-Maure-de-Peyriac;195;3927825;160931;92;3029793;103;898032;20143;10698
39342;Monay;72;1450322;35736;35;1075665;37;374657;20143;10699
71205;Frangy-en-Bresse;352;7090557;283661;149;4913310;203;2177247;20144;10700
43199;Saint-Jeures;533;10736576;330500;238;7512973;295;3223603;20144;10701
10080;Chaource;612;12328334;509450;287;8904044;325;3424290;20144;10702
14762;Vire;6973;140479886;6629453;3257;105955263;3716;34524623;20146;10703
62484;Lagnicourt-Marcel;181;3646475;127173;79;2479131;102;1167344;20146;10704
24296;Mouleydier;657;13236327;360555;338;9869409;319;3366918;20147;10705
16228;Montigné;86;1732615;60632;40;1270527;46;462088;20147;10706
54594;Xammes;71;1430438;17749;31;907457;40;522981;20147;10707
42173;Pommiers;212;4271209;100502;113;3179150;99;1092059;20147;10708
65224;Houeydets;127;2558761;84596;79;2133227;48;425534;20148;10709
52356;Nomécourt;56;1128273;30272;32;894694;24;233579;20148;10710
17151;L'Éguille;543;10940273;468142;268;8078168;275;2862105;20148;10711
57504;Niderhoff;175;3525998;100622;96;2650847;79;875151;20149;10712
59400;Merville;4874;98206938;2962384;2357;71356019;2517;26850919;20149;10713
50348;Montmartin-en-Graignes;294;5923981;196791;144;4242309;150;1681672;20150;10714
12169;Naucelle;1149;23152706;788264;547;16742332;602;6410374;20150;10715
63250;Neschers;467;9410212;438176;215;7147346;252;2262866;20150;10716
90052;Giromagny;1876;37802322;1501167;965;28344618;911;9457704;20150;10717
80811;Voyennes;364;7334822;231602;197;5450985;167;1883837;20151;10718
04031;Bras-d'Asse;323;6508885;173241;164;4778919;159;1729966;20151;10719
62572;Metz-en-Couture;346;6972435;213776;147;4845781;199;2126654;20152;10720
82106;Maubec;81;1632300;74473;39;1248244;42;384056;20152;10721
60110;Broquiers;123;2478689;81882;70;1910502;53;568187;20152;10722
32126;Estampes;97;1954762;43517;47;1449004;50;505758;20152;10723
76219;Doudeville;1476;29744697;1316972;650;21651775;826;8092922;20152;10724
53228;Saint-Jean-sur-Erve;224;4514129;91338;112;3311982;112;1202147;20152;10725
76325;Grémonville;239;4816455;185785;120;3777455;119;1039000;20153;10726
71320;Mont-Saint-Vincent;211;4252233;192794;98;3222121;113;1030112;20153;10727
17216;Lussant;537;10822559;294937;262;7987822;275;2834737;20154;10728
61207;Igé;393;7920614;327351;198;5778909;195;2141705;20154;10729
28089;Châteauneuf-en-Thymerais;1510;30433901;1118992;788;22629348;722;7804553;20155;10730
59053;Bavay;2002;40350187;2119853;942;30228608;1060;10121579;20155;10731
49243;La Poitevinière;532;10722824;100170;276;7410323;256;3312501;20156;10732
85223;Sainte-Hermine;1500;30233743;980768;711;21992084;789;8241659;20156;10733
56244;Sérent;1617;32592429;865304;803;23830091;814;8762338;20156;10734
65239;Labastide;95;1914833;87417;44;1460127;51;454706;20156;10735
54308;Leintrey;80;1612540;43425;41;1170059;39;442481;20157;10736
09058;Bompas;122;2459175;87775;64;1869794;58;589381;20157;10737
86230;Saint-Léomer;107;2156848;50648;50;1510626;57;646222;20157;10738
80665;Regnière-Écluse;73;1471499;31177;38;1167910;35;303589;20158;10739
60157;Clermont;6370;128403619;6315863;3393;102885514;2977;25518105;20158;10740
62440;Hermies;668;13465353;512591;300;9753516;368;3711837;20158;10741
86110;Haims;119;2398797;75322;58;1817581;61;581216;20158;10742
40043;Bias;447;9010725;284940;254;6967064;193;2043661;20158;10743
32146;Gimbrède;172;3467266;153289;74;2457740;98;1009526;20159;10744
49153;Valanjou;1123;22638048;381892;516;15813784;607;6824264;20159;10745
18132;Lugny-Champagne;94;1894927;89785;49;1508890;45;386037;20159;10746
02422;Lesquielles-Saint-Germain;434;8749016;383874;208;6671235;226;2077781;20159;10747
79040;La Boissière-en-Gâtine;135;2721543;61477;69;1950979;66;770564;20160;10748
17367;Saint-Martin-de-Juillers;96;1935331;96417;42;1436158;54;499173;20160;10749
39092;Chambéria;100;2016101;54368;50;1489382;50;526719;20161;10750
10034;Bar-sur-Seine;1801;36310889;2098941;797;27172956;1004;9137933;20162;10751
44128;Plessé;2641;53246935;1361005;1258;38991968;1383;14254967;20162;10752
49137;Le Fief-Sauvin;821;16553643;163662;427;11642714;394;4910929;20163;10753
82107;Maumusson;28;564563;15651;16;430771;12;133792;20163;10754
62100;Beaurainville;1116;22502205;798138;556;16666760;560;5835445;20163;10755
35345;Trévérien;432;8710575;135720;222;6316258;210;2394317;20163;10756
53019;Bannes;70;1411462;29902;31;844161;39;567301;20164;10757
62700;Regnauville;108;2177709;50626;60;1650102;48;527607;20164;10758
41171;Oucques;882;17784802;586075;420;12668924;462;5115878;20164;10759
17186;Le Gué-d'Alleré;361;7279323;169743;165;5219465;196;2059858;20164;10760
58058;La Chapelle-Saint-André;196;3952342;159452;100;2894429;96;1057913;20165;10761
46248;Sainte-Alauzie;68;1371237;21710;31;948086;37;423151;20165;10762
36089;Jeu-les-Bois;200;4033377;94373;102;2895304;98;1138073;20167;10763
53216;Saint-Fraimbault-de-Prières;535;10789531;320210;273;8530707;262;2258824;20167;10764
12265;Sébrazac;230;4638505;171314;101;3270307;129;1368198;20167;10765
46313;Tauriac;223;4497409;126274;122;3422190;101;1075219;20168;10766
62542;Maizières;98;1976454;62762;46;1434557;52;541897;20168;10767
65017;Aragnouet;151;3045475;86611;86;2357106;65;688369;20169;10768
71192;Étang-sur-Arroux;1090;21984546;733040;491;15170444;599;6814102;20169;10769
89365;Saint-Privé;299;6030702;247643;163;4794009;136;1236693;20170;10770
59526;Saint-Amand-les-Eaux;9539;192400967;9175479;4571;146385229;4968;46015738;20170;10771
93006;Bagnolet;19873;400837220;21246083;9955;315250122;9918;85587098;20170;10772
50063;Bolleville;197;3973492;122337;99;2774809;98;1198683;20170;10773
15220;Salins;96;1936341;70964;47;1441676;49;494665;20170;10774
81188;Moulin-Mage;192;3872720;75994;84;2594124;108;1278596;20170;10775
17302;Romegoux;327;6595953;205367;156;4899056;171;1696897;20171;10776
57558;Puttigny;49;988387;26473;27;748738;22;239649;20171;10777
53249;Saint-Pierre-sur-Orthe;286;5768953;178783;140;4246478;146;1522475;20171;10778
50413;Précey;265;5345405;145099;139;3921170;126;1424235;20171;10779
33134;Couquèques;141;2844221;147617;59;2034965;82;809256;20172;10780
21438;Montmoyen;45;907733;34187;22;613004;23;294729;20172;10781
41193;Romilly;97;1956677;66448;44;1404967;53;551710;20172;10782
52092;Chalancey;69;1391900;34709;35;948252;34;443648;20172;10783
81024;Beauvais-sur-Tescou;158;3187312;67648;64;2141240;94;1046072;20173;10784
50420;Quibou;498;10046257;220844;264;7602111;234;2444146;20173;10785
28061;Brou;2172;43816965;2160124;1047;32103296;1125;11713669;20174;10786
37123;Langeais;2409;48598922;1606266;1271;36951883;1138;11647039;20174;10787
21461;Nolay;900;18156549;782067;412;13426597;488;4729952;20174;10788
72032;Berfay;191;3853224;87310;109;2924592;82;928632;20174;10789
36048;Chavin;177;3570798;181637;81;2669350;96;901448;20174;10790
46059;Carlucet;107;2158643;52340;55;1558637;52;600006;20174;10791
30028;Bagnols-sur-Cèze;10864;219173383;10706230;5169;167377367;5695;51796016;20174;10792
21576;Saint-Thibault;93;1876302;60271;53;1432678;40;443624;20175;10793
61344;Rânes;599;12085455;396343;282;8618749;317;3466706;20176;10794
57759;Zarbeling;40;807051;22376;25;675761;15;131290;20176;10795
61086;Les Champeaux;81;1634295;40853;37;1077700;44;556595;20176;10796
52093;Chalindrey;1470;29660035;880035;786;22275640;684;7384395;20177;10797
46138;Labastide-Murat;378;7626867;276083;170;5468511;208;2158356;20177;10798
18098;Gardefort;84;1694869;35941;56;1445042;28;249827;20177;10799
21490;Poiseul-la-Ville-et-Laperrière;89;1795781;37940;43;1290747;46;505034;20177;10800
88373;Raon-sur-Plaine;93;1876537;54206;44;1349349;49;527188;20178;10801
32318;Pis;53;1069429;34933;26;774938;27;294491;20178;10802
62539;Maisnil;127;2562601;81171;59;1879729;68;682872;20178;10803
80251;Doudelainville;150;3026740;71945;71;2225922;79;800818;20178;10804
18275;Vereaux;90;1816098;66650;47;1422328;43;393770;20179;10805
08167;La Férée;50;1008967;34969;22;663925;28;345042;20179;10806
07017;Les Assions;373;7526951;291638;186;5743429;187;1783522;20179;10807
12058;Cassuéjouls;76;1533643;80360;37;1135638;39;398005;20180;10808
49045;La Breille-les-Pins;309;6235533;345260;136;4522377;173;1713156;20180;10809
17232;Meursac;803;16204399;575684;390;11989123;413;4215276;20180;10810
57306;Hayange;8739;176352099;3778963;3544;106671115;5195;69680984;20180;10811
08333;Olizy-Primat;108;2179440;39076;44;1412993;64;766447;20180;10812
23140;Moutier-Rozeille;264;5327636;214612;136;4082137;128;1245499;20180;10813
27194;Cuverville;125;2522641;58109;74;1999811;51;522830;20181;10814
34080;Colombières-sur-Orb;291;5872761;239144;148;4591892;143;1280869;20181;10815
57294;Hanviller;112;2260340;79518;54;1647415;58;612925;20182;10816
22080;L'Hermitage-Lorge;379;7649091;124595;191;5277960;188;2371131;20182;10817
86255;Savigné;751;15157338;585299;346;11052310;405;4105028;20183;10818
80801;Villers-Carbonnel;173;3491669;66960;80;2525213;93;966456;20183;10819
17021;Arvert;2028;40933228;1457953;1016;30293220;1012;10640008;20184;10820
67381;Puberg;169;3411242;70129;92;2520452;77;890790;20185;10821
64077;Auga;82;1655164;31374;41;1124085;41;531079;20185;10822
70362;Montigny-lès-Cherlieu;92;1857042;37452;43;1289215;49;567827;20185;10823
14671;Sept-Frères;191;3855411;86400;93;2789412;98;1065999;20185;10824
58204;Ourouër;166;3350862;95501;87;2473682;79;877180;20186;10825
49097;Cheviré-le-Rouge;504;10174156;231240;245;7466398;259;2707758;20187;10826
24422;Saint-Hilaire-d'Estissac;62;1251603;26594;34;970127;28;281476;20187;10827
59496;Rejet-de-Beaulieu;124;2503243;74038;64;1840758;60;662485;20187;10828
17362;Saint-Martial-de-Mirambeau;141;2846471;81360;64;2110799;77;735672;20188;10829
57241;Fribourg;85;1715970;26505;41;1103148;44;612822;20188;10830
64446;Peyrelongue-Abos;78;1574680;43199;34;1056068;44;518612;20188;10831
72208;Montmirail;243;4905840;199909;104;3358320;139;1547520;20189;10832
35292;Saint-Marc-le-Blanc;696;14051335;234957;371;10193628;325;3857707;20189;10833
55212;Girauvoisin;46;928684;26696;27;710240;19;218444;20189;10834
76739;Vieux-Rouen-sur-Bresle;358;7227651;289839;205;5763747;153;1463904;20189;10835
11369;Sallèles-d'Aude;1434;28951022;891105;689;21490331;745;7460691;20189;10836
56070;Guégon;1313;26508187;670799;681;19725711;632;6782476;20189;10837
27049;Beaumesnil;319;6440481;278815;163;4921183;156;1519298;20190;10838
31378;Montgaillard-sur-Save;38;767214;10468;16;494985;22;272229;20190;10839
88065;Bonvillet;193;3896693;129451;106;2986984;87;909709;20190;10840
62729;Rumilly;125;2523906;67415;50;1650864;75;873042;20191;10841
52138;Colmier-le-Haut;37;747089;18770;16;529015;21;218074;20192;10842
22051;Dolo;327;6602668;108773;151;4549852;176;2052816;20192;10843
84092;Le Pontet;9564;193115757;7762777;4922;147121606;4642;45994151;20192;10844
42009;Arthun;317;6400963;197342;148;4520428;169;1880535;20192;10845
24027;Bayac;202;4078960;131108;99;2903359;103;1175601;20193;10846
35168;Maure-de-Bretagne;1745;35237968;1074934;844;25676959;901;9561009;20194;10847
33241;Lestiac-sur-Garonne;344;6946660;273986;175;5269236;169;1677424;20194;10848
30114;Fontanès;369;7451643;250907;178;5565851;191;1885792;20194;10849
70448;Roche-et-Raucourt;89;1797312;63740;43;1328033;46;469279;20195;10850
31400;Nogaret;47;949165;40752;23;740352;24;208813;20195;10851
55405;Pillon;126;2544652;33909;49;1515873;77;1028779;20196;10852
59445;Ohain;663;13389917;392403;332;9757958;331;3631959;20196;10853
60255;Fréniches;185;3736257;133636;99;2915279;86;820978;20196;10854
34267;Saint-Jean-de-Fos;870;17570701;537469;415;12962774;455;4607927;20196;10855
52331;Montier-en-Der;1205;24337198;1031720;553;17995973;652;6341225;20197;10856
80614;Outrebois;159;3211362;84197;83;2419349;76;792013;20197;10857
72276;Saint-Cosme-en-Vairais;1112;22459652;649541;584;16658390;528;5801262;20198;10858
71552;Uxeau;298;6018906;176164;154;4567229;144;1451677;20198;10859
71148;Coublanc;502;10139455;230044;268;7517238;234;2622217;20198;10860
21363;Magnien;183;3696296;118218;89;2707452;94;988844;20198;10861
27311;Harcourt;593;11977623;548063;272;8790229;321;3187394;20198;10862
33458;Saint-Paul;524;10584010;359217;259;8009675;265;2574335;20198;10863
66100;Llo;89;1797674;78837;45;1350966;44;446708;20199;10864
05178;Ventavon;281;5675912;170237;139;4263782;142;1412130;20199;10865
46103;Flaugnac;245;4948803;164572;116;3578691;129;1370112;20199;10866
22060;Gausson;343;6928354;213312;162;5074672;181;1853682;20199;10867
40259;Saint-Gein;248;5009453;139417;126;3755927;122;1253526;20199;10868
60021;Appilly;265;5353044;115401;148;4107196;117;1245848;20200;10869
25268;Germéfontaine;64;1292816;14471;32;888164;32;404652;20200;10870
42004;Amions;168;3393708;63411;81;2347831;87;1045877;20201;10871
56113;Locmalo;503;10160956;353071;254;7736484;249;2424472;20201;10872
72210;Montreuil-le-Henri;144;2908903;91975;75;2211324;69;697579;20201;10873
50265;Laulne;105;2121096;89102;47;1557776;58;563320;20201;10874
58210;Planchez;182;3676600;138877;98;2794734;84;881866;20201;10875
53232;Saint-Léger;148;2989914;39840;89;2336137;59;653777;20202;10876
55566;Villers-sur-Meuse;148;2989925;66626;83;2219801;65;770124;20202;10877
22100;Langast;345;6969865;198516;180;5155679;165;1814186;20203;10878
18151;Montigny;237;4788016;136239;132;3700059;105;1087957;20203;10879
79311;Secondigny;1054;21294011;853264;431;15045062;623;6248949;20203;10880
27404;Mesnil-Rousset;54;1090969;32533;27;815464;27;275505;20203;10881
03194;Naves;73;1474830;60573;32;1041055;41;433775;20203;10882
07311;Sceautres;80;1616266;103455;36;1170816;44;445450;20203;10883
72291;Saint-Jean-de-la-Motte;492;9940069;152584;261;7451862;231;2488207;20203;10884
11080;Caudeval;80;1616301;43396;35;1115942;45;500359;20204;10885
59533;Saint-Hilaire-lez-Cambrai;910;18385610;747911;411;13174898;499;5210712;20204;10886
80733;Senlis-le-Sec;159;3212546;99527;82;2422742;77;789804;20205;10887
76186;Conteville;283;5717934;102231;134;4213315;149;1504619;20205;10888
22234;Plouvara;567;11456230;273656;299;8431410;268;3024820;20205;10889
09334;Vicdessos;244;4930192;170053;114;3520338;130;1409854;20206;10890
37173;Nouans-les-Fontaines;460;9294675;398409;228;7004848;232;2289827;20206;10891
35289;Saint-Malo-de-Phily;549;11093828;224027;287;8142483;262;2951345;20207;10892
58143;Limon;90;1818740;66150;44;1291192;46;527548;20208;10893
47240;Saint-Étienne-de-Villeréal;156;3152547;67777;65;2188785;91;963762;20209;10894
49041;Brain-sur-Allonnes;1053;21279806;680956;501;15578653;552;5701153;20209;10895
45085;Châtillon-Coligny;1225;24756403;1130810;627;18721554;598;6034849;20209;10896
03296;Valigny;241;4870535;123960;104;3641896;137;1228639;20210;10897
49174;Lézigné;392;7922430;162322;209;5739158;183;2183272;20210;10898
63351;Saint-Germain-près-Herment;46;929707;45236;20;638341;26;291366;20211;10899
37157;Montrésor;214;4325194;223570;95;3221040;119;1104154;20211;10900
59572;Solre-le-Château;1041;21040200;911523;503;15602455;538;5437745;20212;10901
34325;Valros;811;16391714;504886;405;12381855;406;4009859;20212;10902
80306;Fescamps;85;1718009;89545;46;1373363;39;344646;20212;10903
04116;Les Mées;2092;42284797;1634337;1042;31817556;1050;10467241;20213;10904
54276;Jeandelaincourt;396;8004315;182714;201;5825378;195;2178937;20213;10905
62685;Radinghem;125;2526616;69504;64;1868192;61;658424;20213;10906
76648;Saint-Saëns;1427;28844071;1531192;603;20800142;824;8043929;20213;10907
17015;Arces;390;7883224;363792;175;5617658;215;2265566;20213;10908
24289;Montcaret;780;15766583;606305;363;11585143;417;4181440;20214;10909
56254;Trédion;618;12492156;280285;326;9164475;292;3327681;20214;10910
46158;Lascabanes;115;2324593;57709;52;1724417;63;600176;20214;10911
02340;Gauchy;2987;60381305;1950129;1595;45905957;1392;14475348;20215;10912
61284;Montchevrel;122;2466229;60165;58;1771991;64;694238;20215;10913
05016;La Bâtie-Montsaléon;133;2688662;96587;57;2006771;76;681891;20216;10914
67159;Goerlingen;121;2446134;35258;62;1730000;59;716134;20216;10915
50253;Huisnes-sur-Mer;109;2203630;72513;50;1565430;59;638200;20217;10916
53122;Jublains;403;8147687;247777;210;6142700;193;2004987;20218;10917
80503;Maizicourt;92;1860035;41863;42;1250047;50;609988;20218;10918
02418;Lerzy;118;2385703;77462;61;1742400;57;643303;20218;10919
76656;Saint-Victor-l'Abbaye;366;7399789;239945;180;5495099;186;1904690;20218;10920
72158;Lavaré;445;8997240;203912;250;6750923;195;2246317;20219;10921
87073;Gorre;227;4589608;112088;112;3394489;115;1195119;20219;10922
05104;Poligny;186;3760711;149057;87;2708540;99;1052171;20219;10923
51068;Blesme;110;2224146;73979;54;1597856;56;626290;20220;10924
85145;Monsireigne;470;9503207;157408;262;6947926;208;2555281;20220;10925
10227;Marolles-sous-Lignières;196;3963054;136399;106;3086526;90;876528;20220;10926
43132;Mazeyrat-d'Allier;829;16762122;358004;443;12371857;386;4390265;20220;10927
76752;Yerville;1399;28287388;1039353;680;20626762;719;7660626;20220;10928
59076;Bettignies;150;3033019;104744;79;2356609;71;676410;20220;10929
55376;Nantois;53;1071667;42910;29;864463;24;207204;20220;10930
49013;Auverse;246;4974158;240580;113;3517180;133;1456978;20220;10931
39569;Villers-Farlay;305;6167206;138107;158;4617699;147;1549507;20220;10932
47315;Trentels;460;9301409;321552;232;6851498;228;2449911;20220;10933
81032;Blan;557;11263185;321943;253;7967358;304;3295827;20221;10934
23047;Chamborand;138;2790576;110667;69;2107830;69;682746;20222;10935
55569;Villotte-devant-Louppy;93;1880618;54733;45;1375283;48;505335;20222;10936
61010;Aubry-le-Panthou;68;1375091;51286;33;941181;35;433910;20222;10937
72117;Dissé-sous-le-Lude;309;6248721;142820;166;4583411;143;1665310;20222;10938
23211;Saint-Marc-à-Frongier;212;4287176;143062;103;3134630;109;1152546;20223;10939
22358;Trégonneau;265;5358995;122826;135;3879407;130;1479588;20223;10940
42230;Saint-Germain-Laval;915;18504115;697271;376;12927435;539;5576680;20223;10941
67006;Altenheim;115;2325680;68370;59;1665307;56;660373;20223;10942
59246;Forest-en-Cambrésis;270;5460406;193044;132;4155019;138;1305387;20224;10943
48090;Le Malzieu-Ville;476;9626737;419222;237;7192472;239;2434265;20224;10944
09032;Ax-les-Thermes;821;16604122;712517;415;12335233;406;4268889;20224;10945
35179;Miniac-Morvan;2044;41338669;874917;1082;30565790;962;10772879;20224;10946
87046;Cognac-la-Forêt;614;12417928;396122;303;9237903;311;3180025;20225;10947
59287;Haucourt-en-Cambrésis;123;2487652;74033;66;1891938;57;595714;20225;10948
57177;Dieuze;1753;35454135;1746657;854;26543761;899;8910374;20225;10949
40005;Arboucave;115;2325888;89300;50;1571757;65;754131;20225;10950
83083;Montfort-sur-Argens;700;14157659;554150;329;10430896;371;3726763;20225;10951
35129;Guipry;2063;41725351;1125001;1098;31875564;965;9849787;20226;10952
44144;Riaillé;1168;23623554;805782;541;16939977;627;6683577;20226;10953
08035;Autruche;37;748363;19166;16;492605;21;255758;20226;10954
70115;Cerre-lès-Noroy;120;2427178;77303;69;1853012;51;574166;20226;10955
72279;Saint-Georges-de-la-Couée;96;1941749;59749;52;1530492;44;411257;20227;10956
35158;Le Lou-du-Lac;52;1051802;10730;29;809447;23;242355;20227;10957
25354;Luxiol;81;1638404;23981;44;1188943;37;449461;20227;10958
26069;Chamaloc;68;1375501;39082;38;1035043;30;340458;20228;10959
72293;Saint-Jean-du-Bois;324;6554163;162993;161;4742450;163;1811713;20229;10960
25276;Gondenans-Montby;91;1840849;31547;44;1255148;47;585701;20229;10961
19175;Roche-le-Peyroux;52;1051914;41117;29;867420;23;184494;20229;10962
14204;Cricqueville-en-Bessin;91;1840903;48484;49;1357380;42;483523;20230;10963
31470;Saint-Aventin;58;1173340;39063;28;843687;30;329653;20230;10964
53039;Le Bourgneuf-la-Forêt;945;19118298;488789;454;13542237;491;5576061;20231;10965
22195;Pleubian;1605;32471048;1279277;740;23737614;865;8733434;20231;10966
55335;Ménil-sur-Saulx;145;2933526;107560;72;2230078;73;703448;20231;10967
22257;Quemperven;224;4532002;128823;122;3466524;102;1065478;20232;10968
47251;Saint-Léon;181;3662141;149295;89;2824574;92;837567;20233;10969
22099;Lanfains;552;11168547;202453;308;8324817;244;2843730;20233;10970
62646;Palluel;300;6069891;173998;159;4711041;141;1358850;20233;10971
16262;Plaizac;84;1699575;53497;45;1337197;39;362378;20233;10972
21131;Chamblanc;259;5240414;175831;140;3949391;119;1291023;20233;10973
38169;Fontaine;12866;260321350;9546737;7089;202376536;5777;57944814;20233;10974
50145;Courcy;299;6049794;113707;148;4287042;151;1762752;20233;10975
80749;Terramesnil;144;2913678;50597;77;2141086;67;772592;20234;10976
62299;Eps;125;2529257;58354;60;1731745;65;797512;20234;10977
07318;Tauriers;120;2428111;114616;57;1849479;63;578632;20234;10978
03130;Isle-et-Bardais;158;3197024;98901;79;2431959;79;765065;20234;10979
81031;Le Bez;450;9105502;241206;223;6521312;227;2584190;20234;10980
09164;Lescure;280;5665761;160735;131;3930485;149;1735276;20235;10981
81269;Saint-Salvy-de-la-Balme;339;6859692;264650;156;4999849;183;1859843;20235;10982
30317;Sernhac;887;17948992;568668;441;13554054;446;4394938;20236;10983
82174;Saint-Vincent;157;3177024;143664;72;2410775;85;766249;20236;10984
50524;Saint-Michel-de-la-Pierre;102;2064061;30643;49;1431346;53;632715;20236;10985
07186;Privas;5258;106400728;5042903;2660;82835847;2598;23564881;20236;10986
70442;Renaucourt;59;1193925;39634;26;811286;33;382639;20236;10987
17219;Marennes;3364;68077687;2574218;1596;50072029;1768;18005658;20237;10988
14681;Surrain;81;1639225;37320;43;1216352;38;422873;20237;10989
28411;Villars;80;1619054;32000;42;1229154;38;389900;20238;10990
03095;Cusset;8001;161926657;7201596;4022;124445210;3979;37481447;20238;10991
33188;Giscos;115;2327421;71042;58;1717556;57;609865;20238;10992
55179;Erneville-aux-Bois;99;2003671;53352;54;1533615;45;470056;20239;10993
49296;Saint-Laurent-des-Autels;1092;22102530;355628;574;15623762;518;6478768;20240;10994
34001;Abeilhan;847;17143905;466854;401;11933587;446;5210318;20241;10995
17046;Bignay;220;4453023;136521;110;3299189;110;1153834;20241;10996
64360;Lurbe-Saint-Christau;114;2307545;49930;62;1702491;52;605054;20242;10997
93053;Noisy-le-Sec;21683;438902589;20840158;11113;344333681;10570;94568908;20242;10998
65049;Auriébat;157;3178053;103689;60;2231265;97;946788;20242;10999
16238;Moutonneau;58;1174068;31488;28;866038;30;308030;20243;11000
63093;Charbonnières-les-Vieilles;603;12206527;350153;320;9227502;283;2979025;20243;11001
26348;Taulignan;999;20222761;863647;462;15050097;537;5172664;20243;11002
64090;Baliracq-Maumusson;71;1437259;42035;30;990352;41;446907;20243;11003
47047;Cambes;93;1882612;50362;41;1383162;52;499450;20243;11004
47089;Esclottes;85;1720686;83549;38;1286713;47;433973;20243;11005
14496;Périgny;28;566821;11542;12;397589;16;169232;20244;11006
50110;Cerisy-la-Forêt;507;10263519;229898;229;7363557;278;2899962;20244;11007
10303;Précy-Notre-Dame;41;830003;29889;21;611244;20;218759;20244;11008
64364;Macaye;270;5465929;130597;144;4175753;126;1290176;20244;11009
65082;Berbérust-Lias;29;587100;28606;12;470703;17;116397;20245;11010
33123;Cézac;1247;25245465;616639;611;18374990;636;6870475;20245;11011
60179;Crèvecoeur-le-Petit;59;1194463;29754;36;917531;23;276932;20245;11012
64542;Urdos;45;911058;32930;31;739184;14;171874;20246;11013
80474;Licourt;207;4190969;123281;108;3189293;99;1001676;20246;11014
49331;Segré;3920;79365521;2854527;1903;58628531;2017;20736990;20246;11015
40270;Saint-Loubouer;244;4940139;127383;124;3692976;120;1247163;20246;11016
89303;Poilly-sur-Serein;154;3118002;107500;78;2259819;76;858183;20247;11017
58269;Saint-Sulpice;256;5183227;157200;142;4073774;114;1109453;20247;11018
88015;Attignéville;139;2814351;76008;70;2107656;69;706695;20247;11019
49096;Cherré;255;5163029;50276;135;3803974;120;1359055;20247;11020
57662;Suisse;53;1073114;25929;27;817866;26;255248;20247;11021
11183;Ladern-sur-Lauquet;151;3057404;134861;64;2124296;87;933108;20248;11022
57206;Fameck;6869;139083918;3298097;2567;82431694;4302;56652224;20248;11023
76320;Grandcourt;192;3887819;203659;90;2917428;102;970391;20249;11024
64303;Laguinge-Restoue;92;1862916;58175;50;1413846;42;449070;20249;11025
72159;Lavenay;207;4191573;129695;116;3236368;91;955205;20249;11026
32106;Cologne;436;8828717;321288;201;6509547;235;2319170;20249;11027
19152;Nonards;253;5123441;253128;122;3946583;131;1176858;20251;11028
18268;Uzay-le-Venon;231;4678037;127095;130;3511519;101;1166518;20251;11029
32359;Saint-Antonin;89;1802435;66110;45;1378449;44;423986;20252;11030
14211;Culey-le-Patry;187;3787148;106198;102;2997303;85;789845;20252;11031
12095;Escandolières;128;2592360;79422;63;1954904;65;637456;20253;11032
44036;Châteaubriant;6727;136242048;5539601;3138;99882715;3589;36359333;20253;11033
38247;Montalieu-Vercieu;1702;34470952;1016913;908;25467031;794;9003921;20253;11034
32458;Urgosse;150;3038073;92758;74;2164321;76;873752;20254;11035
19181;Saint-Augustin;259;5245773;179504;142;4009260;117;1236513;20254;11036
34183;Nissan-lez-Enserune;2180;44154066;1663954;1048;32300180;1132;11853886;20254;11037
59492;Ramillies;310;6279148;159376;148;4472078;162;1807070;20255;11038
66081;Fontrabiouse;70;1417884;7041;40;1009885;30;407999;20255;11039
06047;Conségudes;49;992519;43313;26;793469;23;199050;20255;11040
39284;Lavangeot;73;1478677;51896;40;1107716;33;370961;20256;11041
24178;Festalemps;164;3322052;134205;74;2413320;90;908732;20256;11042
83043;Collobrières;1103;22343037;1206194;549;17392463;554;4950574;20257;11043
88121;Damas-aux-Bois;144;2916988;94317;75;2214697;69;702291;20257;11044
41189;Rilly-sur-Loire;239;4841445;213300;123;4053510;116;787935;20257;11045
33071;Branne;739;14970031;565539;344;11211365;395;3758666;20257;11046
60219;Escles-Saint-Pierre;77;1559813;54045;41;1180441;36;379372;20257;11047
59286;Haubourdin;8266;167449776;5670236;4397;127955532;3869;39494244;20258;11048
71549;La Truchère;130;2633526;107893;68;1994545;62;638981;20258;11049
72095;Coulaines;4111;83280857;3683001;1938;63341007;2173;19939850;20258;11050
33536;Le Tuzan;130;2633669;72712;60;1884589;70;749080;20259;11051
64416;Navarrenx;641;12986016;565217;291;9616420;350;3369596;20259;11052
60684;Villers-Saint-Paul;3313;67121347;2545751;1722;51405929;1591;15715418;20260;11053
06103;Roquebillière;990;20057747;940293;480;15120265;510;4937482;20260;11054
31083;Boussan;131;2654209;75669;67;1985106;64;669103;20261;11055
47004;Aiguillon;2567;52013262;2881794;983;36930272;1584;15082990;20262;11056
17022;Asnières-la-Giraud;566;11468515;370711;291;8695737;275;2772778;20262;11057
85269;Saint-Sigismond;213;4315946;118539;109;3209231;104;1106715;20263;11058
29225;Pouldreuzic;1231;24943626;728695;628;18105742;603;6837884;20263;11059
88291;Martinvelle;78;1580507;79768;36;1166816;42;413691;20263;11060
57402;Liederschiedt;74;1499469;66827;32;1035024;42;464445;20263;11061
86210;Roiffé;394;7983707;342831;194;5942271;200;2041436;20263;11062
53170;Oisseau;628;12725448;247794;328;9481047;300;3244401;20263;11063
62283;Écoivres;63;1276608;29054;32;923378;31;353230;20264;11064
88018;Aumontzey;277;5613035;117295;153;4069382;124;1543653;20264;11065
88277;Luvigny;55;1114504;20141;30;863643;25;250861;20264;11066
24181;Flaugeac;174;3526035;120500;93;2756781;81;769254;20265;11067
04041;Le Castellet;149;3019512;124330;70;2246281;79;773231;20265;11068
32326;Pouylebon;84;1702300;50008;41;1294192;43;408108;20265;11069
03056;La Chapelle;211;4276300;101728;97;2948598;114;1327702;20267;11070
46270;Saint-Jean-de-Laur;138;2796923;94407;62;2048630;76;748293;20268;11071
56180;Porcaro;385;7803051;188971;199;5571853;186;2231198;20268;11072
21115;Buncey;214;4337290;124072;118;3421024;96;916266;20268;11073
14446;Montigny;54;1094492;26650;33;875302;21;219190;20268;11074
26057;Bourg-de-Péage;6088;123394315;4610311;3096;93107702;2992;30286613;20268;11075
66079;Finestret;114;2310631;78941;56;1770659;58;539972;20269;11076
31084;Boussens;603;12222102;395330;329;9456394;274;2765708;20269;11077
17455;La Vallée;379;7682400;251978;185;5709426;194;1972974;20270;11078
71010;Antully;451;9142293;289132;229;6709172;222;2433121;20271;11079
35034;La Boussac;619;12547941;325523;291;9028710;328;3519231;20271;11080
02786;Verneuil-sous-Coucy;80;1621718;51656;40;1212770;40;408948;20271;11081
22141;Mantallot;111;2250141;45321;59;1707161;52;542980;20272;11082
51290;Heiltz-l'Évêque;168;3405635;99483;78;2311430;90;1094205;20272;11083
05078;Monêtier-Allemont;168;3405656;158906;75;2393510;93;1012146;20272;11084
48050;Cocurès;117;2371826;68442;60;1800369;57;571457;20272;11085
56236;Saint-Servant;471;9548674;364443;224;6928550;247;2620124;20273;11086
29108;Landudec;742;15043080;473914;377;11194024;365;3849056;20274;11087
67241;Kirrberg;109;2209854;65250;62;1737477;47;472377;20274;11088
50340;Montcuit;93;1885544;29698;38;1212145;55;673399;20275;11089
03234;Saint-Gérand-de-Vaux;235;4764652;248306;93;3409358;142;1355294;20275;11090
36241;Villedieu-sur-Indre;1584;32116404;986203;831;23429214;753;8687190;20276;11091
64170;Castagnède;115;2331704;79435;59;1793142;56;538562;20276;11092
88049;Belmont-lès-Darney;59;1196291;27814;34;910370;25;285921;20276;11093
60496;Plainville;94;1905962;47015;52;1444890;42;461072;20276;11094
79251;Saint-Génard;186;3771406;62052;92;2700724;94;1070682;20276;11095
14481;Les Oubeaux;125;2534577;67135;71;1926027;54;608550;20277;11096
58184;Moussy;69;1399120;68404;28;989612;41;409508;20277;11097
37026;Betz-le-Château;335;6792931;223254;156;4794537;179;1998394;20277;11098
49128;Échemiré;281;5698060;128079;140;4186596;141;1511464;20278;11099
10314;Ramerupt;241;4886972;195894;109;3436281;132;1450691;20278;11100
58196;Nolay;203;4116536;142845;109;3137146;94;979390;20279;11101
76678;Sommery;428;8679523;273884;204;6165283;224;2514240;20279;11102
70469;Sainte-Marie-en-Chanois;126;2555267;61284;67;1815433;59;739834;20280;11103
79123;La Forêt-sur-Sèvre;1197;24275081;444724;578;17091963;619;7183118;20280;11104
16023;Aunac;180;3650408;126385;79;2691099;101;959309;20280;11105
02239;Crézancy;609;12350555;395564;326;9470444;283;2880111;20280;11106
03245;Saint-Martin-des-Lais;84;1703539;63649;37;1214559;47;488980;20280;11107
58188;Nannay;67;1358789;64999;27;946737;40;412052;20280;11108
89462;Villeneuve-les-Genêts;161;3265222;149134;77;2563299;84;701923;20281;11109
71056;Branges;1331;26994134;956818;724;20347185;607;6646949;20281;11110
66217;Trouillas;1057;21437261;790981;552;16663344;505;4773917;20281;11111
80570;Moreuil;2285;46343194;1892505;1181;35704023;1104;10639171;20281;11112
79005;Airvault;1806;36628682;1386786;911;27429870;895;9198812;20282;11113
72132;La Ferté-Bernard;5492;111387961;4873685;2752;84587532;2740;26800429;20282;11114
85023;Bessay;221;4482404;96634;113;3338002;108;1144402;20282;11115
81170;Monestiés;775;15718854;500756;376;11410698;399;4308156;20282;11116
24239;Ligueux;159;3224921;92639;92;2500264;67;724657;20283;11117
03115;Fleuriel;194;3934868;108908;95;2986379;99;948489;20283;11118
52061;Bourdons-sur-Rognon;168;3407602;149195;84;2603382;84;804220;20283;11119
38301;Percy;73;1480724;54257;37;1111935;36;368789;20284;11120
40101;Gaas;255;5172543;147774;128;3796010;127;1376533;20284;11121
11090;Cépie;309;6267953;172331;157;4730243;152;1537710;20285;11122
80404;Guyencourt-Saulcourt;72;1460503;42342;34;1058529;38;401974;20285;11123
39361;Montmirey-le-Château;95;1927056;53981;49;1419672;46;507384;20285;11124
32206;Laymont;115;2332762;113666;53;1629626;62;703136;20285;11125
85158;Mouzeuil-Saint-Martin;646;13104171;378473;306;9307079;340;3797092;20285;11126
24563;Valojoulx;163;3306497;138821;92;2756263;71;550234;20285;11127
71214;Genouilly;238;4827946;167112;101;3359231;137;1468715;20285;11128
43101;Goudet;35;710002;49897;15;536611;20;173391;20286;11129
57132;Château-Salins;1386;28116409;1093840;643;20787578;743;7328831;20286;11130
79101;Coulonges-sur-l'Autize;1337;27122601;1051919;599;19736867;738;7385734;20286;11131
56041;Cléguérec;1679;34061512;1200920;797;25139435;882;8922077;20287;11132
60616;Sérifontaine;1530;31038880;989038;819;23610843;711;7428037;20287;11133
42003;Ambierle;1144;23208216;822423;562;18390133;582;4818083;20287;11134
50256;Isigny-le-Buat;1745;35401281;827838;833;25368397;912;10032884;20287;11135
17060;Boutenac-Touvent;131;2657634;101977;54;1866929;77;790705;20287;11136
88361;Provenchères-sur-Fave;469;9514740;301239;222;6811881;247;2702859;20287;11137
22338;Squiffiec;374;7587461;201562;184;5484870;190;2102591;20287;11138
25140;Chaux-lès-Clerval;101;2049025;69313;52;1464651;49;584374;20287;11139
50301;Le Mesnil-Amand;87;1765040;37924;46;1297816;41;467224;20288;11140
30116;Fournès;513;10407680;283282;248;7734765;265;2672915;20288;11141
24223;Lalinde;1862;37776599;1480625;890;27587719;972;10188880;20288;11142
65327;Nestier;100;2028858;76464;56;1591849;44;437009;20289;11143
43119;Lavoûte-sur-Loire;456;9251666;273881;241;6929212;215;2322454;20289;11144
23052;La Chapelle-Taillefert;246;4991241;206439;133;3943103;113;1048138;20290;11145
07069;Colombier-le-Vieux;354;7182653;226224;168;5304532;186;1878121;20290;11146
39506;Savigna;71;1440595;54417;43;1185820;28;254775;20290;11147
15138;Murat;1186;24064694;1216894;590;18370584;596;5694110;20291;11148
22314;Saint-Maudan;203;4119011;64568;113;3068216;90;1050795;20291;11149
36019;Bommiers;162;3287121;83151;83;2428091;79;859030;20291;11150
11012;Argeliers;1040;21102513;584793;492;15027174;548;6075339;20291;11151
17025;Aumagne;380;7710577;289870;187;5916758;193;1793819;20291;11152
17351;Saint-Just-Luzac;1082;21955526;796759;541;16784733;541;5170793;20292;11153
26050;Bésignan;37;750791;25571;16;541029;21;209762;20292;11154
94054;Orly;11925;241979620;10572657;6242;189552825;5683;52426795;20292;11155
80436;Hescamps;296;6006423;170351;156;4431163;140;1575260;20292;11156
58073;Chevroches;88;1785857;62767;52;1435551;36;350306;20294;11157
19126;Marcillac-la-Croze;107;2171509;67085;57;1649366;50;522143;20294;11158
48063;Fontans;132;2679085;53944;50;1731098;82;947987;20296;11159
71234;Huilly-sur-Seille;181;3673628;97770;99;2729793;82;943835;20296;11160
33064;Bossugan;28;568300;12266;12;400859;16;167441;20296;11161
55279;Laneuville-sur-Meuse;233;4729113;121136;116;3557626;117;1171487;20297;11162
49220;Morannes;1022;20743328;641931;468;14453083;554;6290245;20297;11163
70214;Équevilley;76;1542586;31625;42;1089281;34;453305;20297;11164
88213;La Grande-Fosse;59;1197549;49578;24;816843;35;380706;20297;11165
56211;Saint-Congard;397;8058165;196790;216;6082380;181;1975785;20298;11166
86150;Massognes;153;3105607;78609;67;2232335;86;873272;20298;11167
57123;Carling;1987;40335067;1397474;1064;30899681;923;9435386;20299;11168
21343;Larrey;53;1075884;57110;28;887107;25;188777;20300;11169
85086;Falleron;798;16199291;408754;400;11896926;398;4302365;20300;11170
52113;Chassigny;137;2781157;73792;71;2028820;66;752337;20300;11171
53035;Bouchamps-lès-Craon;271;5501417;17277;135;3768550;136;1732867;20300;11172
23003;Alleyrat;93;1887959;87513;49;1456189;44;431770;20301;11173
61178;La Fresnaie-Fayel;31;629321;19123;19;539674;12;89647;20301;11174
33288;Monprimblanc;153;3106047;129180;75;2400903;78;705144;20301;11175
08327;Nouvion-sur-Meuse;1191;24179123;738915;626;17965078;565;6214045;20302;11176
24491;Saint-Rabier;316;6415387;161272;158;4823091;158;1592296;20302;11177
14539;La Rocque;53;1076000;27342;30;901757;23;174243;20302;11178
22256;Quemper-Guézennec;631;12810648;412949;307;9475170;324;3335478;20302;11179
53259;Senonnes;168;3410816;38073;87;2561521;81;849295;20302;11180
42070;Cordelle;492;9989215;241333;252;7757006;240;2232209;20303;11181
35272;Saint-Germain-du-Pinel;432;8771024;104599;232;6292238;200;2478786;20303;11182
61069;Cahan;93;1888211;51195;54;1426774;39;461437;20303;11183
86092;Dangé-Saint-Romain;1807;36688726;1273748;948;27656895;859;9031831;20304;11184
39451;Ranchot;260;5279032;160716;146;3970007;114;1309025;20304;11185
49057;Cernusson;155;3147164;34811;84;2272152;71;875012;20304;11186
34041;Brignac;399;8101516;253963;194;5937465;205;2164051;20305;11187
33401;Sainte-Florence;74;1502541;60241;41;1198706;33;303835;20305;11188
77224;Hautefeuille;154;3126935;133750;62;2598800;92;528135;20305;11189
76758;Yvetot;7145;145077851;6600060;3477;109338936;3668;35738915;20305;11190
24433;Saint-Julien-d'Eymet;59;1197990;19870;23;850532;36;347458;20305;11191
88530;Xertigny;1528;31026500;868049;719;22851279;809;8175221;20305;11192
27507;Saint-André-de-l'Eure;2084;42316601;1679647;1068;31444606;1016;10871995;20305;11193
88419;Saint-Jean-d'Ormont;86;1746306;68367;44;1274008;42;472298;20306;11194
65387;Saint-Lanne;73;1482330;59486;38;1069079;35;413251;20306;11195
65201;Geu;103;2091537;83385;63;1731698;40;359839;20306;11196
15087;Lacapelle-del-Fraisse;168;3411445;75373;75;2321685;93;1089760;20306;11197
76341;Harfleur;4552;92434497;3315912;2550;72581867;2002;19852630;20306;11198
14360;Leffard;103;2091559;49913;47;1534292;56;557267;20306;11199
36200;Saint-Marcel;954;19372395;802084;473;14504173;481;4868222;20306;11200
61273;Ménil-Vin;31;629514;14523;16;441687;15;187827;20307;11201
02676;Saint-Erme-Outre-et-Ramecourt;969;19677617;554248;465;14475220;504;5202397;20307;11202
64539;Uhart-Mixe;104;2111945;88594;41;1396266;63;715679;20307;11203
61488;Touquettes;48;974744;37763;25;749507;23;225237;20307;11204
22279;Saint-Caradec;628;12752904;407445;323;9576874;305;3176030;20307;11205
66011;Bages;2364;48006378;1725002;1197;36530231;1167;11476147;20307;11206
36185;Saint-Christophe-en-Bazelle;216;4386401;159095;105;3174155;111;1212246;20307;11207
33510;Semens;107;2172944;64358;62;1732453;45;440491;20308;11208
59465;Pommereuil;364;7392159;230990;186;5552344;178;1839815;20308;11209
31173;Esperce;149;3025998;100600;87;2421821;62;604177;20309;11210
49033;La Boissière-sur-Èvre;230;4671014;100221;121;3360353;109;1310661;20309;11211
27414;Montreuil-l'Argillé;476;9667141;497863;223;7380126;253;2287015;20309;11212
89025;Avallon;4407;89503797;5076645;2050;68510198;2357;20993599;20309;11213
47104;Frégimont;145;2944939;112469;56;2001034;89;943905;20310;11214
72019;Avessé;172;3493351;44942;88;2456166;84;1037185;20310;11215
76366;Le Houlme;2264;45983177;1354330;1225;35024310;1039;10958867;20311;11216
40188;Momuy;233;4732432;127023;123;3448890;110;1283542;20311;11217
65452;Trie-sur-Baïse;659;13384917;701652;295;9909317;364;3475600;20311;11218
31174;Estadens;287;5829274;193132;150;4415287;137;1413987;20311;11219
19113;Liginiac;381;7738536;296949;187;5805172;194;1933364;20311;11220
85305;Vouvant;493;10013559;377370;213;7103128;280;2910431;20311;11221
53055;Chantrigné;315;6398227;138996;149;4307321;166;2090906;20312;11222
55274;Lamorville;159;3229590;75401;81;2296558;78;933032;20312;11223
86265;Sossais;244;4956246;139966;132;3793911;112;1162335;20312;11224
02064;Belleu;2161;43895288;1550992;1179;33718563;982;10176725;20312;11225
65035;Artagnan;289;5870413;165580;139;4294638;150;1575775;20313;11226
50365;Muneville-sur-Mer;214;4346979;34715;124;3238338;90;1108641;20313;11227
31272;Lapeyrère;35;710956;9432;21;587992;14;122964;20313;11228
64264;L'Hôpital-Saint-Blaise;33;670343;10854;15;508563;18;161780;20313;11229
93063;Romainville;13755;279412024;14039886;7084;221386068;6671;58025956;20313;11230
07086;Étables;418;8491171;191296;212;6081011;206;2410160;20314;11231
42218;Saint-Étienne;96862;1967672623;96636877;48186;1511074110;48676;456598513;20314;11232
40053;Bourriot-Bergonce;194;3940961;179200;90;2898666;104;1042295;20314;11233
72013;Aubigné-Racan;1182;24011541;709144;612;17666712;570;6344829;20314;11234
17268;Nuaillé-sur-Boutonne;116;2356523;98852;50;1622056;66;734467;20315;11235
70118;Chambornay-lès-Bellevaux;97;1970555;38422;53;1469534;44;501021;20315;11236
62128;Biache-Saint-Vaast;2066;41970996;1143420;1080;31439376;986;10531620;20315;11237
66140;Pézilla-la-Rivière;1824;37055017;1258620;831;27421675;993;9633342;20315;11238
81078;Damiatte;583;11844235;392519;252;8296731;331;3547504;20316;11239
88188;Fresse-sur-Moselle;1041;21149029;584869;516;15351207;525;5797822;20316;11240
24268;Meyrals;350;7110763;247037;162;5021425;188;2089338;20316;11241
89474;Villiers-Vineux;161;3271006;109686;84;2571053;77;699953;20317;11242
38419;Saint-Martin-de-Clelles;85;1726949;51971;38;1273241;47;453708;20317;11243
80516;Marquaix;118;2397414;92599;60;1818187;58;579227;20317;11244
55458;Saint-Jean-lès-Buzy;177;3596126;99346;87;2593805;90;1002321;20317;11245
50359;Mortain;1020;20723864;817426;493;15641611;527;5082253;20318;11246
30252;Saint-Félix-de-Pallières;139;2824157;111727;61;2050029;78;774128;20318;11247
49121;Dénezé-sous-Doué;230;4673071;63237;114;3276561;116;1396510;20318;11248
70103;La Bruyère;106;2153756;73000;50;1517087;56;636669;20318;11249
74203;Novel;35;711152;34141;19;581645;16;129507;20319;11250
39478;Saint-Claude;5846;118783888;4853918;3017;88876885;2829;29907003;20319;11251
40331;Villeneuve-de-Marsan;1365;27735288;1171354;652;20847723;713;6887565;20319;11252
05001;Abriès;213;4327968;158950;128;3471487;85;856481;20319;11253
80795;Ville-le-Marclet;255;5181374;153069;140;4066591;115;1114783;20319;11254
49093;Chemiré-sur-Sarthe;140;2844766;78688;65;1891637;75;953129;20320;11255
29301;Trézilidé;156;3169949;44280;84;2327039;72;842910;20320;11256
62162;Bourecq;289;5872603;141541;131;4235963;158;1636640;20320;11257
17270;Ozillac;360;7315390;287062;172;5399705;188;1915685;20321;11258
02164;Le Charmel;164;3332679;81231;91;2471879;73;860800;20321;11259
89107;Chigy;179;3637505;95729;107;2881707;72;755798;20321;11260
38321;Prébois;90;1828914;32514;38;1169156;52;659758;20321;11261
40080;Cazères-sur-l'Adour;599;12172498;402380;311;9156251;288;3016247;20321;11262
64233;Garlin;758;15403816;477314;340;10845993;418;4557823;20322;11263
14404;Martainville;59;1198992;37492;32;961788;27;237204;20322;11264
88480;Ubexy;102;2072938;90366;50;1671927;52;401011;20323;11265
80071;Beauval;1135;23066810;878838;547;16756473;588;6310337;20323;11266
18173;Osmery;160;3251713;126307;85;2471249;75;780464;20323;11267
05139;Saint-Étienne-en-Dévoluy;285;5792140;224713;160;4480008;125;1312132;20323;11268
46157;Larroque-Toirac;78;1585245;55120;33;1140999;45;444246;20324;11269
42171;Pinay;144;2926659;55498;71;2073727;73;852932;20324;11270
12261;Saujac;72;1463340;19355;32;1039039;40;424301;20324;11271
72226;Oizé;593;12052337;169874;317;8804657;276;3247680;20324;11272
49201;La Ménitré;1167;23719266;592335;609;17826396;558;5892870;20325;11273
55477;Savonnières-en-Perthois;250;5081366;162460;127;3768599;123;1312767;20325;11274
42101;Graix;84;1707343;51046;41;1221473;43;485870;20326;11275
58106;Dun-les-Places;237;4817191;211526;117;3596899;120;1220292;20326;11276
09106;Dreuilhe;195;3963523;122919;99;2944100;96;1019423;20326;11277
32361;Saint-Arroman;68;1382159;46273;32;991233;36;390926;20326;11278
70315;Magnoncourt;247;5020521;204255;125;3768270;122;1252251;20326;11279
80437;Heucourt-Croquoison;65;1321197;41323;34;951828;31;369369;20326;11280
63436;Tralaigues;48;975673;76202;13;643797;35;331876;20327;11281
32083;Castéra-Verduzan;584;11870716;364219;268;8625220;316;3245496;20327;11282
83038;Châteaudouble;253;5142632;198646;129;4030973;124;1111659;20327;11283
70485;Selles;145;2947420;80470;74;2115071;71;832349;20327;11284
32213;Lombez;1137;23112149;946891;560;17512570;577;5599579;20327;11285
22384;Uzel;567;11525666;332929;279;8281579;288;3244087;20327;11286
55567;Ville-sur-Cousances;65;1321291;49054;25;842106;40;479185;20328;11287
88524;Vrécourt;199;4045190;142411;96;3038404;103;1006786;20328;11288
86042;Buxeuil;536;10895728;329237;283;8097232;253;2798496;20328;11289
16225;Montemboeuf;373;7582353;242262;155;5471057;218;2111296;20328;11290
71254;Lays-sur-le-Doubs;96;1951504;96772;45;1506103;51;445401;20328;11291
04034;La Brillanne;553;11241817;358486;267;8305391;286;2936426;20329;11292
85291;Thorigny;613;12461699;254250;334;9325777;279;3135922;20329;11293
49190;Le Marillais;513;10428870;182779;253;7229370;260;3199500;20329;11294
54563;Vézelise;852;17320781;801746;387;13324007;465;3996774;20330;11295
22345;Trébry;452;9189111;264382;245;6925515;207;2263596;20330;11296
29025;Cast;874;17769570;454677;420;12601219;454;5168351;20331;11297
82184;Vaïssac;416;8458106;309480;196;6321363;220;2136743;20332;11298
88286;Marainville-sur-Madon;53;1077605;33692;25;814564;28;263041;20332;11299
65328;Neuilh;45;914990;17140;23;627640;22;287350;20333;11300
62197;Camblain-Châtelain;924;18787863;755890;443;14108819;481;4679044;20333;11301
46008;Les Arques;118;2399363;80345;52;1608913;66;790450;20334;11302
03016;Barberier;84;1708046;50620;44;1283455;40;424591;20334;11303
19016;Bar;193;3924543;219662;93;2975126;100;949417;20334;11304
19187;Saint-Bonnet-la-Rivière;205;4168578;116746;114;3208668;91;959910;20335;11305
64058;Arthez-d'Asson;294;5978548;179457;141;4301688;153;1676860;20335;11306
59420;Moustier-en-Fagne;36;732068;32790;17;592031;19;140037;20335;11307
03292;Tronget;463;9415495;298883;234;7118992;229;2296503;20336;11308
52518;Vesaignes-sur-Marne;72;1464229;63510;41;1131703;31;332526;20337;11309
30271;Saint-Julien-de-Cassagnas;371;7544907;215427;178;5346438;193;2198469;20337;11310
17159;Fléac-sur-Seugne;218;4433419;106917;100;3203623;118;1229796;20337;11311
44168;Saint-Joachim;2253;45819248;1307337;1237;34226762;1016;11592486;20337;11312
62267;Dennebroeucq;197;4006434;213347;83;2787053;114;1219381;20337;11313
17346;Saint-Hippolyte;762;15497238;471656;380;11692675;382;3804563;20338;11314
02432;Limé;102;2074475;66186;53;1523734;49;550741;20338;11315
04019;Barcelonnette;1742;35428974;1788259;859;26622917;883;8806057;20338;11316
16142;La Forêt-de-Tessé;117;2379573;63655;61;1757511;56;622062;20338;11317
79314;Sompt;162;3294815;91248;79;2432586;83;862229;20338;11318
54322;Longuyon;3209;65268322;2710631;1308;41973771;1901;23294551;20339;11319
46204;Montfaucon;228;4637332;156704;114;3442088;114;1195244;20339;11320
14073;La Bigne;114;2318669;79036;57;1749506;57;569163;20339;11321
39300;Lons-le-Saunier;10942;222555569;11172600;5497;171702783;5445;50852786;20340;11322
59302;Hérin;2113;42980517;1644430;1046;32366296;1067;10614221;20341;11323
17174;Genouillé;431;8767018;223735;215;6381465;216;2385553;20341;11324
59389;Masnières;1411;28702266;946529;724;21359118;687;7343148;20342;11325
14741;Le Vey;48;976436;12656;25;706124;23;270312;20342;11326
27679;Verneuil-sur-Avre;3965;80658618;3724264;1896;61059743;2069;19598875;20343;11327
88305;Moncel-sur-Vair;115;2339448;67278;64;1841423;51;498025;20343;11328
30161;Massanes;106;2156365;67733;48;1503335;58;653030;20343;11329
02787;Verneuil-sur-Serre;151;3071811;88721;89;2455294;62;616517;20343;11330
64180;Castetpugon;105;2136047;65053;54;1685030;51;451017;20343;11331
08479;Villers-le-Tourneur;90;1830940;48268;54;1397797;36;433143;20344;11332
32416;Sarrant;216;4394272;159264;101;3312106;115;1082166;20344;11333
40068;Cassen;297;6042160;218245;143;4471091;154;1571069;20344;11334
42016;La Bénisson-Dieu;230;4679163;116681;105;3091672;125;1587491;20344;11335
80320;Folies;80;1627547;90271;42;1285045;38;342502;20344;11336
11058;Cailhau;146;2970300;86282;63;1968669;83;1001631;20345;11337
18096;Foëcy;1156;23518350;714234;650;18023541;506;5494809;20345;11338
61335;La Poterie-au-Perche;86;1749659;58481;47;1358826;39;390833;20345;11339
55323;Martincourt-sur-Meuse;31;630699;8857;17;490661;14;140038;20345;11340
24321;Pazayac;452;9196082;322252;257;7187067;195;2009015;20345;11341
61374;Saint-Christophe-de-Chaulieu;50;1017292;39529;23;714717;27;302575;20346;11342
61103;Chaumont;89;1810795;30660;44;1310245;45;500550;20346;11343
48162;Saint-Julien-d'Arpaon;60;1220790;49157;31;917202;29;303588;20347;11344
42145;Montagny;616;12533563;328581;303;9065197;313;3468366;20347;11345
62780;Sauchy-Cauchy;203;4130420;135427;106;3222060;97;908360;20347;11346
85245;Saint-Martin-des-Fontaines;90;1831221;59847;36;1162202;54;669019;20347;11347
80419;Hargicourt;204;4150837;148339;99;3066981;105;1083856;20347;11348
34036;Le Bosc;699;14222909;420466;348;10734026;351;3488883;20348;11349
04142;Oppedette;29;590093;17892;13;428378;16;161715;20348;11350
83033;Carnoules;1877;38193830;1290248;942;28769611;935;9424219;20348;11351
83122;Les Salles-sur-Verdon;145;2950544;118697;80;2359419;65;591125;20349;11352
37029;Bossée;186;3784902;89920;105;2922559;81;862343;20349;11353
54112;Chambley-Bussières;322;6552497;117859;168;4716656;154;1835841;20349;11354
50114;Les Chambres;60;1220965;11533;27;857865;33;363100;20349;11355
33101;Cartelègue;643;13084703;551214;295;9909788;348;3174915;20349;11356
32049;Bétous;53;1078532;34663;26;777731;27;300801;20350;11357
19116;Liourdres;137;2787973;76824;70;2023381;67;764592;20350;11358
61301;Neauphe-sous-Essai;112;2279332;39181;52;1595094;60;684238;20351;11359
46183;Marcilhac-sur-Célé;127;2584625;82436;62;1783387;65;801238;20351;11360
76649;Saint-Saire;294;5983364;159972;140;4510586;154;1472778;20352;11361
17402;Saint-Sigismond-de-Clermont;90;1831658;40794;48;1394002;42;437656;20352;11362
57551;Postroff;117;2381183;76031;64;1862580;53;518603;20352;11363
61029;Bazoches-sur-Hoëne;501;10196373;321735;231;7190641;270;3005732;20352;11364
84087;Orange;17432;354794551;15632368;8463;267877269;8969;86917282;20353;11365
85054;La Chapelle-Hermier;467;9504947;186973;248;6972908;219;2532039;20353;11366
69240;Saint-Vincent-de-Reins;379;7714044;216568;194;5512594;185;2201450;20354;11367
50041;Beaumont-Hague;771;15692712;486751;411;11960212;360;3732500;20354;11368
25284;Grand-Charmont;2838;57764699;2232730;1461;42883677;1377;14881022;20354;11369
57186;Ébersviller;438;8915074;183617;212;6189149;226;2725925;20354;11370
39387;Nevy-lès-Dole;145;2951349;94646;77;2178110;68;773239;20354;11371
61033;Beaulandais;94;1913333;54691;50;1464154;44;449179;20355;11372
34003;Agde;18339;373288283;19885662;8837;288219872;9502;85068411;20355;11373
16241;Nanclars;125;2544397;95890;68;1957982;57;586415;20355;11374
10212;Machy;67;1363799;46646;33;1049520;34;314279;20355;11375
50269;Liesville-sur-Douve;115;2340971;68910;67;1819756;48;521215;20356;11376
79103;Courlay;1315;26770357;723534;646;19609997;669;7160360;20358;11377
27056;Bernay;6582;133995635;7160219;3145;103984084;3437;30011551;20358;11378
50217;Le Grand-Celland;298;6066683;103710;148;4370745;150;1695938;20358;11379
37195;La Riche;6038;122923360;5423960;3447;98564420;2591;24358940;20358;11380
32374;Saint-Élix;96;1954398;54643;49;1422521;47;531877;20358;11381
21378;Marcenay;67;1364054;79135;32;1057054;35;307000;20359;11382
58305;Vauclaix;66;1343718;34329;28;882464;38;461254;20359;11383
61402;Saint-Hilaire-de-Briouze;153;3114997;50601;80;2233620;73;881377;20359;11384
51368;Minaucourt-le-Mesnil-lès-Hurlus;32;651517;13649;15;451303;17;200214;20360;11385
60588;Saint-Maur;202;4112716;148506;104;3145048;98;967668;20360;11386
33177;Gaillan-en-Médoc;1321;26895697;1061179;645;19618440;676;7277257;20360;11387
49125;Doué-la-Fontaine;4270;86937688;3255482;2005;63369726;2265;23567962;20360;11388
71373;Romenay;1022;20808392;801644;449;14969433;573;5838959;20360;11389
61388;Saint-Fulgent-des-Ormes;104;2117506;70154;54;1613444;50;504062;20361;11390
90010;Belfort;26388;537283004;29072600;13331;418515206;13057;118767798;20361;11391
19240;Saint-Salvadour;190;3868651;118969;92;2888499;98;980152;20361;11392
52470;Serqueux;266;5416112;217045;140;4188212;126;1227900;20361;11393
32404;Saint-Puy;336;6841415;373051;149;5096955;187;1744460;20361;11394
72101;Courcemont;320;6515831;107542;179;4941439;141;1574392;20362;11395
24458;Saint-Martin-le-Pin;183;3726477;144030;92;2786480;91;939997;20363;11396
70309;Loulans-Verchamp;252;5131563;119750;127;3699820;125;1431743;20363;11397
70500;Thieffrans;95;1934555;44445;48;1354815;47;579740;20364;11398
29193;Plougourvest;713;14519463;423660;365;11250412;348;3269051;20364;11399
21421;Moloy;123;2504860;49782;68;1905594;55;599266;20365;11400
37048;Chambon;179;3645289;101991;79;2533986;100;1111303;20365;11401
53018;Ballots;636;12952075;289466;295;8945071;341;4007004;20365;11402
88523;Vouxey;83;1690303;28548;44;1266631;39;423672;20365;11403
12120;Laissac;959;19530201;716164;469;14770981;490;4759220;20365;11404
89128;Coutarnoux;65;1323751;43939;38;990191;27;333560;20365;11405
39137;Chemilla;64;1303427;31694;39;1075894;25;227533;20366;11406
04189;Saint-Martin-de-Brômes;329;6700511;226833;164;4982582;165;1717929;20366;11407
15156;Prunet;317;6456264;103729;157;4688511;160;1767753;20367;11408
76411;Marques;131;2668135;79957;66;2038375;65;629760;20367;11409
80138;Bresle;60;1222053;23656;30;901145;30;320908;20368;11410
03257;Saint-Prix;448;9124793;319443;215;6621360;233;2503433;20368;11411
41149;Montoire-sur-le-Loir;2485;50615501;2027598;1201;36765455;1284;13850046;20368;11412
38173;Le Freney-d'Oisans;126;2566446;61343;80;2084043;46;482403;20369;11413
82131;Montpezat-de-Quercy;855;17415817;837124;398;12671424;457;4744393;20369;11414
51388;Mourmelon-le-Grand;2381;48500814;1404296;1365;37167999;1016;11332815;20370;11415
79114;Exireuil;831;16927605;416330;427;12556842;404;4370763;20370;11416
55398;Pagny-sur-Meuse;514;10470470;209697;282;7746020;232;2724450;20371;11417
88466;They-sous-Montfort;95;1935236;69546;54;1487493;41;447743;20371;11418
76269;Fontaine-en-Bray;88;1792640;43919;52;1399615;36;393025;20371;11419
65461;Vidou;45;916716;32412;22;733978;23;182738;20371;11420
72191;Mayet;1809;36852755;1072407;917;26927539;892;9925216;20372;11421
30152;Les Mages;1143;23285482;794158;572;17257469;571;6028013;20372;11422
62256;Crépy;79;1609409;35372;30;902910;49;706499;20372;11423
11161;Gardie;58;1181614;14408;30;886250;28;295364;20373;11424
50401;Pierreville;361;7354632;100486;180;5287187;181;2067445;20373;11425
72097;Coulombiers;232;4726578;130815;115;3666336;117;1060242;20373;11426
58082;Corancy;210;4278416;168793;111;3325883;99;952533;20373;11427
50584;Subligny;189;3850587;89854;97;2903940;92;946647;20373;11428
72042;Bouloire;1162;23674056;766334;580;17271270;582;6402786;20374;11429
49273;Saint-Crespin-sur-Moine;803;16359975;210335;423;11749089;380;4610886;20374;11430
26155;Lapeyrouse-Mornay;630;12835433;323641;334;9659604;296;3175829;20374;11431
69254;Valsonne;442;9005431;218462;227;6513403;215;2492028;20374;11432
55150;Demange-aux-Eaux;282;5745549;197890;135;4094770;147;1650779;20374;11433
27148;La Chapelle-Gauthier;214;4360100;141481;115;3324096;99;1036004;20374;11434
62833;Vacquerie-le-Boucq;49;998360;26609;26;734402;23;263958;20375;11435
70459;Saint-Barthélemy;612;12469715;343076;313;9030282;299;3439433;20375;11436
52476;Sommerécourt;46;937271;24424;27;723927;19;213344;20375;11437
62591;Morchies;109;2220956;69498;48;1439623;61;781333;20376;11438
32172;Labéjan;168;3423174;73813;91;2603128;77;820046;20376;11439
67059;Bourg-Bruche;257;5236669;159036;140;3988964;117;1247705;20376;11440
34105;Fouzilhon;129;2628546;93294;66;2051888;63;576658;20376;11441
37065;Chaveignes;333;6785381;252885;155;4882601;178;1902780;20377;11442
54599;Xonville;65;1324483;20604;33;920152;32;404331;20377;11443
30079;Chambon;158;3219521;108973;69;2166538;89;1052983;20377;11444
17045;Beurlay;540;11003447;355257;274;8308709;266;2694738;20377;11445
07242;Saint-Gineis-en-Coiron;60;1222650;33298;29;912646;31;310004;20378;11446
38306;Pinsot;116;2363950;73784;65;1832757;51;531193;20379;11447
03204;Paray-sous-Briailles;335;6827107;183221;184;5176479;151;1650628;20379;11448
40083;Clèdes;71;1446964;45616;29;1041631;42;405333;20380;11449
88521;Vomécourt;150;3057220;75453;70;2098324;80;958896;20381;11450
80622;Picquigny;780;15897714;533484;415;12342550;365;3555164;20382;11451
50300;Le Mesnil-Adelée;91;1854751;43400;39;1311563;52;543188;20382;11452
72023;Ballon;767;15633071;435904;389;11388316;378;4244755;20382;11453
2B012;Altiani;35;713417;31486;19;592100;16;121317;20383;11454
24304;Nantheuil;557;11353539;327655;290;8537659;267;2815880;20383;11455
02461;Marest-Dampcourt;198;4036036;136295;107;3069285;91;966751;20384;11456
12073;Comps-la-Grand-Ville;286;5829870;117535;143;4277990;143;1551880;20384;11457
29074;Guimiliau;526;10722240;219587;284;8042872;242;2679368;20384;11458
01077;Challes-la-Montagne;114;2323889;75468;68;1790693;46;533196;20385;11459
40263;Saint-Jean-de-Lier;216;4403312;134262;109;3370483;107;1032829;20386;11460
89073;Champignelles;638;13006118;613272;311;9715352;327;3290766;20386;11461
61079;Ceton;1065;21710995;820376;554;16589369;511;5121626;20386;11462
22370;Tréméven;183;3730631;138755;84;2606489;99;1124142;20386;11463
52517;Vesaignes-sous-Lafauche;68;1386289;15899;36;1018096;32;368193;20387;11464
76351;Le Havre;100676;2052444062;100167751;51756;1614203479;48920;438240583;20387;11465
61295;La Motte-Fouquet;80;1630975;41784;44;1216277;36;414698;20387;11466
27596;Saint-Pierre-du-Mesnil;59;1202870;60222;30;941525;29;261345;20388;11467
39430;Plumont;58;1182531;26561;31;857060;27;325471;20388;11468
59035;Avesnelles;1466;29889678;1322215;690;22377060;776;7512618;20389;11469
49244;La Pommeraye;2090;42612672;735606;1016;30493578;1074;12119094;20389;11470
82047;Cumont;34;693239;34507;19;563095;15;130144;20389;11471
26293;Saint-Avit;155;3160419;77600;64;2068573;91;1091846;20390;11472
79038;Boismé;621;12662208;304418;296;8938240;325;3723968;20390;11473
79313;Sepvret;308;6280305;138655;153;4543323;155;1736982;20391;11474
42131;Maizilly;183;3731492;81281;101;2805708;82;925784;20391;11475
54547;Vandoeuvre-lès-Nancy;15234;310635589;16023901;7502;243465614;7732;67169975;20391;11476
57615;Saint-Jean-Rohrbach;490;9991719;271534;245;7296708;245;2695011;20391;11477
88171;Fignévelle;28;570962;15366;13;371265;15;199697;20392;11478
31457;Roquefort-sur-Garonne;439;8951942;293147;235;6830489;204;2121453;20392;11479
65298;Marquerie;46;938017;40433;25;780882;21;157135;20392;11480
08350;Quatre-Champs;117;2385918;50617;63;1729229;54;656689;20392;11481
77288;Melun;22231;453348712;26063845;11966;364449199;10265;88899513;20393;11482
24035;Belvès;872;17782653;692263;381;12203683;491;5578970;20393;11483
22298;Saint-Guen;246;5016793;148212;119;3635694;127;1381099;20393;11484
85257;Saint-Michel-Mont-Mercure;1003;20454730;296453;545;14827331;458;5627399;20394;11485
90066;Leval;130;2651171;105652;62;2023335;68;627836;20394;11486
61406;Saint-Hilaire-sur-Risle;190;3874793;131169;100;2866316;90;1008477;20394;11487
47055;Castelnaud-de-Gratecambe;286;5832680;223827;128;4129810;158;1702870;20394;11488
06058;Escragnolles;257;5241255;151324;128;3941163;129;1300092;20394;11489
32023;Avezan;40;815771;35389;18;586664;22;229107;20394;11490
46009;Assier;354;7219688;255650;156;5089739;198;2129949;20395;11491
03315;Villefranche-d'Allier;707;14419002;497088;357;10358273;350;4060729;20395;11492
72061;La Chapelle-d'Aligné;835;17029935;306497;463;12704195;372;4325740;20395;11493
67385;Ratzwiller;162;3304063;78314;91;2529575;71;774488;20395;11494
21028;Athée;429;8749980;270846;218;6496719;211;2253261;20396;11495
40112;Gibret;57;1162595;42036;26;847951;31;314644;20396;11496
70498;Ternuay-Melay-et-Saint-Hilaire;283;5772248;152852;126;3998423;157;1773825;20397;11497
82105;Mas-Grenier;666;13584223;330352;322;9763939;344;3820284;20397;11498
56104;Lanvaudan;405;8260859;239505;209;6209470;196;2051389;20397;11499
26127;Eygaliers;68;1387035;60620;31;1053890;37;333145;20398;11500
10061;Brévonnes;360;7343420;185936;179;5461338;181;1882082;20398;11501
89439;Vergigny;872;17787930;669099;488;14205576;384;3582354;20399;11502
02763;Vasseny;97;1978756;37415;50;1370639;47;608117;20400;11503
27051;Beaumont-le-Roger;1695;34577612;1295887;844;25677362;851;8900250;20400;11504
51397;La Neuville-aux-Bois;94;1917587;83861;52;1573255;42;344332;20400;11505
70491;Seveux;253;5161167;124855;131;3743043;122;1418124;20400;11506
19269;Treignac;860;17544304;764397;432;13107276;428;4437028;20400;11507
67370;Petersbach;381;7772554;191715;206;5702711;175;2069843;20400;11508
2B293;Sant'Andréa-di-Cotone;122;2488851;104031;65;1871946;57;616905;20400;11509
11426;Villegly;572;11669072;272477;302;8719894;270;2949178;20400;11510
57302;Hattigny;109;2223681;72604;53;1577243;56;646438;20401;11511
53063;Châtelain;229;4671816;30592;130;3545770;99;1126046;20401;11512
52211;Froncles;951;19401520;772640;457;14512038;494;4889482;20401;11513
33235;Lavazan;126;2570567;174765;49;1875952;77;694615;20401;11514
88239;Hergugney;71;1448512;36225;31;950825;40;497687;20402;11515
58299;Trucy-l'Orgueilleux;145;2958235;100826;80;2255610;65;702625;20402;11516
62033;Annay;2243;45762939;1679128;1131;34589119;1112;11173820;20403;11517
38495;La Sône;368;7508390;291741;196;5799238;172;1709152;20403;11518
17178;Givrezac;32;652910;19798;12;435822;20;217088;20403;11519
47070;Condezaygues;482;9834476;324759;248;7373229;234;2461247;20403;11520
09240;Quié;184;3754258;134879;97;2802796;87;951462;20404;11521
64253;Gurs;231;4713453;109629;115;3397791;116;1315662;20405;11522
21546;Saint-Didier;126;2571045;82367;64;1973640;62;597405;20405;11523
51057;Bettancourt-la-Longue;50;1020264;33481;28;782860;22;237404;20405;11524
17449;Tonnay-Charente;4665;95191360;3196900;2444;72627379;2221;22563981;20405;11525
02448;Mâchecourt;65;1326370;39408;34;963884;31;362486;20406;11526
14515;Port-en-Bessin-Huppain;1293;26385080;1103352;705;20155859;588;6229221;20406;11527
30024;Aulas;271;5530081;244728;124;4060857;147;1469224;20406;11528
86117;Jouhet;284;5795381;216082;148;4297592;136;1497789;20406;11529
62494;Léchelle;29;591797;12403;13;397242;16;194555;20407;11530
42165;Panissières;1716;35018407;1062348;842;25423266;874;9595141;20407;11531
25319;Labergement-du-Navois;56;1142796;27939;27;800837;29;341959;20407;11532
03096;Deneuille-lès-Chantelle;58;1183628;44602;32;895868;26;287760;20407;11533
43216;Saint-Paulien;1329;27121740;900598;640;20009919;689;7111821;20408;11534
57209;Faulquemont;2891;58998951;2285706;1449;43728122;1442;15270829;20408;11535
72237;Pirmil;259;5285702;74865;134;3924967;125;1360735;20408;11536
76642;Saint-Pierre-le-Viger;168;3428571;177803;77;2461273;91;967298;20408;11537
80212;Corbie;3568;72816832;3100971;1773;55813708;1795;17003124;20408;11538
21102;Brazey-en-Morvan;87;1775528;71428;32;1194185;55;581343;20408;11539
08089;Buzancy;218;4449046;225106;94;3267561;124;1181485;20408;11540
72262;Ruillé-sur-Loir;726;14816920;716512;334;11236771;392;3580149;20409;11541
50025;Avranches;4850;98983903;5417368;2208;76029684;2642;22954219;20409;11542
33464;Saint-Pierre-de-Bat;178;3632926;141459;83;2677195;95;955731;20410;11543
11407;Verdun-en-Lauragais;155;3163743;128314;78;2476821;77;686922;20411;11544
31362;Montberaud;118;2408558;149569;42;1626966;76;781592;20412;11545
58281;Suilly-la-Tour;350;7144080;242234;176;5289249;174;1854831;20412;11546
27685;La Vieille-Lyre;349;7123693;300657;173;5402364;176;1721329;20412;11547
2A269;Sari-Solenzara;768;15676659;884781;369;11887956;399;3788703;20412;11548
24408;Saint-Front-d'Alemps;162;3306871;103813;81;2373160;81;933711;20413;11549
07073;Le Crestet;293;5980957;160288;137;4357418;156;1623539;20413;11550
71499;Sanvignes-les-Mines;2495;50930074;1600446;1297;38103376;1198;12826698;20413;11551
82003;Angeville;108;2204607;65045;55;1641622;53;562985;20413;11552
82050;Dunes;635;12962965;419819;314;9580283;321;3382682;20414;11553
84008;Le Barroux;399;8145510;435866;155;6321362;244;1824148;20415;11554
16378;Taizé-Aizie;359;7329021;213777;202;5645807;157;1683214;20415;11555
26184;Miribel;154;3143949;97556;76;2279965;78;863984;20415;11556
08500;Wignicourt;41;837039;20571;23;703011;18;134028;20416;11557
41068;Courmemin;282;5757371;213088;128;4154347;154;1603024;20416;11558
59541;Saint-Python;545;11126932;453290;256;7934443;289;3192489;20416;11559
21418;Moitron;31;632912;23806;19;531158;12;101754;20417;11560
41194;Romorantin-Lanthenay;10627;216969999;9695982;5343;166905871;5284;50064128;20417;11561
61114;Commeaux;84;1715025;56799;50;1376595;34;338430;20417;11562
47207;Pompiey;118;2409237;63112;62;1838734;56;570503;20417;11563
24423;Sainte-Innocence;59;1204640;37479;30;925245;29;279395;20418;11564
29004;Bannalec;3172;64767120;1903539;1629;47680340;1543;17086780;20418;11565
14381;Louvagny;33;673818;9848;20;550297;13;123521;20419;11566
11418;Villasavary;602;12292206;478478;274;8895296;328;3396910;20419;11567
71048;Bourg-le-Comte;107;2184836;44012;57;1643496;50;541340;20419;11568
57714;Haute-Vigneulles;228;4655540;130652;115;3435100;113;1220440;20419;11569
51646;Virginy;48;980131;27110;23;736533;25;243598;20419;11570
24431;Saint-Julien-de-Crempse;111;2266577;64825;53;1665389;58;601188;20420;11571
15144;Omps;163;3328547;90680;78;2396246;85;932301;20421;11572
50589;Tanis;168;3430665;66554;95;2554605;73;876060;20421;11573
46076;Cornac;202;4125003;210373;106;3160188;96;964815;20421;11574
38340;Les Roches-de-Condrieu;1083;22115785;763520;600;17054851;483;5060934;20421;11575
55118;Cléry-le-Grand;46;939360;10366;20;489521;26;449839;20421;11576
40038;Bergouey;64;1306941;49333;31;949581;33;357360;20421;11577
26302;Sainte-Eulalie-en-Royans;290;5922133;149790;150;4379666;140;1542467;20421;11578
57004;Achain;45;918964;23495;25;724614;20;194350;20421;11579
05159;Saléon;51;1041528;30003;27;773351;24;268177;20422;11580
69164;Ranchal;173;3533064;89625;83;2493110;90;1039954;20422;11581
79056;Brion-près-Thouet;413;8434473;191429;225;6509384;188;1925089;20422;11582
26278;La Roche-sur-le-Buis;173;3533087;187711;75;2740234;98;792853;20422;11583
14668;Saonnet;133;2716200;24638;75;2115326;58;600874;20423;11584
38302;Le Périer;88;1797210;50498;48;1350150;40;447060;20423;11585
46276;Saint-Martin-Labouval;106;2164829;79938;49;1555624;57;609205;20423;11586
76465;Neuville-Ferrières;296;6045246;168381;157;4677049;139;1368197;20423;11587
41123;Marchenoir;376;7679249;273476;174;5392448;202;2286801;20424;11588
47284;Salles;167;3410771;163458;79;2603135;88;807636;20424;11589
33341;Pugnac;1219;24896962;892837;601;18740110;618;6156852;20424;11590
64167;Carrère;104;2124110;23809;52;1506425;52;617685;20424;11591
18224;Saint-Martin-des-Champs;195;3982769;177340;106;3052309;89;930460;20424;11592
66072;Estavar;253;5167534;228301;126;3986278;127;1181256;20425;11593
25141;Chaux-lès-Passavant;68;1388927;49659;30;1014555;38;374372;20425;11594
24158;Dussac;240;4902166;174088;114;3602420;126;1299746;20426;11595
72204;Montaillé;295;6025607;155774;158;4443799;137;1581808;20426;11596
47066;Clermont-Dessous;414;8456352;200820;208;6237157;206;2219195;20426;11597
76126;Bosc-Mesnil;154;3145643;120878;74;2260163;80;885480;20426;11598
16300;Saint-Angeau;415;8476925;355037;171;5731595;244;2745330;20426;11599
73327;Vions;225;4596043;125897;119;3290380;106;1305663;20427;11600
89388;Sépeaux;252;5147624;221265;141;4126975;111;1020649;20427;11601
37001;Abilly;651;13298593;535428;319;10011875;332;3286718;20428;11602
11116;Cuxac-d'Aude;2422;49476572;2268313;1080;36116823;1342;13359749;20428;11603
21679;Vieilmoulin;62;1266546;45034;36;998434;26;268112;20428;11604
12142;Mayran;308;6291903;96371;147;4502962;161;1788941;20428;11605
29104;Landévennec;213;4351316;177299;100;3320023;113;1031293;20429;11606
77218;Grisy-sur-Seine;68;1389179;41782;35;1082920;33;306259;20429;11607
80263;L'Échelle-Saint-Aurin;30;612878;20271;15;435453;15;177425;20429;11608
39122;Châtillon;75;1532214;65516;34;1095378;41;436836;20430;11609
41265;Troo;196;4004276;190061;104;3128776;92;875500;20430;11610
57489;Mouterhouse;157;3207532;98768;98;2535494;59;672038;20430;11611
79214;Pouffonds;205;4188259;56271;114;3080192;91;1108067;20431;11612
02766;Vaudesson;126;2574303;108690;61;1870302;65;704001;20431;11613
72315;Saint-Rémy-de-Sillé;453;9255338;303211;237;7023812;216;2231526;20431;11614
62129;Biefvillers-lès-Bapaume;53;1082873;29643;25;847654;28;235219;20432;11615
33036;Bazas;2766;56514394;2433812;1335;42844279;1431;13670115;20432;11616
70328;Malbouhans;209;4270306;104847;106;3148904;103;1121402;20432;11617
02431;Liez;240;4903705;159866;144;3983185;96;920520;20432;11618
30131;Goudargues;613;12524945;484232;308;9641639;305;2883306;20432;11619
71351;Pierre-de-Bresse;1180;24110420;1214028;549;18023103;631;6087317;20433;11620
72044;Bousse;228;4658769;88195;130;3605514;98;1053255;20433;11621
64320;Laruns;823;16817166;679225;450;13142685;373;3674481;20434;11622
22147;Merdrignac;1626;33226220;1065242;794;24342916;832;8883304;20434;11623
37231;Saint-Paterne-Racan;942;19249217;569946;454;14008103;488;5241114;20434;11624
88300;Ménil-de-Senones;74;1512148;34499;33;994276;41;517872;20434;11625
02612;Pont-Arcy;61;1246502;33197;33;924200;28;322302;20434;11626
72038;Boëssé-le-Sec;325;6641231;159223;174;4886081;151;1755150;20435;11627
15005;Anglards-de-Saint-Flour;194;3964331;98204;112;3100164;82;864167;20435;11628
24285;Montagnac-la-Crempse;211;4311786;186439;83;2807487;128;1504299;20435;11629
22317;Saint-Méloir-des-Bois;133;2717871;76189;67;2030589;66;687282;20435;11630
31007;Ambax;36;735670;9892;14;562525;22;173145;20435;11631
27265;Francheville;700;14305145;552913;363;10997417;337;3307728;20436;11632
46250;Saint-Caprais;38;776594;35278;12;490525;26;286069;20437;11633
16320;Saint-Genis-d'Hiersac;521;10647546;454221;274;8162091;247;2485455;20437;11634
21220;Cussey-les-Forges;80;1634964;63064;44;1250441;36;384523;20437;11635
53075;Cosmes;156;3188305;44604;78;2180301;78;1008004;20438;11636
34151;Marsillargues;3732;76274310;3197538;1831;57526793;1901;18747517;20438;11637
86287;Vézières;194;3965095;112347;99;3004142;95;960953;20439;11638
11262;Narbonne;30978;633162306;34400438;14397;488603436;16581;144558870;20439;11639
69019;Belleville;4354;88992869;3204896;2206;66261897;2148;22730972;20439;11640
80204;Combles;428;8748242;421473;195;6522799;233;2225443;20440;11641
72281;Saint-Georges-du-Rosay;233;4762506;145607;135;3637770;98;1124736;20440;11642
35029;Bonnemain;758;15493518;367120;362;11167285;396;4326233;20440;11643
02699;Saponay;150;3066009;102767;83;2266628;67;799381;20440;11644
41016;Billy;569;11630444;360548;316;8929978;253;2700466;20440;11645
87079;La Jonchère-Saint-Maurice;453;9259391;327903;224;6773597;229;2485794;20440;11646
34008;Les Aires;343;7011147;288923;174;5195114;169;1816033;20441;11647
61049;Boissei-la-Lande;56;1144679;23772;30;872569;26;272110;20441;11648
49345;Thouarcé;1035;21156203;599628;509;15212261;526;5943942;20441;11649
86152;Mauprévoir;370;7563090;324955;164;5318059;206;2245031;20441;11650
63211;Marsac-en-Livradois;886;18111119;513565;424;13266191;462;4844928;20441;11651
31329;Maurens;120;2452975;85879;67;1985863;53;467112;20441;11652
57215;Flastroff;165;3372863;72889;78;2241629;87;1131234;20442;11653
03083;Contigny;355;7256990;196394;186;5421730;169;1835260;20442;11654
34026;Beaufort;113;2309979;155369;45;1679362;68;630617;20442;11655
81120;Labruguière;3519;71938232;2210201;1716;52865485;1803;19072747;20443;11656
53053;Champgenéteux;292;5969355;127719;146;4283142;146;1686213;20443;11657
64523;Sévignacq;352;7196617;208708;186;5480879;166;1715738;20445;11658
08331;Noyers-Pont-Maugis;392;8014445;196365;216;6019835;176;1994610;20445;11659
67091;Diedendorf;175;3577882;94995;98;2792878;77;785004;20445;11660
88022;Auzainvilliers;112;2289886;57309;56;1659710;56;630176;20445;11661
46189;Mayrinhac-Lentour;277;5663521;175305;133;4086672;144;1576849;20446;11662
14047;Bayeux;8741;178718523;8786619;4177;137642687;4564;41075836;20446;11663
24014;Aubas;335;6849431;183601;177;5157971;158;1691460;20446;11664
15258;Vic-sur-Cère;1168;23881197;1047761;567;17847395;601;6033802;20446;11665
54545;Vandeléville;114;2330891;71003;67;1884248;47;446643;20446;11666
53031;La Bigottière;222;4539114;25836;106;3074496;116;1464618;20446;11667
66173;Saint-Féliu-d'Amont;447;9139593;220733;243;6914299;204;2225294;20447;11668
70285;Héricourt;5708;116709674;4418657;2994;88759440;2714;27950234;20447;11669
11308;Raissac-sur-Lampy;196;4007576;75744;101;3010265;95;997311;20447;11670
80169;Cannessières;56;1145087;43404;30;875510;26;269577;20448;11671
86036;Bournand;426;8711181;287547;211;6316831;215;2394350;20449;11672
22038;Châtelaudren;651;13312379;501126;296;10007978;355;3304401;20449;11673
43091;Les Estables;185;3783090;57980;89;2739648;96;1043442;20449;11674
35355;Vieux-Vy-sur-Couesnon;594;12146834;257040;320;9202701;274;2944133;20449;11675
08018;Ardeuil-et-Montfauxelles;44;899779;26650;23;675110;21;224669;20450;11676
26370;Vercoiran;75;1533730;60859;34;1103498;41;430232;20450;11677
85115;La Jaudonnière;319;6523642;186405;167;4912660;152;1610982;20450;11678
71145;Cormatin;316;6462364;268396;168;4812243;148;1650121;20451;11679
42110;L'Horme;2515;51433966;1846884;1236;37830419;1279;13603547;20451;11680
37210;Saint-Benoît-la-Forêt;442;9039383;411096;214;7177248;228;1862135;20451;11681
33547;Villandraut;578;11820959;426269;281;8764157;297;3056802;20451;11682
37020;Beaulieu-lès-Loches;1071;21903612;694274;577;16725425;494;5178187;20452;11683
34135;Lespignan;1793;36670149;1371789;882;27465995;911;9204154;20452;11684
03047;La Celle;245;5010826;175393;127;3817093;118;1193733;20452;11685
47081;Dolmayrac;390;7976512;231248;213;6211594;177;1764918;20453;11686
57390;Lemberg;798;16321383;485377;406;11912558;392;4408825;20453;11687
87198;Vaulry;212;4336025;224297;105;3256072;107;1079953;20453;11688
07101;Grospierres;484;9899252;407046;229;7443051;255;2456201;20453;11689
60161;Conteville;52;1063558;38136;34;878146;18;185412;20453;11690
17183;Grézac;485;9919785;249933;248;7206934;237;2712851;20453;11691
31250;Labastide-Clermont;322;6586036;187142;162;4799218;160;1786818;20454;11692
71419;Saint-Germain-du-Bois;1186;24258131;1053897;536;17256870;650;7001261;20454;11693
14226;Donnay;140;2863588;98777;73;2218793;67;644795;20454;11694
81306;Valderiès;478;9777243;296679;253;7204470;225;2572773;20454;11695
31034;Auzas;114;2331888;76886;55;1693036;59;638852;20455;11696
86187;Paizay-le-Sec;242;4950158;124283;119;3580242;123;1369916;20455;11697
82007;Auty;71;1452361;40101;34;1013191;37;439170;20456;11698
55444;Rouvrois-sur-Meuse;92;1881938;34053;48;1350477;44;531461;20456;11699
31010;Antignac;66;1350095;63141;42;1127651;24;222444;20456;11700
14216;Damblainville;122;2495639;80296;58;1871076;64;624563;20456;11701
80743;Suzanne;106;2168398;69599;49;1603056;57;565342;20457;11702
01068;Cerdon;435;8898727;339542;227;6724035;208;2174692;20457;11703
19122;Madranges;114;2332093;105015;52;1636882;62;695211;20457;11704
26162;Lens-Lestang;486;9942266;369651;259;7410301;227;2531965;20457;11705
88383;Remiremont;4986;102007629;5230376;2374;77378614;2612;24629015;20459;11706
55408;Pouilly-sur-Meuse;103;2107324;66401;53;1601860;50;505464;20459;11707
18011;Argent-sur-Sauldre;1359;27804716;947298;710;20970732;649;6833984;20460;11708
25419;Nans;52;1063937;39916;28;794003;24;269934;20460;11709
71179;Dompierre-sous-Sanvignes;39;797962;10993;21;594540;18;203422;20461;11710
19232;Saint-Pardoux-le-Neuf;50;1023031;23417;35;909954;15;113077;20461;11711
29277;Sizun;1206;24676054;748017;598;18214654;608;6461400;20461;11712
79098;La Couarde;153;3130596;117313;80;2393410;73;737186;20461;11713
60558;Roye-sur-Matz;235;4808508;170923;131;3641200;104;1167308;20462;11714
60374;Maignelay-Montigny;1392;28482898;971417;718;21462447;674;7020451;20462;11715
51108;Châlons-en-Champagne;26174;535585476;25969857;14016;424717695;12158;110867781;20463;11716
03160;Marcenat;201;4112981;143440;117;3379799;84;733182;20463;11717
08123;Chuffilly-Roche;37;757158;9865;20;544327;17;212831;20464;11718
32064;Bretagne-d'Armagnac;251;5136491;227074;134;4010657;117;1125834;20464;11719
80557;Estrées-Mons;334;6835054;267432;169;5238855;165;1596199;20464;11720
71212;Génelard;850;17396130;596606;423;12970675;427;4425455;20466;11721
65231;Izaux;118;2415057;81819;54;1710042;64;705015;20467;11722
32314;Peyrecave;37;757274;37493;12;494432;25;262842;20467;11723
62573;Meurchin;2000;40934191;1307038;1005;30629004;995;10305187;20467;11724
59092;Bouchain;2257;46195794;1954439;1078;34277452;1179;11918342;20468;11725
81030;Bertre;55;1125729;21118;32;868050;23;257679;20468;11726
11023;Badens;352;7204669;351353;155;5272044;197;1932625;20468;11727
26059;Bouvante;146;2988301;116639;72;2291599;74;696702;20468;11728
40180;Meilhan;628;12853856;350582;309;9507946;319;3345910;20468;11729
37071;Chezelles;75;1535118;43155;44;1244106;31;291012;20468;11730
18094;Feux;205;4196072;123791;105;3090390;100;1105682;20469;11731
76570;Saint-Crespin;172;3520708;147475;71;2523959;101;996749;20469;11732
87151;Saint-Jean-Ligoure;240;4912627;167407;120;3675032;120;1237595;20469;11733
18236;Saint-Symphorien;74;1514748;51438;43;1212758;31;301990;20470;11734
53068;Chérancé;95;1944652;43702;55;1492003;40;452649;20470;11735
79108;Doux;119;2435954;51462;58;1666777;61;769177;20470;11736
21477;Panges;46;941674;26917;25;778057;21;163617;20471;11737
02133;Bucy-lès-Pierrepont;227;4646976;215689;98;3315958;129;1331018;20471;11738
02194;Cilly;110;2251867;82170;57;1704151;53;547716;20472;11739
03305;Verneix;320;6550920;158388;168;4873647;152;1677273;20472;11740
89368;Saint-Sauveur-en-Puisaye;607;12426371;664884;257;9174659;350;3251712;20472;11741
80765;Tours-en-Vimeu;459;9396641;312160;239;7255702;220;2140939;20472;11742
76134;Bourville;148;3029862;87430;67;2132100;81;897762;20472;11743
76681;Sotteville-lès-Rouen;17640;361132550;16179096;9637;289425620;8003;71706930;20472;11744
46170;Leyme;532;10891383;507030;292;9125924;240;1765459;20473;11745
21400;Le Meix;32;655146;30393;16;506678;16;148468;20473;11746
76054;Bailly-en-Rivière;269;5507359;211066;134;4079994;135;1427365;20473;11747
05162;La Saulce;661;13533207;435191;327;10010647;334;3522560;20474;11748
70338;Melincourt;137;2805139;69147;66;1933861;71;871278;20475;11749
24028;Beaumont-du-Périgord;658;13472926;650835;281;9871094;377;3601832;20476;11750
40027;Bassercles;73;1494745;36344;39;1127109;34;367636;20476;11751
32180;Lagraulet-du-Gers;268;5487653;240837;122;4023815;146;1463838;20476;11752
62086;Bavincourt;207;4238624;154174;93;3041073;114;1197551;20476;11753
62822;Tollent;55;1126216;65347;23;808573;32;317643;20477;11754
61489;Les Tourailles;47;962413;46262;27;777602;20;184811;20477;11755
57561;Rahling;436;8927920;200041;226;6571046;210;2356874;20477;11756
57669;Théding;1273;26067324;876432;598;18587398;675;7479926;20477;11757
77016;Bagneaux-sur-Loing;962;19699217;779696;554;15626852;408;4072365;20477;11758
31494;Saint-Laurent;93;1904412;41113;47;1455596;46;448816;20478;11759
64123;Bidache;730;14948936;498035;358;10942485;372;4006451;20478;11760
77327;Nangis;4560;93381967;4151894;2433;72455270;2127;20926697;20479;11761
59288;Haulchin;1223;25045395;957945;589;18430424;634;6614971;20479;11762
49183;Le Louroux-Béconnais;1392;28506887;495708;659;20236898;733;8269989;20479;11763
40203;Nassiet;197;4034411;70785;93;2822624;104;1211787;20479;11764
46066;Cazals;388;7945957;323665;191;5988629;197;1957328;20479;11765
19073;Égletons;2052;42023505;1798769;1042;32065200;1010;9958305;20479;11766
76438;Millebosc;135;2764743;64840;74;2042291;61;722452;20480;11767
55414;Rancourt-sur-Ornain;112;2293740;55442;55;1594355;57;699385;20480;11768
19001;Affieux;204;4177922;168409;99;3098043;105;1079879;20480;11769
55579;Watronville;62;1269792;20719;31;907286;31;362506;20481;11770
62506;Licques;820;16794440;544852;372;11863254;448;4931186;20481;11771
89215;Lain;101;2068595;59110;52;1563024;49;505571;20481;11772
38413;Saint-Laurent-en-Beaumont;243;4976979;170684;124;3715820;119;1261159;20481;11773
07185;Préaux;339;6943335;208337;179;5278692;160;1664643;20482;11774
10223;Marcilly-le-Hayer;390;7987970;380988;180;5902390;210;2085580;20482;11775
17261;Neuvicq-le-Château;210;4301221;202339;91;2975996;119;1325225;20482;11776
58276;Sémelay;155;3174792;122843;57;2191250;98;983542;20483;11777
89431;Vassy-sous-Pisy;48;983189;37161;20;677684;28;305505;20483;11778
85180;La Pommeraie-sur-Sèvre;548;11225097;231549;276;8005609;272;3219488;20484;11779
91215;Épinay-sous-Sénart;6145;125875756;4827565;3334;98183790;2811;27691966;20484;11780
04111;Mane;773;15834644;636376;381;12150100;392;3684544;20485;11781
30124;Le Garn;112;2294339;76651;50;1722902;62;571437;20485;11782
44081;Legé;2297;47056230;1159147;1136;33982796;1161;13073434;20486;11783
82108;Meauzac;663;13582446;260363;332;9907610;331;3674836;20486;11784
28078;Chapelle-Guillaume;105;2151101;80013;57;1622224;48;528877;20487;11785
71303;Montagny-près-Louhans;258;5285627;148562;140;3956961;118;1328666;20487;11786
80226;Croix-Moligneaux;164;3359882;153646;84;2662546;80;697336;20487;11787
02243;Crouy;1651;33824259;1279736;872;25831098;779;7993161;20487;11788
38457;Saint-Siméon-de-Bressieux;1540;31551366;1185182;761;23522338;779;8029028;20488;11789
59015;Arleux;1579;32352047;1134475;781;24425414;798;7926633;20489;11790
59067;Bergues;2393;49030120;2155207;1143;36155718;1250;12874402;20489;11791
80115;Bouchavesnes-Bergen;182;3728995;98901;104;2930672;78;798323;20489;11792
47279;Saint-Sixte;184;3769999;116746;95;2853806;89;916193;20489;11793
60062;Berlancourt;170;3483182;127595;84;2467058;86;1016124;20489;11794
76343;Haucourt;126;2581663;89111;63;1912641;63;669022;20489;11795
24246;Lunas;196;4016176;150394;96;2905574;100;1110602;20491;11796
65159;Escala;226;4630959;117782;137;3642996;89;987963;20491;11797
44023;Bouvron;1602;32826946;663839;852;23903253;750;8923693;20491;11798
49361;Varennes-sur-Loire;1005;20593695;531945;495;14831926;510;5761769;20491;11799
62692;Rebergues;137;2807301;34439;61;1780602;76;1026699;20491;11800
80136;Bray-sur-Somme;770;15778402;674410;376;11850800;394;3927602;20491;11801
58108;Empury;52;1065578;48234;22;757619;30;307959;20492;11802
46252;Saint-Cernin;117;2397608;90990;59;1805791;58;591817;20492;11803
36228;Valençay;1561;31988753;1379485;769;23721515;792;8267238;20492;11804
80329;Forceville;96;1967302;91736;43;1481635;53;485667;20493;11805
19124;Mansac;780;15984963;450092;393;11793723;387;4191240;20494;11806
26216;La Motte-de-Galaure;411;8422913;214825;213;6378747;198;2044166;20494;11807
83003;Ampus;550;11272157;449350;271;8695381;279;2576776;20495;11808
35009;Baguer-Morvan;865;17728898;464731;427;12825336;438;4903562;20496;11809
33032;Bassens;3896;79852175;2824890;2057;61616882;1839;18235293;20496;11810
09115;Esclagne;79;1619182;99526;33;1165467;46;453715;20496;11811
35217;Le Pertre;741;15187779;440286;358;11016562;383;4171217;20496;11812
41266;Valaire;49;1004345;32328;26;745856;23;258489;20497;11813
72120;Doucelles;123;2521202;27094;62;1854430;61;666772;20498;11814
08460;Tremblois-lès-Rocroi;89;1824291;67768;46;1354589;43;469702;20498;11815
22156;Moustéru;348;7133202;239225;177;5394985;171;1738217;20498;11816
55094;Buzy-Darmont;292;5985432;161443;147;4356002;145;1629430;20498;11817
85261;Sainte-Pexine;130;2664932;102217;64;2026235;66;638697;20499;11818
71545;Tramayes;573;11746340;390210;262;8440182;311;3306158;20500;11819
18095;Flavigny;104;2131991;65462;56;1639982;48;492009;20500;11820
70441;Recologne-lès-Rioz;129;2644496;68323;64;1949266;65;695230;20500;11821
14437;Mondeville;5647;115764050;4205352;3254;90998377;2393;24765673;20500;11822
21372;Maisey-le-Duc;54;1107020;19549;33;878467;21;228553;20500;11823
86021;Benassay;456;9348293;339147;227;7208985;229;2139308;20501;11824
19125;Marcillac-la-Croisille;553;11337043;484916;283;8639933;270;2697110;20501;11825
65307;Mazères-de-Neste;195;3997694;130817;91;2721149;104;1276545;20501;11826
14156;Chênedollé;119;2439694;54383;65;1721132;54;718562;20502;11827
56069;Groix;1464;30014537;1474165;720;22329387;744;7685150;20502;11828
59270;Grand-Fayt;238;4879489;128427;112;3545686;126;1333803;20502;11829
10233;Méry-sur-Seine;844;17303782;579605;402;12390104;442;4913678;20502;11830
24120;Cherveix-Cubas;388;7955042;283988;190;5970678;198;1984364;20503;11831
49297;Saint-Laurent-du-Mottay;392;8037075;129349;197;5872993;195;2164082;20503;11832
38014;Arandon;322;6601949;159659;181;4898843;141;1703106;20503;11833
35257;Saint-Brice-en-Coglès;1555;31882100;996548;788;23631764;767;8250336;20503;11834
24494;Saint-Rémy;260;5330996;229587;122;3812641;138;1518355;20504;11835
88526;Wisembach;249;5105549;188332;115;3572589;134;1532960;20504;11836
85289;La Tardière;667;13677003;248861;370;10150749;297;3526254;20505;11837
33131;Coirac;109;2235141;72447;52;1574334;57;660807;20506;11838
71376;Roussillon-en-Morvan;175;3588536;140962;86;2516972;89;1071564;20506;11839
38226;Mens;834;17102033;557693;393;12334343;441;4767690;20506;11840
70262;Genevreuille;90;1845572;28722;52;1442626;38;402946;20506;11841
41284;Villeneuve-Frouville;40;820255;51948;19;596616;21;223639;20506;11842
31300;Lieoux;65;1332926;49098;39;1117317;26;215609;20507;11843
80267;Ennemain;130;2665854;95629;68;2008756;62;657098;20507;11844
64232;Garlède-Mondebat;115;2358279;64859;56;1767359;59;590920;20507;11845
25499;Romain;63;1291943;13662;34;936587;29;355356;20507;11846
73192;Le Noyer;121;2481469;49309;76;1987279;45;494190;20508;11847
17393;Saint-Romain-de-Benet;983;20159513;733752;460;14455862;523;5703651;20508;11848
64283;Jaxu;87;1784249;36419;39;1210105;48;574144;20509;11849
71379;Sagy;687;14089519;489311;335;10394016;352;3695503;20509;11850
70368;Montot;65;1333094;29563;31;888059;34;445035;20509;11851
59493;Ramousies;133;2727726;117160;69;2080421;64;647305;20509;11852
71409;Saint-Émiland;178;3650652;114835;83;2709479;95;941173;20509;11853
62450;Hestrus;128;2625242;66692;62;1878222;66;747020;20510;11854
33393;Saint-Denis-de-Pile;2862;58700180;1983204;1420;44503165;1442;14197015;20510;11855
71342;Paray-le-Monial;5710;117115184;5739144;2672;86660449;3038;30454735;20511;11856
28093;Châtillon-en-Dunois;441;9045156;330559;222;6802523;219;2242633;20511;11857
08195;Gomont;188;3856046;76241;79;2856601;109;999445;20511;11858
35343;Tresboeuf;594;12183580;216507;307;9159376;287;3024204;20511;11859
03089;Coutansouze;67;1374243;46120;34;990760;33;383483;20511;11860
36024;Bretagne;67;1374248;14829;34;917357;33;456891;20511;11861
31324;Martres-Tolosane;1331;27300704;1079166;680;20483431;651;6817273;20511;11862
16032;Bassac;302;6194506;209848;155;4819678;147;1374828;20512;11863
02527;Morsain;237;4861284;158418;128;3723681;109;1137603;20512;11864
82181;Sistels;113;2317842;94783;53;1755048;60;562794;20512;11865
66015;Banyuls-dels-Aspres;694;14235364;588138;319;10847061;375;3388303;20512;11866
89197;Guillon;287;5886987;257345;144;4531052;143;1355935;20512;11867
12200;Rivière-sur-Tarn;580;11897290;400684;296;8970560;284;2926730;20513;11868
84046;Flassan;239;4902526;139086;114;3469614;125;1432912;20513;11869
26043;Beauvoisin;87;1784630;55773;39;1305602;48;479028;20513;11870
39413;La Pesse;197;4041067;150443;95;3057760;102;983307;20513;11871
51406;Norrois;103;2112905;95454;62;1736456;41;376449;20514;11872
52189;Le Val-d'Esnoms;209;4287431;128497;101;3048233;108;1239198;20514;11873
56060;Les Fougerêts;511;10482789;309512;272;8085239;239;2397550;20514;11874
21604;Senailly;82;1682197;42940;39;1193346;43;488851;20515;11875
55104;Chassey-Beaupré;60;1230922;38650;26;874811;34;356111;20515;11876
02143;Le Catelet;103;2113130;49849;47;1547867;56;565263;20516;11877
17048;Blanzac-lès-Matha;180;3692896;108804;86;2667665;94;1025231;20516;11878
81257;Saint-Juéry;4073;83564233;2962470;2188;63676405;1885;19887828;20517;11879
43249;Valprivas;260;5334535;144812;128;3823911;132;1510624;20517;11880
31183;Figarol;151;3098212;71742;74;2264568;77;833644;20518;11881
56195;La Roche-Bernard;458;9397424;434332;238;7284283;220;2113141;20518;11882
64150;Bunus;63;1292698;30823;23;853084;40;439614;20519;11883
25182;Cubry;54;1108027;58694;31;922441;23;185586;20519;11884
79211;Pioussay;185;3796023;143807;73;2416204;112;1379819;20519;11885
29110;Langolen;465;9541474;217342;253;7199630;212;2341844;20519;11886
28204;Langey;213;4370746;162660;127;3445540;86;925206;20520;11887
11385;Soupex;134;2749673;88604;67;2040811;67;708862;20520;11888
89014;Arces-Dilo;387;7941312;298495;194;5750619;193;2190693;20520;11889
86149;Martaizé;230;4719708;175532;109;3338003;121;1381705;20520;11890
09323;Vals;50;1026025;31353;25;730846;25;295179;20521;11891
85121;Le Langon;553;11347957;290677;255;8048019;298;3299938;20521;11892
41063;Couffy;324;6648797;228885;171;4858687;153;1790110;20521;11893
64069;Aste-Béon;142;2914032;72144;78;2173697;64;740335;20521;11894
21084;Source-Seine;37;759328;20912;19;556979;18;202349;20522;11895
48132;Saint-Alban-sur-Limagnole;875;17957147;871048;449;14297046;426;3660101;20522;11896
46108;Fons;226;4638100;147723;114;3465496;112;1172604;20523;11897
24207;Groléjac;356;7306063;312357;175;5606280;181;1699783;20523;11898
2B148;Lucciana;2701;55431849;2497174;1366;42558896;1335;12872953;20523;11899
02052;Bassoles-Aulers;80;1641831;76747;40;1287276;40;354555;20523;11900
62309;Esquerdes;763;15659065;435679;396;11697846;367;3961219;20523;11901
76519;Rainfreville;46;944081;24655;23;697942;23;246139;20524;11902
61156;Essay;301;6177606;172395;170;4765267;131;1412339;20524;11903
81003;Alban;541;11103294;335793;250;7775678;291;3327616;20524;11904
24007;Allemans;300;6157120;235044;143;4625433;157;1531687;20524;11905
36079;Francillon;39;800461;16202;22;566296;17;234165;20525;11906
58170;Monceaux-le-Comte;85;1744645;71976;44;1399097;41;345548;20525;11907
02341;Gercy;158;3243022;119958;92;2634715;66;608307;20525;11908
32428;Sémézies-Cachan;40;821023;27375;19;638058;21;182965;20526;11909
28027;La Bazoche-Gouet;768;15764207;673636;349;11036306;419;4727901;20526;11910
54076;Blainville-sur-l'Eau;2168;44501077;1322118;1133;33262360;1035;11238717;20526;11911
21248;Éringes;38;780008;28854;18;536381;20;243627;20527;11912
33272;Marsas;591;12131415;306019;304;8806050;287;3325365;20527;11913
46043;Cahus;122;2504351;82115;69;1974139;53;530212;20527;11914
35132;Hirel;766;15724152;405373;402;11770672;364;3953480;20528;11915
16100;Chirac;393;8067450;249303;208;6252687;185;1814763;20528;11916
47195;Nérac;4262;87490626;3448733;2027;64949142;2235;22541484;20528;11917
16295;Saint-Amant-de-Boixe;759;15580964;565236;388;11781976;371;3798988;20528;11918
19109;Lascaux;98;2011799;27230;51;1414963;47;596836;20529;11919
52545;Voisines;58;1190664;40415;29;875539;29;315125;20529;11920
61292;Montsecret;291;5973897;129960;140;4327686;151;1646211;20529;11921
15154;Polminhac;676;13877932;396844;323;10009967;353;3867965;20529;11922
25045;Battenans-les-Mines;29;595360;15701;14;440270;15;155090;20530;11923
79022;Availles-Thouarsais;117;2402004;85467;55;1639062;62;762942;20530;11924
49111;Cossé-d'Anjou;212;4352393;85641;105;3019769;107;1332624;20530;11925
58189;Narcy;298;6118316;212150;159;4697140;139;1421176;20531;11926
17156;Expiremont;64;1314001;22414;26;888882;38;425119;20531;11927
59384;Maroilles;768;15768458;554043;368;11594169;400;4174289;20532;11928
61084;Champcerie;73;1498884;57730;29;998136;44;500748;20533;11929
53198;Saint-Aubin-du-Désert;147;3018313;104387;68;2086905;79;931408;20533;11930
32344;Riscle;1049;21539293;995151;461;15883343;588;5655950;20533;11931
03091;Créchy;246;5051175;114197;143;3953569;103;1097606;20533;11932
63461;Vinzelles;208;4270982;114146;107;3201825;101;1069157;20534;11933
21165;Chemin-d'Aisey;36;739263;19434;20;580629;16;158634;20535;11934
65248;Lahitte-Toupière;138;2833848;103306;61;2031498;77;802350;20535;11935
76261;La Ferté-Saint-Samson;231;4743618;115739;140;3789200;91;954418;20535;11936
25624;Villers-Grélot;79;1622372;53969;40;1102313;39;520059;20536;11937
07330;Vallon-Pont-d'Arc;1442;29614608;1244521;713;22393918;729;7220690;20537;11938
07083;Dunière-sur-Eyrieux;235;4826505;134065;125;3678100;110;1148405;20538;11939
46126;Goujounac;129;2649445;143483;60;2003821;69;645624;20538;11940
55412;Rambucourt;90;1848468;29565;49;1357233;41;491235;20539;11941
87150;Saint-Hilaire-les-Places;508;10434038;340237;265;7720211;243;2713827;20539;11942
48085;Laval-du-Tarn;64;1314581;59673;30;974182;34;340399;20540;11943
71263;Louhans;4076;83722536;4171369;1910;63433351;2166;20289185;20540;11944
57051;Baronville;214;4395998;156851;112;3237313;102;1158685;20542;11945
16282;La Rochette;293;6018910;187515;159;4635211;134;1383699;20542;11946
88205;Girmont-Val-d'Ajol;141;2896477;97934;70;2079631;71;816846;20542;11947
38300;Penol;183;3759335;86132;97;2715890;86;1043445;20543;11948
60076;Blargies;265;5443973;144902;140;4054946;125;1389027;20543;11949
22164;Pédernec;1021;20974720;529221;547;15764265;474;5210455;20543;11950
85188;La Réorthe;545;11196416;178687;287;8364929;258;2831487;20544;11951
10057;Bouy-sur-Orvin;39;801215;25449;18;580360;21;220855;20544;11952
33523;Targon;1115;22906958;858045;549;16938877;566;5968081;20544;11953
57711;Vibersviller;232;4766360;109437;123;3541883;109;1224477;20545;11954
31265;Lagraulet-Saint-Nicolas;133;2732518;97993;64;2046167;69;686351;20545;11955
47126;Lachapelle;41;842361;38969;20;644904;21;197457;20545;11956
57106;Bouzonville;2085;42837321;1689570;944;30030100;1141;12807221;20545;11957
61291;Montreuil-la-Cambe;43;883470;27226;20;662321;23;221149;20546;11958
79016;Assais-les-Jumeaux;435;8937673;259122;216;6604849;219;2332824;20546;11959
64148;Bruges-Capbis-Mifaget;503;10334875;351098;235;7508499;268;2826376;20546;11960
71259;Ligny-en-Brionnais;201;4129852;101482;101;3000378;100;1129474;20547;11961
62673;Quéant;324;6657209;214865;151;4871779;173;1785430;20547;11962
88206;Gironcourt-sur-Vraine;492;10109347;259368;254;7212645;238;2896702;20547;11963
84040;Crestet;250;5136998;191488;126;3924677;124;1212321;20548;11964
71289;Matour;576;11835953;343457;299;8659618;277;3176335;20549;11965
33332;Porchères;513;10541570;351285;263;7786902;250;2754668;20549;11966
88318;Moyemont;109;2239846;53363;57;1580060;52;659786;20549;11967
32289;Montpézat;121;2486458;106749;61;1888177;60;598281;20549;11968
80763;Le Titre;197;4048205;92510;103;3008660;94;1039545;20549;11969
32244;Maulichères;112;2301577;96867;57;1724338;55;577239;20550;11970
62593;Morval;50;1027527;16199;27;708170;23;319357;20551;11971
63418;Sermentizon;327;6720032;275423;169;5120540;158;1599492;20551;11972
11322;Roquefort-des-Corbières;527;10830149;381855;261;8160308;266;2669841;20551;11973
55141;Dagonville;46;945347;51256;23;692464;23;252883;20551;11974
56159;Pleucadeuc;938;19276930;487015;491;14073700;447;5203230;20551;11975
19183;Saint-Bazile-de-la-Roche;80;1644139;105313;37;1235026;43;409113;20552;11976
08451;Le Thour;189;3884374;89885;89;2860397;100;1023977;20552;11977
88168;Fauconcourt;67;1377003;46923;33;1024453;34;352550;20552;11978
71399;Saint-Christophe-en-Brionnais;300;6165918;197261;138;4317341;162;1848577;20553;11979
32093;Caumont;66;1356509;48416;36;1078661;30;277848;20553;11980
59131;Cappelle-la-Grande;4040;83034909;2552218;2044;62097675;1996;20937234;20553;11981
21445;La Motte-Ternant;112;2301976;106817;58;1716483;54;585493;20553;11982
08009;Amblimont;99;2034787;64421;51;1571647;48;463140;20553;11983
30095;Corconne;301;6186756;223222;141;4560151;160;1626605;20554;11984
39525;Tassenières;209;4295907;144801;102;3180675;107;1115232;20555;11985
78644;La Verrière;2956;60761283;2492875;1476;45351744;1480;15409539;20555;11986
08097;Challerange;256;5262162;173205;135;3884399;121;1377763;20555;11987
89205;Jaulges;246;5056696;183959;134;3938794;112;1117902;20556;11988
80328;Fontaine-sur-Somme;310;6372320;224877;162;4775793;148;1596527;20556;11989
80466;Lanches-Saint-Hilaire;78;1603364;48427;42;1206435;36;396929;20556;11990
14511;Pont-Bellanger;35;719463;25997;20;567276;15;152187;20556;11991
04057;Clamensane;84;1726721;42067;42;1269153;42;457568;20556;11992
70023;Anjeux;87;1788409;62248;47;1329991;40;458418;20556;11993
34328;Vendémian;584;12005275;307139;286;8837966;298;3167309;20557;11994
30055;Brouzet-lès-Alès;343;7051119;210135;180;5424209;163;1626910;20557;11995
42123;Lorette;2614;53736656;1759899;1340;39552445;1274;14184211;20557;11996
17272;Péré;210;4317078;65504;115;3312128;95;1004950;20558;11997
25461;Pompierre-sur-Doubs;164;3371449;78572;95;2586322;69;785127;20558;11998
07074;Creysseilles;76;1562406;57590;42;1271268;34;291138;20558;11999
17062;Bresdon;150;3083724;146716;68;2277257;82;806467;20558;12000
15187;Saint-Flour;3913;80444840;3848046;1940;62535343;1973;17909497;20558;12001
39104;Chapelle-Voland;326;6702115;314995;149;4969844;177;1732271;20559;12002
17447;Le Thou;870;17886177;250183;463;13564247;407;4321930;20559;12003
08259;Longwé;54;1110199;88571;17;768984;37;341215;20559;12004
27622;Serquigny;1153;23704908;870792;629;18345234;524;5359674;20559;12005
10444;Vulaines;136;2796156;81618;59;1911051;77;885105;20560;12006
40222;Pey;383;7874542;252011;198;5997786;185;1876756;20560;12007
07208;Saint-Andéol-de-Berg;67;1377574;44747;35;1116236;32;261338;20561;12008
21499;Pothières;105;2158887;65829;48;1492950;57;665937;20561;12009
36225;Le Tranger;100;2056086;67788;57;1582918;43;473168;20561;12010
62733;Sailly-au-Bois;147;3022550;71929;68;2083347;79;939203;20562;12011
31130;Cazaril-Tambourès;48;986958;32405;24;759692;24;227266;20562;12012
82062;Finhan;751;15442162;508609;366;11277566;385;4164596;20562;12013
59155;Coudekerque-Branche;11802;242680598;7834302;6143;183141939;5659;59538659;20563;12014
65310;Mérilheu;150;3084414;95961;84;2299715;66;784699;20563;12015
34029;Bélarga;224;4606090;146496;105;3432746;119;1173344;20563;12016
08204;Guincourt;55;1130971;50942;29;880383;26;250588;20563;12017
70027;Argillières;43;884222;36197;17;576576;26;307646;20563;12018
33269;Margueron;211;4339157;249832;90;3052103;121;1287054;20565;12019
07131;Lanas;232;4771071;123559;125;3636590;107;1134481;20565;12020
25470;La Prétière;89;1830339;47732;51;1417068;38;413271;20566;12021
39540;Valempoulières;105;2159405;44822;54;1571040;51;588365;20566;12022
02520;Mont-Notre-Dame;380;7815066;241321;207;6045361;173;1769705;20566;12023
57110;Brettnach;250;5141570;111793;124;3655061;126;1486509;20566;12024
23180;Saint-Amand;262;5388430;204724;133;4004711;129;1383719;20567;12025
08145;Douzy;949;19517817;629512;477;14117944;472;5399873;20567;12026
08489;Voncq;133;2735374;95481;63;1982187;70;753187;20567;12027
58083;Corbigny;1021;20998872;1084566;504;16177315;517;4821557;20567;12028
71091;La Chapelle-du-Mont-de-France;101;2077317;46597;56;1580381;45;496936;20567;12029
40323;Vert;138;2838332;79926;74;2166807;64;671525;20568;12030
40153;Le Leuy;135;2776773;80045;72;2093204;63;683569;20569;12031
58093;Cuncy-lès-Varzy;86;1768927;72428;48;1338513;38;430414;20569;12032
10420;Villenauxe-la-Grande;1352;27809388;1420422;671;21189391;681;6619997;20569;12033
97305;Macouria;3752;77175246;1996508;1407;51971120;2345;25204126;20569;12034
57097;Boulay-Moselle;2794;57470279;2147439;1425;43251630;1369;14218649;20569;12035
22276;Saint-Bihy;121;2488907;72636;63;1902845;58;586062;20569;12036
09119;Eycheil;316;6500002;230880;180;5062556;136;1437446;20570;12037
22268;Ruca;308;6335459;150904;165;4683316;143;1652143;20570;12038
26101;Comps;86;1769065;59316;42;1303506;44;465559;20571;12039
52196;Faverolles;79;1625097;62911;41;1194982;38;430115;20571;12040
50140;Contrières;204;4196495;80812;115;3214277;89;982218;20571;12041
14064;Bernières-d'Ailly;133;2736000;86567;66;2029207;67;706793;20571;12042
10114;Crancey;440;9051622;312617;244;6920583;196;2131039;20572;12043
79179;Moncoutant;1764;36289008;1099122;871;27004666;893;9284342;20572;12044
35246;Roz-Landrieux;701;14420995;327340;367;10773469;334;3647526;20572;12045
54236;Grand-Failly;187;3846991;125834;79;2378525;108;1468466;20572;12046
71352;Le Planois;53;1090335;27033;26;758750;27;331585;20572;12047
35072;Châtillon-en-Vendelais;863;17754347;309465;437;12650783;426;5103564;20573;12048
53115;Hercé;172;3538551;34864;83;2434476;89;1104075;20573;12049
53252;Saint-Samson;224;4608370;114634;110;3294599;114;1313771;20573;12050
71130;Chissey-lès-Mâcon;144;2962527;91913;69;2215175;75;747352;20573;12051
58049;Chalaux;47;966942;38892;27;763632;20;203310;20573;12052
72380;Vivoin;500;10286929;245850;253;7594890;247;2692039;20574;12053
79301;Saint-Vincent-la-Châtre;343;7056950;126521;183;5282435;160;1774515;20574;12054
83086;Le Muy;5315;109353690;4798171;2597;82281392;2718;27072298;20575;12055
62830;Trescault;112;2304445;84486;58;1783214;54;521231;20575;12056
09145;Les Issards;139;2860032;64985;71;2107964;68;752068;20576;12057
19048;Le Chastang;196;4032895;143746;104;3061523;92;971372;20576;12058
54370;Minorville;121;2489733;51024;51;1702510;70;787223;20576;12059
03010;Audes;232;4773899;146524;119;3676952;113;1096947;20577;12060
09340;Vira;100;2057723;59163;48;1525893;52;531830;20577;12061
17087;Chantemerle-sur-la-Soie;83;1707919;39931;43;1289451;40;418468;20577;12062
40002;Amou;870;17902588;608481;420;12903334;450;4999254;20578;12063
57375;Lagarde;98;2016631;44818;46;1417609;52;599022;20578;12064
80833;Yvrencheux;73;1502193;48255;36;1085108;37;417085;20578;12065
52016;Arbot;46;946594;34608;23;646348;23;300246;20578;12066
07183;Pradons;266;5473855;147704;130;3689605;136;1784250;20578;12067
71516;Serley;308;6338272;259936;150;4791041;158;1547231;20579;12068
05163;Le Sauze-du-Lac;78;1605156;78604;33;1131678;45;473478;20579;12069
35098;La Dominelais;639;13150065;275164;343;9765596;296;3384469;20579;12070
33035;Bayon-sur-Gironde;442;9096076;544808;206;6780607;236;2315469;20579;12071
58009;Arbourse;77;1584623;81202;40;1238372;37;346251;20580;12072
76698;Torcy-le-Petit;264;5433019;151027;135;3943809;129;1489210;20580;12073
80294;Éterpigny;88;1811008;57043;43;1324508;45;486500;20580;12074
67483;Struth;134;2757714;80629;72;2019703;62;738011;20580;12075
62543;Mametz;1068;21979836;728364;541;16324060;527;5655776;20580;12076
54600;Xousse;64;1317179;22367;30;887155;34;430024;20581;12077
80479;Lignières-Châtelain;191;3931244;156691;99;3013061;92;918183;20582;12078
65466;Vielle-Louron;47;967386;33207;20;687885;27;279501;20583;12079
88009;Anould;1910;39313175;1065335;1066;30126700;844;9186475;20583;12080
73004;Aillon-le-Jeune;254;5228148;192377;141;4030501;113;1197647;20583;12081
70314;Magnivray;89;1831914;69643;44;1394439;45;437475;20583;12082
16416;Vitrac-Saint-Vincent;297;6113421;284682;149;4718521;148;1394900;20584;12083
86038;Brion;123;2531845;57896;65;1899965;58;631880;20584;12084
17440;Ternant;225;4631454;152073;114;3579183;111;1052271;20584;12085
28088;Châteaudun;7314;150553886;6572442;3609;114262300;3705;36291586;20584;12086
39151;Choux;71;1461509;38228;42;1127005;29;334504;20585;12087
80200;Cocquerel;120;2470160;122111;63;1999559;57;470601;20585;12088
46147;Lagardelle;75;1543868;71213;37;1205915;38;337953;20585;12089
18062;Le Chautay;174;3581827;223132;82;2740619;92;841208;20585;12090
40047;Bonnegarde;157;3231931;94870;65;2273047;92;958884;20586;12091
35035;Bovel;264;5434646;148063;116;3686923;148;1747723;20586;12092
70432;Quers;176;3623104;124872;93;2762641;83;860463;20586;12093
54061;Bénaménil;283;5826035;184342;152;4440639;131;1385396;20587;12094
38127;Cornillon-en-Trièves;98;2017507;52313;48;1472566;50;544941;20587;12095
63131;Culhat;585;12043721;384985;287;8939918;298;3103803;20588;12096
17238;Moings;111;2285262;165573;45;1671352;66;613910;20588;12097
10193;Lesmont;167;3438190;125042;79;2541091;88;897099;20588;12098
43150;Le Pertuis;255;5249937;161557;137;3865018;118;1384919;20588;12099
62853;Vieil-Moutier;196;4035264;104719;107;2999548;89;1035716;20588;12100
69054;Chénelette;203;4179444;138838;100;3083730;103;1095714;20588;12101
29002;Arzano;787;16203103;604293;380;12028988;407;4174115;20588;12102
88127;Deinvillers;32;658846;14283;16;456942;16;201904;20589;12103
76505;Pommereux;58;1194163;47225;29;916138;29;278025;20589;12104
33243;Libourne;14781;304328526;16519848;7206;237151126;7575;67177400;20589;12105
35237;Renac;529;10891791;378670;271;8273579;258;2618212;20589;12106
33186;Gensac;475;9779978;507322;196;6963983;279;2815995;20589;12107
04231;Valernes;135;2779613;98489;73;2142001;62;637612;20590;12108
36044;Châteauroux;27756;571507449;28321861;14625;448548167;13131;122959282;20590;12109
50299;Le Mesnil;105;2162069;75522;55;1664193;50;497876;20591;12110
58135;Isenay;64;1317842;71937;33;1033103;31;284739;20591;12111
76751;Yébleron;687;14146357;377096;363;10650972;324;3495385;20591;12112
29248;Saint-Frégant;380;7824808;119317;221;5985954;159;1838854;20592;12113
23001;Ahun;833;17152814;707585;410;12762248;423;4390566;20592;12114
60017;Ansauvillers;610;12561147;428634;316;9404108;294;3157039;20592;12115
50164;Domjean;506;10420083;191516;269;7651776;237;2768307;20593;12116
60121;Campagne;84;1729823;48002;47;1289580;37;440243;20593;12117
10394;Vallières;81;1668057;67671;37;1218977;44;449080;20593;12118
14012;Angerville;87;1791629;63132;43;1349724;44;441905;20593;12119
50488;Saint-Jean-de-Daye;338;6960598;237682;169;5061770;169;1898828;20593;12120
50605;Trelly;347;7145959;220494;168;5061216;179;2084743;20594;12121
34065;Cazedarnes;286;5889840;163777;123;4108333;163;1781507;20594;12122
34239;Saint-André-de-Sangonis;2960;60958015;2120339;1431;45537805;1529;15420210;20594;12123
62676;Quernes;238;4901468;122818;122;3541609;116;1359859;20594;12124
09315;Trémoulet;56;1153323;39428;25;787462;31;365861;20595;12125
79175;Melleran;316;6508192;349752;127;4709048;189;1799144;20596;12126
24047;La Boissière-d'Ans;138;2842221;131780;68;2196285;70;645936;20596;12127
36165;Pouligny-Saint-Pierre;588;12110431;388839;305;9081383;283;3029048;20596;12128
70492;Soing-Cubry-Charentenay;291;5993703;181589;154;4548349;137;1445354;20597;12129
37058;La Chapelle-sur-Loire;839;17280923;534831;451;13514620;388;3766303;20597;12130
76321;Les Grandes-Ventes;1013;20865133;840406;485;15767441;528;5097692;20597;12131
55117;Clermont-en-Argonne;802;16519369;902287;356;11955738;446;4563631;20598;12132
86086;Coussay-les-Bois;504;10381586;337756;278;7932541;226;2449045;20598;12133
51006;Alliancelles;88;1812748;41461;43;1304361;45;508387;20599;12134
04178;Saint-Étienne-les-Orgues;728;14996467;576312;362;11201605;366;3794862;20600;12135
14452;Morteaux-Couliboeuf;296;6097579;142115;153;4457499;143;1640080;20600;12136
53221;Saint-Georges-sur-Erve;208;4284787;150218;105;3186948;103;1097839;20600;12137
72148;Jauzé;51;1050599;26683;24;757795;27;292804;20600;12138
04188;Saint-Maime;452;9311453;268988;226;6553186;226;2758267;20601;12139
34108;Frontignan;13711;282461966;11167403;7198;217488596;6513;64973370;20601;12140
70196;Dampierre-lès-Conflans;139;2863612;100678;68;2114413;71;749199;20602;12141
17083;Champagne;337;6942936;219528;158;5149613;179;1793323;20602;12142
46058;Carennac;265;5459716;241148;132;4286729;133;1172987;20603;12143
17383;Saint-Pierre-de-Juillers;206;4244174;250174;84;2953877;122;1290297;20603;12144
76337;Guilmécourt;159;3275941;111305;78;2364029;81;911912;20603;12145
58162;Menestreau;68;1401050;62171;36;1110025;32;291025;20604;12146
70409;Pierrecourt;63;1298035;36498;35;970163;28;327872;20604;12147
57266;Guéblange-lès-Dieuze;81;1668926;41570;42;1221248;39;447678;20604;12148
62635;Offin;117;2410706;90332;61;1888800;56;521906;20604;12149
18001;Achères;212;4368207;129207;106;3309902;106;1058305;20605;12150
70088;Bourguignon-lès-la-Charité;70;1442362;47848;39;1102215;31;340147;20605;12151
47267;Saint-Pierre-de-Buzet;158;3255684;94843;83;2496976;75;758708;20606;12152
2B185;Oletta;744;15330609;741113;368;11845941;376;3484668;20606;12153
40286;Samadet;596;12281209;456367;279;9100983;317;3180226;20606;12154
15027;Calvinet;250;5151577;229096;107;3613124;143;1538453;20606;12155
85078;Damvix;442;9108027;371045;201;6601022;241;2507005;20606;12156
24510;Saint-Vincent-de-Cosse;213;4389212;171004;101;3250944;112;1138268;20607;12157
29285;Tréflaouénan;296;6099598;248271;145;4551932;151;1547666;20607;12158
42059;Chazelles-sur-Lyon;2941;60607492;1983209;1546;44701018;1395;15906474;20608;12159
51182;Courcemain;66;1360140;64634;33;1066802;33;293338;20608;12160
87042;Le Châtenet-en-Dognon;241;4966673;172378;121;3690390;120;1276283;20609;12161
06141;Toudon;186;3833209;149627;107;3119309;79;713900;20609;12162
12148;Montbazens;868;17889887;707110;422;13360513;446;4529374;20610;12163
35225;Plesder;399;8223723;185376;217;6169213;182;2054510;20611;12164
70036;Aulx-lès-Cromary;88;1813755;37856;57;1502733;31;311022;20611;12165
60303;Hautbos;84;1731331;53194;44;1326335;40;404996;20611;12166
33147;Daignac;248;5111632;120930;133;3952099;115;1159533;20611;12167
32029;Barran;389;8017993;268979;200;6064920;189;1953073;20612;12168
14471;Notre-Dame-de-Courson;223;4596556;178355;111;3368303;112;1228253;20612;12169
19021;Bellechassagne;47;968782;34219;24;732766;23;236016;20612;12170
02324;Fontenelle;139;2865129;100176;66;2092535;73;772594;20612;12171
73287;Sollières-Sardières;109;2246756;90340;59;1757201;50;489555;20612;12172
16004;Aignes-et-Puypéroux;149;3071254;86797;68;2112241;81;959013;20612;12173
86295;Voulême;236;4864570;174069;118;3680672;118;1183898;20613;12174
88474;Tilleux;42;865731;33903;23;650264;19;215467;20613;12175
24257;Marsalès;134;2762139;99844;63;2083013;71;679126;20613;12176
56173;Pluméliau;2007;41370732;1394772;1016;31091839;991;10278893;20613;12177
60444;Mureaumont;82;1690308;62230;45;1311015;37;379293;20614;12178
76420;Mauquenchy;188;3875364;101226;94;2912841;94;962523;20614;12179
37068;Chemillé-sur-Dême;407;8389760;304158;201;6339441;206;2050319;20614;12180
02776;Vendhuile;272;5607020;165716;126;4062348;146;1544672;20614;12181
57629;Sarraltroff;409;8431255;216838;219;6191014;190;2240241;20614;12182
88443;Sartes;58;1195704;22432;36;939938;22;255766;20616;12183
39138;Chemin;187;3855155;129070;86;2729498;101;1125657;20616;12184
09326;Vèbre;80;1649265;57173;45;1291991;35;357274;20616;12185
35176;Messac;1609;33170939;946256;835;24751601;774;8419338;20616;12186
61302;Neauphe-sur-Dive;71;1463790;45388;37;1138033;34;325757;20617;12187
14281;Formigny;139;2865760;69374;70;2075941;69;789819;20617;12188
31206;Gaillac-Toulza;585;12060961;507269;293;9135473;292;2925488;20617;12189
25087;Branne;86;1773072;40316;47;1255727;39;517345;20617;12190
58154;La Maison-Dieu;85;1752461;72102;46;1375007;39;377454;20617;12191
70188;Creveney;27;556671;14691;14;447190;13;109481;20617;12192
32202;Laujuzan;143;2948296;117574;69;2232651;74;715645;20617;12193
54038;Azerailles;443;9133612;279150;223;6610290;220;2523322;20618;12194
04229;Valbelle;133;2742188;95776;64;2027851;69;714337;20618;12195
30189;Nîmes;84003;1732008746;103183165;38886;1358794015;45117;373214731;20618;12196
43124;Loudes;514;10598459;449169;260;7992499;254;2605960;20620;12197
93013;Le Bourget;8387;172938763;8304072;4335;134572876;4052;38365887;20620;12198
18019;Azy;272;5608660;185617;150;4383944;122;1224716;20620;12199
72142;Grandchamp;93;1917695;63299;46;1423063;47;494632;20620;12200
54523;Thuilley-aux-Groseilles;164;3381757;107427;122;2924852;42;456905;20620;12201
27344;Houlbec-près-le-Gros-Theil;54;1113508;30460;32;883736;22;229772;20621;12202
40040;Beylongue;201;4144782;92464;107;3158656;94;986126;20621;12203
31132;Cazaux-Layrisse;38;783600;33932;23;617329;15;166271;20621;12204
34336;Villeneuve-lès-Béziers;2489;51325818;2160089;1194;38385434;1295;12940384;20621;12205
05172;Trescléoux;186;3835532;143711;89;2826909;97;1008623;20621;12206
72304;Sainte-Osmane;112;2309594;66332;53;1671968;59;637626;20621;12207
72288;Saint-Hilaire-le-Lierru;74;1525989;31239;41;1118025;33;407964;20621;12208
21226;Darcey;180;3711936;125070;90;2722865;90;989071;20622;12209
61378;Sainte-Croix-sur-Orne;44;907374;46276;18;535734;26;371640;20622;12210
09262;Saint-Jean-d'Aigues-Vives;229;4722504;151962;120;3552893;109;1169611;20622;12211
46128;Gramat;2196;45286629;1776157;1087;34154587;1109;11132042;20622;12212
16379;Taponnat-Fleurignac;825;17013524;479101;445;12952372;380;4061152;20622;12213
85285;Le Tablier;353;7279756;96668;203;5540165;150;1739591;20623;12214
41238;Savigny-sur-Braye;1261;26005173;794028;656;19247266;605;6757907;20623;12215
88042;Bazien;41;845534;19613;19;594215;22;251319;20623;12216
17350;Saint-Julien-de-l'Escap;506;10435256;406187;235;7442267;271;2992989;20623;12217
09282;Saverdun;2625;54136045;2114146;1258;40845342;1367;13290703;20623;12218
56085;Hoedic;73;1505538;68559;45;1282482;28;223056;20624;12219
66067;Err;348;7177464;318958;184;5609213;164;1568251;20625;12220
33158;Les Esseintes;145;2990708;70545;74;2234322;71;756386;20626;12221
61281;Moncy;128;2640147;65141;62;1927973;66;712174;20626;12222
22262;Quintin;1660;34240069;1556325;823;26448360;837;7791709;20627;12223
17233;Meux;185;3815997;170254;87;2887383;98;928614;20627;12224
47147;Lévignac-de-Guyenne;353;7281336;387414;161;5439098;192;1842238;20627;12225
17218;Marans;2708;55858045;2473368;1351;42147552;1357;13710493;20627;12226
10054;Bourdenay;72;1485162;43386;41;1121587;31;363575;20627;12227
54177;Emberménil;134;2764057;50722;71;2011553;63;752504;20627;12228
22387;Le Vieux-Marché;732;15099358;460918;373;11264039;359;3835319;20628;12229
47038;Bourran;347;7157834;276195;170;5238632;177;1919202;20628;12230
50184;Flamanville;988;20380806;882350;513;15660833;475;4719973;20628;12231
83026;Cabasse;1047;21598077;712807;523;16315953;524;5282124;20629;12232
32390;Saint-Martin-d'Armagnac;120;2475450;70719;59;1835441;61;640009;20629;12233
17072;Burie;737;15203689;576154;372;11305417;365;3898272;20629;12234
31326;Massabrac;50;1031474;35348;26;829288;24;202186;20629;12235
40135;Labrit;496;10232291;545101;218;7452737;278;2779554;20630;12236
85161;Nieul-le-Dolent;1279;26385385;604266;660;19475922;619;6909463;20630;12237
08454;Touligny;52;1072775;28753;32;821759;20;251016;20630;12238
42192;Rozier-Côtes-d'Aurec;267;5508344;181623;145;4230211;122;1278133;20631;12239
14023;Asnières-en-Bessin;29;598295;14235;14;463810;15;134485;20631;12240
86257;Savigny-sous-Faye;184;3796080;104275;91;2808547;93;987533;20631;12241
10119;Cunfin;119;2455083;105007;65;1889676;54;565407;20631;12242
55202;Futeau;103;2124989;101692;49;1551664;54;573325;20631;12243
21455;Nod-sur-Seine;121;2496436;76662;54;1677166;67;819270;20632;12244
62272;Douchy-lès-Ayette;173;3569296;130724;90;2755634;83;813662;20632;12245
57085;Bionville-sur-Nied;193;3981955;74969;111;2953387;82;1028568;20632;12246
64514;Séby;106;2186996;60547;48;1611291;58;575705;20632;12247
37274;Villebourg;152;3136078;95658;72;2286504;80;849574;20632;12248
52348;Neuilly-l'Évêque;371;7654518;280084;185;5638464;186;2016054;20632;12249
70380;Neurey-en-Vaux;94;1939424;45474;46;1370380;48;569044;20632;12250
31245;Juzet-d'Izaut;102;2104541;94320;56;1722736;46;381805;20633;12251
57675;Torcheville;78;1609377;32261;40;1183471;38;425906;20633;12252
45141;Faverelles;81;1671290;68204;38;1291771;43;379519;20633;12253
40240;Renung;274;5653553;128461;131;4148168;143;1505385;20633;12254
87116;Peyrat-de-Bellac;661;13638754;425518;352;10189019;309;3449735;20634;12255
34052;Capestang;1752;36152897;1695519;758;25958537;994;10194360;20635;12256
42160;Nollieux;106;2187350;100764;48;1541822;58;645528;20635;12257
53112;Le Ham;218;4498622;189091;109;3380990;109;1117632;20636;12258
62585;Montcavrel;206;4251109;86456;106;3151256;100;1099853;20636;12259
09251;Roumengoux;98;2022394;102481;51;1554724;47;467670;20637;12260
47021;Barbaste;864;17830135;549308;406;12783403;458;5046732;20637;12261
21680;Vielverge;257;5303704;155354;137;3935228;120;1368476;20637;12262
63208;Marcillat;153;3157519;87425;88;2584413;65;573106;20637;12263
14756;La Villette;112;2311451;42842;61;1667400;51;644051;20638;12264
97418;Sainte-Marie;15952;329231317;11914609;5471;233012415;10481;96218902;20639;12265
86006;Antigny;312;6439498;194307;150;4609061;162;1830437;20639;12266
58244;Saint-Hilaire-en-Morvan;117;2414820;68738;58;1815219;59;599601;20639;12267
49021;Beaufort-en-Vallée;3363;69410714;1808699;1735;51916643;1628;17494071;20640;12268
87119;Pierre-Buffière;696;14365193;454715;352;10748436;344;3616757;20640;12269
22178;Pléhédel;688;14200725;360321;347;10427929;341;3772796;20641;12270
45251;Pierrefitte-ès-Bois;179;3694688;159191;93;2742437;86;952251;20641;12271
49375;Villedieu-la-Blouère;1285;26523741;360079;663;19001570;622;7522171;20641;12272
59307;Holque;441;9102719;259694;211;6402267;230;2700452;20641;12273
87184;Saint-Symphorien-sur-Couze;148;3054941;170301;77;2360473;71;694468;20641;12274
86090;Curçay-sur-Dive;119;2456350;76382;67;1939849;52;516501;20642;12275
89099;Cheny;1356;27992074;1145585;745;22112859;611;5879215;20643;12276
50380;Notre-Dame-d'Elle;79;1630847;27813;45;1245144;34;385703;20644;12277
03247;Saint-Menoux;558;11519309;343124;285;8717793;273;2801516;20644;12278
85297;Triaize;623;12861255;400349;318;9594515;305;3266740;20644;12279
83114;Saint-Martin;125;2580532;68744;60;1788798;65;791734;20644;12280
15142;Neuvéglise;622;12840953;452176;293;9488985;329;3351968;20645;12281
15010;Arches;100;2064474;131160;38;1434291;62;630183;20645;12282
29136;Locunolé;607;12531479;328534;324;9247031;283;3284448;20645;12283
17044;Berneuil;608;12552125;329034;312;9196254;296;3355871;20645;12284
32209;Lelin-Lapujolle;140;2890305;84024;76;2163329;64;726976;20645;12285
61424;Saint-Martin-des-Landes;108;2229674;25673;53;1623694;55;605980;20645;12286
36203;Saint-Médard;24;495503;22585;11;403326;13;92177;20646;12287
22371;Trémorel;596;12305283;317549;330;9394786;266;2910497;20646;12288
24291;Montignac;1786;36874749;1268032;786;26871244;1000;10003505;20647;12289
25372;Médière;179;3695789;112289;101;2798313;78;897476;20647;12290
32152;Haget;188;3881636;137443;97;2966619;91;915017;20647;12291
62049;Auchy-au-Bois;250;5161782;157152;137;4018577;113;1143205;20647;12292
36013;Baudres;273;5636815;247304;134;4220245;139;1416570;20648;12293
88057;Le Beulay;59;1218248;52170;30;887039;29;331209;20648;12294
39124;Chaumergy;254;5244752;193064;125;3875951;129;1368801;20649;12295
65232;Jacque;43;887910;23633;22;676823;21;211087;20649;12296
24075;Campagnac-lès-Quercy;184;3799570;104686;71;2726722;113;1072848;20650;12297
72246;Prévelles;115;2374743;33069;60;1699470;55;675273;20650;12298
30142;Laval-Pradel;664;13711673;634748;334;10500815;330;3210858;20650;12299
30067;La Capelle-et-Masmolène;252;5203873;179677;119;3701749;133;1502124;20650;12300
16406;Vilhonneur;206;4254088;158926;99;3068697;107;1185391;20651;12301
44156;Corcoué-sur-Logne;1410;29117868;773087;752;21952366;658;7165502;20651;12302
12042;Calmels-et-le-Viala;113;2333584;64175;53;1697255;60;636329;20651;12303
50118;Champrepus;172;3552097;125041;74;2569749;98;982348;20652;12304
14190;Courcy;84;1734746;69190;40;1333667;44;401079;20652;12305
02631;Quierzy;240;4956459;130263;127;3751423;113;1205036;20652;12306
64236;Gayon;39;805462;38346;17;632970;22;172492;20653;12307
62334;Fiennes;446;9211387;228641;229;6802888;217;2408499;20653;12308
87164;Saint-Martin-de-Jussac;294;6072200;168667;156;4447277;138;1624923;20654;12309
10120;Cussangy;126;2602448;90198;55;1892500;71;709948;20654;12310
50180;Fervaches;210;4337464;102368;108;3195814;102;1141650;20655;12311
42082;Dancé;81;1673056;28356;38;1095177;43;577879;20655;12312
30221;Roquemaure;3032;62626883;2362929;1487;47349354;1545;15277529;20655;12313
23247;Saint-Vaury;1079;22287343;991166;561;17297838;518;4989505;20656;12314
61057;Le Bourg-Saint-Léonard;255;5267204;172682;138;3940466;117;1326738;20656;12315
32460;Vergoignan;169;3490816;102501;92;2685741;77;805075;20656;12316
40119;Hagetmau;2718;56144281;2174414;1371;41827889;1347;14316392;20656;12317
80377;Gézaincourt;245;5060904;197041;115;3891505;130;1169399;20657;12318
17041;Benon;668;13799408;207890;335;9860279;333;3939129;20658;12319
02073;Berry-au-Bac;315;6507496;215542;158;4832964;157;1674532;20659;12320
44146;Rougé;1219;25183435;755519;588;18159337;631;7024098;20659;12321
02168;Château-Thierry;8886;183577596;9989644;4303;141920824;4583;41656772;20659;12322
50168;Ducey;1427;29480720;1036278;750;22462018;677;7018702;20659;12323
38049;Bossieu;160;3305490;102064;89;2450351;71;855139;20659;12324
62540;Maisnil-lès-Ruitz;774;15990521;438964;382;11551423;392;4439098;20660;12325
65168;Esquièze-Sère;252;5206261;193423;132;3868130;120;1338131;20660;12326
53010;Assé-le-Bérenger;216;4462564;85233;124;3417324;92;1045240;20660;12327
80699;Saint-Aubin-Rivière;67;1384224;45151;35;1002670;32;381554;20660;12328
30113;Fons-sur-Lussan;143;2954392;112110;63;2055809;80;898583;20660;12329
89351;Sainte-Magnance;232;4793265;141535;124;3649090;108;1144175;20661;12330
80086;Bernaville;571;11797327;325760;271;8404338;300;3392989;20661;12331
59444;Odomez;477;9855641;347491;243;7514189;234;2341452;20662;12332
35344;Tressé;191;3946402;117414;105;3064799;86;881603;20662;12333
32241;Mas-d'Auvignon;104;2148832;76936;50;1656724;54;492108;20662;12334
64484;Saint-Jean-le-Vieux;462;9545809;238242;234;7022955;228;2522854;20662;12335
61459;Saires-la-Verrerie;156;3223360;84503;94;2509897;62;713463;20663;12336
12208;Saint-Affrique;4774;98643671;3962661;2284;72889536;2490;25754135;20663;12337
03059;Chareil-Cintrat;198;4091250;136814;95;3054605;103;1036645;20663;12338
54447;Réclonville;43;888551;34813;17;605397;26;283154;20664;12339
53046;Le Buret;144;2975628;38281;72;2078770;72;896858;20664;12340
76175;Clais;109;2252393;61375;53;1744478;56;507915;20664;12341
54163;Domjevin;141;2913713;67314;67;2040425;74;873288;20665;12342
48056;Esclanèdes;193;3988353;86728;106;3006719;87;981634;20665;12343
54009;Allamont;82;1694549;46413;40;1248691;42;445858;20665;12344
52119;Chaudenay;180;3719767;121145;96;2764180;84;955587;20665;12345
57628;Sarralbe;2519;52056975;2029349;1254;39072412;1265;12984563;20666;12346
06077;Lucéram;725;14982851;525064;419;11765785;306;3217066;20666;12347
59243;Fontaine-au-Pire;677;13991432;501373;341;10427824;336;3563608;20667;12348
05097;Orpierre;200;4133433;159750;98;3113326;102;1020107;20667;12349
63062;Buxières-sous-Montaigut;120;2480143;75884;59;1748978;61;731165;20668;12350
39375;Moutonne;57;1178104;18986;29;811200;28;366904;20668;12351
01233;Marchamp;77;1591490;41034;44;1161051;33;430439;20669;12352
32292;Mouchan;235;4857426;157046;111;3515226;124;1342200;20670;12353
80511;Marestmontiers;54;1116199;30503;30;864106;24;252093;20670;12354
49081;Châtelais;318;6573232;100783;162;4605746;156;1967486;20671;12355
54303;Laronxe;220;4547614;183633;113;3441646;107;1105968;20671;12356
58152;Magny-Cours;836;17281358;585037;430;13016459;406;4264899;20671;12357
30207;Pouzilhac;351;7255821;245342;174;5485820;177;1770001;20672;12358
71318;Montpont-en-Bresse;627;12961456;541791;311;9827276;316;3134180;20672;12359
04209;Sisteron;4439;91764039;4230721;2218;69854208;2221;21909831;20672;12360
60150;Chiry-Ourscamp;631;13044339;498183;350;10436160;281;2608179;20672;12361
62900;Witternesse;303;6263987;218472;143;4601942;160;1662045;20673;12362
86171;Moussac;273;5643883;99431;125;4193276;148;1450607;20674;12363
49304;Saint-Martin-de-la-Place;600;12404208;317187;306;9100969;294;3303239;20674;12364
31111;Castagnac;149;3080475;112174;76;2418613;73;661862;20674;12365
62588;Montreuil;1448;29938254;1971532;670;22631679;778;7306575;20676;12366
61399;Saint-Gervais-des-Sablons;44;909727;34056;22;708811;22;200916;20676;12367
39417;Les Piards;99;2046891;63466;59;1618955;40;427936;20676;12368
76199;Criquiers;354;7319205;251243;187;5604341;167;1714864;20676;12369
04096;Jausiers;638;13191586;544797;349;10358418;289;2833168;20676;12370
07243;Saint-Jacques-d'Atticieux;163;3370310;96440;79;2395495;84;974815;20677;12371
25550;La Sommette;100;2067686;37217;49;1452222;51;615464;20677;12372
52132;Clefmont;118;2439913;131063;50;1778758;68;661155;20677;12373
08477;Villers-devant-Mouzon;60;1240680;42830;29;920488;31;320192;20678;12374
57338;Hottviller;329;6803072;206334;166;4864159;163;1938913;20678;12375
23161;Rimondeix;45;930519;33637;21;768318;24;162201;20678;12376
62005;Achiet-le-Grand;528;10918104;379676;265;7979458;263;2938646;20678;12377
42277;Saint-Priest-la-Roche;168;3474014;109185;92;2671699;76;802315;20679;12378
88448;Sauville;109;2254054;90492;49;1663998;60;590056;20679;12379
10005;Amance;158;3267374;103768;79;2388012;79;879362;20680;12380
61223;Larchamp;160;3308798;43261;83;2441991;77;866807;20680;12381
65325;Moumoulous;28;579049;35694;17;480225;11;98824;20680;12382
54580;Villerupt;5073;104912778;1732184;1340;43578878;3733;61333900;20681;12383
82100;Loze;66;1364922;85358;33;1053694;33;311228;20681;12384
55431;Richecourt;28;579059;1763;13;386415;15;192644;20681;12385
80335;Foucaucourt-en-Santerre;143;2957374;108250;76;2282546;67;674828;20681;12386
50520;Saint-Martin-le-Hébert;79;1633829;38449;47;1330336;32;303493;20681;12387
17150;Les Églises-d'Argenteuil;304;6287155;212824;143;4425165;161;1861990;20681;12388
2B175;Nessa;46;951349;67858;22;766208;24;185141;20682;12389
52419;Rennepont;78;1613267;38017;40;1132522;38;480745;20683;12390
39502;Santans;161;3329985;128353;77;2431181;84;898804;20683;12391
05028;Chabestan;86;1778782;73123;38;1242441;48;536341;20684;12392
55206;Gercourt-et-Drillancourt;78;1613317;56886;35;1201516;43;411801;20684;12393
24249;Manaurie;87;1799479;80639;38;1351284;49;448195;20684;12394
62221;Chelers;158;3268026;151508;69;2499680;89;768346;20684;12395
24024;Bardou;26;537788;12668;13;400420;13;137368;20684;12396
02001;Abbécourt;277;5729703;205587;133;4261677;144;1468026;20685;12397
17451;Les Touches-de-Périgny;306;6329584;215674;134;4451962;172;1877622;20685;12398
17314;Saint-Césaire;521;10776965;338984;272;8028898;249;2748067;20685;12399
2A288;Sotta;693;14334926;614417;383;11426429;310;2908497;20685;12400
42260;Saint-Martin-la-Sauveté;494;10218639;370155;217;7358808;277;2859831;20686;12401
02671;Saint-Aubin;170;3516595;166839;75;2519016;95;997579;20686;12402
65033;Arrodets-ez-Angles;56;1158425;37088;27;889381;29;269044;20686;12403
32192;Lannux;128;2647955;77637;59;1958020;69;689935;20687;12404
57619;Saint-Louis-lès-Bitche;298;6164795;160297;192;4788366;106;1376429;20687;12405
37265;Varennes;122;2523971;59766;61;1773480;61;750491;20688;12406
09275;Saint-Quirc;192;3972159;124393;105;3198990;87;773169;20688;12407
70574;Volon;37;765484;19273;21;601649;16;163835;20689;12408
42125;Luré;83;1717274;49666;42;1237198;41;480076;20690;12409
39195;Dessia;29;600015;13064;13;408709;16;191306;20690;12410
03253;Saint-Pourçain-sur-Besbre;227;4696835;194169;115;3549304;112;1147531;20691;12411
69152;Pierre-Bénite;5334;110365849;4068414;2966;86815361;2368;23550488;20691;12412
32097;Cazaux-d'Anglès;67;1386311;61028;28;1032811;39;353500;20691;12413
11139;Fenouillet-du-Razès;54;1117338;53222;19;798198;35;319140;20691;12414
18249;Sens-Beaujeu;244;5048814;207531;125;3836455;119;1212359;20692;12415
53202;Saint-Berthevin-la-Tannière;186;3848723;99664;83;2714102;103;1134621;20692;12416
52461;Sarrey;192;3972897;91994;94;2905916;98;1066981;20692;12417
36042;Chasseneuil;359;7428604;264096;177;5464825;182;1963779;20692;12418
57225;Fonteny;77;1593344;22654;44;1185282;33;408062;20693;12419
34009;Alignan-du-Vent;923;19099673;731847;423;14244298;500;4855375;20693;12420
81243;Saint-Beauzile;58;1200217;61424;26;909843;32;290374;20693;12421
09173;Loubens;147;3041980;97473;71;2265626;76;776354;20694;12422
50426;Rauville-la-Place;232;4800976;161160;117;3526903;115;1274073;20694;12423
33034;Bayas;261;5401223;210295;114;3997045;147;1404178;20694;12424
80388;Grébault-Mesnil;104;2152462;62751;54;1608436;50;544026;20697;12425
63309;Saillant;169;3497791;185096;76;2601776;93;896015;20697;12426
29046;Douarnenez;9440;195382853;8112054;4718;147074961;4722;48307892;20697;12427
55242;Hennemont;63;1303948;22866;34;974082;29;329866;20698;12428
89184;Fulvy;77;1593748;49352;45;1193799;32;399949;20698;12429
57709;Vescheim;132;2732170;35366;76;2012922;56;719248;20698;12430
53013;Averton;334;6913255;186026;186;5280833;148;1632422;20698;12431
59115;Brunémont;339;7016767;155002;183;5387404;156;1629363;20698;12432
39089;Cézia;39;807261;21658;21;621457;18;185804;20699;12433
42118;Lay;408;8445315;369536;209;6419911;199;2025404;20699;12434
59475;Prouvy;1153;23866717;664600;582;17874861;571;5991856;20700;12435
28202;Lamblore;215;4450502;264118;103;3482815;112;967687;20700;12436
53269;Vautorte;294;6085855;144915;150;4468046;144;1617809;20700;12437
79061;Celles-sur-Belle;2072;42891155;1376345;1076;32390118;996;10501037;20700;12438
64204;Eaux-Bonnes;202;4181508;216007;109;3243882;93;937626;20701;12439
82154;Saint-Amans-de-Pellagal;98;2028665;45688;44;1388813;54;639852;20701;12440
23210;Saint-Maixant;137;2835993;111575;66;2124176;71;711817;20701;12441
61231;Longuenoë;51;1055736;24271;27;820284;24;235452;20701;12442
03058;Chappes;109;2256384;93540;50;1731561;59;524823;20701;12443
28116;Courville-sur-Eure;1634;33825326;1484163;856;26347766;778;7477560;20701;12444
52468;Semilly;66;1366315;54511;31;958577;35;407738;20702;12445
59509;Roost-Warendin;3290;68108868;2193490;1593;50005060;1697;18103808;20702;12446
54252;Haroué;262;5423933;269575;126;4139270;136;1284663;20702;12447
60472;Offoy;54;1117915;23692;28;820728;26;297187;20702;12448
05096;Orcières;510;10558242;406018;308;8401133;202;2157109;20702;12449
59074;Bertry;1168;24180582;726653;561;18125735;607;6054847;20703;12450
50274;Les Loges-Marchis;508;10517279;318733;282;8092456;226;2424823;20703;12451
51253;Florent-en-Argonne;134;2774248;86498;73;2136479;61;637769;20703;12452
34304;Soubès;495;10248538;397699;252;7698561;243;2549977;20704;12453
55383;Neuvilly-en-Argonne;118;2443121;51874;67;1825865;51;617256;20704;12454
14486;Ouilly-le-Tesson;285;5900770;107743;151;4453459;134;1447311;20704;12455
80153;Bus-lès-Artois;83;1718507;58399;41;1279529;42;438978;20705;12456
17176;Gibourne;64;1325114;64485;29;965714;35;359400;20705;12457
41164;Noyers-sur-Cher;1592;32963357;1187784;813;25164108;779;7799249;20706;12458
49316;Saint-Rémy-en-Mauges;738;15281099;248369;387;10729547;351;4551552;20706;12459
46278;Saint-Matré;65;1345954;52555;26;860186;39;485768;20707;12460
62682;Quilen;27;559092;12853;15;454159;12;104933;20707;12461
30053;Brignon;417;8634999;338415;184;6120213;233;2514786;20707;12462
25336;Liesle;291;6026000;272299;161;4664579;130;1361421;20708;12463
63222;Meilhaud;243;5032058;183710;125;3933457;118;1098601;20708;12464
70028;Aroz;89;1843022;39904;43;1291275;46;551747;20708;12465
55180;Esnes-en-Argonne;69;1428872;29799;35;1086759;34;342113;20708;12466
55043;Belleville-sur-Meuse;1951;40402772;1844062;1053;32018634;898;8384138;20709;12467
32103;Chélan;92;1905233;74614;39;1349252;53;555981;20709;12468
94011;Bonneuil-sur-Marne;8695;180068487;8218195;4505;138849679;4190;41218808;20709;12469
24214;Javerlhac-et-la-Chapelle-Saint-Robert;537;11120983;448211;246;8232313;291;2888670;20709;12470
57221;Florange;6516;134946878;3573593;2744;83255465;3772;51691413;20710;12471
41122;Maray;143;2961545;126641;71;2193349;72;768196;20710;12472
18048;La Chapelle-Hugon;212;4390548;132314;114;3277997;98;1112551;20710;12473
70318;Magny-Danigon;232;4804897;142222;127;3552350;105;1252547;20711;12474
24463;Saint-Médard-d'Excideuil;313;6482535;159266;165;4893439;148;1589096;20711;12475
66074;Eus;253;5239925;302939;117;3973154;136;1266771;20711;12476
21588;Saussey;47;973429;53967;21;661923;26;311506;20711;12477
09214;Moulis;487;10086738;470993;243;7676524;244;2410214;20712;12478
08342;Pouru-aux-Bois;142;2941170;59606;67;2010800;75;930370;20712;12479
31349;Mondavezan;477;9879872;293700;250;7733679;227;2146193;20713;12480
62545;Maninghem;76;1574182;33805;40;1184790;36;389392;20713;12481
86241;Saint-Rémy-sur-Creuse;239;4950404;147905;126;3752446;113;1197958;20713;12482
12209;Saint-Amans-des-Cots;437;9051657;411889;180;6493643;257;2558014;20713;12483
47044;Cahuzac;161;3334832;80396;80;2358477;81;976355;20713;12484
02704;Selens;129;2672025;138844;65;2005543;64;666482;20713;12485
81317;Villefranche-d'Albigeois;666;13795494;450760;322;9979177;344;3816317;20714;12486
50092;Cambernon;402;8327204;176041;209;6094624;193;2232580;20714;12487
36097;Liniez;194;4018673;130419;106;3090540;88;928133;20715;12488
24349;Razac-de-Saussignac;207;4288032;112707;95;3327335;112;960697;20715;12489
50119;Les Champs-de-Losque;106;2195915;35589;47;1514328;59;681587;20716;12490
62041;Arras;24223;501818506;30625594;11525;399480891;12698;102337615;20717;12491
25266;Geney;70;1450172;33591;36;990895;34;459277;20717;12492
25105;Byans-sur-Doubs;297;6152910;172206;161;4602465;136;1550445;20717;12493
11296;Pouzols-Minervois;271;5614288;175866;127;3926517;144;1687771;20717;12494
30066;Cannes-et-Clairan;263;5448594;199714;128;4184056;135;1264538;20717;12495
89472;Villiers-Saint-Benoît;286;5925098;250380;142;4551039;144;1374059;20717;12496
11095;Comigne;167;3459790;93811;86;2544602;81;915188;20717;12497
31436;Pouy-de-Touges;201;4164188;125374;103;3158064;98;1006124;20717;12498
64321;Lasclaveries;125;2589723;98880;55;1889605;70;700118;20718;12499
58086;Cosne-Cours-sur-Loire;6580;136324883;6641229;3265;103987296;3315;32337587;20718;12500
37133;Loché-sur-Indrois;277;5739038;272393;128;4139417;149;1599621;20719;12501
31158;Cuguron;113;2341199;61321;64;1677220;49;663979;20719;12502
80004;Acheux-en-Vimeu;282;5842662;175235;149;4411251;133;1431411;20719;12503
18149;Méry-ès-Bois;353;7313827;235555;175;5424731;178;1889096;20719;12504
44149;Saffré;1840;38123408;738414;957;28053438;883;10069970;20719;12505
14368;Lisores;172;3563814;167892;83;2566271;89;997543;20720;12506
67447;Schiltigheim;18101;375059113;18218648;9712;296087197;8389;78971916;20720;12507
80088;Bernes;176;3646789;66955;98;2655638;78;991151;20720;12508
59494;Raucourt-au-Bois;92;1906313;41531;55;1539005;37;367308;20721;12509
39097;Champagnole;4764;98713894;3942065;2357;72680308;2407;26033586;20721;12510
40321;Urgons;139;2880208;79607;69;2050342;70;829866;20721;12511
27594;Saint-Pierre-des-Ifs;144;2983960;103447;75;2236702;69;747258;20722;12512
62337;Flers;112;2320858;102523;48;1601107;64;719751;20722;12513
89134;Cussy-les-Forges;187;3875050;88958;99;2800059;88;1074991;20722;12514
50330;Mobecq;129;2673272;70310;58;1997598;71;675674;20723;12515
18256;Subligny;181;3750881;127958;90;2777215;91;973666;20723;12516
64353;Louvie-Juzon;623;12910755;424740;324;9677695;299;3233060;20724;12517
16039;Bernac;251;5201657;147677;138;3989883;113;1211774;20724;12518
62018;Aix-en-Issart;140;2901350;56336;61;1976245;79;925105;20724;12519
86194;Poitiers;45232;937388618;52735814;23328;759761754;21904;177626864;20724;12520
62463;Hucqueliers;257;5326137;261952;115;3843637;142;1482500;20724;12521
85185;Puyravault;343;7108612;192394;156;4992918;187;2115694;20725;12522
58200;Ouagne;107;2217629;79392;60;1736194;47;481435;20726;12523
21172;Chivres;163;3378373;110801;88;2630486;75;747887;20726;12524
79285;Saint-Pardoux;849;17596745;466237;412;13056253;437;4540492;20726;12525
53225;Saint-Germain-le-Guillaume;242;5015898;121952;126;3724922;116;1290976;20727;12526
80333;Fort-Mahon-Plage;940;19483443;1000991;487;14844016;453;4639427;20727;12527
89416;Thury;289;5990212;228003;153;4570748;136;1419464;20727;12528
24518;Salon;147;3046978;121765;65;2285185;82;761793;20728;12529
81322;Virac;120;2487352;121973;51;1729283;69;758069;20728;12530
71132;Ciry-le-Noble;1308;27112432;902512;699;20410264;609;6702168;20728;12531
25552;Sourans;64;1326611;36912;33;999767;31;326844;20728;12532
87154;Saint-Junien;6603;136871545;5797441;3459;106719264;3144;30152281;20729;12533
14007;Amayé-sur-Seulles;102;2114328;33438;62;1707240;40;407088;20729;12534
80034;Athies;368;7628334;335342;173;5618132;195;2010202;20729;12535
52076;Bricon;239;4954343;140076;121;3756233;118;1198110;20729;12536
42030;Bussy-Albieux;271;5617928;147945;133;4033716;138;1584212;20730;12537
22021;Brusvily;604;12521427;372144;313;9284266;291;3237161;20731;12538
80820;Warloy-Baillon;444;9204644;356794;215;6835300;229;2369344;20731;12539
29124;Lesneven;4030;83547616;2985343;1937;62227477;2093;21320139;20731;12540
61294;Mortrée;588;12190179;486901;286;8805118;302;3385061;20732;12541
41023;Bourré;429;8894018;327896;218;6562818;211;2331200;20732;12542
88340;Padoux;279;5784348;128289;143;4003393;136;1780955;20732;12543
80777;Vauchelles-lès-Authie;83;1720792;62377;43;1359143;40;361649;20732;12544
06142;Touët-de-l'Escarène;154;3192830;104538;92;2624678;62;568152;20733;12545
72050;Brûlon;876;18162112;674247;445;13435517;431;4726595;20733;12546
70455;Roye;723;14990527;438673;396;11415838;327;3574689;20734;12547
80675;Rogy;68;1409909;32812;36;1063009;32;346900;20734;12548
62316;Estrée-Wamin;95;1969747;46144;47;1493214;48;476533;20734;12549
23125;Le Mas-d'Artige;69;1430674;62403;36;1060713;33;369961;20734;12550
48140;Saint-Chély-d'Apcher;2415;50074488;2170120;1264;39202765;1151;10871723;20735;12551
88046;Beauménil;77;1596583;48287;43;1200766;34;395817;20735;12552
02456;Manicamp;180;3732342;110460;104;2980158;76;752184;20735;12553
81145;Lisle-sur-Tarn;2571;53311161;2007439;1267;39978569;1304;13332592;20736;12554
37028;Bossay-sur-Claise;454;9414082;424990;207;6784031;247;2630051;20736;12555
11072;La Cassaigne;102;2115081;63646;52;1618592;50;496489;20736;12556
21603;Semur-en-Auxois;2638;54701932;2662328;1364;43228436;1274;11473496;20736;12557
70397;Ormenans;39;808716;25028;18;576045;21;232671;20736;12558
14208;Croissanville;239;4956079;118020;137;3565287;102;1390792;20737;12559
55072;Braquis;58;1202738;38033;30;922353;28;280385;20737;12560
61124;La Coulonche;282;5848024;163393;151;4484831;131;1363193;20738;12561
33456;Saint-Palais;253;5246712;185166;127;4140806;126;1105906;20738;12562
65099;Bordères-Louron;85;1762784;60646;47;1409984;38;352800;20739;12563
40006;Arengosse;430;8917938;364524;224;6841194;206;2076744;20739;12564
02134;Buire;457;9478023;377837;217;6844669;240;2633354;20740;12565
55027;Bannoncourt;86;1783613;51943;47;1316547;39;467066;20740;12566
33432;Saint-Loubert;104;2156934;51387;59;1797373;45;359561;20740;12567
47059;Caubon-Saint-Sauveur;139;2882830;181520;65;2248485;74;634345;20740;12568
50417;Quettehou;921;19101885;733722;428;13914958;493;5186927;20740;12569
05093;Névache;210;4355527;106191;99;2853510;111;1502017;20741;12570
81147;Lombers;601;12465149;464070;290;9386485;311;3078664;20741;12571
19213;Saint-Jal;344;7134884;176880;182;5350090;162;1784794;20741;12572
50502;Saint-Lô;11250;233335607;11197127;5870;184202319;5380;49133288;20741;12573
14597;Saint-Jean-le-Blanc;176;3650410;78127;85;2600519;91;1049891;20741;12574
55114;Chonville-Malaumont;111;2302353;95287;51;1588337;60;714016;20742;12575
46210;Nadillac;41;850424;38673;20;650514;21;199910;20742;12576
32076;Castelnau-Barbarens;293;6077458;257231;152;4697040;141;1380418;20742;12577
35104;Epiniac;725;15038986;402091;380;11288570;345;3750416;20743;12578
24204;Grèzes;110;2281804;64533;59;1735193;51;546611;20744;12579
79183;Montravers;205;4252504;83313;107;3187636;98;1064868;20744;12580
14411;Meslay;116;2406316;55385;65;1948572;51;457744;20744;12581
62558;Marquay;93;1929207;59997;44;1369615;49;559592;20744;12582
45040;Bonny-sur-Loire;1186;24604387;1192122;605;18785710;581;5818677;20746;12583
71586;Viry;144;2987439;76043;82;2281380;62;706059;20746;12584
81073;Crespinet;94;1950166;64624;48;1470311;46;479855;20746;12585
26341;Serves-sur-Rhône;405;8402366;210868;238;6549240;167;1853126;20747;12586
21426;Montberthault;139;2883793;99212;73;2129412;66;754381;20747;12587
26074;La Chapelle-en-Vercors;389;8070486;221583;198;6046076;191;2024410;20747;12588
85174;Petosse;309;6410873;118607;165;4747015;144;1663858;20747;12589
61116;Condé-sur-Huisne;738;15311676;521731;393;11455024;345;3856652;20748;12590
58263;Saint-Pierre-du-Mont;111;2303036;62068;58;1644509;53;658527;20748;12591
46057;Cardaillac;320;6639396;236749;169;5167162;151;1472234;20748;12592
18207;Saint-Florent-sur-Cher;3917;81271864;3081158;2183;63467666;1734;17804198;20748;12593
14388;Maisoncelles-la-Jourdan;255;5290953;137760;141;4057663;114;1233290;20749;12594
82190;Verdun-sur-Garonne;2544;52786385;1854018;1320;40146229;1224;12640156;20749;12595
52487;Thilleux;41;850760;14838;20;568078;21;282682;20750;12596
08153;Escombres-et-le-Chesnois;174;3610547;63752;91;2669521;83;941026;20750;12597
61102;Le Châtellier;208;4316190;100393;112;3234876;96;1081314;20751;12598
86143;Mairé;96;1992102;77736;50;1548657;46;443445;20751;12599
03081;Colombier;187;3880451;136068;102;2949293;85;931158;20751;12600
43172;Saint-Bonnet-le-Froid;128;2656179;87078;66;1997770;62;658409;20751;12601
71370;Rigny-sur-Arroux;374;7761048;358947;174;5680424;200;2080624;20751;12602
33541;Vensac;546;11330556;531105;279;8638761;267;2691795;20752;12603
82192;Verlhac-Tescou;277;5748345;319774;119;4363107;158;1385238;20752;12604
44185;Saint-Nicolas-de-Redon;1741;36129500;1133747;958;27867511;783;8261989;20752;12605
34172;Montpellier;148920;3090422025;190596503;75050;2491235894;73870;599186131;20752;12606
39043;Beaufort;613;12721163;411509;335;9504494;278;3216669;20752;12607
83007;Aups;1324;27476342;1514976;598;20078211;726;7398131;20753;12608
82031;Castelmayran;543;11268913;389706;265;8286654;278;2982259;20753;12609
02306;La Ferté-Chevresis;313;6495792;269284;147;4747739;166;1748053;20753;12610
60476;Omécourt;107;2220617;76210;60;1658540;47;562077;20753;12611
91223;Étampes;13933;289158638;13240821;7435;229058723;6498;60099915;20754;12612
11361;Saint-Papoul;457;9484414;331322;234;7246921;223;2237493;20754;12613
11178;Labastide-d'Anjou;568;11788086;378203;282;8852521;286;2935565;20754;12614
25346;Longeville;89;1847088;59100;42;1300524;47;546564;20754;12615
09208;Montgauch;74;1535782;74521;42;1262090;32;273692;20754;12616
64464;Ribarrouy;45;933925;35830;21;668901;24;265024;20754;12617
80208;Conteville;103;2137685;74529;41;1544226;62;593459;20754;12618
35005;Arbrissel;145;3009389;37674;83;2320335;62;689054;20754;12619
15004;Andelat;249;5167878;184658;137;3994318;112;1173560;20755;12620
53127;Lassay-les-Châteaux;1419;29450966;1195686;670;21560054;749;7890912;20755;12621
02286;Esquéhéries;457;9485178;381340;240;7170590;217;2314588;20755;12622
29022;Camaret-sur-Mer;1657;34392183;1405427;817;25008203;840;9383980;20756;12623
62897;Wismes;277;5749357;169422;133;4209859;144;1539498;20756;12624
61394;Saint-Germain-de-la-Coudre;462;9589274;350085;249;7269600;213;2319674;20756;12625
88033;Ban-de-Sapt;179;3715359;82640;85;2681536;94;1033823;20756;12626
82149;Réalville;1004;20839379;821922;477;15340229;527;5499150;20756;12627
89470;Villiers-les-Hauts;93;1930368;87440;51;1494829;42;435539;20757;12628
34166;Montblanc;1495;31031757;1231582;712;23536974;783;7494783;20757;12629
89376;Sarry;99;2054972;77321;51;1492335;48;562637;20757;12630
14477;Ondefontaine;165;3424998;75554;97;2638373;68;786625;20758;12631
55001;Abainville;151;3134427;80904;80;2281905;71;852522;20758;12632
56079;Guillac;736;15278210;504352;394;11398654;342;3879556;20758;12633
41007;Authon;385;7992010;333874;202;6095864;183;1896146;20758;12634
52269;Langres;4888;101468419;5455626;2556;80009494;2332;21458925;20759;12635
71573;Versaugues;119;2470418;58201;55;1692305;64;778113;20760;12636
89294;Perreux;208;4318072;178953;116;3426145;92;891927;20760;12637
14147;Cernay;86;1785375;64470;44;1354101;42;431274;20760;12638
52290;Les Loges;68;1411745;77505;26;905998;42;505747;20761;12639
07308;Sarras;1165;24186918;783679;636;18509138;529;5677780;20761;12640
32231;Marambat;232;4816780;108710;115;3609349;117;1207431;20762;12641
38001;Les Abrets;1935;40174753;1784576;986;30628641;949;9546112;20762;12642
35163;Luitré;682;14159947;254086;359;10437866;323;3722081;20762;12643
50205;La Godefroy;121;2512257;30133;71;1862030;50;650227;20762;12644
72186;Maresché;474;9841576;258581;256;7575941;218;2265635;20763;12645
38330;Quincieu;60;1245777;42535;31;876758;29;369019;20763;12646
58060;Charrin;353;7329491;261902;203;5864076;150;1465415;20763;12647
24327;Pezuls;73;1515786;49676;36;1129573;37;386213;20764;12648
88263;Laveline-du-Houx;130;2699352;99198;62;1998734;68;700618;20764;12649
69006;Amplepuis;2814;58430786;1973775;1309;42303676;1505;16127110;20764;12650
42103;La Grand-Croix;2636;54735070;1728179;1251;39555179;1385;15179891;20764;12651
15196;Saint-Mamet-la-Salvetat;842;17484015;571249;446;13444829;396;4039186;20765;12652
45285;Saint-Jean-de-la-Ruelle;9202;191079560;7466973;5154;149572322;4048;41507238;20765;12653
54133;Coincourt;66;1370503;44359;28;916869;38;453634;20765;12654
36167;Preuilly-la-Ville;93;1931197;73664;50;1518987;43;412210;20766;12655
87017;Blanzac;275;5710701;175273;134;4218994;141;1491707;20766;12656
50272;Lingreville;617;12813004;544902;300;9611610;317;3201394;20767;12657
88481;Uriménil;774;16073449;458798;418;12088961;356;3984488;20767;12658
16200;Maine-de-Boixe;251;5212466;155031;154;4223930;97;988536;20767;12659
32124;Espaon;98;2035191;57376;47;1514818;51;520373;20767;12660
02165;Charmes;912;18939938;642266;495;14278615;417;4661323;20767;12661
02351;Goussancourt;66;1370675;55367;33;980661;33;390014;20768;12662
81181;Montpinier;95;1972970;74159;44;1438635;51;534335;20768;12663
07230;Saint-Étienne-de-Boulogne;221;4589939;170707;103;3266676;118;1323263;20769;12664
55403;Peuvillers;34;706148;31222;18;507435;16;198713;20769;12665
80475;Liéramont;123;2554601;63095;72;1988152;51;566449;20769;12666
54097;Bréménil;68;1412315;36918;28;850467;40;561848;20769;12667
22183;Plémet;1706;35433180;1259261;850;26365603;856;9067577;20770;12668
72366;Valennes;195;4050105;136442;115;3222002;80;828103;20770;12669
49261;Les Rosiers-sur-Loire;1312;27251910;932944;628;19874254;684;7377656;20771;12670
80538;Mesnil-en-Arrouaise;80;1661728;63689;29;1060357;51;601371;20772;12671
61020;Avoine;124;2575699;60305;72;1930421;52;645278;20772;12672
71177;Dommartin-lès-Cuiseaux;416;8641366;232975;225;6419380;191;2221986;20773;12673
40191;Montaut;339;7041970;201798;176;5013932;163;2028038;20773;12674
79208;La Peyratte;618;12837661;415248;294;9371620;324;3466041;20773;12675
15094;Laroquebrou;504;10470279;562849;228;7823725;276;2646554;20774;12676
61213;Lalacelle;155;3220045;88632;81;2455570;74;764475;20774;12677
25323;Laissey;246;5110634;178057;130;3852838;116;1257796;20775;12678
80360;Fressenneville;1337;27776137;1193393;670;20809786;667;6966351;20775;12679
89087;Chassignelles;190;3947256;172617;97;3026554;93;920702;20775;12680
47115;Guérin;149;3095656;156821;69;2329380;80;766276;20776;12681
88113;Combrimont;93;1932228;59565;42;1347577;51;584651;20777;12682
17320;Saint-Coutant-le-Grand;225;4674788;136233;97;3229386;128;1445402;20777;12683
76432;Mesnil-Mauger;130;2700990;76573;78;2179302;52;521688;20777;12684
79135;Gourgé;513;10658672;294991;230;7262959;283;3395713;20777;12685
24086;Castelnaud-la-Chapelle;270;5609983;266016;120;3990057;150;1619926;20778;12686
27305;La Guéroulde;421;8747458;201430;253;6938118;168;1809340;20778;12687
60661;Vaumoise;486;10098078;289370;283;7846118;203;2251960;20778;12688
14497;Perrières;155;3220663;68776;87;2418036;68;802627;20778;12689
32191;Lanne-Soubiran;64;1329859;16808;33;939735;31;390124;20779;12690
55017;Autrécourt-sur-Aire;80;1662363;55259;42;1194328;38;468035;20780;12691
42261;Saint-Martin-Lestra;453;9413304;233055;228;6797798;225;2615506;20780;12692
05118;Ribiers;482;10016033;365102;225;7223048;257;2792985;20780;12693
39192;Denezières;47;976670;34972;23;700138;24;276532;20780;12694
10313;Radonvilliers;222;4613279;143868;127;3564780;95;1048499;20781;12695
86236;Saint-Pierre-de-Maillé;542;11263287;581155;219;7896973;323;3366314;20781;12696
85070;Coëx;1689;35099704;1001109;844;25915534;845;9184170;20781;12697
49236;Passavant-sur-Layon;73;1517095;30175;43;1190024;30;327071;20782;12698
65415;Ségus;151;3138204;88770;77;2324570;74;813634;20783;12699
62480;Labourse;1185;24627690;672280;568;18102947;617;6524743;20783;12700
59233;Flaumont-Waudrechies;202;4198162;153472;85;2892729;117;1305433;20783;12701
02010;Allemant;91;1891263;38620;47;1376033;44;515230;20783;12702
11105;Cournanel;374;7773165;268273;203;5997308;171;1775857;20784;12703
11425;Villegailhenc;865;17978136;552274;413;13106694;452;4871442;20784;12704
56037;La Chapelle-Caro;728;15130916;420384;384;11512312;344;3618604;20784;12705
19008;Ambrugeat;124;2577249;107199;69;2048618;55;528631;20784;12706
47178;Monségur;225;4676506;142357;122;3535344;103;1141162;20784;12707
89089;Chastellux-sur-Cure;77;1600433;46309;44;1223426;33;377007;20785;12708
63438;Trézioux;278;5778467;245273;144;4483070;134;1295397;20786;12709
70538;Vellemoz;46;956152;23252;22;687889;24;268263;20786;12710
34206;Poilhes;305;6339764;181080;143;4617918;162;1721846;20786;12711
36234;Verneuil-sur-Igneraie;205;4261314;216022;105;3219496;100;1041818;20787;12712
85268;Saint-Révérend;720;14966721;289777;409;11387110;311;3579611;20787;12713
14141;Castillon-en-Auge;83;1725347;58747;39;1347989;44;377358;20787;12714
84064;Lapalud;1989;41347129;1294717;1024;31111543;965;10235586;20788;12715
01106;Cize;92;1912520;56427;46;1351496;46;561024;20788;12716
24530;Sencenac-Puy-de-Fourches;124;2577748;42965;63;1953649;61;624099;20788;12717
27293;Gouville;204;4240909;108036;107;3259935;97;980974;20789;12718
33094;Caplong;136;2827293;108156;75;2213701;61;613592;20789;12719
05140;Saint-Étienne-le-Laus;171;3554935;105907;87;2601272;84;953663;20789;12720
40149;Lencouacq;240;4989451;216191;107;3388095;133;1601356;20789;12721
10356;Saint-Oulph;137;2848358;56254;85;2265055;52;583303;20791;12722
33489;Saint-Vivien-de-Blaye;208;4324591;134565;99;3244743;109;1079848;20791;12723
31405;Ore;72;1496981;52965;45;1242932;27;254049;20791;12724
71540;Torcy;1512;31436710;1117081;761;23557216;751;7879494;20791;12725
19091;Hautefage;174;3617825;131703;87;2717233;87;900592;20792;12726
35336;Le Tiercent;107;2224756;62040;59;1695678;48;529078;20792;12727
21349;Liernais;339;7048531;234202;152;5304340;187;1744191;20792;12728
60396;Méry-la-Bataille;334;6944713;214777;176;5271694;158;1673019;20793;12729
02472;Mauregny-en-Haye;228;4740719;174374;112;3572891;116;1167828;20793;12730
52083;Champsevraine;495;10292366;410795;234;7580887;261;2711479;20793;12731
71341;Palleau;126;2620025;83536;70;2006340;56;613685;20794;12732
80276;Équennes-Éramecourt;153;3181466;56141;85;2319331;68;862135;20794;12733
60289;Grez;146;3035951;90886;76;2339643;70;696308;20794;12734
77131;Coulommiers;9051;188208327;9535976;4770;147613850;4281;40594477;20794;12735
18078;Crézançay-sur-Cher;36;748596;26058;14;462298;22;286298;20794;12736
71434;Saint-Julien-de-Jonzy;183;3805524;112405;104;3024931;79;780593;20795;12737
49142;La Fosse-de-Tigné;123;2557841;105966;49;1748923;74;808918;20795;12738
65389;Saint-Laurent-de-Neste;577;11999290;447899;295;9310410;282;2688880;20796;12739
33132;Comps;266;5531782;160377;124;4087656;142;1444126;20796;12740
25506;Rougemontot;50;1039826;29090;30;829187;20;210639;20797;12741
55456;Saint-Germain-sur-Meuse;152;3161092;97743;86;2420549;66;740543;20797;12742
46285;Saint-Pantaléon;144;2994838;93753;72;2205112;72;789726;20797;12743
61108;Cisai-Saint-Aubin;93;1934172;55112;45;1375851;48;558321;20798;12744
09249;Roquefixade;92;1913411;106208;42;1460782;50;452629;20798;12745
79058;Brûlain;371;7716053;177672;190;5811045;181;1905008;20798;12746
09318;Unac;70;1455863;55222;48;1252489;22;203374;20798;12747
24065;Breuilh;137;2849384;92088;63;2056617;74;792767;20798;12748
32418;Sauveterre;138;2870220;122831;67;2155820;71;714400;20799;12749
88216;Grandvillers;383;7965944;307080;187;5825797;196;2140147;20799;12750
85072;La Copechagnière;479;9962702;138318;264;7585647;215;2377055;20799;12751
04220;Les Thuiles;234;4866960;147051;125;3653445;109;1213515;20799;12752
49208;Montguillon;106;2204741;25491;59;1696820;47;507921;20799;12753
39495;Saint-Thiébaud;35;727994;25521;18;567734;17;160260;20800;12754
50362;Moulines;153;3182376;47516;82;2473269;71;709107;20800;12755
16326;Saint-Groux;73;1518389;36171;35;1015298;38;503091;20800;12756
52006;Allichamps;197;4097593;106622;106;2957030;91;1140563;20800;12757
11362;Saint-Paulet;103;2142457;48421;60;1753404;43;389053;20801;12758
70514;Valay;314;6531489;237407;146;4750846;168;1780643;20801;12759
76526;Ricarville-du-Val;78;1622473;41396;44;1262701;34;359772;20801;12760
61509;Vingt-Hanaps;230;4784221;119114;131;3844374;99;939847;20801;12761
89465;Villeperrot;185;3848182;142910;106;3049006;79;799176;20801;12762
72088;Congé-sur-Orne;186;3869026;75413;94;2785541;92;1083485;20801;12763
62168;Bourthes;382;7946192;149617;173;5385697;209;2560495;20802;12764
89217;Lalande;78;1622528;98199;36;1232776;42;389752;20802;12765
86018;Basses;192;3993967;136290;110;3240904;82;753063;20802;12766
11331;Saint-Amans;40;832121;26343;26;688012;14;144109;20803;12767
22121;Lanvollon;1015;21115988;768823;476;15367065;539;5748923;20804;12768
61121;Coulimer;176;3661518;111436;87;2716177;89;945341;20804;12769
46060;Carnac-Rouffiac;155;3224644;134588;87;2585673;68;638971;20804;12770
48146;Sainte-Enimie;313;6511726;280585;165;5033671;148;1478055;20804;12771
49014;Aviré;249;5180436;68688;130;3864301;119;1316135;20805;12772
27458;Pîtres;1285;26734554;852356;704;20533580;581;6200974;20805;12773
69150;Ouroux;189;3932211;194728;91;2953723;98;978488;20805;12774
80598;Nouvion;668;13898102;530047;327;10371219;341;3526883;20806;12775
89092;Châtel-Gérard;148;3079273;120238;81;2389504;67;689769;20806;12776
57630;Sarrebourg;7421;154401096;8041700;3774;119998177;3647;34402919;20806;12777
17421;Saujon;4303;89529641;3469108;2174;66976088;2129;22553553;20806;12778
40260;Saint-Geours-d'Auribat;203;4223718;120067;108;3235714;95;988004;20806;12779
18228;Saint-Outrille;129;2684107;74999;71;2057027;58;627080;20807;12780
14140;Castillon;184;3828564;72572;94;2766282;90;1062282;20807;12781
40138;Lacrabe;138;2871543;80897;77;2193713;61;677830;20808;12782
49365;Les Verchers-sur-Layon;469;9759105;228847;222;7243298;247;2515807;20808;12783
51521;Saint-Vrain;110;2288916;83179;62;1761337;48;527579;20808;12784
49353;Trélazé;6723;139896340;3837364;3641;107404408;3082;32491932;20809;12785
31219;Gensac-sur-Garonne;202;4203378;191719;103;3338203;99;865175;20809;12786
28376;Soizé;179;3724800;102482;95;2878536;84;846264;20809;12787
50241;Hémevez;92;1914574;53952;44;1384561;48;530013;20811;12788
57247;Gerbécourt;47;978098;20028;19;638385;28;339713;20811;12789
40299;Serreslous-et-Arribans;109;2268436;65427;58;1710617;51;557819;20811;12790
54164;Dommarie-Eulmont;46;957334;44521;25;801949;21;155385;20812;12791
69258;Vauxrenard;169;3517188;172804;81;2698981;88;818207;20812;12792
33516;Soussac;100;2081189;63515;44;1532234;56;548955;20812;12793
89119;Coulanges-sur-Yonne;335;6971999;416422;147;4898688;188;2073311;20812;12794
02215;Corbeny;398;8283215;210782;210;6322655;188;1960560;20812;12795
44034;La Chapelle-Saint-Sauveur;407;8470728;251386;202;6186839;205;2283889;20813;12796
54467;Rozelieures;91;1894060;40892;48;1430034;43;464026;20814;12797
82136;Orgueil;749;15589748;369812;384;11647972;365;3941776;20814;12798
39434;Poligny;2206;45916026;1967276;1102;35164863;1104;10751163;20814;12799
24229;Le Lardin-Saint-Lazare;1080;22480075;769639;558;17029389;522;5450686;20815;12800
55293;Lion-devant-Dun;93;1935798;55481;54;1504596;39;431202;20815;12801
55313;Malancourt;45;936685;31839;21;702864;24;233821;20815;12802
10003;Aix-en-Othe;1438;29933097;1269873;673;22254856;765;7678241;20816;12803
40165;Luglon;193;4017479;122433;88;2860664;105;1156815;20816;12804
57133;Château-Voué;71;1477935;25321;33;1029571;38;448364;20816;12805
61126;Coulonges-sur-Sarthe;294;6119904;231808;107;4016283;187;2103621;20816;12806
02233;Cramaille;73;1519607;42502;40;1142394;33;377213;20817;12807
32356;Saint-André;56;1165749;35521;31;907899;25;257850;20817;12808
14309;Gouvix;394;8201885;272209;212;6329891;182;1871994;20817;12809
79243;Saint-Coutant;147;3060197;66323;63;2031286;84;1028911;20818;12810
94081;Vitry-sur-Seine;49437;1029171412;53571222;26522;830245119;22915;198926293;20818;12811
61342;Rai;885;18424231;612896;503;14459264;382;3964967;20818;12812
46215;Payrac;376;7827817;266128;182;5736212;194;2091605;20819;12813
29166;Ploéven;284;5912593;138343;157;4467419;127;1445174;20819;12814
07306;Sampzon;121;2519114;78280;74;2082633;47;436481;20819;12815
21557;Saint-Marc-sur-Seine;65;1353246;30110;33;1058765;32;294481;20819;12816
70220;Essertenne-et-Cecey;223;4642702;157180;129;3518980;94;1123722;20819;12817
23011;Aulon;104;2165208;128577;47;1607313;57;557895;20819;12818
71353;Plottes;338;7037104;298801;177;5558308;161;1478796;20820;12819
50123;La Chapelle-en-Juger;352;7328596;148960;204;5763466;148;1565130;20820;12820
09066;Brassac;373;7765834;252007;214;6156595;159;1609239;20820;12821
64250;Guiche;466;9702137;241852;242;7164788;224;2537349;20820;12822
33059;Blésignac;146;3039729;62089;79;2318239;67;721490;20820;12823
46089;Duravel;522;10868109;422881;252;7938596;270;2929513;20820;12824
16244;Nersac;1362;28358242;1213243;736;22285907;626;6072335;20821;12825
02737;Tavaux-et-Pontséricourt;319;6642010;243472;140;4734703;179;1907307;20821;12826
02751;Trucy;84;1749008;41766;44;1257177;40;491831;20822;12827
44205;Les Touches;1229;25589751;619677;625;19052072;604;6537679;20822;12828
88423;Saint-Léonard;752;15657964;463642;399;11587694;353;4070270;20822;12829
61493;La Trinité-des-Laitiers;47;978665;41891;25;750204;22;228461;20823;12830
03270;Sazeret;73;1520058;24172;39;1137128;34;382930;20823;12831
85018;Beauvoir-sur-Mer;2347;48871198;1797367;1174;36127468;1173;12743730;20823;12832
71581;Vindecy;131;2727838;85875;58;1915007;73;812831;20823;12833
87099;Moissannes;199;4143826;73018;100;2887868;99;1255958;20823;12834
71014;Autun;8534;177706555;9185448;4176;134500757;4358;43205798;20823;12835
81262;Saint-Marcel-Campes;126;2623805;106644;48;1860143;78;763662;20824;12836
56011;Béganne;811;16888913;464447;412;12660450;399;4228463;20825;12837
29215;Plozévet;1869;38922765;1525224;951;29390590;918;9532175;20825;12838
30291;Saint-Paul-la-Coste;157;3269606;111558;69;2380128;88;889478;20826;12839
80108;Boisbergues;38;791394;25281;22;606060;16;185334;20826;12840
26107;Crépol;295;6143766;206635;137;4301731;158;1842035;20826;12841
76057;Barentin;6762;140828590;4969354;3672;109493175;3090;31335415;20826;12842
70236;Fleurey-lès-Faverney;229;4769370;103409;126;3633218;103;1136152;20827;12843
04140;Les Omergues;73;1520374;83906;35;1177127;38;343247;20827;12844
55023;Avocourt;65;1353793;40709;29;952478;36;401315;20828;12845
54146;Crézilles;143;2978354;58592;79;2286392;64;691962;20828;12846
61255;Mauves-sur-Huisne;353;7352250;257356;175;5297259;178;2054991;20828;12847
71180;Donzy-le-National;117;2436903;88054;59;1862736;58;574167;20828;12848
31244;Juzet-de-Luchon;246;5123770;187036;149;4035862;97;1087908;20828;12849
70457;Rupt-sur-Saône;85;1770423;54734;51;1398709;34;371714;20829;12850
65294;Lutilhous;128;2666051;74864;67;2123497;61;542554;20829;12851
86097;La Ferrière-Airoux;176;3665862;132318;82;2396579;94;1269283;20829;12852
55159;Dompcevrin;199;4145034;138904;118;3323659;81;821375;20829;12853
18073;Corquoy;128;2666168;87165;74;2073431;54;592737;20829;12854
85022;Le Bernard;620;12914389;369369;333;9668980;287;3245409;20830;12855
24087;Castels;379;7894766;353176;185;5870358;194;2024408;20831;12856
46236;Reilhaguet;67;1395666;43879;33;1089984;34;305682;20831;12857
71328;Nanton;336;6999193;215780;180;5280851;156;1718342;20831;12858
21538;Saint-Andeux;82;1708193;57802;44;1286019;38;422174;20832;12859
49080;Châteauneuf-sur-Sarthe;1618;33706314;698493;705;22891473;913;10814841;20832;12860
70082;Bouhans-lès-Montbozon;60;1249931;22796;33;871836;27;378095;20832;12861
12216;Saint-Côme-d'Olt;789;16436648;672612;388;12376342;401;4060306;20832;12862
26292;Saint-Auban-sur-l'Ouvèze;109;2270733;74250;49;1682829;60;587904;20832;12863
82102;Mansonville;142;2958258;78880;54;1971226;88;987032;20833;12864
55437;Romagne-sous-les-Côtes;64;1333302;19582;29;863187;35;470115;20833;12865
66141;Pia;4105;85518981;3699199;1985;66597967;2120;18921014;20833;12866
39245;Gatey;187;3895849;88594;85;2651147;102;1244702;20833;12867
59267;Gonnelieu;180;3750060;231954;91;2978097;89;771963;20834;12868
61076;Le Cercueil;77;1604201;61380;29;1162719;48;441482;20834;12869
62906;Zutkerque;854;17792161;547839;412;13084199;442;4707962;20834;12870
01447;Villereversure;694;14459171;551556;361;11169594;333;3289577;20835;12871
49300;Saint-Lézin;388;8083817;115288;199;5703347;189;2380470;20835;12872
16072;Chadurie;264;5500471;240184;121;4115131;143;1385340;20835;12873
38363;Saint-Barthélemy;496;10334318;347039;269;7980240;227;2354078;20835;12874
58077;Ciez;236;4917185;224536;123;3783438;113;1133747;20836;12875
89356;Saint-Martin-sur-Ocre;34;708415;28830;20;592590;14;115825;20836;12876
14103;Le Breuil-en-Bessin;208;4333936;89472;117;3354711;91;979225;20836;12877
32068;Cadeilhan;63;1312702;26673;29;864697;34;448005;20837;12878
35116;La Fresnais;1245;25941783;638182;686;19515583;559;6426200;20837;12879
22086;Kerfot;388;8084719;251943;199;5961535;189;2123184;20837;12880
14283;Fourches;103;2146244;35715;53;1596159;50;550085;20837;12881
62576;Moncheaux-lès-Frévent;69;1437790;77800;30;1080947;39;356843;20838;12882
40016;Aubagnan;141;2938114;79955;74;2207513;67;730601;20838;12883
46251;Saint-Céré;2279;47489239;2383890;1112;35478270;1167;12010969;20838;12884
86197;Pouant;245;5105315;190035;122;3756313;123;1349002;20838;12885
45129;Douchy;645;13440567;679937;332;10359002;313;3081565;20838;12886
70049;Barges;50;1041906;35099;22;746696;28;295210;20838;12887
04148;Peyroules;121;2521414;66563;62;1914778;59;606636;20838;12888
51424;Passavant-en-Argonne;120;2500579;93549;65;1944154;55;556425;20838;12889
52265;Bayard-sur-Marne;760;15837778;492369;436;12355145;324;3482633;20839;12890
38245;Montagne;152;3167568;116309;76;2396761;76;770807;20839;12891
50339;Montchaton;180;3751141;99429;93;2772927;87;978214;20840;12892
61408;Sainte-Honorine-la-Guillaume;204;4251441;186083;90;3145633;114;1105808;20840;12893
59472;Preux-au-Bois;451;9399147;352479;239;7010176;212;2388971;20841;12894
66176;Saint-Hippolyte;1478;30803087;1069722;748;23590130;730;7212957;20841;12895
41188;Rhodon;63;1313001;17791;37;1036168;26;276833;20841;12896
24105;Chapdeuil;92;1917410;81377;39;1337830;53;579580;20841;12897
17415;Saintes;16340;340553534;18002158;8138;267650863;8202;72902671;20842;12898
04235;Verdaches;32;666939;28432;16;484270;16;182669;20842;12899
63237;Montel-de-Gelat;252;5252386;112969;106;3843823;146;1408563;20843;12900
88257;Juvaincourt;91;1896699;38734;47;1364310;44;532389;20843;12901
66049;Céret;4916;102463902;5123115;2341;78398427;2575;24065475;20843;12902
70167;Conflandey;209;4356186;81865;128;3452114;81;904072;20843;12903
43013;Vissac-Auteyrac;178;3710310;85928;90;2690226;88;1020084;20844;12904
49239;Le Pin-en-Mauges;671;13986930;225431;309;9557281;362;4429649;20845;12905
40214;Ossages;271;5648976;178538;121;3999227;150;1649749;20845;12906
24233;Laveyssière;79;1646759;53358;38;1276963;41;369796;20845;12907
70169;Confracourt;107;2230462;62665;58;1677802;49;552660;20845;12908
21025;Arrans;39;812981;36426;22;648660;17;164321;20846;12909
83113;Saint-Julien;1224;25515352;898511;607;18810005;617;6705347;20846;12910
46194;Milhac;125;2605782;110454;69;2013840;56;591942;20846;12911
56064;Glénac;486;10131357;223717;268;7618052;218;2513305;20846;12912
50185;Fleury;519;10819786;201348;278;8007203;241;2812583;20847;12913
58147;Lurcy-le-Bourg;164;3418974;95715;87;2573554;77;845420;20847;12914
27289;La Goulafrière;89;1855420;47795;50;1403191;39;452229;20847;12915
02397;Jussy;696;14510410;594420;350;10974960;346;3535450;20848;12916
21152;Châteauneuf;59;1230069;37126;27;819725;32;410344;20849;12917
36030;Buxières-d'Aillac;132;2752023;113888;70;2098743;62;653280;20849;12918
02201;Coeuvres-et-Valsery;266;5545770;246970;118;3989707;148;1556063;20849;12919
80133;Brailly-Cornehotte;139;2898052;107907;64;2068037;75;830015;20849;12920
24496;Saint-Romain-et-Saint-Clément;204;4253292;158136;106;3211367;98;1041925;20849;12921
80221;Cramont;151;3148273;86502;77;2399738;74;748535;20849;12922
47305;Tayrac;196;4086559;93533;107;3047173;89;1039386;20850;12923
50174;Équilly;88;1834841;16899;47;1378308;41;456533;20850;12924
12081;Coussergues;145;3023332;112064;70;2175628;75;847704;20851;12925
70081;Bouhans-lès-Lure;156;3252706;76070;81;2321975;75;930731;20851;12926
73011;Albertville;11603;241932834;12113267;6065;187213484;5538;54719350;20851;12927
14180;Cordey;76;1584750;56810;34;1136707;42;448043;20852;12928
62412;Hardinghen;626;13053517;514861;277;9323552;349;3729965;20852;12929
54551;Vaucourt;37;771541;29166;16;556619;21;214922;20852;12930
64507;Saubole;68;1417973;35325;31;979241;37;438732;20853;12931
53025;Bazougers;525;10947699;176574;267;7937918;258;3009781;20853;12932
21342;Laperrière-sur-Saône;204;4254082;106681;104;2972581;100;1281501;20853;12933
45178;Ladon;815;16995579;628004;451;13115375;364;3880204;20853;12934
59231;Ferrière-la-Petite;536;11177478;421471;273;8565962;263;2611516;20854;12935
35011;Baillé;167;3482578;107847;90;2735864;77;746714;20854;12936
21181;Clomot;64;1334645;33179;37;1077019;27;257626;20854;12937
80747;Templeux-la-Fosse;84;1751819;53105;36;1193725;48;558094;20855;12938
24258;Marsaneix;574;11971132;344715;318;9361966;256;2609166;20856;12939
59183;Dunkerque;52318;1091125934;55070186;25648;843357612;26670;247768322;20856;12940
29276;Sibiril;713;14870096;498384;376;11357393;337;3512703;20856;12941
62691;Rebecques;238;4963839;129195;139;3805424;99;1158415;20856;12942
72234;Pezé-le-Robert;200;4171333;106243;109;3223744;91;947589;20857;12943
63206;Manzat;764;15934742;580467;374;11605430;390;4329312;20857;12944
70104;Bucey-lès-Gy;360;7508544;239021;183;5571365;177;1937179;20857;12945
62367;Gauchin-Verloingt;426;8885207;324084;189;6287986;237;2597221;20857;12946
61310;Nonant-le-Pin;314;6549204;318775;149;4863537;165;1685667;20857;12947
79078;Prissé-la-Charrière;357;7446178;190858;193;5614454;164;1831724;20858;12948
82083;Lachapelle;59;1230606;65745;21;896288;38;334318;20858;12949
16294;Saint-Amant;394;8217964;344482;196;6204331;198;2013633;20858;12950
26094;Claveyson;450;9386014;305775;219;6961013;231;2425001;20858;12951
60435;Morvillers;256;5339730;161792;148;4095550;108;1244180;20858;12952
71538;Thurey;237;4943430;175312;133;3892935;104;1050495;20858;12953
13004;Arles;31709;661408702;35853648;14875;512402161;16834;149006541;20859;12954
39134;Chavéria;119;2482219;55574;72;2066445;47;415774;20859;12955
32221;Lussan;129;2690855;111233;76;2125121;53;565734;20859;12956
50023;Auvers;347;7238349;221923;200;5523411;147;1714938;20860;12957
88476;Totainville;57;1189017;32019;32;954953;25;234064;20860;12958
50080;Brévands;182;3796576;131152;110;3163070;72;633506;20860;12959
33299;Mourens;211;4401637;177071;106;3344052;105;1057585;20861;12960
39095;Champagne-sur-Loue;71;1481152;54101;40;1200322;31;280830;20861;12961
2B329;Tralonca;61;1272547;85393;30;1005169;31;267378;20861;12962
80322;Fonches-Fonchette;76;1585477;51198;38;1200756;38;384721;20862;12963
37125;Lémeré;247;5152809;188822;126;3805891;121;1346918;20862;12964
62626;Noyelles-lès-Vermelles;1125;23469383;579737;568;17295958;557;6173425;20862;12965
73272;Saint-Pierre-de-Belleville;93;1940169;53429;49;1423321;44;516848;20862;12966
02713;Seringes-et-Nesles;146;3045975;103809;69;2191856;77;854119;20863;12967
39096;Champagney;218;4548154;175647;115;3460533;103;1087621;20863;12968
80247;Dompierre-Becquincourt;361;7531672;330502;182;5718800;179;1812872;20863;12969
35100;Dompierre-du-Chemin;293;6113028;129199;156;4580931;137;1532097;20864;12970
42320;Valfleury;344;7177115;155001;179;5457993;165;1719122;20864;12971
41160;Neuvy;175;3651211;102309;97;2760833;78;890378;20864;12972
35030;La Bosse-de-Bretagne;302;6300963;119283;163;4682622;139;1618341;20864;12973
88403;Rozerotte;102;2128206;55767;60;1752455;42;375751;20865;12974
70488;Senoncourt;127;2649934;93652;81;2158939;46;490995;20866;12975
34103;Fontès;549;11455264;498400;213;7985860;336;3469404;20866;12976
89358;Saint-Martin-sur-Ouanne;268;5592165;214463;145;4314133;123;1278032;20866;12977
29020;Briec;2930;61138586;1723964;1514;45774334;1416;15364252;20866;12978
80250;Domvast;163;3401306;112218;79;2554917;84;846389;20867;12979
22181;Plélauff;385;8033786;288684;191;5904201;194;2129585;20867;12980
82019;Boudou;352;7345497;286601;168;5545476;184;1800021;20868;12981
25184;Cuse-et-Adrisans;140;2921526;96553;65;2020267;75;901259;20868;12982
50259;Juilley;340;7095178;137312;185;5309885;155;1785293;20868;12983
80576;Moyencourt;171;3568480;137495;89;2707363;82;861117;20868;12984
21496;Pontailler-sur-Saône;726;15150522;590730;393;11656368;333;3494154;20868;12985
80800;Villers-Campsart;70;1460892;38033;32;1022761;38;438131;20870;12986
80537;Mesnil-Domqueur;45;939152;32179;22;664763;23;274389;20870;12987
87039;Château-Chervix;476;9934256;242512;204;7195590;272;2738666;20870;12988
37147;Marcilly-sur-Vienne;308;6428097;182051;168;4846314;140;1581783;20870;12989
80710;Saint-Maxent;203;4236701;144125;103;3085978;100;1150723;20870;12990
33317;Périssac;553;11541379;345664;277;8513963;276;3027416;20870;12991
39023;L'Aubépin;78;1627928;33327;47;1317919;31;310009;20871;12992
47034;Bouglon;321;6699652;280367;164;5067242;157;1632410;20871;12993
22264;La Roche-Derrien;603;12585335;546300;279;9355344;324;3229991;20871;12994
71509;La Celle-en-Morvan;265;5530894;156776;133;3962664;132;1568230;20871;12995
62508;Lières;188;3923834;67642;95;2846119;93;1077715;20871;12996
17327;Saint-Félix;179;3736027;130691;85;2846080;94;889947;20872;12997
02356;Grisolles;105;2191526;83738;53;1652317;52;539209;20872;12998
58282;Surgy;247;5155331;173284;133;3852624;114;1302707;20872;12999
55028;Bantheville;67;1398425;39248;38;1093707;29;304718;20872;13000
55005;Amanty;25;521801;16755;12;387457;13;134344;20872;13001
50414;Précorbin;286;5969408;151947;155;4481142;131;1488266;20872;13002
33475;Saint-Seurin-de-Bourg;228;4758930;116528;119;3514472;109;1244458;20873;13003
40177;Maylis;182;3798836;140954;82;2908980;100;889856;20873;13004
33046;Bernos-Beaulac;626;13066362;413644;336;10117507;290;2948855;20873;13005
59018;Arnèke;884;18451673;522041;388;12886489;496;5565184;20873;13006
27052;Le Bec-Hellouin;262;5468811;290399;124;4280952;138;1187859;20873;13007
67072;Butten;351;7326589;164234;199;5477018;152;1849571;20873;13008
29091;Kerlouan;1355;28283673;893026;670;20513363;685;7770310;20874;13009
70087;Bourguignon-lès-Conflans;70;1461152;46912;37;1096358;33;364794;20874;13010
03063;Chassenard;504;10520326;250971;278;7984948;226;2535378;20874;13011
11188;La Palme;888;18536024;705056;407;13834784;481;4701240;20874;13012
62788;Seninghem;337;7034584;141450;166;5068308;171;1966276;20874;13013
17469;Villars-en-Pons;309;6450112;200823;154;4784785;155;1665327;20874;13014
51608;Vernancourt;48;1001974;47857;19;696588;29;305386;20874;13015
29244;Saint-Derrien;386;8057634;160364;209;6163660;177;1893974;20875;13016
62177;Brimeux;444;9268505;362064;214;6848524;230;2419981;20875;13017
18030;Blancafort;640;13360101;425403;367;10317309;273;3042792;20875;13018
89164;Festigny;48;1002008;57763;30;834320;18;167688;20875;13019
37260;La Tour-Saint-Gelin;302;6304371;240123;127;4354344;175;1950027;20875;13020
14080;Le Bô;64;1336034;52370;35;1034375;29;301659;20876;13021
24475;Saint-Pantaly-d'Ans;86;1795321;80676;32;1262947;54;532374;20876;13022
25580;Valentigney;5833;121770069;4940546;2969;91064511;2864;30705558;20876;13023
17221;Marsais;483;10083174;479492;224;7397983;259;2685191;20876;13024
77379;Provins;7076;147719721;8482030;3329;113587312;3747;34132409;20876;13025
48104;Nasbinals;278;5803625;300006;134;4267224;144;1536401;20876;13026
50262;La Lande-d'Airou;270;5636643;154945;133;4218856;137;1417787;20876;13027
88119;Crainvilliers;104;2171212;75425;62;1735403;42;435809;20877;13028
53138;Longuefuye;164;3423859;1318;84;2517618;80;906241;20877;13029
06041;Cipières;225;4697381;171845;116;3314768;109;1382613;20877;13030
40245;Roquefort;1142;23841830;902941;610;18112194;532;5729636;20877;13031
22274;Saint-André-des-Eaux;141;2943695;69362;71;2171853;70;771842;20877;13032
54222;Gerbéviller;750;15658237;500894;356;11644645;394;4013592;20878;13033
57635;Schalbach;175;3653724;62830;110;2867409;65;786315;20878;13034
24527;Savignac-les-Églises;540;11274425;427062;262;8348578;278;2925847;20879;13035
43230;Saint-Vincent;543;11337169;355120;299;8640128;244;2697041;20879;13036
79325;Tessonnière;173;3612049;96622;86;2626657;87;985392;20879;13037
25379;Mesmay;41;856059;28298;22;627543;19;228516;20879;13038
71512;Sennecey-le-Grand;1775;37061487;1444874;911;28076411;864;8985076;20880;13039
85152;La Mothe-Achard;1541;32175684;938047;808;24061485;733;8114199;20880;13040
38151;Échirolles;19550;408217504;16682132;10656;319797480;8894;88420024;20881;13041
02539;Nauroy;371;7747294;295918;166;5380331;205;2366963;20882;13042
82068;Gimat;100;2088227;77435;42;1499869;58;588358;20882;13043
02742;Thiernu;74;1545311;94529;31;1128191;43;417120;20883;13044
80140;Brévillers;49;1023255;9176;20;658035;29;365220;20883;13045
09230;Le Pla;37;772664;40748;19;627472;18;145192;20883;13046
31530;Sana;120;2506002;133182;61;1966483;59;539519;20883;13047
60191;Cuvilly;294;6139791;119991;162;4608230;132;1531561;20884;13048
08045;Ballay;150;3132609;115654;76;2383162;74;749447;20884;13049
85247;Saint-Martin-des-Tilleuls;488;10191519;119156;278;7524837;210;2666682;20884;13050
65127;Capvern;758;15830340;550878;412;12151706;346;3678634;20884;13051
79220;Prin-Deyrançon;317;6620363;195725;167;5086077;150;1534286;20884;13052
81088;Fauch;249;5200539;106711;129;3928276;120;1272263;20886;13053
64102;Bayonne;28122;587350245;33609012;14671;466002106;13451;121348139;20886;13054
24154;Douchapt;168;3508939;96496;84;2634484;84;874455;20887;13055
72089;Conlie;1018;21263479;621262;506;15540582;512;5722897;20888;13056
25180;Crouzet-Migette;63;1315932;35988;31;986055;32;329877;20888;13057
44140;La Regrippière;742;15498964;202652;398;11441030;344;4057934;20888;13058
38412;Saint-Laurent-du-Pont;2623;54789717;2072982;1422;43480110;1201;11309607;20888;13059
21354;Longecourt-lès-Culêtre;29;605772;17564;15;452267;14;153505;20889;13060
18100;Genouilly;402;8397254;264277;218;6381370;184;2015884;20889;13061
88348;Pierrepont-sur-l'Arentèle;81;1691985;43875;45;1272762;36;419223;20889;13062
25317;Jallerange;120;2506684;85707;70;1997727;50;508957;20889;13063
38380;Saint-Didier-de-Bizonnes;145;3028921;92565;66;2104669;79;924252;20889;13064
47060;Caudecoste;531;11092257;431494;259;8186253;272;2906004;20889;13065
56190;Réguiny;990;20680567;640711;477;15321151;513;5359416;20889;13066
11281;Pexiora;590;12324841;329089;295;9142659;295;3182182;20890;13067
85262;Saint-Philbert-de-Bouaine;1606;33548905;493120;908;25398661;698;8150244;20890;13068
70296;Larians-et-Munans;127;2653011;63904;71;2086566;56;566445;20890;13069
94041;Ivry-sur-Seine;34028;710840716;42007630;18524;579599192;15504;131241524;20890;13070
19239;Saint-Robert;195;4073644;182143;94;3100853;101;972791;20890;13071
38421;Saint-Martin-d'Hères;18099;378100596;15248283;10161;301703033;7938;76397563;20891;13072
33220;Lamarque;660;13788044;493689;346;10348944;314;3439100;20891;13073
65106;Bourisp;95;1984643;110284;47;1477318;48;507325;20891;13074
40196;Montsoué;293;6121099;202278;169;4959041;124;1162058;20891;13075
22330;Saint-Thélo;221;4616968;103496;101;3277627;120;1339341;20891;13076
49374;Villebernier;729;15230746;384875;374;11283093;355;3947653;20893;13077
07015;Arras-sur-Rhône;251;5244387;115092;123;3795546;128;1448841;20894;13078
76511;Preuseville;76;1588007;85496;34;1145347;42;442660;20895;13079
39086;Cernon;144;3008960;138407;73;2332195;71;676765;20896;13080
57278;Guinzeling;37;773165;12756;22;618080;15;155085;20896;13081
56197;Le Roc-Saint-André;534;11158684;348813;268;8210940;266;2947744;20896;13082
30340;Valliguières;282;5892901;197636;148;4506009;134;1386892;20897;13083
83121;Salernes;2526;52785452;2793854;1225;40652957;1301;12132495;20897;13084
05063;La Grave;286;5976542;258962;147;4487317;139;1489225;20897;13085
81210;Poudis;126;2633028;106261;68;2016297;58;616731;20897;13086
88438;La Salle;214;4472178;109912;125;3442015;89;1030163;20898;13087
55251;Ippécourt;54;1128505;44555;25;752792;29;375713;20898;13088
55396;Ourches-sur-Meuse;113;2361506;89352;63;1826435;50;535071;20898;13089
02423;Leuilly-sous-Coucy;221;4618531;132454;104;3197665;117;1420866;20898;13090
01214;Leyssard;100;2089866;57363;63;1748945;37;340921;20899;13091
76363;Hodeng-au-Bosc;325;6792212;225287;188;5394485;137;1397727;20899;13092
22236;Pludual;400;8359650;281002;210;6305482;190;2054168;20899;13093
36082;Gehée;156;3260264;182222;67;2261173;89;999091;20899;13094
39239;La Frasnée;25;522487;18045;12;396259;13;126228;20899;13095
76074;La Bellière;33;689683;17818;22;585867;11;103816;20899;13096
12289;Valzergues;123;2570654;89027;61;1891972;62;678682;20900;13097
44141;La Remaudière;614;12832450;234408;340;9602118;274;3230332;20900;13098
08150;Écly;102;2131789;86352;51;1653256;51;478533;20900;13099
62057;Audruicq;2654;55469051;2086472;1241;41088600;1413;14380451;20900;13100
12300;Villefranche-de-Rouergue;7047;147283796;7548700;3472;113338969;3575;33944827;20900;13101
61196;Le Gué-de-la-Chaîne;406;8485530;275654;212;6305546;194;2179984;20900;13102
72163;Ligron;230;4807098;91135;115;3574613;115;1232485;20900;13103
32263;Moncassin;74;1546640;69744;39;1228625;35;318015;20901;13104
71013;Authumes;141;2947086;80367;67;2106146;74;840940;20901;13105
55581;Willeroncourt;65;1358610;31736;38;1046836;27;311774;20902;13106
85187;Réaumur;422;8820615;183095;231;6638667;191;2181948;20902;13107
70482;Scey-sur-Saône-et-Saint-Albin;918;19188012;743788;476;14452078;442;4735934;20902;13108
81318;Villeneuve-lès-Lavaur;90;1881217;113452;33;1363143;57;518074;20902;13109
46237;Reyrevignes;176;3678876;111904;102;2900912;74;777964;20903;13110
27134;Cauverville-en-Roumois;114;2382933;46850;66;1864686;48;518247;20903;13111
33261;Lussac;735;15363771;694260;378;11996003;357;3367768;20903;13112
21177;Clamerey;117;2445664;95865;60;1846323;57;599341;20903;13113
76195;Criquetot-le-Mauconduit;89;1860397;50417;45;1368405;44;491992;20903;13114
56140;Moréac;1933;40406315;1052680;1017;30310093;916;10096222;20903;13115
14179;Cordebugle;80;1672298;53403;44;1345930;36;326368;20904;13116
80214;Coullemelle;171;3574554;172387;82;2566351;89;1008203;20904;13117
26268;Rochebaudin;66;1379658;57539;28;980841;38;398817;20904;13118
01022;Artemare;691;14444609;520281;372;10918682;319;3525927;20904;13119
55075;Brauvilliers;86;1797787;65443;43;1302545;43;495242;20905;13120
85013;Bazoges-en-Paillers;626;13086507;139792;386;10128007;240;2958500;20905;13121
37145;Marcé-sur-Esves;143;2989429;144594;73;2250512;70;738917;20905;13122
50478;Saint-Germain-de-Tournebut;223;4662045;187067;117;3562030;106;1100015;20906;13123
36104;Lurais;153;3198624;115250;85;2512611;68;686013;20906;13124
79297;Sainte-Soline;197;4118551;139716;94;2998764;103;1119787;20906;13125
36058;Concremiers;378;7902692;302779;193;6012263;185;1890429;20907;13126
36124;Migné;161;3366043;143598;68;2333647;93;1032396;20907;13127
57631;Sarreguemines;12950;270748481;15038400;6103;208841904;6847;61906577;20907;13128
50507;Saint-Marcouf;199;4160631;167045;105;3213786;94;946845;20908;13129
59093;Boulogne-sur-Helpe;177;3700720;98608;95;2938211;82;762509;20908;13130
50335;Montaigu-la-Brisette;261;5457023;171429;146;4235912;115;1221111;20908;13131
72017;Auvers-sous-Montfaucon;119;2488071;47130;59;1753599;60;734472;20908;13132
80709;Saint-Maulvis;143;2989881;101227;77;2439357;66;550524;20908;13133
65042;Asté;331;6920745;243702;182;5367655;149;1553090;20909;13134
49233;Nyoiseau;650;13591018;287381;351;10028253;299;3562765;20909;13135
62632;Oblinghem;127;2655507;91662;67;2096191;60;559316;20910;13136
14052;Beaulieu;100;2090955;73720;57;1655166;43;435789;20910;13137
11267;Ornaisons;651;13612389;578599;326;10482931;325;3129458;20910;13138
58158;Mars-sur-Allier;158;3304117;96528;81;2512934;77;791183;20912;13139
25479;Rang;236;4935403;164467;125;3609130;111;1326273;20913;13140
28348;Saint-Lubin-des-Joncherets;2279;47660893;1823747;1237;36358757;1042;11302136;20913;13141
87103;Nantiat;965;20181174;773309;481;14848947;484;5332227;20913;13142
83126;La Seyne-sur-Mer;38447;804049423;35508246;20042;630832752;18405;173216671;20913;13143
86130;Leugny;247;5165898;171919;114;3787180;133;1378718;20915;13144
65300;Marsas;39;815671;27050;23;611566;16;204105;20915;13145
62071;Bailleul-lès-Pernes;204;4266595;140045;96;3091862;108;1174733;20915;13146
22039;La Chèze;331;6922773;314085;161;5140137;170;1782636;20915;13147
89441;Vermenton;724;15142380;666275;369;11671642;355;3470738;20915;13148
44015;Blain;5016;104910253;3080669;2605;78930672;2411;25979581;20915;13149
62209;Canlers;96;2007922;96030;43;1417382;53;590540;20916;13150
2B167;Montegrosso;245;5124385;299597;117;4021970;128;1102415;20916;13151
46119;Gigouzac;147;3074733;150861;77;2475602;70;599131;20917;13152
17307;Sablonceaux;737;15415592;542493;387;11807872;350;3607720;20917;13153
31336;Mazères-sur-Salat;346;7237362;295250;187;5529150;159;1708212;20917;13154
03144;Liernolles;126;2635577;148624;48;1911275;78;724302;20917;13155
80095;Bertrancourt;122;2551922;91186;63;1874113;59;677809;20917;13156
88347;Pierrefitte;62;1296897;20494;33;881807;29;415090;20918;13157
17166;Forges;649;13575623;273497;362;10255328;287;3320295;20918;13158
76510;Prétot-Vicquemare;88;1840793;48124;42;1317815;46;522978;20918;13159
19275;Ussel;5826;121869497;5713275;3109;94053395;2717;27816102;20918;13160
59049;Bantouzelle;203;4246431;145733;106;3204179;97;1042252;20918;13161
25388;Montbéliard;14327;299698975;17032622;7028;232873877;7299;66825098;20918;13162
31213;Garin;90;1882678;69989;56;1544448;34;338230;20919;13163
85220;Saint-Germain-de-Prinçay;777;16253816;397708;427;12294256;350;3959560;20919;13164
11420;Villebazy;65;1359719;59110;30;1042251;35;317468;20919;13165
55584;Woimbey;68;1422485;49063;32;1007360;36;415125;20919;13166
04087;Fontienne;75;1568926;47597;35;1144818;40;424108;20919;13167
82160;Saint-Clair;141;2949584;100010;64;2163135;77;786449;20919;13168
47239;Saint-Étienne-de-Fougères;444;9288158;204375;222;6514893;222;2773265;20919;13169
53210;Saint-Denis-d'Anjou;825;17258885;628374;387;12519054;438;4739831;20920;13170
33285;Mombrier;224;4686112;190899;128;3737382;96;948730;20920;13171
46084;Creysse;177;3702872;159553;102;2951982;75;750890;20920;13172
24064;Brantôme;1351;28263366;1274601;655;21309753;696;6953613;20920;13173
05013;Barcillonnette;95;1987476;83465;43;1529577;52;457899;20921;13174
40059;Cagnotte;391;8180537;182388;196;6111907;195;2068630;20922;13175
25183;Cusance;41;857811;26573;17;547238;24;310573;20922;13176
57567;Rémelfang;94;1966740;61897;39;1321649;55;645091;20923;13177
47132;Lalandusse;110;2301546;122145;49;1660009;61;641537;20923;13178
33476;Saint-Seurin-de-Cadourne;401;8390495;362686;213;6521597;188;1868898;20924;13179
06119;Saint-Dalmas-le-Selvage;44;920654;28924;26;772698;18;147956;20924;13180
03020;Beaune-d'Allier;177;3703542;177645;85;2778438;92;925104;20924;13181
02792;Veuilly-la-Poterie;77;1611151;55502;43;1274210;34;336941;20924;13182
66133;Palau-del-Vidre;1637;34252896;1229204;781;25384480;856;8868416;20924;13183
36032;Ceaulmont;421;8809195;297776;222;6636383;199;2172812;20924;13184
62284;Écourt-Saint-Quentin;973;20360067;719330;491;15295913;482;5064154;20925;13185
57308;Hazembourg;59;1234632;18331;32;879523;27;355109;20926;13186
62021;Alette;178;3724864;107621;89;2761580;89;963284;20926;13187
60193;Daméraucourt;119;2490235;79528;68;1921882;51;568353;20926;13188
70504;Traves;212;4436527;158515;124;3448311;88;988216;20927;13189
15163;Roannes-Saint-Mary;575;12033040;274481;328;9547960;247;2485080;20927;13190
37088;Couziers;68;1423062;47432;36;1162923;32;260139;20927;13191
50224;Guilberville;569;11907844;280521;313;9214191;256;2693653;20928;13192
17075;Cabariot;728;15235414;482709;378;11406633;350;3828781;20928;13193
07199;Rosières;687;14377534;451996;323;10852646;364;3524888;20928;13194
40295;Saugnacq-et-Muret;498;10422149;454105;225;7534414;273;2887735;20928;13195
64428;Orriule;75;1569617;76753;36;1186151;39;383466;20928;13196
79172;Mazières-en-Gâtine;575;12033945;481143;293;9042253;282;2991692;20929;13197
46145;Lachapelle-Auzac;456;9543481;305623;235;7083323;221;2460158;20929;13198
60214;Ernemont-Boutavent;107;2239426;81909;51;1660145;56;579281;20929;13199
80324;Fontaine-le-Sec;90;1883639;76647;50;1490298;40;393341;20929;13200
62470;Incourt;47;983685;38048;27;802612;20;181073;20929;13201
49169;La Jumellière;669;14002022;239272;327;10005745;342;3996277;20930;13202
05116;Réotier;122;2553549;76619;67;1982097;55;571452;20931;13203
32118;Durban;89;1862898;60256;42;1405836;47;457062;20931;13204
60389;Maucourt;114;2386188;62796;73;1918804;41;467384;20931;13205
17042;Bercloux;236;4939931;130835;111;3658204;125;1281727;20932;13206
76422;Melleville;151;3160721;162890;77;2350898;74;809823;20932;13207
24182;Le Fleix;810;16954888;661504;400;12785394;410;4169494;20932;13208
08390;Sainte-Marie;43;900084;21273;24;655572;19;244512;20932;13209
15119;Massiac;1116;23361109;962183;516;17291251;600;6069858;20933;13210
81288;Sorèze;1579;33053752;1386995;747;24706774;832;8346978;20933;13211
39194;Desnes;259;5421746;180058;133;4015526;126;1406220;20933;13212
28280;Nogent-le-Rotrou;6219;130186971;6233171;3291;100372239;2928;29814732;20934;13213
47122;Labretonie;99;2072460;53301;51;1635156;48;437304;20934;13214
16263;Plassac-Rouffiac;209;4375199;111812;110;3303915;99;1071284;20934;13215
62082;Barastre;150;3140216;78704;83;2469694;67;670522;20935;13216
31543;Sénarens;54;1130487;47423;25;828914;29;301573;20935;13217
89165;Flacy;67;1402650;55640;41;1161360;26;241290;20935;13218
71009;Anost;423;8855643;407451;212;6578113;211;2277530;20935;13219
30169;Milhaud;3137;65675244;2589105;1628;50316910;1509;15358334;20936;13220
38562;Vizille;4545;95152820;3528503;2606;74871018;1939;20281802;20936;13221
50438;La Ronde-Haye;181;3789366;86834;91;2771217;90;1018149;20936;13222
46202;Montdoumerc;266;5569162;175364;120;4059225;146;1509937;20937;13223
59552;Sancourt;107;2240230;69268;60;1744146;47;496084;20937;13224
32133;Fourcès;174;3643063;211253;77;2697856;97;945207;20937;13225
41018;Blois;27039;566124570;29735565;14238;451129762;12801;114994808;20937;13226
57395;Lesse;101;2114693;43393;47;1391157;54;723536;20938;13227
2B315;Santo-Pietro-di-Venaco;144;3015064;158205;78;2425976;66;589088;20938;13228
41257;Thenay;470;9841435;327064;248;7340172;222;2501263;20939;13229
08488;Vivier-au-Court;1616;33837979;1578942;765;25730669;851;8107310;20939;13230
53061;Charchigné;237;4962748;119173;132;3821571;105;1141177;20940;13231
58312;Villiers-sur-Yonne;176;3685443;121275;92;2695277;84;990166;20940;13232
51033;Le Baizil;146;3057289;89018;85;2453870;61;603419;20940;13233
50320;Le Mesnil-Rogues;83;1738055;22394;34;1133946;49;604109;20940;13234
62848;Verquin;1865;39054362;1406538;949;29185737;916;9868625;20941;13235
82185;Valeilles;119;2491970;106294;53;1893021;66;598949;20941;13236
62531;Louches;485;10156606;336512;234;7545941;251;2610665;20941;13237
11399;Tréville;56;1172756;41571;30;854152;26;318604;20942;13238
48034;La Canourgue;1110;23246212;875781;538;17253871;572;5992341;20943;13239
39206;Écleux;108;2261818;51459;60;1699343;48;562475;20943;13240
36003;Ambrault;460;9633747;314657;265;7140749;195;2492998;20943;13241
64349;Loubieng;243;5089299;155906;123;3885484;120;1203815;20944;13242
33366;Saint-André-de-Cubzac;5783;121116949;4902534;3117;94183520;2666;26933429;20944;13243
39253;Gigny;147;3078761;83974;78;2395053;69;683708;20944;13244
89309;Pont-sur-Yonne;1966;41176467;1818988;1072;32067813;894;9108654;20944;13245
43041;Brives-Charensac;2571;53847911;2404364;1323;40880141;1248;12967770;20944;13246
04151;Pierrerue;311;6513786;224941;164;5022700;147;1491086;20945;13247
55420;Récourt-le-Creux;44;921570;29807;18;595572;26;325998;20945;13248
05122;La Roche-de-Rame;468;9802198;299826;250;7313243;218;2488955;20945;13249
61445;Saint-Pierre-d'Entremont;377;7896264;219450;216;6044623;161;1851641;20945;13250
08416;Seuil;97;2031691;76304;61;1730837;36;300854;20945;13251
09052;Besset;85;1780363;65575;46;1371510;39;408853;20945;13252
76258;Fauville-en-Caux;1286;26935921;1015843;633;20222136;653;6713785;20946;13253
33337;Preignac;1226;25679598;1175381;622;20287148;604;5392450;20946;13254
57267;Le Val-de-Guéblange;488;10221896;382245;224;7132101;264;3089795;20947;13255
36036;Chalais;96;2010897;32991;43;1487244;53;523653;20947;13256
17096;Chaunac;40;837875;25597;20;649618;20;188257;20947;13257
57103;Bousseviller;70;1466300;54439;37;1100286;33;366014;20947;13258
09159;Lassur;39;816944;29573;23;675332;16;141612;20947;13259
31097;Le Cabanial;197;4126664;170567;100;3062996;97;1063668;20948;13260
10004;Allibaudières;121;2534670;100671;59;1886099;62;648571;20948;13261
36158;Badecon-le-Pin;451;9447458;428463;217;6832521;234;2614937;20948;13262
63317;Saint-André-le-Coq;290;6074875;206167;144;4617721;146;1457154;20948;13263
61109;Clairefougère;64;1340664;22613;34;1004548;30;336116;20948;13264
64015;Alçay-Alçabéhéty-Sunharette;109;2283380;76180;54;1694233;55;589147;20948;13265
36218;Sougé;97;2032029;90217;40;1373578;57;658451;20949;13266
42138;Maringes;328;6871269;118981;168;4826547;160;2044722;20949;13267
01185;Hauteville-Lompnes;2003;41961311;1723522;1145;33671752;858;8289559;20949;13268
27500;Routot;769;16110166;548392;381;11668375;388;4441791;20950;13269
44139;Quilly;656;13743018;318729;348;10251171;308;3491847;20950;13270
44030;La Chapelle-des-Marais;2047;42884851;944367;1123;32025208;924;10859643;20950;13271
64334;Léren;116;2430240;61004;57;1850748;59;579492;20950;13272
62030;Amplier;164;3435926;109395;91;2668462;73;767464;20951;13273
02600;Pierrepont;200;4190161;130091;95;2987547;105;1202614;20951;13274
21717;Voulaines-les-Templiers;184;3854990;210557;84;2925161;100;929829;20951;13275
40190;Monségur;209;4378828;101955;109;3346735;100;1032093;20951;13276
71044;Bosjean;178;3729375;134341;96;2902232;82;827143;20952;13277
33251;Louchats;348;7291225;254009;167;5469216;181;1822009;20952;13278
49257;Les Rairies;528;11062607;299024;279;8223034;249;2839573;20952;13279
03146;Limoise;82;1718098;56077;38;1301714;44;416384;20952;13280
04136;La Mure-Argens;188;3939118;157800;106;3134854;82;804264;20953;13281
81313;Le Verdier;128;2681991;73954;61;2047559;67;634432;20953;13282
17158;Ferrières;396;8297494;206843;233;6461291;163;1836203;20953;13283
19046;Chapelle-Spinasse;73;1529597;102808;33;1097125;40;432472;20953;13284
29030;Cléder;2230;46729699;1439060;1070;34083769;1160;12645930;20955;13285
12107;Gaillac-d'Aveyron;173;3625234;80184;75;2582463;98;1042771;20955;13286
26303;Sainte-Euphémie-sur-Ouvèze;46;963949;23198;19;708559;27;255390;20955;13287
17332;Saint-Georges-Antignac;231;4840773;281838;105;3665657;126;1175116;20956;13288
13096;Saintes-Maries-de-la-Mer;1931;40466365;2164915;948;31484114;983;8982251;20956;13289
50609;Turqueville;80;1676498;50289;40;1166290;40;510208;20956;13290
08070;Blanzy-la-Salonnaise;170;3562566;72548;77;2408068;93;1154498;20956;13291
63052;Le Breuil-sur-Couze;558;11694174;396800;292;8871533;266;2822641;20957;13292
65043;Astugue;108;2263395;69251;57;1733770;51;529625;20957;13293
59353;Locquignol;185;3877370;167554;92;2927531;93;949839;20959;13294
57424;Lucy;116;2431270;81372;65;1857022;51;574248;20959;13295
31565;Valentine;525;11004066;492865;254;8117581;271;2886485;20960;13296
64341;Lichos;75;1572033;36886;46;1228544;29;343489;20960;13297
55574;Vouthon-Bas;33;691707;32516;14;492273;19;199434;20961;13298
38265;La Motte-d'Aveillans;1037;21737396;699412;572;16564385;465;5173011;20962;13299
41229;Saint-Romain-sur-Cher;844;17691988;522272;472;13508158;372;4183830;20962;13300
24066;Brouchaud;126;2641232;99969;65;2089382;61;551850;20962;13301
85242;Saint-Mars-la-Réorthe;513;10753701;247710;292;8105862;221;2647839;20962;13302
08200;Grivy-Loisy;108;2263947;89782;62;1753190;46;510757;20962;13303
2A090;Coggia;440;9223534;498343;208;7086856;232;2136678;20963;13304
67524;Weiterswiller;293;6142074;148621;159;4547671;134;1594403;20963;13305
11289;Pieusse;548;11487620;402228;285;8707877;263;2779743;20963;13306
32327;Pouy-Loubrin;50;1048183;44347;20;694093;30;354090;20964;13307
62382;Gouy-Saint-André;337;7064835;230918;152;5121612;185;1943223;20964;13308
51060;Bignicourt-sur-Saulx;98;2054518;71062;53;1482759;45;571759;20964;13309
56017;Bignan;1488;31195380;909476;829;24293844;659;6901536;20965;13310
11087;Cazalrenoux;47;985342;3042;20;754033;27;231309;20965;13311
02065;Bellicourt;332;6960388;210700;170;5376776;162;1583612;20965;13312
82079;Labastide-Saint-Pierre;1888;39582045;1345185;907;29179234;981;10402811;20965;13313
30334;Uzès;5551;116379077;6948898;2535;90193771;3016;26185306;20965;13314
54519;Thiaville-sur-Meurthe;289;6059137;123853;165;4659579;124;1399558;20966;13315
61361;Saint-André-de-Briouze;100;2096654;81913;52;1584996;48;511658;20967;13316
33383;Saint-Christoly-Médoc;189;3962769;338695;84;3035241;105;927528;20967;13317
59289;Haussy;849;17801024;757336;382;12986307;467;4814717;20967;13318
02555;Nogent-l'Artaud;1197;25097605;966366;645;19291538;552;5806067;20967;13319
59224;Féchain;1042;21847803;1009199;503;16752751;539;5095052;20967;13320
50295;Maupertuis;71;1488688;66177;33;1072692;38;415996;20967;13321
18118;Jouet-sur-l'Aubois;842;17654745;652336;442;13143045;400;4511700;20968;13322
44199;Soudan;1109;23253374;762562;554;17204083;555;6049291;20968;13323
52022;Aubepierre-sur-Aube;113;2369409;138671;50;1751372;63;618037;20968;13324
49171;La Lande-Chasles;60;1258114;32042;33;987713;27;270401;20969;13325
36171;Reuilly;1190;24952753;872252;621;18681558;569;6271195;20969;13326
24586;Villetoureix;497;10421726;357484;247;7857460;250;2564266;20969;13327
34051;Canet;1738;36444917;1101144;831;27105506;907;9339411;20969;13328
50381;Notre-Dame-du-Touchet;337;7066757;182482;162;4994725;175;2072032;20970;13329
80146;Brutelles;100;2096965;56521;50;1573580;50;523385;20970;13330
69181;Saint-Appolinaire;99;2076013;65804;55;1670010;44;406003;20970;13331
01023;Asnières-sur-Saône;46;964633;47874;30;805904;16;158729;20970;13332
67321;Neuviller-la-Roche;199;4173313;107513;107;3140298;92;1033015;20971;13333
41097;Gièvres;1153;24180336;995376;635;18890050;518;5290286;20972;13334
73147;Loisieux;115;2411802;91078;64;1916194;51;495608;20972;13335
26116;Donzère;2818;59100189;1875972;1451;44142520;1367;14957669;20972;13336
04100;Larche;27;566263;14418;12;419826;15;146437;20973;13337
39278;Largillay-Marsonnay;92;1929494;60411;57;1535064;35;394430;20973;13338
88016;Attigny;138;2894356;93740;76;2254476;62;639880;20974;13339
32085;Castet-Arrouy;88;1845697;42954;35;1290763;53;554934;20974;13340
13067;Orgon;1646;34522956;1711827;737;26091592;909;8431364;20974;13341
39518;Songeson;40;838960;15751;15;513229;25;325731;20974;13342
35154;Livré-sur-Changeon;794;16654459;378607;396;12241966;398;4412493;20975;13343
39333;Moirans-en-Montagne;1141;23933305;720503;604;17809708;537;6123597;20976;13344
64499;Salies-de-Béarn;3034;63640371;2803796;1461;47669594;1573;15970777;20976;13345
33043;Bellebat;118;2475177;64670;62;1856463;56;618714;20976;13346
80822;Warsy;69;1447378;60677;39;1132866;30;314512;20976;13347
13089;Saint-Andiol;1737;36436168;1402067;809;27010507;928;9425661;20976;13348
46018;Le Bastit;81;1699097;125650;32;1204266;49;494831;20977;13349
65448;Tournous-Darré;47;985901;48758;19;705013;28;280888;20977;13350
57182;Donjeux;50;1048833;27517;27;756078;23;292755;20977;13351
55415;Ranzières;40;839080;10693;24;672247;16;166833;20977;13352
12130;Livinhac-le-Haut;688;14432389;440877;345;10424740;343;4007649;20977;13353
22315;Saint-Maudez;153;3209545;42092;73;2170920;80;1038625;20977;13354
52355;Noidant-le-Rocheux;110;2307528;94451;61;1799078;49;508450;20978;13355
71208;Frontenard;128;2685163;78735;64;2043222;64;641941;20978;13356
33270;Marimbault;91;1908991;33912;41;1297029;50;611962;20978;13357
86044;Ceaux-en-Loudun;349;7321335;254140;161;5242660;188;2078675;20978;13358
88488;Valfroicourt;143;2999913;124849;76;2325384;67;674529;20978;13359
08401;Saulces-Champenoises;124;2601349;71906;58;1834582;66;766767;20979;13360
48121;Prunières;133;2790183;76704;74;2227447;59;562736;20979;13361
58245;Saint-Hilaire-Fontaine;115;2412637;134698;60;1896866;55;515771;20979;13362
30257;Saint-Gervasy;906;19007535;525819;467;14313589;439;4693946;20980;13363
70353;Montagney;289;6063151;197286;139;4530692;150;1532459;20980;13364
04126;Montclar;240;5035194;141201;125;3853910;115;1181284;20980;13365
56010;Baud;3377;70849841;2346458;1798;53901961;1579;16947880;20980;13366
27499;La Roussière;106;2223896;75790;53;1695451;53;528445;20980;13367
22196;Pleudaniel;526;11035662;393229;246;7802705;280;3232957;20980;13368
81301;Le Travet;61;1279810;30623;25;818299;36;461511;20980;13369
22174;Pléboulle;404;8476446;232369;210;6204338;194;2272108;20981;13370
14121;Cahagnolles;130;2727574;49506;65;1967506;65;760068;20981;13371
06116;Saint-Auban;120;2517768;130658;65;1985653;55;532115;20981;13372
12160;Mostuéjouls;194;4070393;221436;93;2908467;101;1161926;20981;13373
88492;Le Valtin;55;1153996;42053;29;894954;26;259042;20982;13374
43240;Solignac-sous-Roche;118;2475865;117434;63;1892871;55;582994;20982;13375
02492;Monceau-lès-Leups;243;5098617;159677;130;3875651;113;1222966;20982;13376
17428;Sonnac;295;6189750;220601;136;4579184;159;1610566;20982;13377
49179;Le Longeron;1134;23794119;353512;639;17842351;495;5951768;20982;13378
25095;Bretonvillers;137;2874641;85858;65;2117935;72;756706;20983;13379
87191;Séreilhac;989;20752862;651764;539;16445937;450;4306925;20984;13380
02093;Blérancourt;688;14437263;905069;337;11063206;351;3374057;20984;13381
69099;Haute-Rivoire;734;15403073;382567;375;11598201;359;3804872;20985;13382
76744;Villers-sous-Foucarmont;111;2329372;81905;52;1672593;59;656779;20985;13383
34230;Les Rives;72;1511002;57952;33;1123109;39;387893;20986;13384
49010;Armaillé;151;3168921;63498;92;2600163;59;568758;20986;13385
06145;Tourette-du-Château;57;1196238;56120;31;921289;26;274949;20987;13386
03173;Molinet;638;13389782;445042;324;10060317;314;3329465;20987;13387
59081;Bévillers;309;6485083;283149;157;4975201;152;1509882;20987;13388
88387;Removille;118;2476520;94197;57;1785781;61;690739;20987;13389
29008;Beuzec-Cap-Sizun;613;12865368;353012;317;9387024;296;3478344;20988;13390
79247;Saint-Étienne-la-Cigogne;75;1574069;22769;44;1148141;31;425928;20988;13391
83032;Carcès;1983;41619237;1970609;954;31774321;1029;9844916;20988;13392
58025;Béard;91;1909915;60400;52;1448118;39;461797;20988;13393
01437;Vescours;110;2308741;55152;54;1639312;56;669429;20989;13394
55562;Villers-le-Sec;96;2014921;71650;53;1556363;43;458558;20989;13395
55503;Taillancourt;67;1406273;33727;35;1039832;32;366441;20989;13396
50129;Cherbourg-Octeville;21637;454149676;23911614;10854;358272882;10783;95876794;20989;13397
85179;Poiroux;505;10599747;245379;274;8049655;231;2550092;20990;13398
81155;Marsal;166;3484363;184094;88;2752558;78;731805;20990;13399
52034;Bailly-aux-Forges;75;1574270;32738;38;1154462;37;419808;20990;13400
60636;Thourotte;2670;56045494;2143232;1437;43441112;1233;12604382;20991;13401
50050;Beuvrigny;65;1364426;31604;39;1082747;26;281679;20991;13402
33148;Dardenac;52;1091548;15869;24;713408;28;378140;20991;13403
63393;Saint-Rémy-sur-Durolle;1024;21495212;886349;515;16175969;509;5319243;20991;13404
71092;La Chapelle-Naude;294;6171602;235019;147;4715459;147;1456143;20992;13405
64449;Poey-d'Oloron;99;2078197;79963;53;1647401;46;430796;20992;13406
54154;Deneuvre;304;6381642;235600;162;4946101;142;1435541;20992;13407
42015;Belmont-de-la-Loire;858;18011359;695007;412;13046738;446;4964621;20992;13408
63017;Augnat;88;1847327;82096;51;1491024;37;356303;20992;13409
01283;Oyonnax;11923;250294628;10732306;5860;185336872;6063;64957756;20993;13410
42117;Lavieu;56;1175589;31073;29;877700;27;297889;20993;13411
80396;Gueschart;176;3694748;142367;88;2754044;88;940704;20993;13412
72252;Requeil;584;12259870;196976;327;9109282;257;3150588;20993;13413
38322;Presles;51;1070643;43714;26;810832;25;259811;20993;13414
56061;La Gacilly;1350;28340933;981147;705;21633422;645;6707511;20993;13415
02498;Montaigu;405;8502330;283692;204;6323752;201;2178578;20993;13416
89436;Venizy;507;10643670;341490;281;8255156;226;2388514;20993;13417
64479;Saint-Girons-en-Béarn;86;1805460;11106;48;1300969;38;504491;20994;13418
37042;Candes-Saint-Martin;158;3317163;169007;73;2487930;85;829233;20995;13419
40110;Geaune;422;8860053;452465;175;6554206;247;2305847;20995;13420
49034;Botz-en-Mauges;398;8356199;65418;209;5761221;189;2594978;20995;13421
25538;Séchin;59;1238743;26998;29;849325;30;389418;20996;13422
61215;Laleu;201;4220200;166042;104;3315688;97;904512;20996;13423
14717;Truttemer-le-Grand;331;6949806;179165;178;5327427;153;1622379;20996;13424
14188;Coulvain;189;3968343;56356;105;2938941;84;1029402;20997;13425
61051;Boitron;163;3422461;79675;86;2621452;77;801009;20997;13426
05170;Tallard;1099;23075629;830331;589;17762836;510;5312793;20997;13427
70050;La Barre;43;902871;19849;22;679289;21;223582;20997;13428
21085;Bligny-le-Sec;96;2015728;72095;52;1508733;44;506995;20997;13429
66167;Saillagouse;583;12241674;518716;303;9662935;280;2578739;20998;13430
33105;Castelviel;100;2099826;51537;48;1472782;52;627044;20998;13431
09015;Arignac;380;7979373;258282;191;5913228;189;2066145;20998;13432
54511;Sponville;70;1469926;43618;31;921599;39;548327;20999;13433
12123;Lapanouse;420;8819700;271015;238;6739485;182;2080215;20999;13434
50108;Céaux;226;4745858;142536;112;3382916;114;1362942;20999;13435
70519;Vandelans;57;1196965;22422;28;860409;29;336556;20999;13436
80199;Cléry-sur-Somme;300;6299885;237093;149;4690481;151;1609404;21000;13437
55132;Cousances-les-Forges;933;19592928;673859;485;14689205;448;4903723;21000;13438
22011;Boqueho;532;11171960;218906;269;8165039;263;3006921;21000;13439
02122;Brie;29;609012;28834;14;479543;15;129469;21000;13440
36219;Tendu;335;7035290;184644;197;5401454;138;1633836;21001;13441
11196;Laurac;91;1911140;64136;48;1476040;43;435100;21002;13442
09170;Lissac;105;2205166;81286;51;1669258;54;535908;21002;13443
62541;Maisoncelle;57;1197095;4933;23;781100;34;415995;21002;13444
24059;Bourgnac;193;4053431;240038;87;3023558;106;1029873;21002;13445
89016;Argentenay;53;1113130;43905;26;800833;27;312297;21002;13446
72102;Courcival;49;1029121;37195;27;842500;22;186621;21002;13447
88284;Mandray;346;7267214;311992;185;5555081;161;1712133;21004;13448
85092;Fontenay-le-Comte;7990;167819232;7712950;3710;127657677;4280;40161555;21004;13449
62403;Hallines;682;14324514;533592;369;10861811;313;3462703;21004;13450
71262;Longepierre;111;2331466;69265;53;1675845;58;655621;21004;13451
37128;Lignières-de-Touraine;641;13463943;365964;359;10453813;282;3010130;21005;13452
72046;Le Breil-sur-Mérize;804;16887896;461514;455;13013421;349;3874475;21005;13453
31451;Revel;5501;115547657;5179389;2584;87514066;2917;28033591;21005;13454
04061;Colmars;256;5377293;278277;134;4240147;122;1137146;21005;13455
17354;Saint-Léger;325;6826678;194428;177;5253896;148;1572782;21005;13456
71266;Lucenay-l'Évêque;191;4012081;127746;92;2985749;99;1026332;21006;13457
54259;Herbéviller;118;2478679;50673;64;1854803;54;623876;21006;13458
56219;Saint-Guyomard;620;13023568;233374;350;9752227;270;3271341;21006;13459
33146;Cussac-Fort-Médoc;1063;22329654;551200;575;16659815;488;5669839;21006;13460
65447;Tournay;770;16174937;685205;401;12441246;369;3733691;21006;13461
11325;Rouffiac-d'Aude;229;4810572;224636;118;3657838;111;1152734;21007;13462
76136;Brachy;415;8718068;287939;229;6651671;186;2066397;21007;13463
86142;Maillé;288;6050161;149975;145;4243110;143;1807051;21008;13464
49037;Le Bourg-d'Iré;415;8718195;155063;221;6519497;194;2198698;21008;13465
69041;La Chapelle-de-Mardore;117;2457902;56076;66;1920371;51;537531;21008;13466
52362;Orbigny-au-Mont;90;1890732;55468;52;1513671;38;377061;21008;13467
24450;Saint-Martial-de-Nabirat;359;7541958;273521;194;5862475;165;1679483;21008;13468
27547;Saint-Germain-la-Campagne;495;10399358;623362;233;7790095;262;2609263;21009;13469
21403;Ménessaire;47;987415;37403;25;722244;22;265171;21009;13470
60555;Rouvroy-les-Merles;26;546231;11190;12;390444;14;155787;21009;13471
52180;Droyes;224;4706240;153470;119;3661819;105;1044421;21010;13472
50281;La Lucerne-d'Outremer;451;9475553;359431;197;6646461;254;2829092;21010;13473
60096;Boutavent;52;1092525;53166;28;840745;24;251780;21010;13474
15101;Laveissière;329;6912436;229032;175;5199239;154;1713197;21010;13475
61150;Échauffour;454;9538824;529876;208;7304561;246;2234263;21011;13476
79170;Mauzé-sur-le-Mignon;1561;32798565;1224417;753;24117095;808;8681470;21011;13477
49163;Jarzé;958;20128932;620498;480;15084976;478;5043956;21011;13478
52446;Saint-Broingt-les-Fosses;120;2521377;53893;60;1836583;60;684794;21011;13479
40227;Pissos;843;17713284;837043;408;13319165;435;4394119;21012;13480
72243;Pontvallain;843;17713414;466613;422;12955708;421;4757706;21012;13481
97411;Saint-Denis;80692;1695553250;80292691;29771;1274170262;50921;421382988;21013;13482
65037;Artiguemy;49;1029625;29721;26;759008;23;270617;21013;13483
47222;La Réunion;284;5967631;188644;145;4664040;139;1303591;21013;13484
62439;Hermelinghen;167;3509145;89467;88;2578072;79;931073;21013;13485
02570;Ollezy;82;1723098;37164;41;1258636;41;464462;21013;13486
30002;Aigremont;335;7039596;189732;177;5358121;158;1681475;21014;13487
89152;Épineau-les-Voves;374;7859225;225692;233;6381330;141;1477895;21014;13488
73205;Le Pontet;81;1702134;51044;41;1220955;40;481179;21014;13489
58055;Champvert;480;10086816;356896;285;7892148;195;2194668;21014;13490
05168;Sigoyer;413;8678895;368350;207;6731027;206;1947868;21014;13491
33040;Béguey;625;13134195;501395;328;10064149;297;3070046;21015;13492
32264;Monclar;110;2311674;90931;52;1720666;58;591008;21015;13493
73168;Montgilbert;70;1471088;48754;45;1151751;25;319337;21016;13494
24520;Sarlat-la-Canéda;6176;129794627;6039618;3078;99936021;3098;29858606;21016;13495
34313;Tressan;301;6325814;203128;148;4828606;153;1497208;21016;13496
42177;Pouilly-sous-Charlieu;1500;31524021;1007682;772;23496226;728;8027795;21016;13497
57484;Morsbach;1481;31125024;1157672;763;23381595;718;7743429;21016;13498
50512;Saint-Martin-de-Bonfossé;285;5989731;159492;158;4629862;127;1359869;21017;13499
27269;Fresne-Cauverville;122;2564172;85166;66;1949194;56;614978;21018;13500
62118;Béthonsart;82;1723461;56463;45;1350212;37;373249;21018;13501
63178;Issoire;9227;193937869;9731597;4874;151775417;4353;42162452;21019;13502
47319;Villebramar;52;1092969;32533;22;791891;30;301078;21019;13503
03025;Bessay-sur-Allier;762;16016231;482213;403;12145108;359;3871123;21019;13504
03264;Saint-Yorre;1650;34680961;1260603;867;26657868;783;8023093;21019;13505
01050;Boissey;159;3342040;80300;85;2574890;74;767150;21019;13506
62449;Hesmond;89;1870726;51544;39;1381431;50;489295;21019;13507
86278;Vaux;410;8618025;243640;195;6217886;215;2400139;21020;13508
07237;Saint-Fortunat-sur-Eyrieux;397;8345025;259376;201;6181469;196;2163556;21020;13509
70553;Villargent;63;1324284;39775;30;957601;33;366683;21020;13510
76731;Vénestanville;89;1870822;34243;47;1331851;42;538971;21020;13511
88506;Vieux-Moulin;172;3615552;74877;98;2757976;74;857576;21021;13512
38446;Saint-Pierre-d'Entremont;320;6726955;184612;174;4870843;146;1856112;21022;13513
47093;Fargues-sur-Ourbise;197;4141282;153819;99;3119596;98;1021686;21022;13514
53244;Saint-Ouën-des-Vallons;99;2081193;43809;53;1458806;46;622387;21022;13515
02680;Saint-Gobain;1270;26698559;1043721;617;19470853;653;7227706;21022;13516
30056;La Bruguière;148;3111366;104839;61;2191953;87;919413;21023;13517
89413;Thorey;27;567622;24255;15;476815;12;90807;21023;13518
01124;Cormoz;369;7757512;188679;197;5834837;172;1922675;21023;13519
89447;Vézinnes;101;2123368;78705;61;1708332;40;415036;21023;13520
01200;Labalme;107;2249510;66043;57;1643873;50;605637;21023;13521
47212;Poussignac;156;3279729;93424;84;2478909;72;800820;21024;13522
28219;Luigny;222;4667396;183663;123;3703954;99;963442;21024;13523
72333;Semur-en-Vallon;266;5592476;150244;150;4535953;116;1056523;21024;13524
28165;Frétigny;281;5908247;202837;158;4566331;123;1341916;21026;13525
47175;Monflanquin;1383;29079334;1115683;665;21881644;718;7197690;21026;13526
58064;Châteauneuf-Val-de-Bargis;340;7149124;313479;183;5454119;157;1695005;21027;13527
22312;Saint-Maden;111;2334057;59411;50;1662851;61;671206;21028;13528
04141;Ongles;206;4331763;143109;110;3343042;96;988721;21028;13529
81207;Peyregoux;49;1030395;46851;25;740793;24;289602;21028;13530
52369;Orquevaux;51;1072492;33378;29;844006;22;228486;21029;13531
47027;Bias;1765;37118066;1324526;898;27885962;867;9232104;21030;13532
80232;Damery;128;2691869;86088;78;2174716;50;517153;21030;13533
61492;Trémont;55;1156678;24653;31;841969;24;314709;21031;13534
14643;Saint-Paul-du-Vernay;379;7970605;223004;197;5962699;182;2007906;21031;13535
33074;Brouqueyran;109;2292358;61377;58;1770193;51;522165;21031;13536
19042;Chanteix;334;7024303;160917;191;5424617;143;1599686;21031;13537
21252;Étais;50;1051544;36177;29;815349;21;236195;21031;13538
32297;Noilhan;188;3953811;125690;101;3109322;87;844489;21031;13539
80336;Foucaucourt-Hors-Nesle;39;820207;18286;22;595776;17;224431;21031;13540
07061;Chauzon;228;4795074;163914;118;3709724;110;1085350;21031;13541
76472;Notre-Dame-d'Aliermont;340;7150594;213578;182;5448462;158;1702132;21031;13542
37137;Lublé;81;1703539;46018;41;1215504;40;488035;21031;13543
02170;Châtillon-sur-Oise;84;1766647;59488;49;1440959;35;325688;21032;13544
33553;Virsac;511;10747312;371197;291;8623463;220;2123849;21032;13545
02810;Villers-Cotterêts;5776;121483454;5162963;3027;93225303;2749;28258151;21032;13546
70235;Flagy;85;1787763;57791;49;1382513;36;405250;21033;13547
35244;Romazy;139;2923565;101183;64;2110455;75;813110;21033;13548
70439;Raze;185;3891100;93423;103;2889986;82;1001114;21033;13549
72289;Sainte-Jamme-sur-Sarthe;1077;22652690;562982;584;17128359;493;5524331;21033;13550
71330;Neuvy-Grandchamp;430;9044732;247717;208;6335987;222;2708745;21034;13551
50522;Saint-Maurice-en-Cotentin;149;3134158;86487;75;2309973;74;824185;21035;13552
56058;Férel;1676;35254333;1116972;888;26574731;788;8679602;21035;13553
86043;Ceaux-en-Couhé;276;5805740;189043;131;4252613;145;1553127;21035;13554
03279;Teillet-Argenty;289;6079224;177859;145;4417582;144;1661642;21035;13555
85090;La Flocellière;1300;27346175;538012;710;20545149;590;6801026;21036;13556
97113;Le Gosier;17221;362253467;19103216;6431;276026937;10790;86226530;21036;13557
10301;Pouy-sur-Vannes;97;2040453;128808;51;1603960;46;436493;21036;13558
55290;Lignières-sur-Aire;28;589026;19807;16;480665;12;108361;21037;13559
76373;Imbleville;158;3323804;178837;66;2524669;92;799135;21037;13560
62784;Saulty;360;7573240;139531;167;5371929;193;2201311;21037;13561
26193;Montbrun-les-Bains;269;5658995;332789;119;4131073;150;1527922;21037;13562
32316;Peyrusse-Massas;57;1199132;36667;27;866362;30;332770;21037;13563
24390;Saint-Crépin-d'Auberoche;159;3344966;112692;79;2424474;80;920492;21038;13564
52044;Roches-Bettaincourt;321;6753154;211953;161;4915062;160;1838092;21038;13565
76280;Fréauville;85;1788235;69886;42;1291940;43;496295;21038;13566
39530;Thoirette;378;7952597;234044;213;6049703;165;1902894;21039;13567
55482;Senoncourt-les-Maujouy;50;1051969;26264;28;817882;22;234087;21039;13568
40094;Escource;359;7553220;213645;194;5707584;165;1845636;21040;13569
07020;Aubignas;242;5091842;172996;125;3901027;117;1190815;21041;13570
73237;Saint-Georges-des-Hurtières;195;4103002;119868;104;3035872;91;1067130;21041;13571
57477;Montbronn;922;19401511;606313;490;14448934;432;4952577;21043;13572
72196;Mézières-sur-Ponthouin;360;7575683;191013;193;5521864;167;2053819;21044;13573
33106;Castets-en-Dorthe;647;13615305;589914;317;10498237;330;3117068;21044;13574
61480;Tanville;122;2567344;114974;58;1886700;64;680644;21044;13575
39320;Maynal;187;3935209;107292;113;3134247;74;800962;21044;13576
45041;Bordeaux-en-Gâtinais;76;1599340;66262;44;1294203;32;305137;21044;13577
44022;Boussay;1401;29482633;655936;743;21830098;658;7652535;21044;13578
63401;Saint-Victor-la-Rivière;119;2504334;76379;60;1870644;59;633690;21045;13579
30293;Saint-Privat-de-Champclos;190;3998537;218532;85;2985890;105;1012647;21045;13580
76148;Bures-en-Bray;160;3367249;129470;86;2588609;74;778640;21045;13581
54157;Dieulouard;2561;53897846;1728007;1389;40906682;1172;12991164;21046;13582
25113;Chamesey;56;1178560;41807;27;846605;29;331955;21046;13583
62794;Setques;314;6608844;216923;163;4947667;151;1661177;21047;13584
87155;Saint-Junien-les-Combes;101;2125806;81530;53;1642834;48;482972;21048;13585
79252;Saint-Généroux;204;4293732;111882;120;3433879;84;859853;21048;13586
70271;Gouhenans;230;4841011;136647;124;3628705;106;1212306;21048;13587
61270;Ménil-Jean;60;1262929;28677;32;911240;28;351689;21049;13588
17394;Saint-Saturnin-du-Bois;468;9850855;403898;231;7280200;237;2570655;21049;13589
12002;Aguessac;463;9745757;275622;242;7078013;221;2667744;21049;13590
37005;Antogny-le-Tillac;276;5809629;208440;155;4539713;121;1269916;21049;13591
64552;Vialer;91;1915514;71686;36;1325787;55;589727;21050;13592
37188;Pouzay;455;9577592;360932;251;7328480;204;2249112;21050;13593
42136;Marcoux;393;8272572;239503;207;6127983;186;2144589;21050;13594
72323;Saint-Victeur;221;4652082;102241;120;3475890;101;1176192;21050;13595
62622;Nort-Leulinghem;96;2020828;90673;41;1452700;55;568128;21050;13596
49113;Courchamps;256;5388902;116501;143;4147035;113;1241867;21050;13597
61450;Saint-Quentin-de-Blavou;38;799916;21958;22;645100;16;154816;21050;13598
37247;Sepmes;369;7767734;313456;213;6184149;156;1583585;21051;13599
83137;Toulon;101585;2138478166;113171351;52159;1700854737;49426;437623429;21051;13600
19092;Le Jardin;50;1052572;29634;24;792482;26;260090;21051;13601
09154;Larbont;26;547365;57973;12;501171;14;46194;21053;13602
35295;Saint-Maugan;261;5494799;40536;148;4019059;113;1475740;21053;13603
62054;Audinghen;309;6505405;275716;169;5101778;140;1403627;21053;13604
64309;Lamayou;110;2315863;85253;55;1783786;55;532077;21053;13605
76655;Saint-Valery-en-Caux;2727;57413244;3070421;1401;45777475;1326;11635769;21054;13606
64235;Garris;188;3958148;210858;95;3140473;93;817675;21054;13607
62187;Buneville;95;2000151;59725;43;1334503;52;665648;21054;13608
21069;Beurizot;66;1389579;37021;36;1086839;30;302740;21054;13609
70293;Lambrey;46;968524;25771;24;715038;22;253486;21055;13610
21446;Moutiers-Saint-Jean;141;2968743;131215;58;2070849;83;897894;21055;13611
48117;Pourcharesses;78;1642340;46516;44;1226843;34;415497;21056;13612
39456;Relans;182;3832141;83126;112;3056053;70;776088;21056;13613
46127;Gourdon;2878;60598598;2961152;1354;45501495;1524;15097103;21056;13614
14016;Annebault;238;5011356;167325;136;3700428;102;1310928;21056;13615
52123;Chevillon;770;16213539;561372;390;12235174;380;3978365;21057;13616
37111;Genillé;923;19435197;711859;455;14284983;468;5150214;21057;13617
80705;Saint-Léger-lès-Authie;51;1073885;31655;24;754606;27;319279;21057;13618
39040;Barretaine;99;2084625;46051;54;1590921;45;493704;21057;13619
25047;Baume-les-Dames;3110;65488234;2466567;1636;50340522;1474;15147712;21057;13620
14324;Hamars;248;5222419;146001;141;4107420;107;1114999;21058;13621
58103;Dornecy;316;6654390;231818;156;4970932;160;1683458;21058;13622
28192;Happonvilliers;172;3622011;156761;90;2782090;82;839921;21058;13623
02277;Épagny;170;3579905;164356;85;2675077;85;904828;21058;13624
43051;Le Chambon-sur-Lignon;1478;31124264;1349147;682;22933091;796;8191173;21058;13625
04012;Aubenas-les-Alpes;50;1052939;30463;26;830974;24;221965;21059;13626
58081;Colméry;174;3664263;159643;96;2938911;78;725352;21059;13627
33438;Saint-Maixant;926;19500806;648191;473;14764192;453;4736614;21059;13628
88366;Rainville;141;2969352;66738;72;2172330;69;797022;21059;13629
85159;Nalliers;1216;25608262;808568;607;18913185;609;6695077;21059;13630
21703;Villiers-en-Morvan;31;652844;33306;13;467837;18;185007;21059;13631
89224;Lichères-près-Aigremont;97;2042841;58761;44;1401383;53;641458;21060;13632
52300;Magneux;101;2127112;67023;57;1655328;44;471784;21061;13633
88454;Sercoeur;142;2990614;85428;69;2126249;73;864365;21061;13634
50375;Néville-sur-Mer;105;2211381;72417;62;1747964;43;463417;21061;13635
49065;Champigné;1072;22577762;730360;521;16602248;551;5975514;21061;13636
14590;Sainte-Honorine-de-Ducy;66;1390064;35446;37;1036307;29;353757;21062;13637
07035;Boffres;355;7477058;510877;165;5532072;190;1944986;21062;13638
21258;Étrochey;109;2295784;99405;63;1914668;46;381116;21062;13639
19185;Saint-Bonnet-Avalouze;120;2527545;105612;70;2003201;50;524344;21063;13640
80021;Amiens;72844;1534305151;93822867;36410;1234146383;36434;300158768;21063;13641
52197;Fayl-Billot;775;16324099;751388;378;12340135;397;3983964;21063;13642
80599;Noyelles-en-Chaussée;149;3138449;92979;76;2366634;73;771815;21063;13643
49115;Coutures;283;5960973;161827;135;4282389;148;1678584;21064;13644
10359;Saint-Phal;304;6403341;181554;169;4897861;135;1505480;21064;13645
61403;Saint-Hilaire-la-Gérard;60;1263833;24994;31;937060;29;326773;21064;13646
24143;Couze-et-Saint-Front;439;9247063;361726;240;7200627;199;2046436;21064;13647
51270;Gigny-Bussy;133;2801570;79982;77;2139281;56;662289;21064;13648
72161;Lhomme;529;11143229;377845;281;8310516;248;2832713;21065;13649
34333;Vic-la-Gardiole;2061;43414838;2046204;1122;33816449;939;9598389;21065;13650
33212;Labescau;55;1158603;34033;30;862443;25;296160;21066;13651
70290;Jasney;124;2612146;30919;73;1921900;51;690246;21066;13652
57138;Chenois;31;653038;1210;19;522116;12;130922;21066;13653
11099;Conques-sur-Orbiel;1300;27385564;914467;664;20898887;636;6486677;21066;13654
54445;Raville-sur-Sânon;54;1137564;30038;29;845877;25;291687;21066;13655
50117;Champeaux;224;4718826;195260;105;3477171;119;1241655;21066;13656
40172;Mant;179;3771051;161185;81;2769399;98;1001652;21067;13657
47191;Montpouillan;384;8089890;275323;214;6366004;170;1723886;21067;13658
11144;Fitou;608;12809271;689942;263;9864159;345;2945112;21068;13659
57270;Val-de-Bride;322;6783891;208467;159;5009835;163;1774056;21068;13660
40228;Pomarez;893;18814346;685774;435;13975947;458;4838399;21069;13661
71311;Montcony;144;3033905;78565;73;2225040;71;808865;21069;13662
26171;Manas;114;2401872;58385;58;1770672;56;631200;21069;13663
11353;Saint-Marcel-sur-Aude;914;19257157;666258;421;14185872;493;5071285;21069;13664
80762;Tincourt-Boucly;195;4108513;143379;107;3245442;88;863071;21069;13665
85128;Luçon;5789;121974040;5611943;2839;92785312;2950;29188728;21070;13666
80579;Muille-Villette;438;9228689;346415;234;7015270;204;2213419;21070;13667
02224;Courcelles-sur-Vesle;195;4108747;172942;88;2944083;107;1164664;21070;13668
10289;Plancy-l'Abbaye;563;11862731;656330;265;8971721;298;2891010;21071;13669
64555;Viellenave-de-Navarrenx;81;1706722;44619;41;1165768;40;540954;21071;13670
82119;Montalzat;303;6384469;150624;138;4566274;165;1818195;21071;13671
80442;Hombleux;580;12221339;468210;292;9181061;288;3040278;21071;13672
49101;Clefs;514;10830672;264667;259;8004485;255;2826187;21071;13673
60205;Élencourt;30;632163;20397;18;518140;12;114023;21072;13674
40324;Vicq-d'Auribat;134;2823729;55221;70;2135549;64;688180;21073;13675
71410;Saint-Étienne-en-Bresse;452;9525023;330608;247;7310160;205;2214863;21073;13676
64504;Sare;1386;29207287;1206811;723;22343121;663;6864166;21073;13677
30250;Saint-Étienne-de-l'Olm;196;4130332;146756;96;3129481;100;1000851;21073;13678
26307;Saint-Jean-en-Royans;1716;36161881;1454023;863;27112051;853;9049830;21073;13679
54365;Merviller;196;4130516;108539;98;3015043;98;1115473;21074;13680
50211;Gouberville;76;1601651;66009;37;1204695;39;396956;21074;13681
37126;Lerné;195;4109591;174665;104;3185470;91;924121;21075;13682
31491;Saint-Julia;206;4341479;191478;103;3383982;103;957497;21075;13683
21386;Marigny-le-Cahouët;189;3983239;175745;101;3184867;88;798372;21075;13684
19160;Pérols-sur-Vézère;122;2571204;129528;63;1961748;59;609456;21075;13685
44053;Drefféac;1002;21118385;398708;573;15883269;429;5235116;21076;13686
37023;Beaumont-Village;161;3393301;146743;81;2503437;80;889864;21076;13687
62501;Lespinoy;111;2339486;76262;52;1544954;59;794532;21076;13688
59285;Haspres;1478;31151539;1088481;766;23584032;712;7567507;21077;13689
61250;Marchainville;135;2845416;163806;71;2254230;64;591186;21077;13690
54019;Ansauville;43;906330;15260;18;604612;25;301718;21077;13691
62756;Sainte-Marie-Kerque;735;15492084;420035;370;11270500;365;4221584;21078;13692
62486;Lambres;558;11761697;491693;295;8914089;263;2847608;21078;13693
16221;Mons;138;2908858;134932;61;2100716;77;808142;21079;13694
52491;Thonnance-les-Moulins;61;1285829;36181;30;944691;31;341138;21079;13695
76696;Tocqueville-sur-Eu;108;2276573;40116;51;1581699;57;694874;21079;13696
32007;Ardizas;109;2297716;62260;56;1746843;53;550873;21080;13697
36144;Nuret-le-Ferron;166;3499329;105810;90;2751683;76;747646;21080;13698
50278;Le Loreur;118;2487511;64040;59;1728144;59;759367;21081;13699
40095;Estibeaux;367;7736697;275900;190;6004269;177;1732428;21081;13700
49324;La Salle-et-Chapelle-Aubry;620;13070233;93919;348;9402532;272;3667701;21081;13701
22278;Saint-Brieuc;26985;568874395;30525012;13656;448345753;13329;120528642;21081;13702
10243;Molins-sur-Aube;57;1201629;56865;29;920709;28;280920;21081;13703
51289;Heiltz-le-Maurupt;229;4827616;133378;122;3532558;107;1295058;21081;13704
47150;Longueville;194;4089781;116844;97;3128662;97;961119;21081;13705
80220;Courtemanche;60;1264901;60468;32;1024146;28;240755;21082;13706
21310;Grosbois-en-Montagne;58;1222753;50277;35;1040776;23;181977;21082;13707
77079;Champagne-sur-Seine;3534;74503828;2986427;2061;59827786;1473;14676042;21082;13708
53029;Bierné;342;7210080;241347;144;4945103;198;2264977;21082;13709
19178;Sadroc;468;9866534;280723;262;7692568;206;2173966;21082;13710
71293;Ménetreuil;235;4954468;173946;113;3703746;122;1250722;21083;13711
44052;Donges;3860;81380165;2183725;2160;62414308;1700;18965857;21083;13712
79141;Irais;118;2487795;67797;64;1873641;54;614154;21083;13713
39432;Pointre;60;1264981;29500;32;899217;28;365764;21083;13714
31123;Castillon-de-Larboust;42;885512;43218;27;759555;15;125957;21084;13715
02480;Mesbrecourt-Richecourt;173;3647505;136617;85;2760628;88;886877;21084;13716
82074;Gramont;84;1771053;68866;39;1321543;45;449510;21084;13717
55382;Neuville-sur-Ornain;208;4385605;137497;124;3372597;84;1013008;21085;13718
19247;Saint-Victour;110;2319337;111855;49;1684953;61;634384;21085;13719
50276;Lolif;322;6789527;221278;174;5320177;148;1469350;21085;13720
02677;Saint-Eugène;130;2741225;83367;70;2055169;60;686056;21086;13721
49191;Martigné-Briand;1018;21466133;669785;505;16125113;513;5341020;21087;13722
39457;Les Repôts;30;632611;15221;17;487219;13;145392;21087;13723
76454;Mortemer;55;1159826;65592;25;852007;30;307819;21088;13724
64020;Ance;132;2783640;82837;68;2088224;64;695416;21088;13725
08020;Les Petites-Armoises;35;738108;32953;19;624198;16;113910;21089;13726
09289;Lorp-Sentaraille;810;17081931;704519;423;13173186;387;3908745;21089;13727
35308;Saint-Pierre-de-Plesguen;1465;30895862;880205;756;23246289;709;7649573;21089;13728
44085;Louisfert;471;9933202;176147;251;7351168;220;2582034;21090;13729
88250;Jarménil;239;5040423;248779;131;3896208;108;1144215;21090;13730
61189;Giel-Courteilles;196;4133716;103122;106;3025660;90;1108056;21090;13731
05142;Saint-Firmin;279;5884256;284969;123;4204094;156;1680162;21091;13732
09250;Roquefort-les-Cascades;54;1138893;55344;23;869631;31;269262;21091;13733
80559;Montagne-Fayel;88;1855995;75560;47;1481919;41;374076;21091;13734
29116;Lanneuffret;73;1539641;12795;41;1165148;32;374493;21091;13735
42215;Saint-Denis-de-Cabanne;735;15502046;456267;388;11565242;347;3936804;21091;13736
81143;Lescout;299;6306384;163752;155;4560842;144;1745542;21092;13737
52271;Lanques-sur-Rognon;112;2362263;81552;62;1829214;50;533049;21092;13738
69107;Lamure-sur-Azergues;535;11284148;256995;284;8236692;251;3047456;21092;13739
53078;Coudray;380;8014980;86408;216;5929280;164;2085700;21092;13740
40033;Bélis;90;1898325;59265;39;1361188;51;537137;21093;13741
72125;Écorpain;169;3564664;84780;90;2657586;79;907078;21093;13742
08028;Aubrives;487;10272279;342419;250;7706760;237;2565519;21093;13743
22074;Le Haut-Corlay;384;8099751;317760;164;5665024;220;2434727;21093;13744
50440;Rouffigny;168;3543697;98412;86;2614211;82;929486;21093;13745
80524;Méharicourt;306;6454757;247444;152;4740068;154;1714689;21094;13746
42207;Saint-Chamond;20222;426562528;18770297;9979;319791920;10243;106770608;21094;13747
86271;Thurageau;430;9070513;256270;224;6853786;206;2216727;21094;13748
88297;Méménil;80;1687544;38890;45;1311364;35;376180;21094;13749
62216;La Cauchie;116;2446952;103960;60;1861456;56;585496;21094;13750
50491;Saint-Jean-de-Savigny;195;4113422;93073;95;2844924;100;1268498;21094;13751
52040;Bay-sur-Aube;36;759425;28457;20;610320;16;149105;21095;13752
14162;Clécy;716;15104128;437662;357;10847833;359;4256295;21095;13753
17040;La Benâte;222;4683170;160233;110;3625283;112;1057887;21095;13754
52017;Arc-en-Barrois;441;9303093;404999;212;6765958;229;2537135;21095;13755
03316;Villeneuve-sur-Allier;560;11813899;490429;309;9168622;251;2645277;21096;13756
26114;Dieulefit;2010;42403718;1948202;955;31161428;1055;11242290;21096;13757
39298;Longcochon;30;632911;20250;16;481541;14;151370;21097;13758
72187;Marigné-Laillé;852;17974777;506093;465;13836020;387;4138757;21097;13759
21435;Montliot-et-Courcelles;187;3945292;191872;115;3291406;72;653886;21098;13760
49105;Contigné;400;8439198;356879;187;6342236;213;2096962;21098;13761
57141;Chicourt;56;1181490;35417;33;928271;23;253219;21098;13762
73187;La Léchère;1118;23587823;888320;660;18974811;458;4613012;21098;13763
11394;Tourreilles;81;1708973;43309;35;1334201;46;374772;21098;13764
16165;Houlette;222;4684033;233060;108;3517525;114;1166508;21099;13765
72022;Le Bailleul;582;12279807;309657;319;9154465;263;3125342;21099;13766
47316;Varès;353;7448074;231120;198;5769067;155;1679007;21099;13767
14510;La Pommeraye;29;611884;16487;17;494478;12;117406;21099;13768
31455;Rieux-Volvestre;1445;30488873;1330970;713;23320655;732;7168218;21100;13769
65225;Hourc;57;1202689;25243;32;1000111;25;202578;21100;13770
88023;Avillers;47;991729;29093;30;808563;17;183166;21101;13771
47257;Saint-Martin-Petit;275;5802799;200376;154;4620078;121;1182721;21101;13772
88517;Viviers-le-Gras;101;2131224;64336;55;1578823;46;552401;21101;13773
62028;Ames;339;7153582;219635;162;5171435;177;1982147;21102;13774
88245;Hurbache;165;3481865;84626;94;2703453;71;778412;21102;13775
66025;Bourg-Madame;618;13041169;458754;306;9678823;312;3362346;21102;13776
64259;Hélette;356;7512699;303672;182;5713916;174;1798783;21103;13777
19030;Brignac-la-Plaine;505;10657067;305294;272;8142519;233;2514548;21103;13778
02353;Grandlup-et-Fay;161;3397821;145450;75;2506430;86;891391;21104;13779
22032;Caulnes;1324;27943295;899340;654;20903990;670;7039305;21105;13780
51237;Esternay;1087;22941822;990836;533;16796032;554;6145790;21106;13781
52459;Sarcey;69;1456295;38531;43;1165882;26;290413;21106;13782
21706;Villotte-sur-Ource;63;1329692;47372;35;1002574;28;327118;21106;13783
62341;Foncquevillers;245;5171065;152382;129;3978046;116;1193019;21106;13784
59577;Staple;347;7324370;204689;175;5412730;172;1911640;21108;13785
26362;Valence;38367;809842396;45263266;19414;637677132;18953;172165264;21108;13786
86196;Pouançay;120;2533037;54762;65;1882980;55;650057;21109;13787
89174;Fontenailles;41;865456;34719;23;685629;18;179827;21109;13788
07162;Montréal;317;6691453;222432;165;5082630;152;1608823;21109;13789
25472;Puessans;23;485502;21530;11;352326;12;133176;21109;13790
35223;Plélan-le-Grand;2021;42662978;1253297;1051;31767040;970;10895938;21110;13791
21070;Bévy;64;1351041;44163;36;1054698;28;296343;21110;13792
23096;Guéret;8340;176058105;9968038;4336;141587624;4004;34470481;21110;13793
33514;Soulac-sur-Mer;1966;41503949;2174623;951;31261051;1015;10242898;21111;13794
31199;Fronsac;129;2723438;76710;62;1998171;67;725267;21112;13795
55332;Menaucourt;130;2744721;74935;82;2229289;48;515432;21113;13796
52060;Bourbonne-les-Bains;1380;29136385;1400839;616;21470309;764;7666076;21113;13797
25334;Levier;1016;21451362;616752;542;16437310;474;5014052;21114;13798
12045;Camboulazet;192;4053831;71949;84;2870303;108;1183528;21114;13799
59459;Petite-Forêt;2556;53967139;1931342;1355;41713771;1201;12253368;21114;13800
79088;Chiché;830;17524546;489626;389;12550937;441;4973609;21114;13801
32024;Ayguetinte;98;2069177;99992;48;1608841;50;460336;21114;13802
63381;Saint-Ours;879;18559263;572087;507;14562549;372;3996714;21114;13803
17126;Courcerac;177;3737325;156653;86;2786695;91;950630;21115;13804
39105;Chapois;118;2491572;64985;67;1867387;51;624185;21115;13805
76286;Fresnoy-Folny;351;7411429;300209;173;5374726;178;2036703;21115;13806
35057;La Chapelle-Bouëxic;657;13872884;372366;352;10515837;305;3357047;21116;13807
25088;Breconchaux;47;992429;23326;23;701313;24;291116;21116;13808
39386;Neuvilley;46;971334;28385;25;706878;21;264456;21116;13809
17063;Breuil-la-Réorte;219;4624475;172057;102;3521510;117;1102965;21116;13810
26207;Montmiral;319;6736171;198442;153;4986383;166;1749788;21117;13811
30006;Aimargues;2734;57733334;2654123;1375;44279126;1359;13454208;21117;13812
58016;Asnois;96;2027354;79047;51;1540607;45;486747;21118;13813
10386;Trouans;116;2449743;89840;53;1786761;63;662982;21118;13814
05164;Savines-le-Lac;622;13135842;471456;316;9858110;306;3277732;21119;13815
88395;Romont;189;3991444;95569;92;2850745;97;1140699;21119;13816
89260;Molesmes;92;1943043;66431;58;1601690;34;341353;21120;13817
30086;Collorgues;306;6462774;232580;159;5018825;147;1443949;21120;13818
49187;Marans;296;6251593;152544;163;4922373;133;1329220;21120;13819
72195;Mézeray;917;19367376;464007;494;14351843;423;5015533;21120;13820
30072;Castelnau-Valence;207;4371940;105060;101;3186871;106;1185069;21120;13821
89394;Sery;57;1203900;38737;29;854939;28;348961;21121;13822
89468;Villevallier;248;5238075;180873;132;3850352;116;1387723;21121;13823
33391;Saint-Côme;170;3590698;86722;99;2754676;71;836022;21122;13824
19252;Sarroux;245;5174899;170256;128;3945745;117;1229154;21122;13825
57377;Landange;130;2745876;127915;64;2045937;66;699939;21122;13826
71270;Mâcon;19923;420827807;23389735;10178;327665683;9745;93162124;21123;13827
10158;Fouchères;296;6252351;249160;157;5033807;139;1218544;21123;13828
11236;Molandier;129;2724858;170277;57;2015515;72;709343;21123;13829
88280;Madegney;50;1056153;16726;28;850871;22;205282;21123;13830
25498;Rognon;26;549203;20073;15;455738;11;93465;21123;13831
60701;Wavignies;564;11913908;403535;285;9014706;279;2899202;21124;13832
46109;Fontanes;275;5809158;302738;149;4627225;126;1181933;21124;13833
18105;Gron;240;5069904;118976;127;3809877;113;1260027;21125;13834
08422;Singly;75;1584351;50780;41;1231302;34;353049;21125;13835
65372;Pujo;344;7266938;209112;170;5445249;174;1821689;21125;13836
21325;Jouey;116;2450642;92300;64;1883108;52;567534;21126;13837
12243;Saint-Rome-de-Cernon;447;9443442;295736;240;7186948;207;2256494;21126;13838
63199;Ludesse;253;5344952;150719;132;4000551;121;1344401;21126;13839
25463;Pont-de-Roide;2630;55562251;2187978;1464;43361289;1166;12200962;21126;13840
60194;Dargies;142;3000044;96455;78;2267791;64;732253;21127;13841
85001;L'Aiguillon-sur-Mer;1438;30381232;1253546;732;22581046;706;7800186;21127;13842
63234;Montaigut-le-Blanc;459;9697509;318061;232;7193042;227;2504467;21127;13843
76158;Canville-les-Deux-Églises;162;3422685;80657;89;2593155;73;829530;21128;13844
14313;Grandchamp-le-Château;46;971876;40092;32;807706;14;164170;21128;13845
88130;Destord;117;2471966;57479;61;1806602;56;665364;21128;13846
62254;Coyecques;294;6211638;159992;150;4414439;144;1797199;21128;13847
85137;Marsais-Sainte-Radégonde;278;5873674;175597;145;4435661;133;1438013;21128;13848
37045;La Celle-Saint-Avant;597;12614106;449828;324;9659328;273;2954778;21129;13849
24385;Saint-Cernin-de-Labarde;124;2620036;121212;61;2058479;63;561557;21129;13850
14236;Ellon;250;5282405;184035;129;4045502;121;1236903;21130;13851
89021;Asquins;190;4014663;155366;97;2990755;93;1023908;21130;13852
03102;Dompierre-sur-Besbre;1934;40866016;1939116;925;30621365;1009;10244651;21130;13853
62478;Journy;138;2916023;80613;64;2047003;74;869020;21131;13854
04169;La Rochegiron;60;1267840;109101;20;913216;40;354624;21131;13855
60237;Fléchy;49;1035415;38618;22;682732;27;352683;21131;13856
67454;Schoenbourg;219;4627721;88481;120;3505531;99;1122190;21131;13857
39299;Longwy-sur-le-Doubs;277;5853374;157329;137;4127903;140;1725471;21131;13858
01406;Servignat;95;2007510;86884;49;1573210;46;434300;21132;13859
01138;Culoz;1581;33409694;1079896;849;25617309;732;7792385;21132;13860
66112;Montauriol;135;2852840;119469;66;2202578;69;650262;21132;13861
39520;Souvans;273;5769154;204284;144;4335630;129;1433524;21132;13862
22036;La Chapelle-Blanche;103;2176705;51858;54;1626732;49;549973;21133;13863
01212;Lescheroux;377;7967349;194171;205;6052945;172;1914404;21134;13864
41237;Sassay;466;9848302;237306;256;7415933;210;2432369;21134;13865
88047;Begnécourt;87;1838655;40272;55;1495254;32;343401;21134;13866
80084;Bermesnil;118;2493835;77206;72;1972356;46;521479;21134;13867
09024;Aston;132;2789753;95567;85;2358421;47;431332;21134;13868
08402;Saulces-Monclin;370;7819872;286012;179;5813890;191;2005982;21135;13869
30015;Arphy;98;2071317;83028;48;1565355;50;505962;21136;13870
62524;Longfossé;751;15873135;508504;376;11782593;375;4090542;21136;13871
44038;Chauvé;1333;28174910;739660;693;21147282;640;7027628;21136;13872
41034;Chambord;72;1521851;94759;46;1264887;26;256964;21137;13873
80732;Senarpont;404;8539608;370772;232;6954393;172;1585215;21138;13874
56038;La Chapelle-Gaceline;413;8729921;231837;241;6910988;172;1818933;21138;13875
12230;Saint-Jean-Delnous;197;4164156;180721;85;2944624;112;1219532;21138;13876
69102;Joux;348;7355986;183632;204;5768935;144;1587051;21138;13877
55254;Les Trois-Domaines;59;1247157;49061;27;881887;32;365270;21138;13878
44090;La Marne;711;15029571;337244;401;11497627;310;3531944;21139;13879
53003;Ambrières-les-Vallées;1507;31856698;1094708;709;22853199;798;9003499;21139;13880
86249;Saires;79;1670007;80406;40;1189030;39;480977;21139;13881
60657;Vauchelles;151;3192097;98334;88;2461287;63;730810;21140;13882
48092;Marvejols;3055;64582287;3226860;1536;50025048;1519;14557239;21140;13883
64378;Menditte;99;2092852;61367;47;1496591;52;596261;21140;13884
59501;Rieulay;742;15686027;479510;358;11430470;384;4255557;21140;13885
11164;Ginestas;753;15918714;638772;357;12023527;396;3895187;21140;13886
62276;Douvrin;2644;55895356;1861481;1379;42509421;1265;13385935;21140;13887
61369;Saint-Bômer-les-Forges;527;11141075;326764;281;8313571;246;2827504;21141;13888
35304;Saint-Ouen-des-Alleux;643;13593403;288528;344;10361582;299;3231821;21141;13889
85055;La Chapelle-Palluau;477;10084458;218365;277;7833436;200;2251022;21141;13890
35165;Marcillé-Robert;528;11162696;390092;233;7998195;295;3164501;21141;13891
29300;Le Trévoux;823;17401204;568798;448;13355361;375;4045843;21144;13892
60146;Chepoix;211;4461316;156450;112;3349642;99;1111674;21144;13893
10278;Pargues;80;1691502;91570;37;1262688;43;428814;21144;13894
09070;Les Cabannes;214;4524776;200058;121;3589636;93;935140;21144;13895
35267;Saint-Étienne-en-Coglès;889;18796992;422301;499;14237778;390;4559214;21144;13896
38053;Bourgoin-Jallieu;15666;331248482;15745338;8417;258498547;7249;72749935;21144;13897
60519;Quesmy;93;1966549;48763;49;1442892;44;523657;21146;13898
32400;Saint-Orens-Pouy-Petit;81;1712818;68931;43;1337105;38;375713;21146;13899
57713;Vieux-Lixheim;142;3002816;76833;81;2278842;61;723974;21147;13900
17431;Soulignonne;397;8395199;401270;192;6357437;205;2037762;21147;13901
11248;Montirat;46;972744;69729;21;715242;25;257502;21147;13902
61176;Francheville;86;1818647;50003;42;1313650;44;504997;21147;13903
33193;Grayan-et-l'Hôpital;818;17298728;762440;424;13108792;394;4189936;21148;13904
21514;Quemigny-sur-Seine;67;1416889;87698;30;1013815;37;403074;21148;13905
38154;Entraigues;132;2791541;90441;72;2117462;60;674079;21148;13906
59295;Hazebrouck;11795;249441127;10244344;5805;189261022;5990;60180105;21148;13907
86217;Saint-Christophe;170;3595191;136287;79;2560925;91;1034266;21148;13908
01312;Pressiat;132;2791566;102948;78;2239999;54;551567;21148;13909
28310;La Puisaye;157;3320273;144197;89;2681108;68;639165;21148;13910
02823;Voharies;35;740193;24388;14;528084;21;212109;21148;13911
48128;Rimeize;348;7359660;241487;194;5745630;154;1614030;21148;13912
62762;Saint-Michel-sous-Bois;60;1268927;39489;27;918877;33;350050;21149;13913
80113;Bonneville;180;3806820;112033;106;2969694;74;837126;21149;13914
40229;Pontenx-les-Forges;852;18018964;757128;436;13608697;416;4410267;21149;13915
15254;Veyrières;60;1268952;80048;25;875106;35;393846;21149;13916
72067;La Chapelle-Saint-Rémy;492;10405769;233167;277;7904403;215;2501366;21150;13917
30164;Méjannes-le-Clap;336;7106399;273402;178;5468938;158;1637461;21150;13918
60368;Longueil-Annel;1354;28637160;1151151;733;22702587;621;5934573;21150;13919
02495;Mondrepuis;519;10977112;383603;284;8729091;235;2248021;21151;13920
97313;Montsinéry-Tonnegrande;618;13071027;356316;217;8080821;401;4990206;21151;13921
48002;Albaret-Sainte-Marie;285;6027964;125869;163;4612382;122;1415582;21151;13922
70245;Fougerolles;2128;45008966;1398070;1077;33338757;1051;11670209;21151;13923
11438;Villesiscle;177;3743706;117732;94;2858148;83;885558;21151;13924
46086;Cuzance;312;6599214;164184;167;4876841;145;1722373;21151;13925
33144;Cudos;431;9116370;310737;206;6776610;225;2339760;21152;13926
45022;Batilly-en-Gâtinais;231;4886101;186833;138;3907114;93;978987;21152;13927
57159;Créhange;2134;45138455;1707476;1045;32778559;1089;12359896;21152;13928
49149;Gennes;1191;25193471;767834;567;18265641;624;6927830;21153;13929
18038;Bruère-Allichamps;365;7720979;432512;186;5928315;179;1792664;21153;13930
56007;Auray;7473;158081212;7342058;3737;121265758;3736;36815454;21154;13931
56198;Rohan;925;19567244;738508;478;14663741;447;4903503;21154;13932
80081;Belloy-Saint-Léonard;49;1036539;34229;27;821504;22;215035;21154;13933
73330;Yenne;1754;37104083;1376130;945;28438556;809;8665527;21154;13934
85169;Palluau;534;11296242;303644;273;8251318;261;3044924;21154;13935
63375;Saint-Martin-des-Plains;79;1671208;57568;40;1183249;39;487959;21155;13936
65385;Saint-Arroman;61;1290469;42762;33;997704;28;292765;21155;13937
14168;Colombières;115;2432875;79841;60;1781622;55;651253;21155;13938
50597;Tirepied;410;8674124;205192;202;6241676;208;2432448;21156;13939
70387;Noidans-le-Ferroux;332;7023951;190713;177;5295815;155;1728136;21156;13940
89117;Coulangeron;105;2221449;70885;58;1684719;47;536730;21157;13941
66228;Villeneuve-la-Rivière;680;14386589;525038;354;11262680;326;3123909;21157;13942
02442;Loupeigne;52;1100163;95814;28;920158;24;180005;21157;13943
62387;Grévillers;195;4125629;107686;107;3023944;88;1101685;21157;13944
26252;Portes-lès-Valence;5371;113635657;3569329;2900;86020026;2471;27615631;21157;13945
12215;Saint-Christophe-Vallon;650;13752468;375593;359;10502460;291;3250008;21158;13946
54556;Vého;60;1269460;32965;32;954445;28;315015;21158;13947
18243;Santranges;262;5543324;291912;131;4200519;131;1342805;21158;13948
67413;Rosteig;309;6538187;181499;164;4949418;145;1588769;21159;13949
07122;Lachapelle-sous-Aubenas;875;18514657;868144;452;14861406;423;3653251;21160;13950
88019;Autigny-la-Tour;102;2158325;67601;57;1645397;45;512928;21160;13951
80427;Hem-Hardinval;170;3597217;90640;86;2571866;84;1025351;21160;13952
45070;Champoulet;37;782927;36047;25;642952;12;139975;21160;13953
02817;Ville-Savoye;42;888741;23039;27;735889;15;152852;21161;13954
79204;Périgné;527;11152076;249775;257;8100257;270;3051819;21161;13955
71217;Germolles-sur-Grosne;69;1460158;38326;46;1226543;23;233615;21162;13956
70228;Faverney;579;12253061;608156;297;9172158;282;3080903;21162;13957
85116;La Jonchère;224;4740423;171148;119;3565919;105;1174504;21163;13958
58258;Saint-Ouen-sur-Loire;282;5967858;127032;156;4561319;126;1406539;21163;13959
70137;Chassey-lès-Montbozon;138;2920505;129482;63;2151477;75;769028;21163;13960
80701;Saint-Christ-Briost;241;5100323;187687;134;3994247;107;1106076;21163;13961
65433;Soues;1746;36952374;1192661;994;28811812;752;8140562;21164;13962
46094;Espédaillac;162;3428618;162730;83;2559185;79;869433;21164;13963
18142;Meillant;416;8804523;412254;240;7102129;176;1702394;21165;13964
39215;Essia;37;783100;26405;19;597056;18;186044;21165;13965
39419;Pillemoine;31;656111;29588;17;503441;14;152670;21165;13966
57083;Bining;637;13482357;359005;346;10098510;291;3383847;21165;13967
70343;Mersuay;161;3407641;105687;99;2722560;62;685081;21165;13968
10378;Thors;42;888963;19064;23;670234;19;218729;21166;13969
80279;Ercheu;430;9101312;405190;209;6653267;221;2448045;21166;13970
61253;Marmouillé;80;1693322;30737;43;1244355;37;448967;21167;13971
53209;Saint-Cyr-le-Gravelais;255;5397639;67662;131;3734916;124;1662723;21167;13972
52375;Palaiseul;34;719693;9839;21;547905;13;171788;21167;13973
31005;Alan;162;3429194;136336;82;2575346;80;853848;21168;13974
85038;Les Brouzils;1432;30312625;671660;776;23212948;656;7099677;21168;13975
67392;Reipertswiller;531;11240579;317746;313;8742184;218;2498395;21169;13976
57008;Adelange;114;2413255;63061;61;1784665;53;628590;21169;13977
82158;Saint-Cirice;84;1778264;69280;42;1335702;42;442562;21170;13978
29019;Brest;78777;1667713579;81692739;42887;1336103052;35890;331610527;21170;13979
64212;Espéchède;80;1693631;38755;44;1308749;36;384882;21170;13980
76733;Ventes-Saint-Rémy;120;2540456;69648;68;1892772;52;647684;21170;13981
88431;Saint-Paul;72;1524274;89928;32;1092695;40;431579;21170;13982
43203;Saint-Julien-du-Pinet;243;5144431;170558;138;3999892;105;1144539;21170;13983
52245;Humberville;39;825654;20114;20;539712;19;285942;21171;13984
80767;Le Translay;129;2731032;97409;71;2183756;58;547276;21171;13985
29266;Saint-Thégonnec;1439;30464831;866704;770;23022602;669;7442229;21171;13986
14301;Giberville;2677;56675007;1787853;1524;44556429;1153;12118578;21171;13987
19270;Troche;275;5822166;223956;138;4333990;137;1488176;21172;13988
64466;Rivehaute;145;3069891;154640;73;2400359;72;669532;21172;13989
32439;Tarsac;99;2096007;86057;46;1387997;53;708010;21172;13990
64129;Billère;8798;186271149;9058749;5022;150104270;3776;36166879;21172;13991
59309;Hondschoote;2020;42767796;1389441;967;31512519;1053;11255277;21172;13992
27226;Étrépagny;2141;45329971;2010045;1163;34895758;978;10434213;21172;13993
24081;Carlux;395;8363245;427306;181;6045115;214;2318130;21173;13994
80219;Courcelles-sous-Thoix;33;698722;33042;16;551569;17;147153;21173;13995
22028;Camlez;465;9845777;306870;243;7372363;222;2473414;21174;13996
85071;Commequiers;1766;37394102;907567;973;28057309;793;9336793;21174;13997
17154;Les Essards;355;7516943;226266;183;5739784;172;1777159;21174;13998
24302;Nailhac;177;3747934;135559;91;2856135;86;891799;21175;13999
81140;Lavaur;6080;128743593;5843746;2979;99480283;3101;29263310;21175;14000
65065;Barlest;152;3218598;98482;83;2465596;69;753002;21175;14001
14664;Sallen;141;2985678;93615;71;2260706;70;724972;21175;14002
52523;Vignes-la-Côte;27;571732;13132;16;475807;11;95925;21175;14003
59176;Doignies;149;3155176;79472;75;2200719;74;954457;21176;14004
09049;Bénac;94;1990531;63559;53;1621588;41;368943;21176;14005
52220;Giey-sur-Aujon;79;1672896;52839;40;1173581;39;499315;21176;14006
03278;Taxat-Senat;120;2541132;89221;56;1883948;64;657184;21176;14007
31367;Montclar-de-Comminges;46;974158;17426;28;745623;18;228535;21177;14008
48150;Saint-Flour-de-Mercoire;93;1969506;79752;48;1496517;45;472989;21177;14009
59177;Dompierre-sur-Helpe;515;10906779;493738;279;8545126;236;2361653;21178;14010
65305;Mauléon-Barousse;68;1440123;68336;37;1144194;31;295929;21178;14011
59268;La Gorgue;3063;64869539;1922041;1579;48575591;1484;16293948;21178;14012
39437;Pont-du-Navoy;140;2965021;114415;69;2115607;71;849414;21179;14013
47285;Samazan;435;9212849;277391;214;6664360;221;2548489;21179;14014
72009;Arthezé;174;3685153;45696;93;2702133;81;983020;21179;14015
76755;Ypreville-Biville;289;6120759;169831;164;4809772;125;1310987;21179;14016
52067;Brainville-sur-Meuse;45;953073;22686;16;577724;29;375349;21179;14017
25530;Sancey-le-Long;193;4087699;145406;101;3191272;92;896427;21180;14018
08365;Rimogne;744;15757804;797516;342;11686612;402;4071192;21180;14019
95018;Argenteuil;58432;1237581194;60416096;31044;992467831;27388;245113363;21180;14020
86165;Montmorillon;3710;78579897;3467844;1903;60589963;1807;17989934;21181;14021
38036;Beauvoir-en-Royans;52;1101430;46205;28;827788;24;273642;21181;14022
76612;Saint-Martin-au-Bosc;122;2584131;118104;69;2044109;53;540022;21181;14023
53222;Saint-Germain-d'Anxure;160;3389152;12520;87;2487648;73;901504;21182;14024
41197;Saint-Agil;166;3516298;146108;94;2743627;72;772671;21183;14025
60132;Catigny;111;2351326;87791;56;1816539;55;534787;21183;14026
57469;Mittersheim;331;7012214;244568;162;5129145;169;1883069;21185;14027
24507;Sainte-Trie;71;1504191;60242;34;1157573;37;346618;21186;14028
46101;Felzins;227;4809203;120009;116;3477201;111;1332002;21186;14029
08403;Sault-lès-Rethel;1035;21927507;1012289;484;16550863;551;5376644;21186;14030
24242;Liorac-sur-Louyre;135;2860155;125118;64;2137855;71;722300;21186;14031
32012;Aubiet;659;13961809;540194;363;10976951;296;2984858;21186;14032
45294;Saint-Michel;71;1504268;57250;43;1204398;28;299870;21187;14033
21285;Franxault;246;5212090;204440;128;4038022;118;1174068;21187;14034
89163;La Ferté-Loupière;334;7076633;287751;164;5305768;170;1770865;21188;14035
91235;Fleury-Mérogis;2782;58944299;2373627;1653;47972014;1129;10972285;21188;14036
67134;Eschwiller;102;2161204;58790;51;1500493;51;660711;21188;14037
64435;Osserain-Rivareyte;126;2669781;76645;68;2050548;58;619233;21189;14038
38219;Marcollin;322;6822856;169146;153;4809763;169;2013093;21189;14039
79229;La Rochénard;315;6674559;202785;161;5093156;154;1581403;21189;14040
33386;Saint-Cibard;115;2436755;85041;63;1917193;52;519562;21189;14041
84080;Monteux;6546;138704876;5663212;3323;106045446;3223;32659430;21189;14042
39337;Molamboz;42;889951;30105;19;640863;23;249088;21189;14043
79295;Saint-Romans-lès-Melle;383;8115639;228339;218;6327099;165;1788540;21190;14044
36152;Paudy;284;6017980;199555;149;4567648;135;1450332;21190;14045
62078;Balinghem;575;12184983;350756;291;9335172;284;2849811;21191;14046
29082;Île-de-Batz;316;6696670;274520;146;5038350;170;1658320;21192;14047
56108;Larré;485;10278417;208771;258;7699801;227;2578616;21193;14048
24307;Naussannes;120;2543219;125370;58;1856149;62;687070;21193;14049
81124;Lacaune;1511;32023979;1294071;803;25391171;708;6632808;21194;14050
38130;La Côte-Saint-André;2769;58686490;2934883;1375;44773239;1394;13913251;21194;14051
49272;Saint-Clément-des-Levées;606;12843674;396260;311;9610856;295;3232818;21194;14052
51567;Thiéblemont-Farémont;323;6845902;381152;150;5186174;173;1659728;21195;14053
79200;Pamplie;158;3348842;134672;80;2526378;78;822464;21195;14054
43054;Chanaleilles;126;2670599;142028;32;1746723;94;923876;21195;14055
76561;Saint-Aubin-lès-Elbeuf;4632;98178433;3935069;2739;79342391;1893;18836042;21196;14056
60313;Hermes;1375;29144640;1059005;793;23098949;582;6045691;21196;14057
79320;Surin;328;6952428;110478;186;5310253;142;1642175;21196;14058
53242;Saint-Michel-de-la-Roë;120;2543607;58758;52;1736060;68;807547;21197;14059
57560;Racrange;335;7101003;238191;171;5295139;164;1805864;21197;14060
04216;Thèze;126;2670849;132556;64;2138824;62;532025;21197;14061
47125;Lacépède;169;3582351;114666;86;2783030;83;799321;21197;14062
80824;Wiencourt-l'Équipée;144;3052475;103824;72;2277230;72;775245;21198;14063
53062;Château-Gontier;6570;139270481;6184138;3240;106286555;3330;32983926;21198;14064
62647;Le Parcq;394;8352115;257858;178;5957089;216;2395026;21198;14065
57451;Marthille;100;2119832;59572;60;1686137;40;433695;21198;14066
71315;Mont-lès-Seurre;88;1865476;71732;51;1401893;37;463583;21199;14067
35086;Combourtillé;274;5808488;74268;161;4383758;113;1424730;21199;14068
15141;Neussargues-Moissac;619;13122152;847369;284;9568388;335;3553764;21199;14069
53179;Placé;163;3455467;56486;81;2477243;82;978224;21199;14070
82188;Varennes;296;6275081;208627;137;4708398;159;1566683;21200;14071
08071;Blombay;64;1356785;33456;36;1080955;28;275830;21200;14072
86239;Sainte-Radégonde;92;1950388;68633;45;1406115;47;544273;21200;14073
14119;Cagny;813;17235712;526566;465;13338572;348;3897140;21200;14074
49378;Vivy;1284;27222028;821926;645;20092724;639;7129304;21201;14075
02058;Beaurieux;401;8501653;331997;180;6050595;221;2451058;21201;14076
89267;Montréal;103;2183721;73191;52;1624141;51;559580;21201;14077
59206;Escaudoeuvres;1899;40262356;2222144;893;30482943;1006;9779413;21202;14078
55066;Bovée-sur-Barboure;70;1484154;29687;34;1013237;36;470917;21202;14079
24129;Condat-sur-Trincou;265;5618775;198871;145;4231778;120;1386997;21203;14080
55054;Bislée;35;742123;33478;13;479028;22;263095;21204;14081
70277;Granges-le-Bourg;210;4453075;135268;131;3545377;79;907698;21205;14082
47096;Ferrensac;106;2247754;71464;52;1682696;54;565058;21205;14083
55557;Ville-en-Woëvre;77;1632820;77726;45;1339612;32;293208;21205;14084
71301;Mont;107;2268998;58417;55;1614507;52;654491;21206;14085
42077;Croizet-sur-Gand;162;3435356;75436;87;2590538;75;844818;21206;14086
50293;Martigny;165;3499031;83832;83;2525365;82;973666;21206;14087
46001;Albas;316;6701342;271313;146;4971515;170;1729827;21207;14088
16067;Bunzac;258;5471429;198473;141;4314753;117;1156676;21207;14089
54582;Villette;103;2184399;59513;42;1363889;61;820510;21208;14090
43096;Fontannes;493;10455499;337207;267;8040353;226;2415146;21208;14091
55226;Han-lès-Juvigny;50;1060402;11671;25;685492;25;374910;21208;14092
89297;Pierre-Perthuis;79;1675464;101099;34;1233204;45;442260;21208;14093
32308;Pébées;48;1018009;26732;22;780700;26;237309;21209;14094
87126;Rochechouart;2240;47507919;2007794;1152;35968365;1088;11539554;21209;14095
55014;Aubréville;225;4772060;178123;119;3684172;106;1087888;21209;14096
21114;Buffon;94;1993706;61363;52;1474926;42;518780;21210;14097
46330;Vayrac;784;16628466;695412;378;12493609;406;4134857;21210;14098
76204;Cropus;129;2736065;56412;67;2088080;62;647985;21210;14099
80667;Remaugies;69;1463516;48927;35;1050786;34;412730;21210;14100
86022;Berrie;143;3033088;160531;71;2217104;72;815984;21210;14101
71495;Salornay-sur-Guye;477;10117445;434458;237;7699108;240;2418337;21211;14102
30328;Théziers;572;12132639;422843;296;9148798;276;2983841;21211;14103
09264;Saint-Jean-de-Verges;651;13808503;423165;366;10857931;285;2950572;21211;14104
03137;Langy;139;2948463;99105;80;2267801;59;680662;21212;14105
12299;Villefranche-de-Panat;403;8548432;299972;184;6153330;219;2395102;21212;14106
70008;Ainvelle;97;2057607;75346;60;1685664;37;371943;21212;14107
55316;Mangiennes;188;3987963;192164;74;2622410;114;1365553;21213;14108
24286;Montagrier;280;5939552;231602;146;4637369;134;1302183;21213;14109
47211;Poudenas;140;2969877;150940;65;2264370;75;705507;21213;14110
52155;Culmont;323;6851984;196609;190;5344159;133;1507825;21214;14111
12126;Lavernhe;132;2800232;96837;63;1930707;69;869525;21214;14112
25242;Flagey-Rigney;54;1145592;23765;36;959047;18;186545;21215;14113
16179;Lamérac;115;2439744;104373;63;1859095;52;580649;21215;14114
08491;Vrigne-aux-Bois;1846;39163689;1687940;911;29816655;935;9347034;21215;14115
65384;Sailhan;88;1866985;80761;51;1501956;37;365029;21216;14116
39335;Moissey;319;6767913;276420;167;4924496;152;1843417;21216;14117
68307;Sewen;296;6280203;164619;172;4894692;124;1385511;21217;14118
11288;Pezens;746;15827975;638439;383;12058685;363;3769290;21217;14119
43017;Azérat;150;3182582;122405;81;2518009;69;664573;21217;14120
38177;La Garde;50;1060861;21287;29;826020;21;234841;21217;14121
35038;Bréal-sous-Vitré;344;7298916;128955;208;5626359;136;1672557;21218;14122
50249;Houesville;150;3182805;75131;79;2430978;71;751827;21219;14123
35255;Saint-Benoît-des-Ondes;558;11840253;346299;309;9124909;249;2715344;21219;14124
07052;Champis;319;6768907;249127;163;4956397;156;1812510;21219;14125
24445;Saint-Marcel-du-Périgord;85;1803675;97858;44;1349274;41;454401;21220;14126
16074;Challignac;172;3649824;92549;90;2829811;82;820013;21220;14127
24374;Saint-Aubin-de-Lanquais;170;3607503;145471;78;2716951;92;890552;21221;14128
62058;Aumerval;107;2270654;77985;58;1726447;49;544207;21221;14129
12104;Foissac;230;4880902;133007;109;3459526;121;1421376;21221;14130
60105;Brétigny;204;4329253;154126;108;3199152;96;1130101;21222;14131
76049;Avesnes-en-Val;147;3119710;103433;72;2311741;75;807969;21223;14132
25277;Gondenans-les-Moulins;36;764016;17061;16;492309;20;271707;21223;14133
40319;Trensacq;149;3162182;111290;79;2425272;70;736910;21223;14134
02390;Jeancourt;149;3162239;128934;75;2399004;74;763235;21223;14135
59606;Valenciennes;25418;539479633;35093877;12330;434672418;13088;104807215;21224;14136
89070;Chambeugle;34;721630;21881;19;560392;15;161238;21224;14137
42235;Saint-Hilaire-Cusson-la-Valmitte;179;3799191;105338;80;2692320;99;1106871;21225;14138
55250;Inor;113;2398400;67391;61;1715726;52;682674;21225;14139
65024;Argelès-Bagnères;74;1570644;58974;36;1166757;38;403887;21225;14140
70097;Briaucourt;142;3013973;68272;73;2225331;69;788642;21225;14141
57077;Bezange-la-Petite;49;1040041;30356;23;753623;26;286418;21225;14142
35235;Rannée;579;12289994;224201;311;9087280;268;3202714;21226;14143
09187;Mercenac;194;4118037;122870;106;3171292;88;946745;21227;14144
87014;Bessines-sur-Gartempe;1732;36765564;1330455;854;27904539;878;8861025;21227;14145
21250;Essarois;47;997691;30835;24;757423;23;240268;21227;14146
76201;Croisy-sur-Andelle;293;6219748;144971;171;4813436;122;1406312;21228;14147
89024;Auxerre;21988;466760755;28544906;11342;373155977;10646;93604778;21228;14148
51663;Magenta;1078;22884922;1099198;680;18906490;398;3978432;21229;14149
60691;Villers-Vermont;70;1486079;43510;38;1140614;32;345465;21230;14150
62525;Longuenesse;5603;118950463;5082826;2570;91167779;3033;27782684;21230;14151
64450;Pomps;124;2632494;68765;67;2074538;57;557956;21230;14152
62081;Baralle;242;5137658;129405;119;3651491;123;1486167;21230;14153
59350;Lille;124910;2651839364;183011405;64924;2183591888;59986;468247476;21230;14154
27166;Condé-sur-Iton;490;10402749;377562;273;8411336;217;1991413;21230;14155
19015;Ayen;390;8279782;486233;186;6254093;204;2025689;21230;14156
55278;Laneuville-au-Rupt;87;1847029;24077;39;1174041;48;672988;21230;14157
01274;Les Neyrolles;307;6517751;183394;159;4695095;148;1822656;21230;14158
62891;Willencourt;73;1549830;59386;34;1152630;39;397200;21231;14159
31033;Auterive;5314;112819858;4676784;2747;87046067;2567;25773791;21231;14160
25589;Vauclusotte;55;1167708;26318;29;848779;26;318929;21231;14161
89330;Sacy;115;2441588;73216;52;1807953;63;633635;21231;14162
64462;Ramous;244;5180616;137055;141;3952386;103;1228230;21232;14163
55572;Vittarville;47;997914;26685;17;624697;30;373217;21232;14164
33515;Soulignac;234;4968546;173694;105;3602167;129;1366379;21233;14165
62753;Saint-Laurent-Blangy;3639;77268337;3163140;2026;60739167;1613;16529170;21233;14166
54428;Pierrepont;498;10574387;240622;236;6925578;262;3648809;21234;14167
33127;Civrac-sur-Dordogne;133;2824104;137885;61;2056345;72;767759;21234;14168
73070;Champagneux;338;7177255;250873;182;5536460;156;1640795;21234;14169
44021;Bourgneuf-en-Retz;1903;40409525;1162713;959;29967503;944;10442022;21235;14170
58048;Cessy-les-Bois;66;1401513;52228;42;1139952;24;261561;21235;14171
46268;Saint-Géry;245;5202639;238257;129;3997617;116;1205022;21235;14172
57507;Niedervisse;136;2888124;71004;77;2314649;59;573475;21236;14173
77187;Fontaine-Fourches;301;6392240;196977;151;4827315;150;1564925;21237;14174
03043;Broût-Vernet;660;14016359;629307;306;9975554;354;4040805;21237;14175
52538;Villiers-sur-Suize;159;3376771;139096;92;2645757;67;731014;21238;14176
57180;Dolving;199;4226286;97172;111;3282948;88;943338;21238;14177
66233;Vivès;94;1996357;86229;52;1603361;42;392996;21238;14178
16338;Saint-Médard;168;3568033;161119;87;2858963;81;709070;21238;14179
14154;La Chapelle-Yvon;288;6116678;171587;176;4985580;112;1131098;21238;14180
13018;Cabannes;2469;52438187;2088389;1182;39429891;1287;13008296;21239;14181
25385;Montagney-Servigney;61;1295560;15155;29;816237;32;479323;21239;14182
82072;Golfech;479;10173501;285279;255;7750514;224;2422987;21239;14183
62596;Mouriez;121;2569933;75000;57;1923114;64;646819;21239;14184
12031;Bournazel;163;3462038;94170;87;2703116;76;758922;21239;14185
31119;Castelnau-Picampeau;110;2336345;149375;50;1777792;60;558553;21240;14186
76323;Graval;69;1465549;40328;45;1258391;24;207158;21240;14187
52392;Plesnoy;61;1295637;39491;34;981322;27;314315;21240;14188
79274;Saint-Martin-de-Mâcon;165;3504727;98975;90;2770124;75;734603;21241;14189
21156;Chaudenay-le-Château;26;552279;17232;12;393365;14;158914;21242;14190
89379;Savigny-en-Terre-Plaine;86;1826800;78022;36;1279306;50;547494;21242;14191
08188;Gespunsart;612;13000442;422912;295;9455962;317;3544480;21243;14192
06014;Bendejun;554;11768385;483545;321;9663320;233;2105065;21243;14193
11040;Bizanet;788;16739546;693088;397;13024406;391;3715140;21243;14194
85267;Sainte-Radégonde-des-Noyers;474;10069227;326403;259;7783677;215;2285550;21243;14195
39543;Vannoz;133;2825511;98737;67;2211443;66;614068;21244;14196
50027;Bacilly;496;10537261;251092;277;8070525;219;2466736;21244;14197
60058;Beauvoir;149;3165463;99604;80;2354425;69;811038;21245;14198
70014;Amblans-et-Velotte;196;4163977;155307;117;3277218;79;886759;21245;14199
65473;Villelongue;238;5056259;194568;139;3898626;99;1157633;21245;14200
40284;Saint-Vincent-de-Tyrosse;4688;99595563;3717439;2637;77837827;2051;21757736;21245;14201
69067;Courzieu;643;13660693;373067;350;10373817;293;3286876;21245;14202
63405;Sallèdes;302;6416142;187741;171;4961574;131;1454568;21246;14203
80558;Monsures;135;2868161;102897;65;2039648;70;828513;21246;14204
55521;Troyon;135;2868221;99991;68;2211619;67;656602;21246;14205
62326;Favreuil;121;2570780;92056;71;2068317;50;502463;21246;14206
33133;Coubeyrac;52;1104841;110491;19;826562;33;278279;21247;14207
55443;Rouvres-en-Woëvre;166;3526995;130350;87;2602783;79;924212;21247;14208
58037;Brassy;377;8010204;314489;189;5978952;188;2031252;21247;14209
32402;Saint-Paul-de-Baïse;62;1317334;54054;31;1010175;31;307159;21247;14210
85061;Château-Guibert;784;16658006;365232;396;12143618;388;4514388;21247;14211
63179;Job;613;13024719;500137;345;10162446;268;2862273;21248;14212
38208;Lavars;85;1806136;60705;50;1499692;35;306444;21249;14213
08193;Givry;128;2719874;43736;65;1979807;63;740067;21249;14214
59300;Hem-Lenglet;301;6395995;260864;159;5028370;142;1367625;21249;14215
70249;Francalmont;65;1381230;62320;33;1094717;32;286513;21250;14216
21134;Chamesson;149;3166220;104466;77;2395118;72;771102;21250;14217
52473;Signéville;56;1190010;25361;27;847465;29;342545;21250;14218
10372;Soulaines-Dhuys;160;3400063;103858;75;2337763;85;1062300;21250;14219
21202;Courban;101;2146320;81034;60;1594493;41;551827;21251;14220
39445;Publy;147;3123868;69607;75;2187693;72;936175;21251;14221
81139;Lautrec;972;20655941;683646;445;15250006;527;5405935;21251;14222
88391;Rochesson;358;7608042;187128;204;5925803;154;1682239;21252;14223
24562;Vallereuil;159;3378992;125314;85;2541526;74;837466;21252;14224
40003;Angoumé;152;3230262;86058;96;2564851;56;665411;21252;14225
53177;La Pellerine;164;3485393;75018;92;2684171;72;801222;21252;14226
70048;Bard-lès-Pesmes;71;1508946;43569;33;1093084;38;415862;21253;14227
66058;Corneilla-la-Rivière;1005;21359367;761694;480;16155002;525;5204365;21253;14228
08324;Neuvizy;61;1296482;29628;34;963695;27;332787;21254;14229
51236;Les Essarts-le-Vicomte;90;1912851;73488;45;1356168;45;556683;21254;14230
26020;La Répara-Auriples;128;2720505;98618;68;2111414;60;609091;21254;14231
54356;Mattexey;33;701399;5633;17;483941;16;217458;21255;14232
52432;Rolampont;900;19129270;813611;478;14514473;422;4614797;21255;14233
27396;Ménesqueville;232;4931104;157769;140;3839222;92;1091882;21255;14234
24295;Montrem;684;14538694;453690;363;10922650;321;3616044;21255;14235
40218;Parleboscq;231;4910116;180954;104;3387171;127;1522945;21256;14236
77301;Montceaux-lès-Provins;190;4038655;144799;106;3124385;84;914270;21256;14237
21690;Villeberny;60;1275400;56188;29;957504;31;317896;21257;14238
19130;Maussac;216;4591456;153748;116;3480290;100;1111166;21257;14239
01210;Lélex;128;2720876;99610;68;2096501;60;624375;21257;14240
57362;Kerprich-aux-Bois;72;1530499;50106;41;1175663;31;354836;21257;14241
82104;Marsac;83;1764327;87390;33;1252089;50;512238;21257;14242
06049;Courmes;72;1530521;84141;32;1111787;40;418734;21257;14243
10123;Dienville;515;10947630;412164;277;8243435;238;2704195;21258;14244
85306;Xanton-Chassenon;377;8014207;201159;206;5932840;171;2081367;21258;14245
70039;Autoreille;155;3294979;93921;92;2592677;63;702302;21258;14246
72273;Saint-Christophe-du-Jambet;120;2551107;80530;65;1982833;55;568274;21259;14247
25503;Rosières-sur-Barbèche;57;1211781;34188;25;872477;32;339304;21259;14248
37238;Saint-Senoch;276;5867657;207151;137;4420507;139;1447150;21260;14249
89243;Marchais-Beton;79;1679525;81725;43;1380326;36;299199;21260;14250
76306;Gonnetot;92;1956038;43083;54;1546588;38;409450;21261;14251
08421;Signy-Montlibert;46;978039;45234;20;700916;26;277123;21262;14252
39211;Les Essards-Taignevaux;139;2955380;79823;83;2338136;56;617244;21262;14253
50260;Juvigny-le-Tertre;342;7271679;152064;144;5223453;198;2048226;21262;14254
32196;Larroque-Saint-Sernin;105;2232539;101614;54;1720447;51;512092;21262;14255
80252;Douilly;139;2955492;67738;66;2173879;73;781613;21263;14256
33360;La Roquille;184;3912332;192911;82;2922688;102;989644;21263;14257
39198;Dole;14018;298067077;14837020;7077;234540751;6941;63526326;21263;14258
44127;La Planche;1275;27111039;551525;684;20435171;591;6675868;21264;14259
54521;Thil;892;18967235;262291;247;7736430;645;11230805;21264;14260
17030;Balanzac;285;6060241;258390;134;4438905;151;1621336;21264;14261
71408;Saint-Edmond;192;4082866;64746;110;3114726;82;968140;21265;14262
44174;Saint-Lumine-de-Coutais;941;20010857;328878;516;14807908;425;5202949;21266;14263
65282;Loudenvielle;153;3253679;120239;89;2522673;64;731006;21266;14264
45191;Malesherbes;3405;72412323;2848362;1941;56981089;1464;15431234;21266;14265
14424;Le Mesnil-Robert;98;2084122;57144;56;1682221;42;401901;21267;14266
63326;Saint-Bonnet-près-Orcival;262;5571888;185844;150;4463847;112;1108041;21267;14267
04006;Allos;423;8995955;430206;245;7284221;178;1711734;21267;14268
06020;La Bollène-Vésubie;320;6805461;269911;157;5183547;163;1621914;21267;14269
85200;Saint-Avaugourd-des-Landes;515;10952571;270806;284;8324581;231;2627990;21267;14270
22331;Sainte-Tréphine;99;2105483;76030;48;1625280;51;480203;21268;14271
10350;Saint-Mards-en-Othe;359;7635057;325366;193;5965825;166;1669232;21268;14272
71284;Martailly-lès-Brancion;82;1744044;64743;48;1395192;34;348852;21269;14273
71346;Perrecy-les-Forges;928;19737975;663404;471;14505038;457;5232937;21269;14274
57301;Haspelschiedt;169;3594536;70995;89;2476189;80;1118347;21269;14275
86188;Payré;540;11485813;353219;282;8827435;258;2658378;21270;14276
17057;Bouhet;398;8465498;221546;221;6665199;177;1800299;21270;14277
34173;Montpeyroux;701;14910468;666469;331;11141590;370;3768878;21270;14278
18260;Tendron;55;1169872;50201;21;816534;34;353338;21270;14279
50206;La Gohannière;57;1212435;19775;31;906900;26;305535;21271;14280
21365;Magny-la-Ville;43;914655;16830;26;692508;17;222147;21271;14281
33314;Pauillac;2935;62431542;2539397;1354;46901361;1581;15530181;21271;14282
17215;Lussac;35;744508;68245;11;529063;24;215445;21272;14283
33225;Landiras;1164;24760705;780988;609;18925238;555;5835467;21272;14284
70011;Amage;181;3850291;119336;106;3027965;75;822326;21272;14285
24030;Beauregard-de-Terrasson;386;8211321;262834;221;6405732;165;1805589;21273;14286
53203;Saint-Brice;269;5722402;186464;155;4365524;114;1356878;21273;14287
41258;Thésée;667;14189128;488063;371;11195824;296;2993304;21273;14288
24074;Calviac-en-Périgord;296;6296843;265245;170;4875540;126;1421303;21273;14289
61485;Ticheville;127;2701798;114495;69;2109855;58;591943;21274;14290
19105;Lanteuil;294;6254596;198379;166;4894562;128;1360034;21274;14291
58216;Pouques-Lormes;86;1829635;65491;45;1345677;41;483958;21275;14292
89252;Merry-Sec;89;1893464;57232;50;1404647;39;488817;21275;14293
32324;Ponsan-Soubiran;55;1170131;24194;26;843464;29;326667;21275;14294
54492;Sanzey;68;1446739;38862;34;1096844;34;349895;21276;14295
81114;Labastide-Gabausse;261;5552967;154344;142;4235008;119;1317959;21276;14296
12255;Salmiech;435;9254957;427405;195;7011303;240;2243654;21276;14297
80671;Ribeaucourt;113;2404179;31962;52;1794945;61;609234;21276;14298
34220;Le Puech;124;2638239;114375;58;1899545;66;738694;21276;14299
62381;Gouy-en-Ternois;84;1787195;50974;48;1391496;36;395699;21276;14300
29263;Saint-Ségal;528;11233847;355305;301;8871043;227;2362804;21276;14301
16148;Genac;429;9127827;387987;217;6977368;212;2150459;21277;14302
76606;Morienne;93;1978766;56138;58;1559080;35;419686;21277;14303
12194;Quins;449;9553881;408163;203;6835993;246;2717888;21278;14304
03133;Jenzat;284;6043059;200789;154;4796226;130;1246833;21278;14305
47203;Penne-d'Agenais;1468;31236783;1664262;678;23318566;790;7918217;21278;14306
21594;Savoisy;118;2510888;115147;64;1997891;54;512997;21279;14307
02714;Sermoise;172;3659981;98293;90;2640468;82;1019513;21279;14308
54160;Domèvre-en-Haye;191;4064299;74188;97;2958952;94;1105347;21279;14309
49320;Saint-Sauveur-de-Landemont;412;8767045;154783;211;6239067;201;2527978;21279;14310
04206;Sigonce;249;5298591;236984;134;4307759;115;990832;21279;14311
26277;La Roche-sur-Grane;99;2106673;57787;49;1584375;50;522298;21280;14312
66084;Fourques;628;13363617;498096;313;10305352;315;3058265;21280;14313
22206;Plouagat;1486;31621844;908506;804;24045828;682;7576016;21280;14314
29229;Quéménéven;664;14129851;431128;339;10708333;325;3421518;21280;14315
46262;Saint-Cyprien;162;3447379;200130;56;2268253;106;1179126;21280;14316
18115;Ivoy-le-Pré;491;10448538;483255;254;8016508;237;2432030;21280;14317
18088;Ennordres;134;2851593;82397;81;2276431;53;575162;21281;14318
28229;Mainvilliers;5842;124321415;5531107;3311;100020991;2531;24300424;21281;14319
34126;Lamalou-les-Bains;1399;29771624;1516799;699;23273455;700;6498169;21281;14320
64266;Hours;117;2489858;48033;69;1986910;48;502948;21281;14321
32078;Castelnau-d'Arbieu;119;2532422;85395;56;1847710;63;684712;21281;14322
14210;La Croupte;70;1489666;49059;35;1083551;35;406115;21281;14323
80522;Le Mazis;60;1276893;54039;34;949616;26;327277;21282;14324
79261;Saint-Jouin-de-Milly;107;2277138;51081;46;1549918;61;727220;21282;14325
46187;Mauroux;274;5831184;276554;132;4400308;142;1430876;21282;14326
41002;Angé;478;10173071;289537;272;8043813;206;2129258;21283;14327
07042;Bourg-Saint-Andéol;4315;91837748;3774450;2012;69541180;2303;22296568;21283;14328
13084;La Roque-d'Anthéron;2753;58593968;2284816;1291;43801855;1462;14792113;21284;14329
02516;Montigny-sous-Marle;37;787520;58413;17;636918;20;150602;21284;14330
70156;Citey;54;1149357;35698;33;934147;21;215210;21284;14331
70546;Vereux;133;2830833;89398;77;2245058;56;585775;21284;14332
60122;Campeaux;273;5810663;209177;151;4560210;122;1250453;21284;14333
88160;Épinal;19232;409343940;24435869;9526;327471176;9706;81872764;21285;14334
25125;Charmoille;173;3682324;112948;80;2628865;93;1053459;21285;14335
61430;Saint-Maurice-sur-Huisne;37;787553;24191;19;609433;18;178120;21285;14336
82012;Les Barthes;248;5278946;232988;109;3758422;139;1520524;21286;14337
08249;Laval-Morency;126;2682047;111661;57;1876777;69;805270;21286;14338
73007;Aiton;724;15411414;534174;404;12118553;320;3292861;21286;14339
86047;Cernay;237;5044957;143347;121;3704794;116;1340163;21287;14340
62240;Corbehem;1187;25267614;697895;664;19120141;523;6147473;21287;14341
85197;Saint-André-Treize-Voies;688;14645956;242233;407;11263618;281;3382338;21288;14342
29049;Elliant;1760;37466863;1042424;912;28138053;848;9328810;21288;14343
11152;Fontjoncouse;83;1766968;78526;37;1369335;46;397633;21289;14344
08132;Corny-Machéroménil;85;1809578;59823;44;1402358;41;407220;21289;14345
57192;Enchenberg;699;14881346;427930;373;11438803;326;3442543;21289;14346
73233;Saint-Franc;86;1830918;55793;43;1383060;43;447858;21290;14347
87187;Saint-Yrieix-la-Perche;4202;89459933;3596331;2148;68505465;2054;20954468;21290;14348
88166;Évaux-et-Ménil;182;3874756;136672;108;3097145;74;777611;21290;14349
60035;Avricourt;135;2874172;99128;70;2175566;65;698606;21290;14350
39443;Présilly;62;1320059;29848;36;1048295;26;271764;21291;14351
50191;Foucarville;81;1724597;71418;44;1267013;37;457584;21291;14352
87084;Lavignac;84;1788482;49864;44;1379993;40;408489;21291;14353
63185;Lamontgie;325;6919777;255589;170;5143904;155;1775873;21292;14354
61113;Comblot;38;809085;11666;22;631633;16;177452;21292;14355
24094;Chalagnac;211;4492580;136849;114;3467476;97;1025104;21292;14356
39370;Mouchard;537;11434278;375272;293;8735350;244;2698928;21293;14357
26276;Roche-Saint-Secret-Béconne;221;4705738;149146;124;3707267;97;998471;21293;14358
37121;Jaulnay;142;3023746;60874;70;2193515;72;830231;21294;14359
03061;Charmes;203;4322721;126274;104;3262900;99;1059821;21294;14360
88189;Fréville;81;1724834;48002;45;1300512;36;424322;21294;14361
87085;Limoges;76914;1637853058;97078321;41281;1340550503;35633;297302555;21295;14362
01053;Bourg-en-Bresse;23302;496209453;26286942;12477;391410799;10825;104798654;21295;14363
52173;Domremy-Landéville;45;958287;39647;25;730155;20;228132;21295;14364
79012;Ardin;667;14204113;427654;363;10659760;304;3544353;21296;14365
03039;Bresnay;214;4557273;151719;108;3425297;106;1131976;21296;14366
84098;Roaix;350;7453513;280552;169;5506995;181;1946518;21296;14367
09076;Canté;116;2470452;144036;68;1919989;48;550463;21297;14368
34089;Creissan;697;14844033;548815;348;11218072;349;3625961;21297;14369
52455;Saint-Thiébault;156;3322338;101381;93;2573564;63;748774;21297;14370
62723;Roussent;104;2214904;62725;52;1657285;52;557619;21297;14371
89283;Ouanne;397;8455016;436125;186;6084362;211;2370654;21297;14372
65393;Saint-Pastous;71;1512158;57125;40;1152049;31;360109;21298;14373
47171;Monbalen;225;4792124;170038;112;3628250;113;1163874;21298;14374
18044;Cerbois;231;4920265;197133;127;3815791;104;1104474;21300;14375
08130;Contreuve;42;894611;49606;19;664922;23;229689;21300;14376
86231;Saint-Macoux;275;5857594;207389;134;4404383;141;1453211;21300;14377
80644;Proyart;334;7114459;232776;164;5252733;170;1861726;21301;14378
32193;Larée;131;2790418;141411;70;2154259;61;636159;21301;14379
64207;Escou;173;3685150;106960;106;3071886;67;613264;21301;14380
02211;Condé-sur-Suippe;136;2897004;85325;80;2356614;56;540390;21302;14381
07157;Meysse;725;15443675;547695;383;11743591;342;3700084;21302;14382
10327;La Rothière;61;1299417;39836;36;1003400;25;296017;21302;14383
59003;Aibes;194;4132594;127540;108;3273624;86;858970;21302;14384
85192;Rochetrejoux;486;10352816;253837;292;8072434;194;2280382;21302;14385
70456;Ruhans;72;1533808;60880;36;1223505;36;310303;21303;14386
10050;Bossancourt;125;2662862;103217;76;2111751;49;551111;21303;14387
70031;Athesans-Étroitefontaine;358;7626536;276160;187;5676562;171;1949974;21303;14388
64096;Barraute-Camu;88;1874693;40514;52;1443521;36;431172;21303;14389
31098;Cadours;586;12483987;513211;270;8978811;316;3505176;21304;14390
28083;Charray;68;1448662;56413;43;1141428;25;307234;21304;14391
60103;Bresles;2269;48339857;2004121;1287;38417935;982;9921922;21304;14392
14680;Sully;82;1746983;56202;39;1327358;43;419625;21305;14393
05072;Laye;153;3259796;131505;96;2678614;57;581182;21306;14394
21500;Pouillenay;320;6817958;206548;194;5383550;126;1434408;21306;14395
40105;Garein;227;4836527;147215;117;3680387;110;1156140;21306;14396
80504;Malpart;39;830949;30133;21;619472;18;211477;21306;14397
76334;Gueures;285;6072461;211358;150;4573998;135;1498463;21307;14398
52543;Voillecomte;269;5731596;136604;155;4424435;114;1307161;21307;14399
79069;Chanteloup;487;10376565;212215;272;7921907;215;2454658;21307;14400
27043;Les Baux-de-Breteuil;371;7905203;347751;205;6183710;166;1721493;21308;14401
37100;Épeigné-les-Bois;224;4772987;165564;120;3536161;104;1236826;21308;14402
40204;Nerbis;144;3068396;93604;84;2443221;60;625175;21308;14403
35160;Loutehel;136;2897980;37632;75;2321026;61;576954;21309;14404
33140;Créon;2486;52974811;1749848;1310;40356372;1176;12618439;21309;14405
31095;Cabanac-Cazaux;63;1342485;46005;29;916406;34;426079;21309;14406
41127;La Marolle-en-Sologne;233;4965064;193413;129;3906714;104;1058350;21309;14407
35286;Saint-Léger-des-Prés;119;2535824;57522;53;1769209;66;766615;21309;14408
85006;Apremont;923;19668813;702705;456;14453217;467;5215596;21310;14409
59461;Petit-Fayt;158;3366944;116536;89;2705175;69;661769;21310;14410
21287;Fresnes;91;1939236;47721;50;1501684;41;437552;21310;14411
80068;Beaumetz;107;2280219;68013;52;1632689;55;647530;21310;14412
24147;Cubjac;431;9184899;418172;220;6977850;211;2207049;21311;14413
54405;Ochey;227;4837691;35798;126;3528286;101;1309405;21311;14414
31479;Saint-Ferréol-de-Comminges;29;618037;28304;14;490689;15;127348;21312;14415
12140;Martiel;575;12254261;486239;302;9462953;273;2791308;21312;14416
76059;Bazinval;200;4262420;98093;122;3381486;78;880934;21312;14417
14586;Saint-Germain-du-Pert;108;2301792;112585;54;1727731;54;574061;21313;14418
80087;Bernay-en-Ponthieu;125;2664131;128949;53;1884315;72;779816;21313;14419
08268;Maisoncelle-et-Villers;36;767293;17834;12;451954;24;315339;21314;14420
09071;Cadarcet;130;2770803;101288;62;2084182;68;686621;21314;14421
66062;Dorres;98;2088792;87011;64;1796193;34;292599;21314;14422
38514;Tréminis;107;2280688;89870;64;1867290;43;413398;21315;14423
54502;Serres;134;2856223;75509;70;2135345;64;720878;21315;14424
17119;Corme-Écluse;615;13109192;399903;342;10095243;273;3013949;21316;14425
71096;La Chapelle-sous-Uchon;122;2600537;112667;67;2052572;55;547965;21316;14426
43102;Grazac;524;11170040;303300;271;8129672;253;3040368;21317;14427
34093;Dio-et-Valquières;103;2195646;110245;55;1721634;48;474012;21317;14428
23039;La Celle-Dunoise;351;7482316;313987;170;5756748;181;1725568;21317;14429
89385;Sennevoy-le-Bas;63;1343034;53468;37;1082858;26;260176;21318;14430
71060;Briant;133;2835298;84418;66;2042243;67;793055;21318;14431
17031;Ballans;124;2643444;122778;58;2017936;66;625508;21318;14432
01230;Mantenay-Montlin;156;3325636;70255;81;2256984;75;1068652;21318;14433
50631;Les Veys;219;4668878;163608;112;3495953;107;1172925;21319;14434
52394;Poinson-lès-Fayl;108;2302462;57478;59;1774649;49;527813;21319;14435
02223;Courboin;161;3432457;91463;94;2684915;67;747542;21320;14436
30034;Bellegarde;3506;74748579;2831095;1777;56972443;1729;17776136;21320;14437
53066;Chemazé;686;14625786;350035;349;10760469;337;3865317;21320;14438
25365;Mancenans;174;3709855;97657;92;2731654;82;978201;21321;14439
89190;Givry;110;2345352;109946;60;1868385;50;476967;21321;14440
33404;Sainte-Gemme;109;2324035;86204;48;1733530;61;590505;21321;14441
14503;Pierres;106;2260078;64707;59;1779423;47;480655;21321;14442
53088;Cuillé;490;10447595;366971;227;7387553;263;3060042;21322;14443
80374;Gapennes;142;3027713;100013;74;2372966;68;654747;21322;14444
07145;Lussas;571;12174853;366615;311;9317155;260;2857698;21322;14445
80228;Le Crotoy;1349;28763363;1553654;620;21896620;729;6866743;21322;14446
64372;Maure;66;1407273;47219;36;1147203;30;260070;21322;14447
71506;Savigny-en-Revermont;652;13902290;434546;351;10484338;301;3417952;21323;14448
50509;Sainte-Marie-du-Mont;441;9403475;533317;201;6764710;240;2638765;21323;14449
33347;Puynormand;150;3198468;133366;72;2422951;78;775517;21323;14450
62489;Lapugnoy;1790;38168460;1544399;904;29061658;886;9106802;21323;14451
19284;Viam;66;1407401;56551;38;1110218;28;297183;21324;14452
55241;Heippes;41;874301;34435;21;683375;20;190926;21324;14453
76724;Vatierville;62;1322141;39848;28;916338;34;405803;21325;14454
39322;Menétrux-en-Joux;32;682402;14407;17;510420;15;171982;21325;14455
08449;Thin-le-Moutier;326;6952005;183612;175;5232822;151;1719183;21325;14456
45035;Boiscommun;654;13946887;453635;326;10154169;328;3792718;21326;14457
15092;Lanobre;880;18766500;757790;450;14172237;430;4594263;21326;14458
72373;Vibraye;1499;31967710;1220443;824;24727424;675;7240286;21326;14459
02315;Flavy-le-Martel;882;18809780;828349;403;13626180;479;5183600;21326;14460
59543;Saint-Remy-du-Nord;616;13137001;493365;343;10346954;273;2790047;21326;14461
55025;Baâlon;146;3113672;107634;72;2204141;74;909531;21327;14462
72115;Dissay-sous-Courcillon;541;11537986;360493;292;8864136;249;2673850;21327;14463
65462;Vidouze;149;3177872;161075;75;2449807;74;728065;21328;14464
39013;Arbois;2053;43786510;2084979;1050;33799844;1003;9986666;21328;14465
87088;Magnac-Bourg;633;13500751;656423;311;9903201;322;3597550;21328;14466
81258;Saint-Julien-du-Puy;222;4734865;194614;104;3549004;118;1185861;21328;14467
61261;Le Ménil-Broût;91;1940888;56625;48;1470548;43;470340;21328;14468
64110;Béost;131;2794245;92183;73;2171087;58;623158;21330;14469
14029;Les Autels-Saint-Bazile;22;469275;12035;11;364931;11;104344;21331;14470
26159;Laval-d'Aix;77;1642486;67020;42;1292220;35;350266;21331;14471
80465;Languevoisin-Quiquery;123;2623731;89040;71;1996348;52;627383;21331;14472
53017;Ballée;373;7956741;364066;187;5977554;186;1979187;21332;14473
24225;Lamonzie-Saint-Martin;1285;27411294;892881;673;20852111;612;6559183;21332;14474
47263;Saint-Pardoux-du-Breuil;348;7423619;257217;178;5686425;170;1737194;21332;14475
85091;Fontaines;446;9514278;289365;239;7187929;207;2326349;21332;14476
86280;Vellèches;205;4373181;131574;98;3156813;107;1216368;21333;14477
58131;Guérigny;1466;31274245;1208784;775;23560349;691;7713896;21333;14478
07259;Saint-Just-d'Ardèche;884;18858640;738543;462;14458100;422;4400540;21333;14479
14195;Courvaudon;117;2496015;58465;62;1844703;55;651312;21333;14480
53205;Saint-Céneré;236;5034729;104845;138;3976344;98;1058385;21334;14481
54190;Fécocourt;61;1301390;39538;29;927218;32;374172;21334;14482
05134;Saint-Clément-sur-Durance;176;3754845;117110;92;2746561;84;1008284;21334;14483
61363;Saint-Aquilin-de-Corbion;50;1066719;40737;26;823520;24;243199;21334;14484
39135;Chazelles;67;1429404;20575;37;1042136;30;387268;21334;14485
49047;Brigné;231;4928559;120067;128;3654190;103;1274369;21336;14486
80430;Herbécourt;90;1920264;92136;44;1418495;46;501769;21336;14487
79357;Xaintray;124;2645703;88545;71;2133912;53;511791;21336;14488
30184;Moussac;685;14616155;527791;343;10868989;342;3747166;21337;14489
65103;Bouilh-Péreuilh;53;1130897;29919;28;835567;25;295330;21338;14490
81300;Tonnac;71;1514979;64957;31;1129853;40;385126;21338;14491
39356;Montigny-sur-l'Ain;101;2155133;51042;52;1461307;49;693826;21338;14492
26172;Manthes;367;7831103;237703;182;5811959;185;2019144;21338;14493
60377;Maisoncelle-Tuilerie;168;3584823;148591;84;2646753;84;938070;21338;14494
64165;Cardesse;125;2667312;71211;66;2049080;59;618232;21338;14495
32094;Caupenne-d'Armagnac;256;5462655;233431;121;4151607;135;1311048;21338;14496
66224;Villelongue-de-la-Salanque;1782;38026172;1639505;885;29352929;897;8673243;21339;14497
57143;Clouange;2177;46455825;1731220;1065;33007723;1112;13448102;21339;14498
79126;Les Fosses;231;4929421;156076;122;3758507;109;1170914;21339;14499
50528;Saint-Nicolas-de-Pierrepont;146;3115572;75631;66;2180948;80;934624;21340;14500
33038;Bégadan;540;11523358;534305;260;8511849;280;3011509;21340;14501
47041;Bruch;415;8856005;330964;197;6455857;218;2400148;21340;14502
09045;Bédeilhac-et-Aynat;112;2390103;123470;61;1954976;51;435127;21340;14503
05145;Saint-Jean-Saint-Nicolas;542;11566485;462563;273;8768649;269;2797836;21340;14504
02458;Marchais-en-Brie;165;3521259;100135;99;2837388;66;683871;21341;14505
63113;Clermont-Ferrand;78231;1669547186;95245021;43117;1363907777;35114;305639409;21341;14506
33479;Saint-Sève;122;2603720;94966;61;1997094;61;606626;21342;14507
61247;Malétable;56;1195256;57408;29;866324;27;328932;21344;14508
49276;Saint-Florent-le-Vieil;1479;31568118;749254;782;23703000;697;7865118;21344;14509
88215;Grandrupt;40;853778;24842;22;684120;18;169658;21344;14510
39557;Vescles;124;2646768;64196;68;1912391;56;734377;21345;14511
66106;Maureillas-las-Illas;1615;34472181;1608194;778;25888396;837;8583785;21345;14512
37041;Bueil-en-Touraine;172;3671405;65124;99;2948162;73;723243;21345;14513
04084;Estoublon;277;5912720;209712;146;4602927;131;1309793;21346;14514
13054;Marignane;19467;415538013;18114081;10477;329168674;8990;86369339;21346;14515
71382;Saint-Agnan;385;8218255;225248;210;6084393;175;2133862;21346;14516
54021;Armaucourt;121;2582887;87709;73;2036336;48;546551;21346;14517
02335;Fressancourt;110;2348134;83391;49;1621994;61;726140;21347;14518
54185;Étreval;40;853868;41208;27;766820;13;87048;21347;14519
52377;Parnoy-en-Bassigny;157;3351458;141279;66;2332553;91;1018905;21347;14520
02081;Béthancourt-en-Vaux;244;5208651;203539;126;4025919;118;1182732;21347;14521
17338;Saint-Georges-du-Bois;969;20686134;764750;507;15808150;462;4877984;21348;14522
83023;Brignoles;9417;201036934;10136480;4492;153827681;4925;47209253;21348;14523
76220;Douvrend;261;5572068;183017;132;4088671;129;1483397;21349;14524
27176;Coudray;104;2220308;81757;47;1548317;57;671991;21349;14525
37072;Chinon;5068;108199450;5537907;2593;86129740;2475;22069710;21350;14526
24575;Veyrines-de-Domme;124;2647348;80799;57;1823429;67;823919;21350;14527
10297;Pont-Sainte-Marie;2557;54591551;2452192;1281;41884002;1276;12707549;21350;14528
74030;La Baume;168;3586830;132138;93;2729770;75;857060;21350;14529
65343;Ossen;122;2604773;100336;61;1913492;61;691281;21351;14530
23224;Saint-Oradoux-de-Chirouze;49;1046212;46198;30;860934;19;185278;21351;14531
17079;Chaillevette;827;17658019;682658;437;13597406;390;4060613;21352;14532
27490;Richeville;141;3010672;116209;72;2272284;69;738388;21352;14533
47121;Labastide-Castel-Amouroux;189;4035602;143326;101;3093838;88;941764;21352;14534
53096;Ernée;3172;67729807;2202207;1534;49093349;1638;18636458;21352;14535
33437;Saint-Magne-de-Castillon;1102;23530458;1563708;522;17328799;580;6201659;21353;14536
57269;Guénange;3782;80755832;1857182;1805;53472671;1977;27283161;21353;14537
61355;Rouellé;101;2156636;47723;50;1638419;51;518217;21353;14538
39128;Chaussin;926;19772746;909181;478;15199398;448;4573348;21353;14539
90033;Delle;3359;71724468;3668485;1814;56600579;1545;15123889;21353;14540
80310;Fienvillers;324;6918452;214122;158;5036223;166;1882229;21353;14541
80573;Morvillers-Saint-Saturnin;229;4889960;229507;120;3840044;109;1049916;21354;14542
37119;L'Île-Bouchard;1040;22207790;707850;447;16054726;593;6153064;21354;14543
63168;Glaine-Montaigut;318;6790509;292406;163;5316196;155;1474313;21354;14544
33339;Prignac-et-Marcamps;796;16997847;638450;420;13190759;376;3807088;21354;14545
52510;Vaux-sur-Blaise;224;4783387;145188;127;3697785;97;1085602;21354;14546
14746;Viessoix;408;8712620;173520;237;6564464;171;2148156;21354;14547
50038;Beauchamps;209;4463122;130531;106;3211569;103;1251553;21355;14548
49074;La Chapelle-Rousselin;366;7816036;144128;202;5795928;164;2020108;21355;14549
56239;Saint-Vincent-sur-Oust;776;16571714;548089;431;12988866;345;3582848;21355;14550
59007;Anhiers;450;9610061;247436;223;6938308;227;2671753;21356;14551
40327;Vielle-Soubiran;133;2840321;81329;75;2278996;58;561325;21356;14552
55008;Amel-sur-l'Étang;85;1815289;40334;36;1148136;49;667153;21356;14553
15189;Saint-Gérons;140;2989921;131407;71;2300787;69;689134;21357;14554
03318;Vitray;67;1430932;62084;37;1168952;30;261980;21357;14555
57664;Tarquimpol;43;918360;32470;26;700864;17;217496;21357;14556
55517;Seuil-d'Argonne;298;6364520;264654;151;4710130;147;1654390;21357;14557
38278;Notre-Dame-de-l'Osier;290;6193760;265835;147;4857824;143;1335936;21358;14558
71233;L'Hôpital-le-Mercier;156;3331869;85633;84;2423288;72;908581;21358;14559
12121;Lanuéjouls;395;8436472;241694;189;6160525;206;2275947;21358;14560
33320;Petit-Palais-et-Cornemps;380;8116156;270621;184;6059024;196;2057132;21358;14561
38094;Châtonnay;1074;22938896;691962;600;17669207;474;5269689;21358;14562
49245;Pontigné;127;2712516;125003;56;1889478;71;823038;21358;14563
30301;Saint-Victor-des-Oules;167;3566863;104755;80;2685054;87;881809;21358;14564
65081;Benqué;54;1153362;48554;28;859140;26;294222;21359;14565
66069;Espira-de-l'Agly;1715;36630199;1511723;871;28122187;844;8508012;21359;14566
14544;Roucamps;104;2221334;51544;50;1525876;54;695458;21359;14567
85296;Treize-Vents;611;13051010;244441;345;9745587;266;3305423;21360;14568
76590;Saint-Jacques-d'Aliermont;188;4015762;110678;104;3197000;84;818762;21360;14569
32345;La Romieu;305;6514992;253903;152;5008023;153;1506969;21361;14570
71570;Verjux;300;6408281;257396;150;4797582;150;1610699;21361;14571
38163;La Ferrière;144;3075996;117649;80;2408507;64;667489;21361;14572
46317;Thégra;278;5938388;233180;138;4484299;140;1454089;21361;14573
29217;Pont-Aven;1787;38172315;1663224;879;28188169;908;9984146;21361;14574
70401;Ovanches;75;1602108;60352;45;1277992;30;324116;21361;14575
62149;Boisdinghem;120;2563376;86157;64;2028865;56;534511;21361;14576
14333;Honfleur;4817;102901285;5952957;2327;78499679;2490;24401606;21362;14577
53027;Beaumont-Pied-de-Boeuf;110;2349848;79947;53;1776398;57;573450;21362;14578
58090;Courcelles;127;2713018;145554;70;2103020;57;609998;21362;14579
59590;Thiennes;439;9378081;220205;237;7024845;202;2353236;21362;14580
21243;Écutigny;57;1217667;60426;27;898750;30;318917;21363;14581
21304;Grancey-le-Château-Neuvelle;137;2926784;110659;73;2273215;64;653569;21363;14582
72154;La Flèche;8354;178470269;7217890;4262;136355686;4092;42114583;21363;14583
57383;Languimberg;98;2093622;57127;48;1475531;50;618091;21363;14584
03157;Magnet;472;10083673;269130;260;7639699;212;2443974;21364;14585
25244;Fleurey;50;1068186;31471;27;829573;23;238613;21364;14586
09040;La Bastide-de-Lordat;145;3097803;91304;80;2440468;65;657335;21364;14587
40056;Brocas;439;9378949;291138;224;7193397;215;2185552;21364;14588
70583;Vy-lès-Filain;53;1132321;16847;27;846654;26;285667;21365;14589
33485;Sainte-Terre;1048;22390063;867518;507;16689750;541;5700313;21365;14590
39549;Vercia;173;3696109;146602;102;2963512;71;732597;21365;14591
89182;Fouronnes;91;1944212;82702;48;1510610;43;433602;21365;14592
28086;Chassant;170;3632069;123510;96;2924420;74;707649;21365;14593
65455;Tuzaguet;277;5918145;232006;165;4782641;112;1135504;21365;14594
65113;Burg;164;3503886;184426;82;2714475;82;789411;21365;14595
25488;Rennes-sur-Loue;51;1089642;19426;30;924625;21;165017;21366;14596
19241;Saint-Setiers;153;3268928;172311;87;2569125;66;699803;21366;14597
51442;Possesse;90;1922904;62035;49;1401036;41;521868;21366;14598
69230;Sainte-Paule;161;3439993;99599;86;2687011;75;752982;21366;14599
69037;Chambost-Allières;424;9059394;256625;233;6878217;191;2181177;21366;14600
29294;Le Tréhou;286;6110949;129424;140;4359400;146;1751549;21367;14601
30243;Saint-Christol-lès-Alès;3851;82285368;3415030;1885;61695382;1966;20589986;21367;14602
18007;Apremont-sur-Allier;43;918827;40069;30;759963;13;158864;21368;14603
85286;La Taillée;301;6431886;248117;159;4939427;142;1492459;21368;14604
71461;Saint-Maurice-des-Champs;37;790631;16590;20;588883;17;201748;21368;14605
54465;Roville-devant-Bayon;414;8846637;197161;212;6365883;202;2480754;21369;14606
10179;Jeugny;250;5342213;135379;139;3959828;111;1382385;21369;14607
43202;Saint-Julien-des-Chazes;47;1004355;44917;24;726150;23;278205;21369;14608
55264;Koeur-la-Petite;146;3119930;84871;89;2509577;57;610353;21369;14609
46136;Labastide-du-Vert;144;3077211;116818;70;2278969;74;798242;21370;14610
46035;Boussac;101;2158413;63338;52;1590266;49;568147;21370;14611
62245;Coulomby;312;6667615;138522;153;4710939;159;1956676;21371;14612
35061;La Chapelle-Erbrée;319;6817294;108254;179;4982515;140;1834779;21371;14613
58253;Sainte-Marie;54;1154037;45191;35;932440;19;221597;21371;14614
80787;Vercourt;51;1089945;21765;26;750368;25;339577;21371;14615
27370;Lisors;182;3889736;114865;101;3017454;81;872282;21372;14616
85034;Bournezeau;1663;35542062;1139680;883;27081776;780;8460286;21372;14617
58157;Marigny-l'Église;194;4146218;194810;98;3310354;96;835864;21372;14618
63116;Combronde;1252;26758161;1068425;659;20506626;593;6251535;21372;14619
85010;Avrillé;776;16584974;660657;407;12552542;369;4032432;21372;14620
68226;Munster;2845;60806884;2728530;1402;45524580;1443;15282304;21373;14621
67434;Sarre-Union;1700;36335087;1655873;811;27062763;889;9272324;21374;14622
29073;Guimaëc;559;11947954;404262;298;9236283;261;2711671;21374;14623
62881;Beauvoir-Wavans;214;4574007;142673;112;3474955;102;1099052;21374;14624
80365;Fricamps;69;1474797;34431;35;1076198;34;398599;21374;14625
51535;Sézanne;3135;67007304;3617753;1628;52722440;1507;14284864;21374;14626
76333;Guerville;244;5215367;206072;140;4058131;104;1157236;21374;14627
19179;Saillac;113;2415315;79567;64;1974448;49;440867;21374;14628
49009;Antoigné;256;5471949;133683;136;3983390;120;1488559;21375;14629
54053;Bauzemont;73;1560373;34726;39;1187782;34;372591;21375;14630
79029;Beaulieu-sous-Parthenay;352;7524025;282950;189;5817807;163;1706218;21375;14631
21337;Lamarche-sur-Saône;721;15411675;404818;413;11883616;308;3528059;21375;14632
53051;Champéon;324;6925698;260276;156;4931201;168;1994497;21376;14633
25404;Montmahoux;52;1111544;40212;26;833115;26;278429;21376;14634
55425;Remoiville;75;1603193;33884;44;1169141;31;434052;21376;14635
45050;Boynes;698;14920487;471124;378;11300604;320;3619883;21376;14636
89057;Brosses;180;3847693;135310;106;3016498;74;831195;21376;14637
17424;Semoussac;152;3249347;124312;71;2454847;81;794500;21377;14638
31317;Marignac-Lasclares;213;4553386;101330;106;3435427;107;1117959;21377;14639
62882;Wavrans-sur-l'Aa;634;13554048;374578;328;10055634;306;3498414;21379;14640
64166;Caro;104;2223378;72471;50;1667985;54;555393;21379;14641
02357;Gronard;32;684133;12741;17;487659;15;196474;21379;14642
19272;Tulle;8747;187004267;9181221;4862;149081172;3885;37923095;21379;14643
10433;Villy-en-Trodes;141;3014483;107507;86;2483279;55;531204;21379;14644
88293;Maxey-sur-Meuse;135;2886212;94908;68;2204884;67;681328;21379;14645
03227;Saint-Didier-la-Forêt;222;4746284;170922;113;3472279;109;1274005;21380;14646
31554;Touille;152;3249965;134020;82;2469317;70;780648;21381;14647
88460;Soulosse-sous-Saint-Élophe;338;7227042;244512;177;5637680;161;1589362;21382;14648
76130;Bouelles;140;2993604;67905;79;2336105;61;657499;21383;14649
51399;La Neuville-au-Pont;293;6265358;226144;164;4776374;129;1488984;21383;14650
33377;Saint-Avit-de-Soulège;43;919497;39363;17;608022;26;311475;21384;14651
02771;Vauxcéré;50;1069205;30491;24;763899;26;305306;21384;14652
82045;Cordes-Tolosannes;173;3699472;102165;86;2796703;87;902769;21384;14653
31586;Villeneuve-Lécussan;305;6522195;236507;173;5267739;132;1254456;21384;14654
83148;Vidauban;5767;123323232;5166271;2974;95261924;2793;28061308;21384;14655
80030;Arry;99;2117065;72064;46;1698095;53;418970;21384;14656
16353;Saint-Sornin;443;9473417;361577;212;6729831;231;2743586;21385;14657
55029;Bar-le-Duc;9449;202067549;11393903;4961;162162503;4488;39905046;21385;14658
21468;Orain;62;1325877;42470;28;867302;34;458575;21385;14659
42023;Bourg-Argental;1737;37147169;1273754;915;28115655;822;9031514;21386;14660
35293;Saint-Marc-sur-Couesnon;276;5902501;112871;156;4539253;120;1363248;21386;14661
13117;Vitrolles;19874;425031141;16912658;10878;336461051;8996;88570090;21386;14662
50070;Boutteville;29;620208;19452;16;491102;13;129106;21386;14663
80549;Miraumont;358;7656399;298869;194;5890237;164;1766162;21387;14664
49258;La Renaudière;488;10436708;129736;271;7613946;217;2822762;21387;14665
87071;Glandon;460;9838063;418586;245;7727394;215;2110669;21387;14666
74273;Sixt-Fer-à-Cheval;437;9346184;293150;261;7493065;176;1853119;21387;14667
73303;Ugine;4163;89034860;3365785;2353;69603476;1810;19431384;21387;14668
24156;La Douze;603;12896708;520639;300;9582620;303;3314088;21388;14669
29214;Plovan;416;8897259;400169;212;6890005;204;2007254;21388;14670
57264;Guebenhouse;222;4748065;162114;113;3416339;109;1331726;21388;14671
49351;La Tourlandry;662;14159451;228723;368;10553172;294;3606279;21389;14672
85051;Chantonnay;4481;95844279;2701736;2335;72161207;2146;23683072;21389;14673
71383;Saint-Albain;281;6010463;181666;168;4733210;113;1277253;21390;14674
64293;Labatut;90;1925083;85359;46;1495193;44;429890;21390;14675
30285;Saint-Maurice-de-Cazevieille;341;7294034;299480;147;5180331;194;2113703;21390;14676
39329;Mièges;50;1069512;41671;27;794559;23;274953;21390;14677
07336;Vernon;132;2823541;158580;66;2228786;66;594755;21390;14678
17425;Semussac;1203;25733192;803964;688;20081727;515;5651465;21391;14679
17406;Saint-Sornin;188;4021632;147413;104;3101484;84;920148;21392;14680
38359;Saint-Antoine-l'Abbaye;610;13049046;498369;306;9904191;304;3144855;21392;14681
67477;Steige;323;6909796;193311;186;5243678;137;1666118;21393;14682
85002;L'Aiguillon-sur-Vie;1007;21542591;507032;572;16390211;435;5152380;21393;14683
24177;Faux;343;7337781;260810;175;5572693;168;1765088;21393;14684
08156;Éteignières;260;5562282;162007;138;3881335;122;1680947;21393;14685
93048;Montreuil;63452;1357460507;83344135;32955;1103127250;30497;254333257;21394;14686
47280;Saint-Sylvestre-sur-Lot;1324;28325237;1219206;666;21414961;658;6910276;21394;14687
54189;Favières;300;6418147;209525;166;4981131;134;1437016;21394;14688
12145;Millau;13452;287794164;13306769;6614;218403430;6838;69390734;21394;14689
32220;Luppé-Violles;85;1818570;59988;39;1224452;46;594118;21395;14690
85232;Saint-Hilaire-le-Vouhis;510;10912159;450211;234;7760922;276;3151237;21396;14691
71564;Vendenesse-lès-Charolles;414;8858339;254533;211;6349282;203;2509057;21397;14692
04055;Chaudon-Norante;93;1989936;69452;53;1591966;40;397970;21397;14693
65283;Loudervielle;34;727507;36041;18;587973;16;139534;21397;14694
49376;Villemoisan;315;6740196;107768;165;4871446;150;1868750;21397;14695
61309;Nocé;437;9350975;378187;241;7314555;196;2036420;21398;14696
72244;Précigné;1585;33916363;993524;852;26131142;733;7785221;21398;14697
16301;Saint-Aulais-la-Chapelle;150;3209801;165672;75;2543463;75;666338;21399;14698
66214;Tresserre;482;10314162;379313;260;8068355;222;2245807;21399;14699
27552;Saint-Jean-du-Thenney;114;2439476;72316;60;1870509;54;568967;21399;14700
57587;Rodalbe;126;2696487;84087;76;2117468;50;579019;21401;14701
17171;Geay;373;7982634;259197;190;6070725;183;1911909;21401;14702
79031;Beauvoir-sur-Niort;999;21379948;806279;547;16629208;452;4750740;21401;14703
41125;Marcilly-en-Gault;448;9587933;359363;248;7351408;200;2236525;21402;14704
71104;Charnay-lès-Chalon;115;2461255;110027;58;1810384;57;650871;21402;14705
85129;Les Lucs-sur-Boulogne;1760;37667923;1141801;925;28369145;835;9298778;21402;14706
27248;Folleville;106;2268670;51511;62;1695544;44;573126;21403;14707
72172;Le Luart;761;16287458;477423;444;12899347;317;3388111;21403;14708
68247;Oderen;741;15859918;644274;384;11735084;357;4124834;21403;14709
30254;Saint-Geniès-de-Comolas;1002;21446398;654919;534;16224169;468;5222229;21404;14710
30241;Saint-Chaptes;931;19926896;707853;474;15022973;457;4903923;21404;14711
72332;Ségrie;320;6849273;182388;185;5316551;135;1532722;21404;14712
14616;Sainte-Marguerite-de-Viette;202;4323646;169385;92;3067495;110;1256151;21404;14713
21332;Labergement-lès-Seurre;542;11601106;358440;270;8557478;272;3043628;21404;14714
08310;Mouron;43;920399;18940;16;572401;27;347998;21405;14715
12199;Rignac;1069;22881903;1099125;519;17315831;550;5566072;21405;14716
32034;Bazugues;33;706384;10173;14;392889;19;313495;21406;14717
50086;Brillevast;189;4045744;127181;89;2919171;100;1126573;21406;14718
14219;Danvou-la-Ferrière;89;1905141;73207;51;1557805;38;347336;21406;14719
33196;Guillac;90;1926572;52818;42;1371574;48;554998;21406;14720
52165;Dancevoir;140;2996915;164220;66;2222988;74;773927;21407;14721
51222;Éclaires;50;1070329;58503;23;826980;27;243349;21407;14722
21249;Esbarres;380;8134621;225641;196;5951340;184;2183281;21407;14723
03307;Verneuil-en-Bourbonnais;144;3082625;68360;72;2000985;72;1081640;21407;14724
40236;Poyartin;420;8991022;337033;223;6825432;197;2165590;21407;14725
76397;Longueville-sur-Scie;503;10767923;574390;239;7913464;264;2854459;21407;14726
24357;Rouffignac-de-Sigoulès;192;4110284;172860;95;3108591;97;1001693;21408;14727
72382;Volnay;454;9719507;213468;257;7362840;197;2356667;21409;14728
62701;Rely;231;4945572;111559;125;3751424;106;1194148;21409;14729
19218;Saint-Julien-près-Bort;250;5352392;172403;117;3384569;133;1967823;21410;14730
50133;Chèvreville;102;2183828;29023;53;1629980;49;553848;21410;14731
33024;Bagas;140;2997470;97549;72;2255517;68;741953;21411;14732
17122;Coulonges;131;2804780;132315;69;2134007;62;670773;21411;14733
21398;Maxilly-sur-Saône;169;3618395;127114;89;2705343;80;913052;21411;14734
61288;Montmerrei;270;5781108;232320;143;4491013;127;1290095;21412;14735
17473;Villemorin;66;1413160;75677;33;1082333;33;330827;21412;14736
71141;Colombier-en-Brionnais;155;3318808;71721;84;2394089;71;924719;21412;14737
67144;Fouday;185;3961243;98278;105;3019896;80;941347;21412;14738
63230;Le Monestier;125;2676524;120167;62;1945983;63;730541;21412;14739
58250;Saint-Léger-des-Vignes;1160;24838469;1024678;635;19408141;525;5430328;21412;14740
33321;Peujard;927;19849684;500075;493;14917686;434;4931998;21413;14741
42151;Mornand-en-Forez;199;4261160;141143;99;3201339;100;1059821;21413;14742
61160;Feings;133;2847919;122247;71;2167874;62;680045;21413;14743
41172;Ouzouer-le-Doyen;125;2676630;92367;65;1927548;60;749082;21413;14744
70111;Calmoutier;141;3019285;122796;86;2487157;55;532128;21413;14745
48009;Aumont-Aubrac;640;13704580;608191;327;10435323;313;3269257;21413;14746
25439;Ougney-Douvot;121;2591227;72871;68;2058876;53;532351;21415;14747
31434;Poubeau;44;942265;31351;25;704289;19;237976;21415;14748
41275;La Ville-aux-Clercs;748;16019471;625401;379;11963687;369;4055784;21416;14749
27221;Épinay;182;3897786;146891;94;2953227;88;944559;21416;14750
35226;Pleugueneuc;907;19424921;552105;463;14683686;444;4741235;21417;14751
41232;Salbris;3302;70719304;3146787;1827;55175363;1475;15543941;21417;14752
73058;La Bridoire;678;14520952;524198;359;11040752;319;3480200;21417;14753
19289;Yssandon;362;7753376;191311;196;5869074;166;1884302;21418;14754
76026;Arques-la-Bataille;1425;30522022;1254445;764;23407122;661;7114900;21419;14755
38272;Murinais;207;4433780;160567;113;3501103;94;932677;21419;14756
19100;Lagraulière;623;13344977;469732;332;10400649;291;2944328;21421;14757
35281;Saint-Jacques-de-la-Lande;6166;132080160;5117504;3794;108261877;2372;23818283;21421;14758
60108;Briot;146;3127460;92376;89;2561667;57;565793;21421;14759
85119;Les Landes-Genusson;1246;26690838;515456;718;20417165;528;6273673;21421;14760
30039;Bezouce;1206;25834589;874201;661;20248959;545;5585630;21422;14761
33488;Saint-Vincent-de-Pertignas;233;4991350;176411;119;3757873;114;1233477;21422;14762
39264;Grusse;112;2399277;70760;63;1899021;49;500256;21422;14763
77489;Vaux-sur-Lunain;134;2870602;125400;57;1933819;77;936783;21422;14764
24091;Cénac-et-Saint-Julien;690;14781478;584647;364;11426711;326;3354767;21422;14765
57088;Bistroff;191;4091685;163316;108;3208184;83;883501;21422;14766
02219;Coucy-la-Ville;93;1992297;60763;49;1521062;44;471235;21423;14767
47022;Bazens;273;5848374;219921;135;4481961;138;1366413;21423;14768
60537;Ribécourt-Dreslincourt;2028;43448082;1652111;1114;33867525;914;9580557;21424;14769
70163;Colombier;236;5056095;135050;126;3832585;110;1223510;21424;14770
62122;Beugny;203;4349160;134376;113;3371296;90;977864;21424;14771
25197;Deluz;370;7927305;251895;225;6319074;145;1608231;21425;14772
66226;Villemolaque;611;13091027;586354;286;9742161;325;3348866;21426;14773
54362;Mercy-le-Bas;714;15297897;321778;301;9028704;413;6269193;21426;14774
62805;Tangry;137;2935368;100449;65;2197919;72;737449;21426;14775
39027;Augisey;107;2292589;61563;57;1744245;50;548344;21426;14776
62638;Oisy-le-Verger;683;14634146;599153;355;11123953;328;3510193;21426;14777
80332;Forest-Montiers;226;4842414;226020;112;3816630;114;1025784;21427;14778
69110;Larajasse;988;21169554;592928;510;15605325;478;5564229;21427;14779
88358;Pouxeux;1078;23097956;726418;607;17905079;471;5192877;21427;14780
89146;Domecy-sur-le-Vault;56;1199919;62363;29;945813;27;254106;21427;14781
89478;Vincelles;592;12684973;575597;321;10067433;271;2617540;21427;14782
36183;Sainte-Cécile;49;1049943;35488;23;757008;26;292935;21427;14783
21618;Talmay;310;6642507;233520;165;4947531;145;1694976;21427;14784
01323;Reyssouze;509;10906664;357776;285;8732304;224;2174360;21428;14785
57515;Novéant-sur-Moselle;1053;22564675;881119;558;17734515;495;4830160;21429;14786
59200;Eringhem;229;4907284;121848;114;3498297;115;1408987;21429;14787
85036;La Bretonnière-la-Claye;295;6321884;176132;152;4588305;143;1733579;21430;14788
52090;Celsoy;56;1200104;24794;32;876727;24;323377;21430;14789
21356;Losne;862;18473220;533761;466;13995018;396;4478202;21431;14790
21292;Genlis;3035;65042073;2198183;1748;51003748;1287;14038325;21431;14791
79356;Voultegon;273;5850594;71974;140;4206533;133;1644061;21431;14792
56202;Saint-Abraham;274;5872049;112820;150;4430569;124;1441480;21431;14793
59627;Villers-Sire-Nicole;541;11594101;472308;288;9011019;253;2583082;21431;14794
54359;Méhoncourt;133;2850375;76899;73;2159670;60;690705;21431;14795
26166;Loriol-sur-Drôme;3305;70830796;2543028;1587;51947607;1718;18883189;21431;14796
82002;Albias;1693;36284949;1419844;821;27401427;872;8883522;21432;14797
89364;Saint-Père;216;4629646;245237;109;3581679;107;1047967;21434;14798
55285;Lavoye;87;1864730;86303;40;1374986;47;489744;21434;14799
29297;Tréméven;1253;26856580;720628;716;20686774;537;6169806;21434;14800
54134;Colmey;136;2915098;99061;56;1764808;80;1150290;21435;14801
18140;Massay;818;17533469;590778;452;13410365;366;4123104;21435;14802
61199;Habloville;187;4008283;175847;93;2923197;94;1085086;21435;14803
12151;Montézic;134;2872286;83955;61;1998030;73;874256;21435;14804
71185;Dyo;174;3729746;75244;87;2646181;87;1083565;21435;14805
80490;Longueval;148;3172438;106860;69;2187962;79;984476;21435;14806
57455;Mégange;96;2057801;56507;52;1611464;44;446337;21435;14807
67017;Baerendorf;149;3193922;73465;79;2299164;70;894758;21436;14808
34210;Le Pouget;1045;22400867;1068445;495;17039301;550;5361566;21436;14809
34315;Usclas-d'Hérault;174;3729929;128063;77;2637307;97;1092622;21436;14810
27227;Étréville;326;6988441;209172;172;5122134;154;1866307;21437;14811
38473;Sardieu;502;10761427;221748;276;7998949;226;2762478;21437;14812
46163;Laval-de-Cère;203;4351774;315174;98;3401932;105;949842;21437;14813
80519;Matigny;287;6152562;336788;145;4562087;142;1590475;21437;14814
71272;Malay;140;3001276;103667;73;2181303;67;819973;21438;14815
65025;Argelès-Gazost;2061;44183733;1967953;1062;33505540;999;10678193;21438;14816
72266;Saint-Aubin-de-Locquenay;373;7996497;184298;212;6009022;161;1987475;21438;14817
28051;Bonneval;2808;60199051;2705806;1490;47350686;1318;12848365;21438;14818
25331;Lavans-Vuillafans;107;2293932;23117;51;1615067;56;678865;21439;14819
86173;Mouterre-Silly;391;8382581;242965;206;6295802;185;2086779;21439;14820
53089;Daon;259;5552896;184362;138;4076030;121;1476866;21440;14821
16340;Saint-Même-les-Carrières;620;13292741;499339;295;9841031;325;3451710;21440;14822
27367;Lieurey;760;16294410;654372;386;12373839;374;3920571;21440;14823
71355;Pontoux;143;3065946;93372;83;2359427;60;706519;21440;14824
34341;Villeveyrac;1843;39514569;1398172;898;29623754;945;9890815;21440;14825
30309;Sardan;171;3666381;164626;80;2747654;91;918727;21441;14826
46223;Pontcirq;103;2208449;79734;56;1714548;47;493901;21441;14827
47084;Douzains;130;2787401;109998;72;2166409;58;620992;21442;14828
73112;Feissons-sur-Isère;348;7461829;247723;193;5617209;155;1844620;21442;14829
70083;Bouligney;240;5146278;162009;130;3961228;110;1185050;21443;14830
60604;Sarcus;134;2873428;93232;72;2166803;62;706625;21443;14831
35195;Montreuil-sur-Ille;1070;22945029;529923;579;17577177;491;5367852;21444;14832
89188;Girolles;96;2058649;40743;54;1556310;42;502339;21444;14833
70105;Bucey-lès-Traves;68;1458210;53181;38;1118669;30;339541;21444;14834
40118;Habas;823;17648912;610635;404;13141080;419;4507832;21445;14835
83006;Artigues;121;2594925;53731;60;1829416;61;765509;21446;14836
73012;Albiez-le-Jeune;69;1479764;54562;40;1212016;29;267748;21446;14837
61089;Champosoult;50;1072296;34552;32;866571;18;205725;21446;14838
12177;Palmas;190;4074745;156662;99;3212706;91;862039;21446;14839
39409;Peintre;69;1479842;43742;35;1120079;34;359763;21447;14840
33436;Saint-Magne;512;10980957;380713;255;8375471;257;2605486;21447;14841
80049;Ayencourt;94;2016037;90014;51;1544685;43;471352;21447;14842
30133;Le Grau-du-Roi;6539;140244100;8166857;3443;111290981;3096;28953119;21447;14843
38237;Mizoën;103;2209225;69438;68;1829127;35;380098;21449;14844
80647;Puzeaux;121;2595316;57820;62;1922621;59;672695;21449;14845
63074;Chalus;102;2187804;54047;59;1703574;43;484230;21449;14846
26016;Aubres;216;4633140;127326;124;3661759;92;971381;21450;14847
71435;Saint-Julien-sur-Dheune;126;2702697;75531;72;2091178;54;611519;21450;14848
33537;Uzeste;242;5190907;219185;125;3976897;117;1214010;21450;14849
25516;Saint-Georges-Armont;54;1158321;31820;24;718030;30;440291;21450;14850
62777;Le Sars;82;1758934;82075;39;1319845;43;439089;21450;14851
71147;Cortevaix;137;2938741;129652;69;2169066;68;769675;21451;14852
62121;Beugnâtre;69;1480119;63770;31;976164;38;503955;21451;14853
36181;Saint-Aubin;100;2145106;58117;57;1663855;43;481251;21451;14854
07099;Gras;306;6564048;211741;151;4902820;155;1661228;21451;14855
48047;La Chaze-de-Peyre;155;3324954;146258;87;2644634;68;680320;21451;14856
09276;Saint-Victor-Rouzaud;121;2595682;157474;59;2012052;62;583630;21452;14857
54407;Ognéville;62;1330029;42065;36;1027693;26;302336;21452;14858
35171;Médréac;920;19736552;425128;475;14311176;445;5425376;21453;14859
14650;Saint-Pierre-du-Fresne;99;2123907;67379;55;1616578;44;507329;21454;14860
49328;Saumur;16079;344954445;17891907;7931;265787901;8148;79166544;21454;14861
70340;Membrey;115;2467243;70606;62;1733810;53;733433;21454;14862
18015;Aubigny-sur-Nère;3336;71571675;3180167;1778;55496279;1558;16075396;21454;14863
32457;Urdens;143;3067982;63440;71;2057943;72;1010039;21454;14864
71363;Le Puley;54;1158563;36880;29;886025;25;272538;21455;14865
86056;La Chapelle-Montreuil;348;7466356;168954;189;5611765;159;1854591;21455;14866
89249;Mercy;46;986933;14756;23;710164;23;276769;21455;14867
22065;Goudelin;877;18816530;500464;456;13936856;421;4879674;21456;14868
55281;Latour-en-Woëvre;42;901142;23268;25;720281;17;180861;21456;14869
47185;Montayral;1670;35831455;1328305;812;26795190;858;9036265;21456;14870
14570;Saint-Cyr-du-Ronceray;355;7616974;235112;187;5706835;168;1910139;21456;14871
64418;Noguères;80;1716505;51759;47;1310207;33;406298;21456;14872
18215;Saint-Hilaire-de-Gondilly;98;2102729;71386;49;1576771;49;525958;21456;14873
80662;Ramburelles;143;3068286;141865;67;2360363;76;707923;21457;14874
37181;Paulmy;133;2853739;92067;71;2125762;62;727977;21457;14875
22076;Hénanbihen;756;16221477;547936;396;12109952;360;4111525;21457;14876
62139;Blendecques;2691;57742038;2310089;1309;42953170;1382;14788868;21457;14877
79166;Marigny;465;9977723;261042;266;7736227;199;2241496;21457;14878
67099;Domfessel;159;3411860;101404;79;2424151;80;987709;21458;14879
80019;Allery;444;9527486;405089;217;6996820;227;2530666;21458;14880
05029;Chabottes;433;9291751;337068;224;6905402;209;2386349;21459;14881
54080;Blénod-lès-Toul;543;11652272;325017;293;8878062;250;2774210;21459;14882
70557;Villefrancon;62;1330462;54128;39;1088099;23;242363;21459;14883
34073;Cers;1262;27082650;1092321;614;20175549;648;6907101;21460;14884
80500;Maisnières;273;5858658;290617;137;4402290;136;1456368;21460;14885
16140;Fontclaireau;210;4506716;150305;104;3322458;106;1184258;21461;14886
32073;Campagne-d'Armagnac;113;2425077;65885;56;1849958;57;575119;21461;14887
72307;Saint-Ouen-en-Champagne;94;2017322;40141;54;1571938;40;445384;21461;14888
57427;Lutzelbourg;371;7962047;297297;202;6069320;169;1892727;21461;14889
85246;Saint-Martin-des-Noyers;1210;25967979;729910;678;20102253;532;5865726;21461;14890
61232;Lonlay-l'Abbaye;647;13885958;576214;292;10199517;355;3686441;21462;14891
56031;Camors;1557;33416565;1005442;835;25205051;722;8211514;21462;14892
31505;Saint-Michel;184;3949064;159844;87;2902049;97;1047015;21462;14893
01051;Bolozon;54;1159000;54713;31;922402;23;236598;21463;14894
57556;Puttelange-aux-Lacs;1735;37238566;1750898;828;27436696;907;9801870;21463;14895
02018;Anizy-le-Château;1109;23803151;1053501;551;17954751;558;5848400;21464;14896
89355;Saint-Martin-sur-Armançon;79;1695648;85214;48;1387137;31;308511;21464;14897
39309;Mallerey;35;751258;22096;21;581625;14;169633;21465;14898
45115;Courtenay;2426;52073262;2473647;1278;40037154;1148;12036108;21465;14899
56020;Bohal;385;8263930;175055;219;6423943;166;1839987;21465;14900
49012;Aubigné-sur-Layon;210;4507606;184079;102;3291331;108;1216275;21465;14901
47233;Sainte-Bazeille;1717;36855584;1469903;840;27345919;877;9509665;21465;14902
40194;Montfort-en-Chalosse;659;14145511;619215;321;10730999;338;3414512;21465;14903
46027;Berganty;61;1309418;50749;30;970389;31;339029;21466;14904
22380;Trévron;366;7856525;243011;188;5718348;178;2138177;21466;14905
80278;Erches;95;2039272;58794;58;1625786;37;413486;21466;14906
62123;Beussent;283;6074899;294765;127;4490449;156;1584450;21466;14907
33044;Bellefond;138;2962398;127498;72;2208024;66;754374;21467;14908
31408;Payssous;41;880161;24882;20;640373;21;239788;21467;14909
42014;Belleroche;143;3069924;103641;74;2361131;69;708793;21468;14910
59406;Monceau-Saint-Waast;248;5324092;240748;123;4087766;125;1236326;21468;14911
65100;Bordères-sur-l'Échez;2598;55774644;2142414;1409;43951689;1189;11822955;21468;14912
37209;Saint-Bauld;100;2146936;47726;56;1676754;44;470182;21469;14913
07013;Ardoix;536;11508069;231045;296;8627806;240;2880263;21470;14914
62651;Penin;211;4530241;160150;109;3458474;102;1071767;21470;14915
80677;Roisel;999;21449346;1039869;460;16250429;539;5198917;21471;14916
03128;Huriel;1485;31884293;1193586;852;25346771;633;6537522;21471;14917
22323;Saint-Pôtan;427;9168258;258719;228;6999640;199;2168618;21471;14918
72011;Assé-le-Boisne;462;9919865;196864;256;7486074;206;2433791;21472;14919
50317;Le Mesnil-Ozenne;116;2490740;54534;69;1879892;47;610848;21472;14920
04222;Turriers;139;2984628;121427;73;2335200;66;649428;21472;14921
25175;Courtetain-et-Salans;43;923304;44319;17;610819;26;312485;21472;14922
47289;La Sauvetat-de-Savères;270;5797614;184257;134;4403305;136;1394309;21473;14923
44224;La Grigonnais;760;16319314;416562;400;12086842;360;4232472;21473;14924
18171;Orcenais;147;3156509;64512;58;2183170;89;973339;21473;14925
25145;Chazot;68;1460167;50444;37;1060939;31;399228;21473;14926
88243;Housseras;257;5518688;156484;133;4142149;124;1376539;21473;14927
51080;Brandonvillers;88;1889688;48960;48;1410035;40;479653;21474;14928
02596;Pavant;412;8847274;271601;233;6866707;179;1980567;21474;14929
40306;Sorde-l'Abbaye;353;7580372;263521;194;5835811;159;1744561;21474;14930
59583;Taisnières-en-Thiérache;265;5690706;223208;137;4386109;128;1304597;21474;14931
40274;Saint-Martin-d'Oney;704;15118195;416518;405;11708158;299;3410037;21475;14932
50633;Le Vicel;80;1717977;86004;37;1372009;43;345968;21475;14933
61036;Belfonds;109;2340783;111881;48;1815781;61;525002;21475;14934
33406;Saint-Genès-de-Castillon;224;4810534;187891;119;3718507;105;1092027;21476;14935
55570;Villotte-sur-Aire;109;2340852;54212;60;1802991;49;537861;21476;14936
54526;Tomblaine;4102;88093938;3192138;2234;68943053;1868;19150885;21476;14937
05077;Molines-en-Queyras;198;4252319;158940;104;3254081;94;998238;21476;14938
25453;Pierrefontaine-les-Varans;762;16365155;591476;388;12117749;374;4247406;21477;14939
65009;Anères;99;2126187;63901;56;1590662;43;535525;21477;14940
16339;Auge-Saint-Médard;184;3951714;307155;71;2975079;113;976635;21477;14941
56083;Hennebont;9026;193849122;8742935;4865;151787173;4161;42061949;21477;14942
76488;Ouainville;250;5369191;161647;129;4048957;121;1320234;21477;14943
79030;Beaussais;236;5068573;132857;118;3711121;118;1357452;21477;14944
23150;Peyrabout;97;2083352;99165;49;1641736;48;441616;21478;14945
35128;Guipel;850;18256371;418282;461;13813536;389;4442835;21478;14946
45053;Briare;3318;71264692;3393176;1724;55160167;1594;16104525;21478;14947
32369;Sainte-Christie-d'Armagnac;218;4682363;194441;118;3613043;100;1069320;21479;14948
23201;Saint-Hilaire-la-Plaine;136;2921114;149230;72;2401144;64;519970;21479;14949
38171;La Forteresse;178;3823317;147233;104;3083388;74;739929;21479;14950
51432;Pleurs;488;10481956;464228;242;7798496;246;2683460;21479;14951
33102;Casseuil;234;5026216;278499;106;3725563;128;1300653;21480;14952
81190;Mouzieys-Teulet;211;4532270;185180;106;3385717;105;1146553;21480;14953
17240;Montendre;2007;43111662;1887274;824;32349461;1183;10762201;21481;14954
88104;Circourt-sur-Mouzon;114;2448816;85499;69;1855748;45;593068;21481;14955
39444;Pretin;38;816284;24028;20;593042;18;223242;21481;14956
39517;Sirod;296;6358522;175067;155;4702013;141;1656509;21481;14957
73142;Landry;493;10590550;366214;306;8667658;187;1922892;21482;14958
33030;Barsac;1211;26014967;1239228;637;20441461;574;5573506;21482;14959
19006;Alleyrat;65;1396451;34860;36;989248;29;407203;21484;14960
33310;Origne;108;2320266;114868;63;1886170;45;434096;21484;14961
17256;Nantillé;167;3587849;189763;87;2830113;80;757736;21484;14962
39522;Supt;63;1353512;54320;31;982293;32;371219;21484;14963
54602;Han-devant-Pierrepont;74;1589851;25035;32;950432;42;639419;21484;14964
85142;La Merlatière;482;10355617;216447;273;8015046;209;2340571;21485;14965
44040;Chéméré;1229;26404945;569780;680;20236095;549;6168850;21485;14966
80282;Érondelle;230;4941546;114112;128;3618694;102;1322852;21485;14967
02548;La Neuville-lès-Dorengt;192;4125120;152479;99;3097967;93;1027153;21485;14968
50020;Auderville;135;2900545;123620;77;2400309;58;500236;21486;14969
31432;Portet-de-Luchon;22;472703;24658;11;360587;11;112116;21487;14970
31406;Palaminy;428;9196276;314171;217;7001966;211;2194310;21487;14971
03033;Bost;98;2105695;43782;58;1615049;40;490646;21487;14972
47328;Saint-Georges;274;5887387;217739;131;4291688;143;1595699;21487;14973
26105;Cornillon-sur-l'Oule;47;1009903;28875;14;726874;33;283029;21487;14974
80284;Esmery-Hallon;425;9132380;357989;217;6972387;208;2159993;21488;14975
55461;Saint-Laurent-sur-Othain;241;5178749;101084;108;3182496;133;1996253;21489;14976
11158;Gaja-et-Villedieu;175;3760706;160373;91;2982201;84;778505;21490;14977
19055;Chirac-Bellevue;147;3159014;95686;82;2438582;65;720432;21490;14978
64014;Ainhoa;360;7736491;280231;187;5877906;173;1858585;21490;14979
55022;Avioth;82;1762215;55657;40;1203516;42;558699;21490;14980
35269;Saint-Georges-de-Chesné;310;6662074;112349;157;4760999;153;1901075;21491;14981
65418;Sénac;150;3223676;133900;84;2530724;66;692952;21491;14982
02447;Maast-et-Violaine;85;1826782;126071;38;1439752;47;387030;21492;14983
44005;Arthon-en-Retz;2015;43307440;1071867;1072;32146740;943;11160700;21493;14984
88390;Robécourt;65;1397108;58603;33;1059210;32;337898;21494;14985
02312;La Flamengrie;570;12251712;331482;284;8991357;286;3260355;21494;14986
08256;Liry;58;1246687;78832;29;941320;29;305367;21495;14987
03074;Chevagnes;397;8533420;396852;207;6435283;190;2098137;21495;14988
18164;Neuvy-le-Barrois;74;1590623;27869;41;1276900;33;313723;21495;14989
63207;Marat;513;11026973;420173;288;8667766;225;2359207;21495;14990
02450;Macquigny;206;4428166;256842;103;3608145;103;820021;21496;14991
66129;Ortaffa;699;15025711;601003;347;11362795;352;3662916;21496;14992
58286;Tannay;383;8233117;404065;200;6398813;183;1834304;21496;14993
51047;Belval-en-Argonne;30;644892;14493;19;490563;11;154329;21496;14994
23024;Blessac;291;6255562;232896;158;4813570;133;1441992;21497;14995
02112;Brancourt-le-Grand;327;7029566;219230;165;5301442;162;1728124;21497;14996
70518;Le Val-Saint-Éloi;64;1375822;62540;35;1060219;29;315603;21497;14997
72149;Joué-en-Charnie;311;6685653;201715;172;5173162;139;1512491;21497;14998
17047;Biron;134;2880702;132289;64;2243966;70;636736;21498;14999
18246;Savigny-en-Sancerre;610;13114093;635408;308;10073583;302;3040510;21499;15000
72284;Saint-Germain-sur-Sarthe;268;5761659;109821;159;4398915;109;1362744;21499;15001
48005;Antrenas;148;3181922;94304;82;2499562;66;682360;21499;15002
72035;Bessé-sur-Braye;1373;29519169;1036945;768;22995723;605;6523446;21500;15003
18190;Quincy;474;10190886;384056;274;8230335;200;1960551;21500;15004
19005;Allassac;2204;47386236;1705669;1205;37177440;999;10208796;21500;15005
02814;Villers-lès-Guise;97;2085513;68855;51;1605324;46;480189;21500;15006
86147;Marigny-Chemereau;307;6600615;203838;168;4969985;139;1630630;21500;15007
86184;Ouzilly;447;9610801;214942;239;7231206;208;2379595;21501;15008
90009;Beaucourt;2802;60245597;2644546;1551;46734522;1251;13511075;21501;15009
71139;Collonge-en-Charollais;74;1591071;85617;39;1240298;35;350773;21501;15010
65047;Aureilhan;4514;97055360;4029480;2462;75237742;2052;21817618;21501;15011
01364;Saint-Jean-sur-Reyssouze;413;8879913;258681;217;6509510;196;2370403;21501;15012
62790;Senlis;91;1956614;63078;49;1447740;42;508874;21501;15013
43268;Yssingeaux;4012;86264851;3506926;2020;65572843;1992;20692008;21502;15014
30052;Bréau-et-Salagosse;225;4837977;217002;120;3864127;105;973850;21502;15015
50552;Saint-Sébastien-de-Raids;177;3805892;98485;104;2999197;73;806695;21502;15016
53144;Marcillé-la-Ville;394;8472017;134423;220;6477373;174;1994644;21503;15017
64172;Casteide-Candau;114;2451328;82268;55;1777083;59;674245;21503;15018
62414;Haucourt;127;2730871;41531;66;1993959;61;736912;21503;15019
02647;Ribeauville;44;946137;46921;21;698707;23;247430;21503;15020
21020;Arconcey;122;2623400;84261;66;1919839;56;703561;21503;15021
24388;Saint-Chamassy;306;6580042;217318;168;5206129;138;1373913;21503;15022
12136;Maleville;513;11031348;385785;240;7978808;273;3052540;21504;15023
39558;Vevy;149;3204049;83587;84;2470183;65;733866;21504;15024
18288;Vorly;151;3247087;145730;82;2604669;69;642418;21504;15025
19288;Voutezac;695;14945217;456318;392;11537647;303;3407570;21504;15026
71181;Donzy-le-Pertuis;79;1698812;44976;42;1367416;37;331396;21504;15027
24375;Saint-Aubin-de-Nabirat;70;1505301;37729;38;1197121;32;308180;21504;15028
21701;Villers-Rotin;76;1634348;30147;49;1287479;27;346869;21505;15029
56153;Péaule;1372;29504729;1113739;714;22206931;658;7297798;21505;15030
31283;Lautignac;159;3419321;121028;77;2530912;82;888409;21505;15031
88241;Houécourt;236;5075248;171542;136;4097099;100;978149;21505;15032
21108;Brianny;54;1161291;20960;32;900518;22;260773;21505;15033
18210;Saint-Georges-sur-la-Prée;336;7225850;256774;183;5538001;153;1687849;21506;15034
30141;Laudun-l'Ardoise;3349;72022300;2712770;1903;55932348;1446;16089952;21506;15035
34258;Saint-Geniès-de-Fontedit;774;16646001;549309;377;12295978;397;4350023;21506;15036
79235;Saint-Amand-sur-Sèvre;681;14646196;421395;360;10877012;321;3769184;21507;15037
56126;Marzan;1153;24797720;722559;626;18862726;527;5934994;21507;15038
55303;Loupmont;54;1161396;61721;28;953149;26;208247;21507;15039
2A253;Quasquara;23;494670;19111;11;350434;12;144236;21507;15040
27075;Bois-Normand-près-Lyre;187;4021980;156720;90;2871807;97;1150173;21508;15041
44192;Saint-Viaud;1197;25744996;612550;663;19346170;534;6398826;21508;15042
22158;Mûr-de-Bretagne;1228;26412123;1077447;609;19867425;619;6544698;21508;15043
69124;Marchampt;235;5054529;150390;121;3748767;114;1305762;21509;15044
71579;Villeneuve-en-Montagne;84;1806758;47662;42;1343695;42;463063;21509;15045
85037;Breuil-Barret;331;7119578;190716;179;5305478;152;1814100;21509;15046
15090;Lafeuillade-en-Vézie;303;6517327;214795;125;4484650;178;2032677;21509;15047
05184;Vitrolles;111;2387558;83812;51;1641152;60;746406;21510;15048
16153;Gondeville;304;6539035;271792;155;5098697;149;1440338;21510;15049
52292;Longeau-Percey;416;8948503;371446;236;6836558;180;2111945;21511;15050
42334;Violay;709;15251716;461719;388;11674494;321;3577222;21512;15051
31237;His;133;2861070;153192;69;2225540;64;635530;21512;15052
76345;Haussez;163;3506514;167623;88;2831047;75;675467;21512;15053
08503;Yvernaumont;82;1764022;104664;45;1396234;37;367788;21512;15054
67467;Siewiller;201;4324266;104928;105;3229003;96;1095263;21514;15055
61027;Batilly;82;1764176;30073;46;1322070;36;442106;21514;15056
67148;Frohmuhl;103;2215992;84695;46;1616782;57;599210;21514;15057
02019;Annois;216;4647137;193304;101;3524479;115;1122658;21515;15058
54063;Bernécourt;94;2022383;59066;58;1622574;36;399809;21515;15059
17467;Vervant;125;2689362;117907;68;2035055;57;654307;21515;15060
17321;Saint-Crépin;171;3679116;123078;81;2730988;90;948128;21515;15061
22233;Plourivo;1276;27454093;1003285;659;20380619;617;7073474;21516;15062
66168;Saint-André;1970;42386359;1656014;1013;32242597;957;10143762;21516;15063
72166;Longnes;170;3657730;83864;88;2548046;82;1109684;21516;15064
71157;Cuiseaux;1019;21924961;814170;589;17121620;430;4803341;21516;15065
61195;Le Grais;118;2538948;49513;61;1826467;57;712481;21517;15066
40146;Latrille;98;2108622;66769;48;1605752;50;502870;21517;15067
72069;Chassé;86;1850432;40558;48;1386840;38;463592;21517;15068
72004;Amné;267;5745109;155694;143;4370319;124;1374790;21517;15069
18200;Saint-Bouize;193;4152871;214671;97;3177051;96;975820;21517;15070
80478;Lignières;81;1743005;63720;39;1304194;42;438811;21519;15071
25253;Fourg;179;3851959;101741;107;3091797;72;760162;21519;15072
40166;Lussagnet;51;1097500;36665;22;763002;29;334498;21520;15073
62631;Nuncq-Hautecôte;208;4476121;152011;108;3375659;100;1100462;21520;15074
85117;Lairoux;336;7230661;218632;169;5364465;167;1866196;21520;15075
43126;Malrevers;397;8543400;262682;224;6655530;173;1887870;21520;15076
88490;Valleroy-le-Sec;89;1915399;68843;56;1592902;33;322497;21521;15077
49090;Cheffes;505;10868718;348844;248;8262035;257;2606683;21522;15078
30337;Vallabrix;228;4907273;200775;118;3846569;110;1060704;21523;15079
33137;Cours-les-Bains;114;2453684;106328;56;1875219;58;578465;21524;15080
23212;Saint-Marc-à-Loubaud;70;1506658;27914;28;1176762;42;329896;21524;15081
12171;Nauviale;274;5897512;193346;151;4568571;123;1328941;21524;15082
14136;Cardonville;41;882545;61799;19;699354;22;183191;21525;15083
27365;Léry;1174;25271193;1138270;644;20775153;530;4496040;21526;15084
38315;Le Pont-de-Beauvoisin;1971;42427492;1893324;1034;32947902;937;9479590;21526;15085
67528;Weyer;314;6759326;238301;173;5110441;141;1648885;21527;15086
07250;Saint-Jeure-d'Ay;227;4886663;147208;116;3583216;111;1303447;21527;15087
85123;Liez;144;3099963;87552;81;2439159;63;660804;21528;15088
80555;Monchy-Lagache;396;8524992;344485;204;6540783;192;1984209;21528;15089
44184;Saint-Nazaire;41099;884782162;38801310;22232;698252651;18867;186529511;21528;15090
53109;Grazay;307;6609119;139309;170;5012825;137;1596294;21528;15091
02796;Vichel-Nanteuil;46;990321;39148;26;769445;20;220876;21529;15092
95052;Beaumont-sur-Oise;5531;119075336;5292727;3211;96734252;2320;22341084;21529;15093
47217;Puymirol;535;11518028;476897;259;8510001;276;3008027;21529;15094
17226;Mazeray;483;10398615;354387;264;8091562;219;2307053;21529;15095
35125;La Guerche-de-Bretagne;2349;50573210;1928305;1075;37031922;1274;13541288;21530;15096
70252;Framont;87;1873130;60019;42;1341097;45;532033;21530;15097
31550;Soueich;316;6803575;236207;166;5188866;150;1614709;21530;15098
76018;Val-de-Saâne;795;17116690;676749;410;13070890;385;4045800;21530;15099
56228;Saint-Marcel;551;11863375;336006;290;9086019;261;2777356;21531;15100
89132;Cry;110;2368375;98603;56;1780704;54;587671;21531;15101
24023;Baneuil;201;4327709;113552;113;3265948;88;1061761;21531;15102
77458;Souppes-sur-Loing;3036;65368074;2919429;1649;52329203;1387;13038871;21531;15103
30061;La Calmette;1120;24115264;974609;603;18906931;517;5208333;21531;15104
39158;Coisia;95;2045531;46898;61;1631960;34;413571;21532;15105
71463;Saint-Maurice-lès-Châteauneuf;340;7320874;256022;179;5631431;161;1689443;21532;15106
85033;Bourneau;385;8289895;233038;196;6215858;189;2074037;21532;15107
50238;Héauville;207;4457216;167807;115;3432547;92;1024669;21532;15108
65260;Lapeyre;45;968982;37977;19;672256;26;296726;21533;15109
80029;Arrest;475;10228216;336021;261;7894544;214;2333672;21533;15110
63236;Mont-Dore;902;19423103;1039298;491;15239857;411;4183246;21533;15111
51223;Écollemont;35;753706;29444;18;525500;17;228206;21534;15112
24262;Mayac;182;3919378;117367;94;3019012;88;900366;21535;15113
86221;Saint-Genest-d'Ambière;654;14083940;506150;355;10957536;299;3126404;21535;15114
67273;Lohr;265;5706797;138521;152;4283553;113;1423244;21535;15115
24217;Journiac;245;5276162;223846;130;4236682;115;1039480;21535;15116
26235;Pierrelatte;7110;153118212;6643068;3655;118294536;3455;34823676;21536;15117
62458;Houlle;533;11478782;352188;292;8728839;241;2749943;21536;15118
76265;Flamets-Frétils;80;1722908;37244;42;1342032;38;380876;21536;15119
50212;Gourbesville;77;1658488;16751;33;1051801;44;606687;21539;15120
62512;Ligny-lès-Aire;291;6267896;162596;145;4566351;146;1701545;21539;15121
76754;Yport;543;11695768;560482;287;9118918;256;2576850;21539;15122
31102;Cambiac;111;2390850;115727;59;1936506;52;454344;21539;15123
72212;Moulins-le-Carbonnel;387;8335979;254455;213;6463634;174;1872345;21540;15124
35224;Plerguer;1277;27506765;881504;645;20768309;632;6738456;21540;15125
62296;Enquin-sur-Baillons;123;2649445;87961;55;1854051;68;795394;21540;15126
08436;Taillette;178;3834243;104024;94;3009053;84;825190;21541;15127
02795;Vic-sur-Aisne;989;21304044;991585;500;16150267;489;5153777;21541;15128
89398;Sormery;226;4868284;197861;133;3899150;93;969134;21541;15129
12048;Campouriez;223;4803698;250333;109;3625477;114;1178221;21541;15130
57433;Maizières-lès-Metz;5808;125112920;4010336;2913;89456622;2895;35656298;21541;15131
02263;Dhuizel;64;1378684;60798;30;1053350;34;325334;21542;15132
21275;Foncegrive;89;1917370;64524;63;1591831;26;325539;21543;15133
26310;Saint-Laurent-d'Onay;82;1766654;66702;48;1423122;34;343532;21545;15134
76190;Crasville-la-Rocquefort;124;2671801;107610;72;2045031;52;626770;21547;15135
83011;Bargemon;870;18745747;1071910;395;14165733;475;4580014;21547;15136
35017;La Baussaine;318;6852010;139479;173;5130148;145;1721862;21547;15137
04149;Peyruis;1526;32881237;1110488;806;25030951;720;7850286;21547;15138
90017;Bourogne;1057;22775598;935953;700;18912604;357;3862994;21547;15139
57060;Bénestroff;295;6356490;187857;171;4964957;124;1391533;21547;15140
53251;Saint-Quentin-les-Anges;205;4417302;34000;117;3319410;88;1097892;21548;15141
86004;Angles-sur-l'Anglin;226;4869855;222671;122;3841872;104;1027983;21548;15142
65195;Génos;89;1917797;85933;55;1569390;34;348407;21548;15143
16387;Triac-Lautrait;220;4740642;176308;116;3566261;104;1174381;21548;15144
34215;Pouzols;459;9890912;280783;237;7603327;222;2287585;21549;15145
08303;Monthois;224;4827066;236554;96;3402894;128;1424172;21549;15146
62902;Wizernes;1731;37302339;1130755;921;28359213;810;8943126;21550;15147
15111;Madic;126;2715259;68706;74;2056996;52;658263;21550;15148
54175;Einvaux;167;3598853;92281;92;2794724;75;804129;21550;15149
27428;Le Neubourg;2599;56008619;2538561;1374;44076758;1225;11931861;21550;15150
21574;Saint-Seine-sur-Vingeanne;223;4805675;163377;115;3373581;108;1432094;21550;15151
19158;Pandrignes;104;2241245;89691;54;1751426;50;489819;21550;15152
02260;Danizy;302;6508373;243175;151;4883871;151;1624502;21551;15153
55097;Chalaines;183;3944014;116082;102;2968852;81;975162;21552;15154
38403;Saint-Jean-d'Hérans;159;3426834;128412;86;2748457;73;678377;21552;15155
53246;Saint-Pierre-des-Nids;1076;23190461;789879;567;17603233;509;5587228;21552;15156
44213;Varades;1906;41079523;1062524;997;30388407;909;10691116;21553;15157
43113;Lantriac;1033;22264729;640414;570;17226759;463;5037970;21553;15158
90099;Valdoie;3132;67505733;2956138;1745;53137069;1387;14368664;21554;15159
18176;Parassy;250;5388484;232575;124;4105954;126;1282530;21554;15160
29107;Landudal;477;10281583;251050;277;8050149;200;2231434;21555;15161
40018;Audon;180;3879884;133414;99;2930457;81;949427;21555;15162
62583;Mondicourt;305;6574287;111428;134;4672681;171;1901606;21555;15163
39317;La Marre;176;3793888;101314;95;2773128;81;1020760;21556;15164
70435;Raddon-et-Chapendu;500;10778137;362407;267;8100404;233;2677733;21556;15165
50059;Blosville;157;3384350;98634;97;2745522;60;638828;21556;15166
33117;Cazaugitat;124;2673105;126828;57;1969873;67;703232;21557;15167
49165;La Jubaudière;599;12913202;179304;333;9316571;266;3596631;21558;15168
03075;Chezelle;101;2177400;112122;47;1631167;54;546233;21558;15169
39301;Loulle;100;2155908;67434;57;1731780;43;424128;21559;15170
31012;Arbon;51;1099526;65748;26;890267;25;209259;21559;15171
21291;Genay;207;4462872;184882;121;3574154;86;888718;21560;15172
25233;Fallerans;125;2695001;62718;64;1945352;61;749649;21560;15173
33115;Cazalis;130;2802860;117146;66;2192321;64;610539;21560;15174
05006;L'Argentière-la-Bessée;1307;28179555;988326;670;20902630;637;7276925;21560;15175
60020;Antilly;170;3665332;132792;73;2531777;97;1133555;21561;15176
34329;Vendres;1465;31587101;1263465;760;24172592;705;7414509;21561;15177
28112;Coudreceau;219;4721923;245672;122;3854475;97;867448;21561;15178
02033;Aubigny-en-Laonnois;68;1466174;71676;37;1113940;31;352234;21561;15179
50160;Denneville;353;7611219;315771;189;5926987;164;1684232;21562;15180
81084;Escoussens;346;7460658;210045;155;5309646;191;2151012;21563;15181
14720;Ussy;427;9207327;215594;224;6591481;203;2615846;21563;15182
02788;Versigny;247;5326178;174429;126;3893266;121;1432912;21563;15183
52313;Mareilles;88;1897601;78764;51;1489691;37;407910;21564;15184
51156;Cloyes-sur-Marne;80;1725137;70489;43;1282322;37;442815;21564;15185
46118;Gignac;387;8345624;346258;188;6313159;199;2032465;21565;15186
14410;Méry-Corbon;520;11213821;307444;310;8898029;210;2315792;21565;15187
33047;Berson;944;20357837;734088;458;15141147;486;5216690;21566;15188
30088;Combas;338;7289189;264974;179;5621426;159;1667763;21566;15189
72174;Lucé-sous-Ballon;64;1380216;76726;32;1086263;32;293953;21566;15190
39025;Augea;175;3774042;114214;106;3056020;69;718022;21566;15191
71414;Saint-Forgeot;279;6017124;220591;161;4760934;118;1256190;21567;15192
39556;Vertamboz;51;1099917;37732;25;874997;26;224920;21567;15193
40328;Vieux-Boucau-les-Bains;1071;23098620;1046375;581;18087372;490;5011248;21567;15194
21560;Saint-Martin-de-la-Mer;177;3817427;124242;101;3075728;76;741699;21567;15195
08349;Pure;310;6685975;181759;163;5043618;147;1642357;21568;15196
57625;Salonnes;90;1941103;113730;42;1525071;48;416032;21568;15197
45087;Châtillon-sur-Loire;1818;39210760;1568924;986;30578241;832;8632519;21568;15198
02282;Eppes;234;5047074;166594;135;4091861;99;955213;21569;15199
58213;Pougny;264;5694381;164882;138;4129249;126;1565132;21570;15200
57196;Erching;227;4896368;145957;134;3874479;93;1021889;21570;15201
54198;Fléville-Lixières;148;3192421;70115;76;2283058;72;909363;21570;15202
80308;Feuquières-en-Vimeu;1426;30759685;1443430;759;23709418;667;7050267;21571;15203
41159;Neung-sur-Beuvron;725;15639185;711493;335;11485366;390;4153819;21571;15204
41152;Montrieux-en-Sologne;344;7420663;216658;186;5507393;158;1913270;21572;15205
68112;Guebwiller;6656;143581426;7140687;3584;112946278;3072;30635148;21572;15206
54275;Jaulny;126;2718043;87337;66;2101803;60;616240;21572;15207
13105;Sénas;3740;80678837;3436990;1873;61078871;1867;19599966;21572;15208
18272;Veaugues;379;8175753;348652;183;6308334;196;1867419;21572;15209
27628;Thevray;168;3624088;135068;98;2880717;70;743371;21572;15210
64143;Bouillon;62;1337468;35174;25;880094;37;457374;21572;15211
60442;Muidorge;75;1617905;47672;44;1215209;31;402696;21572;15212
52050;Biesles;743;16028336;584315;432;12476959;311;3551377;21572;15213
87118;Peyrilhac;653;14086921;417529;363;10800769;290;3286152;21573;15214
45103;Corbeilles;847;18272302;814181;454;14358965;393;3913337;21573;15215
17247;Mornac-sur-Seudre;500;10786485;476429;266;8331448;234;2455037;21573;15216
49285;Saint-Germain-sur-Moine;1471;31733863;609387;780;23019005;691;8714858;21573;15217
88101;Cheniménil;660;14238192;422804;342;10752785;318;3485407;21573;15218
64064;Asasp-Arros;278;5997343;220597;152;4601072;126;1396271;21573;15219
16274;Rancogne;197;4249941;131809;112;3294176;85;955765;21573;15220
54553;Vaudeville;103;2222056;73183;57;1737596;46;484460;21573;15221
41177;Le Plessis-Dorin;104;2243662;90751;58;1678111;46;565551;21574;15222
11025;Bagnoles;137;2955802;71895;70;2241306;67;714496;21575;15223
89348;Saint-Julien-du-Sault;1377;29709381;1349168;732;23272107;645;6437274;21575;15224
64314;Larceveau-Arros-Cibits;206;4444569;267149;104;3488122;102;956447;21576;15225
81065;Castres;24456;527665802;27172066;12020;409461228;12436;118204574;21576;15226
14460;Moyaux;785;16937521;580804;388;12634363;397;4303158;21576;15227
11254;Montréal;1068;23043849;1186878;490;17371293;578;5672556;21577;15228
84078;Mondragon;1999;43132276;1620368;1044;33184204;955;9948072;21577;15229
54432;Pont-Saint-Vincent;1107;23885725;838921;644;18784185;463;5101540;21577;15230
63366;Saint-Jean-en-Val;192;4142898;114066;105;3173117;87;969781;21578;15231
25232;Faimbe;55;1186768;29834;28;854167;27;332601;21578;15232
40184;Mimizan;4395;94838266;4329076;2464;74805625;1931;20032641;21579;15233
06055;Duranus;68;1467359;48927;41;1141954;27;325405;21579;15234
50419;Quettreville-sur-Sienne;771;16637399;557297;407;12657276;364;3980123;21579;15235
01265;Montréal-la-Cluse;1887;40721096;1560282;1056;31589299;831;9131797;21580;15236
72297;Saint-Marceau;263;5675540;138000;149;4445212;114;1230328;21580;15237
30135;Jonquières-Saint-Vincent;1818;39232485;1473802;906;29815239;912;9417246;21580;15238
76185;Compainville;76;1640086;53552;40;1327596;36;312490;21580;15239
36108;Lys-Saint-Georges;147;3172412;111516;75;2457142;72;715270;21581;15240
62340;Floringhem;419;9042648;253791;214;6741091;205;2301557;21581;15241
27453;Perriers-sur-Andelle;1006;21712276;681644;569;16823819;437;4888457;21583;15242
18022;Barlieu;224;4834569;195161;119;3822696;105;1011873;21583;15243
22190;Pleslin-Trigavou;1859;40123189;1187625;1003;30441282;856;9681907;21583;15244
08087;Brognon;77;1661925;49948;37;1189868;40;472057;21583;15245
54071;Bezange-la-Grande;93;2007275;72732;48;1521462;45;485813;21584;15246
39141;Chevigny;157;3388713;107605;96;2743083;61;645630;21584;15247
03151;Louroux-de-Beaune;100;2158430;59471;54;1542791;46;615639;21584;15248
88080;Bult;140;3021834;58842;71;2278381;69;743453;21585;15249
69096;Grigny;4863;104965835;3390128;2873;83772477;1990;21193358;21585;15250
82125;Montech;3156;68120995;2433921;1646;51945784;1510;16175211;21585;15251
15014;Aurillac;17217;371622967;19649355;9286;297500986;7931;74121981;21585;15252
22225;Ploumagoar;2813;60719762;2040632;1565;47528154;1248;13191608;21585;15253
69098;Les Halles;243;5245396;160836;136;4049899;107;1195497;21586;15254
71067;Burnand;74;1597425;43627;41;1189086;33;408339;21587;15255
79023;Avon;43;928246;34418;23;745258;20;182988;21587;15256
02746;Travecy;355;7663562;272873;186;5833499;169;1830063;21587;15257
77285;Le Mée-sur-Seine;10328;222964646;9740217;5687;175900518;4641;47064128;21588;15258
60648;Troussencourt;194;4188437;160091;114;3411788;80;776649;21590;15259
14382;Louvières;45;971545;48966;22;759257;23;212288;21590;15260
14445;Montfiquet;45;971556;32133;28;820234;17;151322;21590;15261
57492;Moyeuvre-Petite;275;5937407;171051;138;4194388;137;1743019;21591;15262
54079;Blénod-lès-Pont-à-Mousson;2348;50696417;1903556;1340;39518941;1008;11177476;21591;15263
71471;Saint-Privé;54;1165943;49987;27;866894;27;299049;21592;15264
44220;Vue;780;16841831;434653;443;13046014;337;3795817;21592;15265
02377;Haution;76;1641001;38569;31;1071483;45;569518;21592;15266
49274;Saint-Cyr-en-Bourg;503;10860863;312593;287;8430687;216;2430176;21592;15267
07276;Saint-Michel-d'Aurance;131;2828625;49043;80;2242710;51;585915;21593;15268
33223;Landerrouat;101;2180875;118126;45;1621534;56;559341;21593;15269
25016;Amathay-Vésigneux;86;1857008;69546;43;1376638;43;480370;21593;15270
2A065;Cargèse;700;15115365;926280;325;11695556;375;3419809;21593;15271
79158;Luché-sur-Brioux;69;1489996;31412;38;1148933;31;341063;21594;15272
57071;Bettborn;224;4837186;121406;137;3932554;87;904632;21595;15273
49213;Montpollin;102;2202666;36646;66;1747970;36;454696;21595;15274
16176;Lachaise;177;3822300;164515;93;2932242;84;890058;21595;15275
51419;Outines;83;1792396;71404;33;1223880;50;568516;21595;15276
33142;Cubnezais;698;15073585;459927;377;11778094;321;3295491;21595;15277
2A103;Cuttoli-Corticchiato;1103;23820146;877745;588;18705864;515;5114282;21596;15278
73107;Entremont-le-Vieux;365;7882592;304500;191;5990383;174;1892209;21596;15279
27151;Charleval;1066;23021742;880607;609;18239242;457;4782500;21596;15280
33440;Saint-Martial;127;2742833;103481;58;2109527;69;633306;21597;15281
50436;Romagny;546;11792297;270506;319;9370842;227;2421455;21598;15282
67036;Bettwiller;178;3844612;101621;105;3028035;73;816577;21599;15283
11318;Roquecourbe-Minervois;66;1425610;56476;25;975911;41;449699;21600;15284
10164;Gélannes;404;8726887;306152;228;7006984;176;1719903;21601;15285
08387;Saint-Loup-Terrier;93;2008924;49447;46;1397180;47;611744;21601;15286
86220;Saint-Gaudent;173;3737048;138911;89;2922278;84;814770;21601;15287
17485;Le Grand-Village-Plage;679;14667384;678240;346;10885883;333;3781501;21601;15288
52457;Saint-Vallier-sur-Marne;93;2008995;54849;49;1522565;44;486430;21602;15289
55268;Lacroix-sur-Meuse;373;8057763;264543;222;6349923;151;1707840;21603;15290
53220;Saint-Georges-le-Fléchard;159;3434824;76608;87;2525128;72;909696;21603;15291
88464;Tendon;276;5962388;188635;144;4446843;132;1515545;21603;15292
45120;Dammarie-en-Puisaye;102;2203496;97011;54;1703995;48;499501;21603;15293
79080;Châtillon-sur-Thouet;1581;34155263;1304008;807;25450066;774;8705197;21604;15294
70313;Lyoffans;193;4169564;106319;102;3103909;91;1065655;21604;15295
72313;Saint-Pierre-des-Ormes;124;2678908;69333;75;2104815;49;574093;21604;15296
38221;Marnans;74;1598704;33149;38;1185980;36;412724;21604;15297
61035;Beauvain;157;3391976;144303;84;2641491;73;750485;21605;15298
22242;Plurien;881;19034332;844047;463;14444470;418;4589862;21605;15299
69266;Villeurbanne;83634;1806960375;89629139;47933;1470186968;35701;336773407;21606;15300
34122;Jonquières;221;4774902;194805;106;3582600;115;1192302;21606;15301
29187;Plougar;414;8945049;255222;214;6727174;200;2217875;21606;15302
86153;Mazerolles;489;10565611;296630;261;8135918;228;2429693;21607;15303
76344;Haudricourt;261;5639377;191747;133;4250375;128;1389002;21607;15304
67558;Zinswiller;427;9226164;228072;248;7094523;179;2131641;21607;15305
21033;Aubigny-lès-Sombernon;82;1771771;58666;52;1417625;30;354146;21607;15306
10018;Auxon;551;11905993;608322;279;8957798;272;2948195;21608;15307
01040;Béréziat;231;4991480;89038;127;3808472;104;1183008;21608;15308
26009;Andancette;756;16335765;721676;415;12930398;341;3405367;21608;15309
64453;Pontacq;1637;35372659;1267989;873;27819371;764;7553288;21608;15310
85063;Les Châtelliers-Châteaumur;376;8124860;172529;209;6176782;167;1948078;21609;15311
85186;La Rabatelière;479;10350839;188989;299;8154030;180;2196809;21609;15312
70521;Vantoux-et-Longevelle;90;1944857;58601;44;1447408;46;497449;21610;15313
08166;Fépin;132;2852477;82521;64;1983277;68;869200;21610;15314
33018;Aubie-et-Espessas;656;14175978;434087;351;10839796;305;3336182;21610;15315
46331;Vers;250;5402512;224864;136;4063412;114;1339100;21610;15316
29259;Saint-Pol-de-Léon;4172;90157751;3773295;2073;69208687;2099;20949064;21610;15317
32215;Loubersan;89;1923320;69609;37;1295053;52;628267;21610;15318
08329;Novion-Porcien;264;5705176;238115;128;4409122;136;1296054;21611;15319
57173;Desseling;54;1166995;31607;30;874168;24;292827;21611;15320
55530;Valbois;57;1231834;44165;33;976684;24;255150;21611;15321
04174;Saint-Benoît;81;1750506;88022;47;1467113;34;283393;21611;15322
55551;Vigneulles-lès-Hattonchâtel;871;18824010;797072;441;14170532;430;4653478;21612;15323
60502;Le Plessis-Patte-d'Oie;58;1253520;34716;33;973550;25;279970;21612;15324
52502;Valleret;37;799703;24774;23;647281;14;152422;21614;15325
21381;Marcilly-et-Dracy;50;1080702;32234;31;875653;19;205049;21614;15326
65078;Beaudéan;249;5381915;174827;127;3987244;122;1394671;21614;15327
32204;Lavardens;238;5144216;242661;117;3902060;121;1242156;21614;15328
81142;Lempaut;428;9251279;340572;222;7150091;206;2101188;21615;15329
54065;Bertrichamps;603;13034072;442390;367;10390397;236;2643675;21615;15330
40159;Louer;165;3566631;139115;96;2928143;69;638488;21616;15331
23110;Lioux-les-Monges;24;518790;8733;12;355466;12;163324;21616;15332
88162;Esley;101;2183256;88663;53;1646330;48;536926;21616;15333
65333;Oléac-Dessus;59;1275384;33596;32;1021307;27;254077;21617;15334
21472;Orville;101;2183389;67305;57;1712675;44;470714;21618;15335
65101;Bordes;410;8863374;304858;234;7065891;176;1797483;21618;15336
63105;Chaumont-le-Bourg;128;2767117;100263;58;1989173;70;777944;21618;15337
43174;Saint-Christophe-sur-Dolaison;522;11284673;320755;286;8607959;236;2676714;21618;15338
79244;Saint-Cyr-la-Lande;189;4085850;149033;97;2928085;92;1157765;21618;15339
10099;Chessy-les-Prés;288;6226341;266612;153;4781978;135;1444363;21619;15340
14061;Le Bény-Bocage;573;12387892;464428;278;9295055;295;3092837;21619;15341
85125;Loge-Fougereuse;196;4237510;172403;103;3156926;93;1080584;21620;15342
73126;Granier;198;4280765;134898;119;3368283;79;912482;21620;15343
35097;Domalain;954;20626256;456662;491;15014696;463;5611560;21621;15344
81290;Souel;97;2097286;55935;41;1467942;56;629344;21622;15345
62613;Nielles-lès-Bléquin;434;9383773;369362;200;6879797;234;2503976;21622;15346
41176;Pierrefitte-sur-Sauldre;500;10810833;554137;267;8515751;233;2295082;21622;15347
54173;Drouville;90;1945966;35384;45;1465009;45;480957;21622;15348
55373;Nant-le-Grand;42;908130;48639;21;702351;21;205779;21622;15349
17349;Saint-Jean-de-Liversay;1322;28584552;795161;711;21770066;611;6814486;21622;15350
27527;Saint-Cyr-de-Salerne;126;2724431;111379;77;2260959;49;463472;21622;15351
64044;Arget;49;1059503;27240;16;644008;33;415495;21623;15352
46123;Girac;217;4692110;193392;127;3805368;90;886742;21623;15353
72160;Lavernat;330;7135475;228165;198;5689945;132;1445530;21623;15354
40031;Bégaar;624;13492663;466636;344;10570950;280;2921713;21623;15355
56250;Théhillac;321;6941192;314934;174;5412547;147;1528645;21624;15356
80526;Le Meillard;73;1578544;29015;33;1048177;40;530367;21624;15357
07194;Rochessauve;227;4908647;157553;115;3797425;112;1111222;21624;15358
17013;Antezant-la-Chapelle;196;4238310;205920;96;3109424;100;1128886;21624;15359
11370;Salles-d'Aude;1647;35614925;1307193;825;26935464;822;8679461;21624;15360
81251;Saint-Germain-des-Prés;431;9320229;300193;223;6942046;208;2378183;21625;15361
40067;Carcen-Ponson;357;7720180;254329;196;6092405;161;1627775;21625;15362
35102;Drouges;245;5298357;99944;124;3805353;121;1493004;21626;15363
41099;Gy-en-Sologne;280;6055384;257546;152;4747106;128;1308278;21626;15364
47186;Montesquieu;427;9234605;467399;204;6910395;223;2324210;21627;15365
10304;Précy-Saint-Martin;115;2487106;75698;71;1995212;44;491894;21627;15366
45229;Nogent-sur-Vernisson;1401;30300231;1255205;796;24114426;605;6185805;21628;15367
42034;Cervières;60;1297705;106979;27;980269;33;317436;21628;15368
02074;Bertaucourt-Epourdon;300;6488573;168102;164;4921408;136;1567165;21629;15369
01064;Briord;512;11074054;358587;292;8576275;220;2497779;21629;15370
19279;Vars-sur-Roseix;192;4152817;105481;102;3045287;90;1107530;21629;15371
76685;Thérouldeville;322;6964643;179159;177;5200265;145;1764378;21629;15372
46192;Meyronne;162;3504039;95585;83;2645380;79;858659;21630;15373
29243;Saint-Coulitz;253;5472402;200575;137;4297599;116;1174803;21630;15374
62620;Norrent-Fontes;775;16763315;795740;381;12705600;394;4057715;21630;15375
32212;Ligardes;132;2855173;141041;58;2220170;74;635003;21630;15376
88151;Dompaire;615;13302708;478965;336;10272765;279;3029943;21630;15377
55330;Méligny-le-Grand;55;1189689;39745;26;840994;29;348695;21631;15378
66016;Banyuls-sur-Mer;2928;63334984;3150420;1542;50186234;1386;13148750;21631;15379
13099;Saint-Paul-lès-Durance;499;10793783;438020;282;8419334;217;2374449;21631;15380
22035;Les Champs-Géraux;566;12243683;330123;299;9258332;267;2985351;21632;15381
77385;Rebais;1193;25807033;1143080;656;20270297;537;5536736;21632;15382
38290;Pact;450;9734540;294359;261;7641688;189;2092852;21632;15383
58252;Saint-Malo-en-Donziois;87;1882041;93944;50;1505264;37;376777;21633;15384
61473;Sevrai;119;2574287;59617;73;2070201;46;504086;21633;15385
81289;Soual;1339;28966449;1147389;664;22173780;675;6792669;21633;15386
02725;Sommeron;64;1384539;40039;31;1050121;33;334418;21633;15387
62180;Brias;150;3245034;86358;79;2449210;71;795824;21634;15388
58217;Pousseaux;114;2466264;98841;68;2022660;46;443604;21634;15389
38311;Pommier-de-Beaurepaire;377;8156005;258089;198;6267861;179;1888144;21634;15390
51279;Granges-sur-Aube;99;2141769;89157;52;1627449;47;514320;21634;15391
10300;Pougy;144;3115407;100647;82;2508892;62;606515;21635;15392
30244;Saint-Clément;177;3829370;137316;88;2940106;89;889264;21635;15393
52332;Val-de-Meuse;1274;27563022;1184109;663;21139157;611;6423865;21635;15394
77152;Dammarie-les-Lys;11472;248201248;12477015;6187;198029674;5285;50171574;21635;15395
43092;Fay-sur-Lignon;221;4781427;273897;70;3084765;151;1696662;21635;15396
76292;Fry;84;1817405;34483;38;1324786;46;492619;21636;15397
2A070;Casaglione;270;5841710;363009;129;4676250;141;1165460;21636;15398
76301;Glicourt;111;2401604;62407;62;1750177;49;651427;21636;15399
54598;Xivry-Circourt;148;3202159;76746;50;1702226;98;1499933;21636;15400
28071;Champrond-en-Gâtine;329;7118327;216183;190;5535529;139;1582798;21636;15401
45029;Beaulieu-sur-Loire;1052;22761485;1028554;568;17608931;484;5152554;21636;15402
25311;Hyémondans;110;2380045;104657;58;1768097;52;611948;21637;15403
11214;Malras;210;4543780;181207;107;3534114;103;1009666;21637;15404
76084;Bertreville;59;1276602;29148;33;972260;26;304342;21637;15405
51009;Anglure;503;10883683;482994;262;8198108;241;2685575;21638;15406
03230;Saint-Étienne-de-Vicq;262;5669125;162713;136;4283517;126;1385608;21638;15407
57151;Conthil;87;1882497;66681;44;1422451;43;460046;21638;15408
65403;Sanous;56;1211819;40267;38;1018265;18;193554;21640;15409
33305;Le Nizan;261;5647988;256323;137;4492368;124;1155620;21640;15410
95212;Épiais-lès-Louvres;62;1341741;52388;40;1120011;22;221730;21641;15411
24251;Manzac-sur-Vern;315;6816915;229392;169;5186991;146;1629924;21641;15412
38085;Charvieu-Chavagneux;4171;90264989;2702062;2336;70134862;1835;20130127;21641;15413
30102;Dions;337;7293113;318061;167;5545214;170;1747899;21641;15414
81222;Réalmont;1920;41551720;1545095;890;30560817;1030;10990903;21642;15415
38218;Marcilloles;496;10734286;286834;261;8189382;235;2544904;21642;15416
60376;Maisoncelle-Saint-Pierre;88;1904641;69463;50;1523332;38;381309;21644;15417
56044;Cournon;403;8722605;210898;239;6955537;164;1767068;21644;15418
85156;Moutiers-les-Mauxfaits;1090;23592310;925536;556;17803937;534;5788373;21644;15419
33226;Langoiran;1322;28614026;1106417;737;22350207;585;6263819;21644;15420
29068;Guiclan;1275;27597229;1009828;666;20957958;609;6639271;21645;15421
70170;Contréglise;66;1428565;58387;35;1082833;31;345732;21645;15422
49211;Montilliers;601;13008894;283699;291;9279190;310;3729704;21645;15423
08317;La Neuville-à-Maire;50;1082302;9423;24;681570;26;400732;21646;15424
79064;Chail;268;5801421;144691;147;4344776;121;1456645;21647;15425
44061;Frossay;1596;34548902;655276;775;25105576;821;9443326;21647;15426
49206;Montfaucon-Montigné;1053;22794899;634083;576;17240006;477;5554893;21648;15427
89298;Piffonds;329;7122185;224431;193;5748195;136;1373990;21648;15428
89100;Chéroy;947;20500705;722950;514;15416535;433;5084170;21648;15429
57577;Reyersviller;214;4632686;206787;112;3458120;102;1174566;21648;15430
59134;Cartignies;629;13617071;504753;291;10032622;338;3584449;21649;15431
60306;Hécourt;79;1710254;42340;48;1340151;31;370103;21649;15432
21518;Quincy-le-Vicomte;126;2727840;108797;73;2217604;53;510236;21650;15433
33125;Cissac-Médoc;1039;22494485;879838;585;17668299;454;4826186;21650;15434
09122;Foix;5803;125637488;6454296;3030;98846951;2773;26790537;21650;15435
30109;Euzet;224;4849787;151667;119;3714192;105;1135595;21651;15436
64538;Uhart-Cize;414;8963598;365746;221;6957359;193;2006239;21651;15437
06037;Caussols;151;3269337;159659;96;2794406;55;474931;21651;15438
80473;Liancourt-Fosse;151;3269345;121651;75;2446584;76;822761;21651;15439
89259;Môlay;67;1450646;66433;37;1119362;30;331284;21651;15440
03123;Givarlais;127;2749839;87446;76;2191772;51;558067;21652;15441
70452;Rosey;138;2988049;73106;88;2437339;50;550710;21653;15442
35236;Redon;5321;115213501;5682414;2628;89851913;2693;25361588;21653;15443
22079;Hénon;1149;24879316;739912;598;18320812;551;6558504;21653;15444
23128;Mazeirat;85;1840517;56908;47;1400796;38;439721;21653;15445
60324;Jaulzy;469;10155332;362684;270;8133069;199;2022263;21653;15446
64459;Préchacq-Navarrenx;85;1840537;47554;45;1398185;40;442352;21653;15447
23043;Chamberaud;59;1277554;63618;33;1014767;26;262787;21653;15448
52065;Bouzancourt;34;736221;18040;18;583890;16;152331;21654;15449
16331;Saint-Laurent-des-Combes;57;1234287;42580;25;868234;32;366053;21654;15450
17395;Saint-Sauvant;300;6496313;284050;158;5140475;142;1355838;21654;15451
14128;Campandré-Valcongrain;60;1299267;57429;33;1043582;27;255685;21654;15452
35239;Retiers;2060;44608549;1295184;1073;33098956;987;11509593;21655;15453
82140;Piquecos;216;4677428;150446;120;3694828;96;982600;21655;15454
19058;Combressol;195;4222755;130818;103;3033523;92;1189232;21655;15455
32300;Orbessan;128;2771920;75342;71;2198835;57;573085;21656;15456
29077;Guissény;1128;24427800;802913;593;18300943;535;6126857;21656;15457
63386;Saint-Pierre-Roche;255;5522270;233454;130;4204597;125;1317673;21656;15458
25416;Myon;112;2425471;65573;61;1908814;51;516657;21656;15459
15036;Chalvignac;259;5608905;319762;117;4057229;142;1551676;21656;15460
49193;Le May-sur-Èvre;2003;43378074;956125;1094;32040962;909;11337112;21657;15461
55049;Beurey-sur-Saulx;232;5024382;179491;139;4010204;93;1014178;21657;15462
06129;Saint-Sauveur-sur-Tinée;178;3854955;166703;105;3117385;73;737570;21657;15463
07291;Saint-Remèze;474;10265508;414282;248;7883547;226;2381961;21657;15464
42079;Cuinzier;349;7558422;175116;184;5487054;165;2071368;21657;15465
31134;Cazeneuve-Montaut;35;758015;30260;24;685285;11;72730;21658;15466
17115;Colombiers;179;3876779;173543;95;3031999;84;844780;21658;15467
64008;Ahaxe-Alciette-Bascassan;135;2923877;71004;63;2031361;72;892516;21658;15468
32230;Mansencôme;28;606445;8778;16;442802;12;163643;21659;15469
46165;Lavergne;241;5219786;163507;135;4090783;106;1129003;21659;15470
16154;Gond-Pontouvre;3563;77170916;3637541;1979;61310597;1584;15860319;21659;15471
49119;Daumeray;771;16699084;453757;423;12708118;348;3990966;21659;15472
83063;La Garde-Freinet;1145;24799615;1633445;540;19423557;605;5376058;21659;15473
63114;Collanges;92;1992658;85708;56;1662345;36;330313;21659;15474
66207;Terrats;380;8230565;332749;203;6597773;177;1632792;21659;15475
52274;Latrecey-Ormoy-sur-Aube;192;4158674;218203;92;3292128;100;866546;21660;15476
74045;Le Bouchet;119;2577515;158810;62;1947797;57;629718;21660;15477
33445;Saint-Martin-du-Bois;436;9443695;393588;220;7291726;216;2151969;21660;15478
80443;Hornoy-le-Bourg;915;19818773;921335;459;15314171;456;4504602;21660;15479
87144;Saint-Genest-sur-Roselle;253;5480031;169639;129;4172245;124;1307786;21660;15480
86003;Anché;186;4028900;183641;91;3066119;95;962781;21661;15481
40097;Eugénie-les-Bains;267;5783453;224542;148;4656243;119;1127210;21661;15482
89312;Précy-le-Sec;132;2859281;101219;73;2228803;59;630478;21661;15483
49025;Beauvau;146;3162577;87280;87;2494189;59;668388;21661;15484
66008;Argelès-sur-Mer;7075;153257194;7825110;3626;119223247;3449;34033947;21662;15485
59349;Ligny-en-Cambrésis;945;20470476;806807;452;15347296;493;5123180;21662;15486
18231;Saint-Pierre-les-Étieux;409;8859804;343838;229;7036685;180;1823119;21662;15487
33358;Romagne;226;4895639;157135;119;3682439;107;1213200;21662;15488
21713;Vonges;175;3790981;98571;104;2945788;71;845193;21663;15489
47327;Xaintrailles;227;4917445;259621;112;3639073;115;1278372;21663;15490
06043;Coaraze;469;10160061;411455;278;8078508;191;2081553;21663;15491
53058;La Chapelle-Craonnaise;158;3422836;78923;86;2511988;72;910848;21664;15492
09241;Rabat-les-Trois-Seigneurs;218;4722665;265389;123;3845028;95;877637;21664;15493
40279;Saint-Paul-lès-Dax;8042;174222877;8388684;4502;137857177;3540;36365700;21664;15494
50534;Saint-Pellerin;196;4246262;134523;101;3210806;95;1035456;21665;15495
31196;Francon;118;2556448;86500;56;1977453;62;578995;21665;15496
47067;Clermont-Soubiran;198;4289809;147633;106;3259393;92;1030416;21666;15497
60633;Thieuloy-Saint-Antoine;182;3943260;152985;96;2990418;86;952842;21666;15498
26111;Crupies;49;1061654;36195;27;776715;22;284939;21666;15499
2B342;Ventiseri;1230;26649701;919497;730;21334272;500;5315429;21666;15500
66051;Clara;125;2708349;70543;62;1965149;63;743200;21667;15501
57741;Walschbronn;274;5936755;209832;136;4362196;138;1574559;21667;15502
54240;Grosrouvres;33;715011;21191;16;503203;17;211808;21667;15503
62379;Gouy-en-Artois;195;4225212;176979;104;3282238;91;942974;21668;15504
73028;La Balme;163;3531903;109885;89;2755718;74;776185;21668;15505
29264;Saint-Servais;357;7735535;125681;199;5759013;158;1976522;21668;15506
57232;Francaltroff;394;8537263;236767;214;6478377;180;2058886;21668;15507
10202;Les Loges-Margueron;106;2296845;75190;64;1895841;42;401004;21668;15508
89017;Argenteuil-sur-Armançon;151;3271956;162493;92;2604852;59;667104;21669;15509
28196;Illiers-Combray;1961;42492809;1644863;1029;32387359;932;10105450;21669;15510
86284;Vernon;334;7237676;218650;173;5497394;161;1740282;21670;15511
67313;Mutzig;3142;68086867;2783612;1815;54133669;1327;13953198;21670;15512
57706;Vergaville;313;6782699;214769;180;5214585;133;1568114;21670;15513
39036;La Balme-d'Épy;28;606776;20111;13;413498;15;193278;21671;15514
14117;Cabourg;2567;55628371;3004033;1400;43476217;1167;12152154;21671;15515
54476;Saint-Jean-lès-Longuyon;207;4485848;108438;102;3188101;105;1297747;21671;15516
85048;Chambretaud;797;17271818;255063;466;12961355;331;4310463;21671;15517
79020;Augé;510;11052599;323309;282;8770191;228;2282408;21672;15518
25420;Nans-sous-Sainte-Anne;84;1820435;64329;48;1371216;36;449219;21672;15519
47220;Razimet;146;3164094;118716;82;2542456;64;621638;21672;15520
38113;Clelles;309;6696723;247073;182;5375241;127;1321482;21672;15521
76624;Saint-Nicolas-d'Aliermont;2079;45057116;1825777;1163;35652639;916;9404477;21672;15522
27159;Cintray;245;5309878;218193;131;4109395;114;1200483;21673;15523
25529;Sancey-le-Grand;535;11595530;461689;263;8481316;272;3114214;21674;15524
61131;Courménil;63;1365489;59113;28;1004086;35;361403;21674;15525
76381;Landes-Vieilles-et-Neuves;83;1799034;59023;35;1300528;48;498506;21675;15526
23169;La Saunière;339;7347905;272506;208;6002790;131;1345115;21675;15527
10298;Pont-sur-Seine;571;12376601;574955;313;9720901;258;2655700;21675;15528
85139;Le Mazeau;248;5375486;192280;126;4133273;122;1242213;21675;15529
32110;Courrensan;220;4768596;190558;102;3331849;118;1436747;21675;15530
82030;Castelferrus;234;5072057;140479;118;3887400;116;1184657;21675;15531
25192;Dampjoux;88;1907529;56933;61;1630307;27;277222;21676;15532
01439;Vésines;55;1192223;35036;30;910626;25;281597;21677;15533
85097;La Gaubretière;1643;35615365;1082155;927;27568383;716;8046982;21677;15534
72171;Louzes;64;1387365;42342;38;1092066;26;295299;21678;15535
50176;L'Étang-Bertrand;165;3576958;83359;85;2628478;80;948480;21679;15536
11165;Ginoles;197;4270678;148654;95;3098531;102;1172147;21679;15537
37155;Monthodon;343;7435815;248075;190;5881781;153;1554034;21679;15538
38372;Saint-Bueil;404;8758222;284828;213;6367164;191;2391058;21679;15539
79002;Adilly;165;3577027;124557;93;2765465;72;811562;21679;15540
72059;Chantenay-Villedieu;441;9560473;260724;245;7173639;196;2386834;21679;15541
11371;Salles-sur-l'Hers;351;7609489;270514;176;5781271;175;1828218;21679;15542
29048;Edern;1131;24519731;685424;614;18688263;517;5831468;21680;15543
39475;Saint-Amour;1309;28379207;1298382;656;21256564;653;7122643;21680;15544
45083;Château-Renard;1405;30460612;1876817;695;23612782;710;6847830;21680;15545
40116;Gouts;146;3165331;78805;82;2381203;64;784128;21680;15546
80652;Le Quesnel;401;8694018;274765;208;6451902;193;2242116;21681;15547
35333;Le Theil-de-Bretagne;803;17409912;365307;439;13041206;364;4368706;21681;15548
54143;Crépey;185;4011282;100584;97;3013437;88;997845;21683;15549
83076;Mazaugues;453;9822275;334505;243;7624988;210;2197287;21683;15550
55573;Void-Vacon;926;20078328;847877;466;14846792;460;5231536;21683;15551
21198;Corrombles;130;2818797;91440;69;2097503;61;721294;21683;15552
55565;Villers-sous-Pareid;33;715549;26637;17;527408;16;188141;21683;15553
02283;Erlon;146;3165785;145704;63;2376593;83;789192;21683;15554
21522;Renève;247;5355965;265410;135;4255005;112;1100960;21684;15555
76170;La Chapelle-du-Bourgay;76;1648017;44938;50;1320460;26;327557;21684;15556
42137;Margerie-Chantagret;370;8023433;216805;210;6134111;160;1889322;21685;15557
02338;Froidmont-Cohartille;140;3035905;181276;68;2252804;72;783101;21685;15558
89289;Paroy-sur-Tholon;181;3925063;156026;108;3215338;73;709725;21685;15559
08056;Beffu-et-le-Morthomme;30;650593;45480;14;541688;16;108905;21686;15560
57525;Oriocourt;33;715674;37042;15;619886;18;95788;21687;15561
66037;Canet-en-Roussillon;8722;189161141;10493787;4575;150048362;4147;39112779;21688;15562
85045;La Chaize-Giraud;544;11798284;340641;305;8849090;239;2949194;21688;15563
09272;Saint-Paul-de-Jarrat;772;16743162;701480;414;12843454;358;3899708;21688;15564
54538;Uruffe;198;4294279;178897;98;3100493;100;1193786;21688;15565
24532;Serres-et-Montguyard;99;2147178;71896;51;1686885;48;460293;21689;15566
33545;Vertheuil;710;15399152;718574;359;11894462;351;3504690;21689;15567
42226;Saint-Georges-de-Baroille;190;4121047;86267;110;3157339;80;963708;21690;15568
31262;Lagarde;192;4164429;111815;101;3288144;91;876285;21690;15569
38449;Saint-Quentin-Fallavier;2886;62597367;2115937;1573;48435784;1313;14161583;21690;15570
35142;Landéan;634;13752083;324467;360;10535586;274;3216497;21691;15571
27475;La Poterie-Mathieu;92;1995581;76114;54;1676889;38;318692;21691;15572
62116;Bernieulles;99;2147448;51752;51;1629017;48;518431;21691;15573
58039;Brèves;191;4143087;288645;108;3362117;83;780970;21692;15574
46253;Saint-Chamarand;121;2624756;91897;69;2177525;52;447231;21692;15575
60498;Le Plessier-sur-Saint-Just;286;6204072;213281;170;4952754;116;1251318;21693;15576
12100;Firmi;1493;32387152;1359679;760;24183503;733;8203649;21693;15577
10395;Vanlay;156;3384068;110634;84;2607529;72;776539;21693;15578
80123;Bourdon;198;4295206;114767;111;3370523;87;924683;21693;15579
82138;Perville;71;1540209;62413;37;1183214;34;356995;21693;15580
32444;Thoux;129;2798416;98503;76;2318295;53;480121;21693;15581
57002;Aboncourt-sur-Seille;41;889435;35183;22;674123;19;215312;21694;15582
30100;Cruviers-Lascours;331;7180625;235916;177;5601881;154;1578744;21694;15583
62719;Rollancourt;134;2907021;101239;62;2094774;72;812247;21694;15584
49295;Saint-Laurent-de-la-Plaine;857;18592711;409152;465;13721865;392;4870846;21695;15585
82175;Saint-Vincent-Lespinasse;123;2668554;100553;59;2034760;64;633794;21696;15586
41119;Lorges;198;4295775;129718;117;3446411;81;849364;21696;15587
50503;Saint-Lô-d'Ourville;286;6205111;269173;144;4575853;142;1629258;21696;15588
26367;Venterol;442;9589991;567061;211;7629894;231;1960097;21697;15589
51155;Clesles;338;7333532;246268;192;5704651;146;1628881;21697;15590
85266;Saint-Prouant;776;16836903;437091;435;12895153;341;3941750;21697;15591
77347;Les Ormes-sur-Voulzie;520;11282698;442108;274;8758910;246;2523788;21697;15592
39277;Le Larderet;44;954698;30192;26;761340;18;193358;21698;15593
07090;Flaviac;689;14949860;527586;394;11849144;295;3100716;21698;15594
21228;Détain-et-Bruant;73;1583963;35814;41;1207448;32;376515;21698;15595
55269;Lahaymeix;51;1106618;37761;26;798007;25;308611;21698;15596
33306;Noaillac;219;4752006;153298;112;3346994;107;1405012;21699;15597
82076;L'Honor-de-Cos;822;17836536;631040;413;13472128;409;4364408;21699;15598
29197;Plouhinec;2541;55137912;2306054;1291;41382699;1250;13755213;21699;15599
64157;Buzy;510;11066785;376054;268;8217446;242;2849339;21700;15600
62514;Ligny-Saint-Flochel;136;2951146;104093;76;2312084;60;639062;21700;15601
54119;Charey;42;911390;15402;25;757204;17;154186;21700;15602
65314;Monfaucon;103;2235101;81106;45;1599589;58;635512;21700;15603
16110;Courcôme;221;4795706;304614;109;3611915;112;1183791;21700;15604
45211;Montcorbon;256;5555217;214558;137;4361411;119;1193806;21700;15605
54344;Mangonville;121;2625743;67258;73;2110370;48;515373;21700;15606
21573;Saint-Seine-l'Abbaye;194;4209886;140567;98;3258277;96;951609;21700;15607
53145;Marigné-Peuton;267;5794125;106700;156;4409769;111;1384356;21701;15608
49092;Chemillé;3745;81269927;2572503;1958;62169735;1787;19100192;21701;15609
89227;Ligny-le-Châtel;764;16579572;625956;416;12846012;348;3733560;21701;15610
02675;Sainte-Croix;72;1562482;43668;37;1200888;35;361594;21701;15611
22352;Tréfumel;145;3146674;93755;71;2374955;74;771719;21701;15612
32080;Castelnau-sur-l'Auvignon;101;2191825;92114;45;1704065;56;487760;21701;15613
70275;Grandvelle-et-le-Perrenot;168;3645816;84842;96;2882362;72;763454;21701;15614
25475;Quingey;696;15104196;494168;369;11356721;327;3747475;21701;15615
70134;Chariez;127;2756085;100840;76;2212086;51;543999;21701;15616
34010;Aniane;1608;34897291;1567729;797;27091209;811;7806082;21702;15617
61240;Macé;239;5186881;181303;111;3735698;128;1451183;21702;15618
35155;Lohéac;351;7617698;213279;193;5951000;158;1666698;21703;15619
70403;Palante;104;2257103;51208;61;1789009;43;468094;21703;15620
76497;Petit-Couronne;4918;106739364;4302169;2931;86952759;1987;19786605;21704;15621
21501;Pouilly-en-Auxois;892;19360135;833732;425;14552471;467;4807664;21704;15622
81270;Saint-Sernin-lès-Lavaur;75;1627816;35656;39;1261285;36;366531;21704;15623
21395;Massingy-lès-Vitteaux;55;1193749;49797;30;932296;25;261453;21705;15624
02176;Chavonne;98;2127044;44186;57;1621304;41;505740;21705;15625
60343;Lalande-en-Son;357;7748609;219039;205;6225350;152;1523259;21705;15626
71397;Sainte-Cécile;152;3299159;78877;89;2622409;63;676750;21705;15627
16218;Mesnac;232;5035646;165449;126;3878593;106;1157053;21705;15628
24576;Veyrines-de-Vergt;134;2908528;92881;66;2167248;68;741280;21705;15629
27139;Chambord;100;2170571;124315;53;1734277;47;436294;21706;15630
73261;Saint-Michel-de-Maurienne;1514;32862516;1247768;883;25770660;631;7091856;21706;15631
38216;Malleval-en-Vercors;32;694585;14990;17;523558;15;171027;21706;15632
79306;Saurais;93;2018671;26356;42;1371103;51;647568;21706;15633
18003;Les Aix-d'Angillon;1123;24376249;926325;618;18944398;505;5431851;21706;15634
47073;Cours;108;2344296;90162;59;1898599;49;445697;21706;15635
09338;Villeneuve-du-Latou;71;1541163;19808;30;946261;41;594902;21707;15636
67063;Breitenbach;387;8400465;268507;210;6416625;177;1983840;21707;15637
53186;Quelaines-Saint-Gault;1020;22141062;413116;532;16225762;488;5915300;21707;15638
65177;Fontrailles;80;1736581;53626;40;1298866;40;437715;21707;15639
80509;Marchélepot;247;5361737;273943;123;4098883;124;1262854;21707;15640
30336;Vallabrègues;758;16454958;700343;408;12883969;350;3570989;21708;15641
59301;Hergnies;2217;48127607;1742665;1192;37714362;1025;10413245;21708;15642
37086;Courcelles-de-Touraine;234;5079796;191038;110;3704971;124;1374825;21709;15643
71482;Saint-Symphorien-de-Marmagne;449;9747150;270392;244;7415441;205;2331709;21709;15644
19003;Albignac;138;2995813;124505;65;2216894;73;778919;21709;15645
22155;La Motte;1128;24487694;727781;639;19250236;489;5237458;21709;15646
33021;Auros;529;11484200;481429;268;8661262;261;2822938;21709;15647
02372;Hartennes-et-Taux;190;4124760;140320;110;3227799;80;896961;21709;15648
47256;Saint-Martin-de-Villeréal;60;1302571;69963;31;1028868;29;273703;21710;15649
33255;Lucmau;118;2561735;78863;72;2110135;46;451600;21710;15650
18026;Belleville-sur-Loire;551;11962326;557034;298;9558802;253;2403524;21710;15651
25218;Épenouse;67;1454607;38106;38;1105787;29;348820;21711;15652
33002;Aillas;451;9791505;674525;201;7551796;250;2239709;21711;15653
62887;Widehem;133;2887561;94485;71;2233957;62;653604;21711;15654
89333;Saint-André-en-Terre-Plaine;102;2214534;86759;54;1700971;48;513563;21711;15655
71173;Devrouze;163;3538918;142772;76;2604093;87;934825;21711;15656
89400;Sougères-en-Puisaye;205;4450809;194745;115;3502823;90;947986;21711;15657
21124;Censerey;106;2301403;91332;48;1649933;58;651470;21711;15658
42054;Châtelneuf;161;3495533;71367;81;2549777;80;945756;21711;15659
57474;Mondelange;3354;72820016;2227156;1657;49535415;1697;23284601;21711;15660
72305;Saint-Ouen-de-Mimbré;492;10682175;250362;282;8169296;210;2512879;21712;15661
54397;Neuves-Maisons;3966;86109488;3170491;2232;68867000;1734;17242488;21712;15662
57486;Morville-sur-Nied;66;1432992;65643;32;1020917;34;412075;21712;15663
71223;La Grande-Verrière;324;7034802;257072;171;5236041;153;1798761;21712;15664
81311;Vénès;390;8467945;269834;178;5980601;212;2487344;21713;15665
30333;Uchaud;2240;48637432;1807632;1222;37472619;1018;11164813;21713;15666
60535;Reuil-sur-Brêche;169;3669644;115303;101;2968645;68;700999;21714;15667
88195;Gendreville;61;1324551;51638;29;941283;32;383268;21714;15668
33104;Castelnau-de-Médoc;2227;48357619;1864346;1220;37989954;1007;10367665;21714;15669
70267;Gevigney-et-Mercey;248;5385148;157384;133;4128705;115;1256443;21714;15670
63061;Bussières-et-Pruns;218;4733903;197611;119;3708210;99;1025693;21715;15671
88461;Suriauville;116;2518962;92815;65;1970409;51;548553;21715;15672
52390;Pisseloup;27;586322;30871;11;428140;16;158182;21716;15673
89307;Pontigny;443;9620084;385882;268;7851141;175;1768943;21716;15674
29222;Port-Launay;284;6167349;298536;148;4803402;136;1363947;21716;15675
33120;Cérons;1031;22390350;929819;555;17404010;476;4986340;21717;15676
59192;Émerchicourt;460;9989899;325701;265;7927236;195;2062663;21717;15677
36122;Meunet-sur-Vatan;109;2367264;80606;62;1870877;47;496387;21718;15678
33182;Gauriac;472;10251362;471511;231;7745566;241;2505796;21719;15679
50069;Bourguenolles;163;3540231;82456;77;2423592;86;1116639;21719;15680
71387;Saint-André-le-Désert;138;2997271;128910;66;2224699;72;772572;21719;15681
48074;Hures-la-Parade;125;2714967;80094;59;1862499;66;852468;21720;15682
73146;Lescheraines;388;8427495;262353;225;6569883;163;1857612;21720;15683
17411;Saint-Trojan-les-Bains;858;18636298;744102;424;14473615;434;4162683;21721;15684
77337;Noisiel;8221;178565804;8186747;4566;143852129;3655;34713675;21721;15685
80409;Hallu;101;2193795;114877;55;1775241;46;418554;21721;15686
80734;Sentelie;111;2411034;87346;61;1872398;50;538636;21721;15687
19138;Meyssac;797;17311675;863663;397;13211282;400;4100393;21721;15688
88338;Ortoncourt;35;760238;12633;17;488513;18;271725;21721;15689
69220;Saint-Laurent-de-Chamousset;1013;22003546;775749;527;17013449;486;4990097;21721;15690
54258;Hénaménil;81;1759439;48060;44;1307694;37;451745;21721;15691
41059;Contres;2050;44529104;1977462;1097;34580591;953;9948513;21722;15692
22165;Penguily;298;6473054;98397;161;4799338;137;1673716;21722;15693
31177;Eup;89;1933271;94776;55;1603017;34;330254;21722;15694
39462;Rochefort-sur-Nenon;333;7233484;282048;199;5649527;134;1583957;21722;15695
56177;Pluvigner;3901;84738208;2917035;2038;63802669;1863;20935539;21722;15696
58121;Garchizy;2043;44378489;1984721;1153;35982177;890;8396312;21722;15697
15261;Le Vigean;511;11100065;477466;254;8165378;257;2934687;21722;15698
60521;Quincampoix-Fleuzy;207;4496655;145247;111;3341651;96;1155004;21723;15699
11360;Saint-Nazaire-d'Aude;908;19724989;691852;458;14973811;450;4751178;21724;15700
37094;Cussay;316;6864905;206666;177;5338913;139;1525992;21724;15701
59089;Bollezeele;769;16706183;805263;343;12039106;426;4667077;21725;15702
46144;Lacave;162;3519410;146011;93;2799443;69;719967;21725;15703
62228;Clerques;147;3193648;76889;74;2297577;73;896071;21725;15704
10094;Chavanges;366;7951872;446901;171;6048196;195;1903676;21726;15705
54532;Tremblecourt;99;2150929;62871;50;1553400;49;597529;21727;15706
33139;Coutures;49;1064605;40659;23;753719;26;310886;21727;15707
25445;Paroy;63;1368792;32529;34;1045547;29;323245;21727;15708
83102;Régusse;1248;27115421;986783;648;20295312;600;6820109;21727;15709
62442;Hernicourt;251;5453561;124803;137;4206102;114;1247459;21727;15710
41074;Dhuizon;740;16078555;579630;351;11534775;389;4543780;21728;15711
53214;Saint-Erblon;78;1694784;34325;38;1210366;40;484418;21728;15712
86108;La Grimaudière;222;4823676;243380;94;3463060;128;1360616;21728;15713
31107;Carbonne;2997;65120107;2532590;1511;49819530;1486;15300577;21728;15714
57478;Montdidier;48;1042989;39565;30;868501;18;174488;21729;15715
89421;Trévilly;37;804009;18526;17;575503;20;228506;21730;15716
31386;Montoulieu-Saint-Bernard;113;2455548;105778;56;1859380;57;596168;21731;15717
60354;Laverrière;24;521542;27798;13;405314;11;116228;21731;15718
25283;Goux-sous-Landet;33;717147;23225;18;545769;15;171378;21732;15719
28126;Dancy;122;2651360;109508;70;2100138;52;551222;21732;15720
82165;Saint-Loup;266;5780887;214205;153;4644476;113;1136411;21733;15721
61016;Autheuil;98;2129822;114657;53;1666131;45;463691;21733;15722
21676;Vic-de-Chassenay;134;2912243;106473;79;2324510;55;587733;21733;15723
17404;Saint-Simon-de-Pellouaille;284;6172257;184862;142;4707978;142;1464279;21733;15724
53108;La Gravelle;269;5846352;205099;149;4614489;120;1231863;21734;15725
51248;Fère-Champenoise;1255;27276614;1138200;668;20906639;587;6369975;21734;15726
72074;Chemiré-en-Charnie;117;2542920;89173;59;1873846;58;669074;21734;15727
70058;Beaujeu-Saint-Vallier-Pierrejux-et-Quitteur;482;10476251;276945;283;8141812;199;2334439;21735;15728
32452;Tournecoupe;158;3434195;155676;66;2602166;92;832029;21735;15729
48094;Le Massegros;201;4368927;152380;104;3177705;97;1191222;21736;15730
69139;Montrottier;775;16845539;613145;413;13109528;362;3736011;21736;15731
62141;Blessy;428;9303118;370183;230;7091398;198;2211720;21736;15732
55487;Seuzey;64;1391130;85777;33;1065285;31;325845;21736;15733
62829;Le Transloy;233;5064675;257741;119;3887737;114;1176938;21737;15734
21362;Maconge;75;1630280;49067;42;1215141;33;415139;21737;15735
10441;Vosnon;120;2608450;96926;63;1989776;57;618674;21737;15736
54431;Pont-à-Mousson;7993;173745532;8105528;4157;135225692;3836;38519840;21737;15737
62008;Acquin-Westbécourt;388;8434105;248189;199;6196669;189;2237436;21737;15738
62536;Magnicourt-en-Comte;350;7608261;274938;163;5801838;187;1806423;21738;15739
83041;Claviers;365;7934370;481827;174;6252566;191;1681804;21738;15740
70201;Delain;126;2739009;104903;69;2016670;57;722339;21738;15741
35211;Paimpont;924;20086068;777866;494;15663606;430;4422462;21738;15742
30188;Ners;396;8608367;382606;196;6527103;200;2081264;21738;15743
89344;Saint-Fargeau;975;21195199;1153192;459;16152055;516;5043144;21739;15744
86026;Beuxes;279;6065098;298654;133;4401659;146;1663439;21739;15745
80061;Beaucamps-le-Jeune;117;2543525;197343;54;1973426;63;570099;21740;15746
86070;Chauvigny;4169;90632471;4026824;2157;70398440;2012;20234031;21740;15747
47274;Saint-Romain-le-Noble;242;5261151;206174;127;4217618;115;1043533;21740;15748
59498;Reumont;188;4087289;115899;94;3083777;94;1003512;21741;15749
86125;Leigné-les-Bois;310;6739708;283392;176;5533207;134;1206501;21741;15750
24063;Bouzic;87;1891469;64257;42;1406184;45;485285;21741;15751
13027;Châteaurenard;8999;195649335;9829037;4313;149520549;4686;46128786;21741;15752
59117;Bugnicourt;509;11066683;394614;285;8644850;224;2421833;21742;15753
61401;Saint-Gilles-des-Marais;51;1108849;52385;27;859910;24;248939;21742;15754
62398;Guisy;152;3304830;99830;89;2671873;63;632957;21742;15755
70581;Vy-lès-Lure;347;7544597;269614;176;5566730;171;1977867;21742;15756
16099;Chillac;116;2522131;154770;55;1900132;61;621999;21743;15757
39064;Bonnaud;28;608804;22498;17;468193;11;140611;21743;15758
42157;Noailly;388;8436527;199690;214;6450160;174;1986367;21744;15759
89412;Thizy;114;2478774;140004;49;1940393;65;538381;21744;15760
07087;Fabras;202;4392215;152671;116;3487878;86;904337;21744;15761
25519;Saint-Hippolyte;552;12002615;546809;315;9616933;237;2385682;21744;15762
70577;Vouhenans;215;4674989;152347;121;3782649;94;892340;21744;15763
42289;Saint-Symphorien-de-Lay;955;20765657;585501;493;15078832;462;5686825;21744;15764
56181;Port-Louis;1700;36966006;1715048;850;28084047;850;8881959;21745;15765
24127;Coly;117;2544155;66206;71;2113675;46;430480;21745;15766
59149;Clary;598;13003569;449678;306;9948756;292;3054813;21745;15767
41228;Saint-Rimay;181;3935959;150006;104;3135419;77;800540;21746;15768
39201;Doucier;176;3827311;152626;88;2901005;88;926306;21746;15769
89086;Charny;1034;22485610;1688890;486;17117276;548;5368334;21746;15770
72126;Épineu-le-Chevreuil;150;3261957;84652;87;2500468;63;761489;21746;15771
41106;Lamotte-Beuvron;2732;59411475;2455842;1499;45661347;1233;13750128;21747;15772
62625;Noyelles-lès-Humières;26;565413;744;12;346583;14;218830;21747;15773
59474;Prisches;526;11438985;580444;246;8667038;280;2771947;21747;15774
60312;Héricourt-sur-Thérain;56;1217850;32514;26;866966;30;350884;21747;15775
30330;Tornac;502;10917173;443736;235;7834745;267;3082428;21747;15776
52203;Fontaines-sur-Marne;83;1805031;73761;47;1388912;36;416119;21747;15777
42328;Verrières-en-Forez;365;7937793;328124;192;6101285;173;1836508;21747;15778
40032;Belhade;109;2370550;168360;54;1856052;55;514498;21748;15779
34044;Cabrerolles;189;4110452;196651;78;3083029;111;1027423;21748;15780
55428;Réville-aux-Bois;75;1631140;55119;40;1257264;35;373876;21749;15781
01058;Brégnier-Cordon;412;8960712;287108;232;6975021;180;1985691;21749;15782
32387;Saint-Loube;58;1261468;52804;29;881082;29;380386;21749;15783
55429;Riaville;30;652503;30295;15;509404;15;143099;21750;15784
63311;Saint-Agoulin;160;3480186;54974;87;2599852;73;880334;21751;15785
60068;Béthisy-Saint-Pierre;1737;37783432;1436656;999;30058646;738;7724786;21752;15786
40206;Oeyregave;193;4198220;142519;112;3341196;81;857024;21752;15787
70412;Plainemont;32;696083;22291;17;515034;15;181049;21753;15788
51416;Orbais-l'Abbaye;336;7308980;337822;171;5496509;165;1812471;21753;15789
27286;Giverville;197;4285416;247074;95;3205205;102;1080211;21753;15790
24524;Savignac-de-Miremont;88;1914387;85531;43;1521270;45;393117;21754;15791
60589;Saint-Maximin;1690;36765744;1454251;998;29527648;692;7238096;21755;15792
17486;La Brée-les-Bains;525;11421550;578598;274;8815372;251;2606178;21755;15793
71017;Ballore;53;1153057;31696;28;873125;25;279932;21756;15794
25159;Colombier-Fontaine;798;17361253;820335;442;13372693;356;3988560;21756;15795
58011;Armes;185;4024861;163815;116;3301034;69;723827;21756;15796
08027;Auboncourt-Vauzelles;52;1131349;36347;22;758619;30;372730;21757;15797
61305;Neuilly-sur-Eure;340;7397514;289146;179;5758364;161;1639150;21757;15798
04127;Montfort;192;4177446;184551;105;3341521;87;835925;21758;15799
08370;Rouvroy-sur-Audry;265;5765746;129962;137;4071421;128;1694325;21758;15800
85273;Saint-Urbain;844;18363948;490791;468;13851078;376;4512870;21758;15801
36063;Déols;4692;102089845;3943335;2823;82763855;1869;19325990;21758;15802
04070;Digne-les-Bains;10403;226351504;12439638;5598;182895642;4805;43455862;21758;15803
36023;Bouges-le-Château;166;3611899;151420;74;2568873;92;1043026;21758;15804
74129;La Forclaz;119;2589314;73740;66;1873884;53;715430;21759;15805
88333;Nossoncourt;50;1087950;23493;24;789926;26;298024;21759;15806
03243;Saint-Marcel-en-Murat;77;1675458;43393;38;1215280;39;460178;21759;15807
10207;Longueville-sur-Aube;83;1806025;83412;43;1436410;40;369615;21759;15808
44119;Paulx;929;20214940;492125;484;15042390;445;5172550;21760;15809
59317;Houplines;4151;90325696;3334680;2327;71751165;1824;18574531;21760;15810
62684;Racquinghem;1137;24741263;864490;623;18650909;514;6090354;21760;15811
89040;Bessy-sur-Cure;112;2437166;80042;65;1940186;47;496980;21760;15812
76358;Le Héron;133;2894211;64358;77;2245816;56;648395;21761;15813
59132;Carnières;543;11816279;390471;289;9199749;254;2616530;21761;15814
41139;Meusnes;640;13927261;586869;329;10446318;311;3480943;21761;15815
86017;Ayron;605;13165711;418962;328;10214210;277;2951501;21762;15816
49145;Le Fuilet;1081;23524767;801084;534;16984448;547;6540319;21762;15817
61407;Sainte-Honorine-la-Chardonne;385;8378477;291339;227;6663541;158;1714936;21762;15818
34068;Cazouls-d'Hérault;210;4570089;176535;97;3480033;113;1090056;21762;15819
55047;Béthelainville;101;2198003;83701;49;1445854;52;752149;21762;15820
21563;Saint-Mesmin;78;1697546;62825;45;1390207;33;307339;21763;15821
21358;Lucenay-le-Duc;116;2524583;86858;56;1816820;60;707763;21764;15822
13024;Charleval;1407;30621749;1201943;700;23454076;707;7167673;21764;15823
38261;Morestel;2214;48185348;1958064;1107;35783314;1107;12402034;21764;15824
45063;Cerdon;609;13254831;613690;318;10218018;291;3036813;21765;15825
02179;Chéry-Chartreuve;202;4396534;157413;109;3388265;93;1008269;21765;15826
50075;Brectouville;92;2002389;34887;60;1653164;32;349225;21765;15827
57262;Grostenquin;334;7269563;274296;170;5303715;164;1965848;21765;15828
84145;Villars;458;9968486;358039;259;7978886;199;1989600;21765;15829
83146;La Verdière;883;19218969;692897;457;14550614;426;4668355;21766;15830
22193;Plestan;872;18979730;657679;495;15186896;377;3792834;21766;15831
55334;Ménil-la-Horgne;83;1806560;40071;46;1458594;37;347966;21766;15832
89150;Égleny;244;5310921;206115;129;4039242;115;1271679;21766;15833
72345;Surfonds;184;4004966;91407;110;3104342;74;900624;21766;15834
70024;Apremont;245;5332775;181568;139;3947206;106;1385569;21766;15835
52011;Annéville-la-Prairie;48;1044804;39864;25;793360;23;251444;21767;15836
39119;Le Chateley;51;1110105;54947;22;767076;29;343029;21767;15837
33434;Saint-Louis-de-Montferrand;1106;24074738;813583;642;19350071;464;4724667;21767;15838
29021;Brignogan-Plage;550;11972232;633046;271;8974613;279;2997619;21768;15839
28123;Dampierre-sous-Brou;274;5964449;155492;163;4772183;111;1192266;21768;15840
52058;Bologne;1118;24337419;859059;647;19237247;471;5100172;21769;15841
24045;Boisse;127;2764635;68744;47;1688259;80;1076376;21769;15842
35101;Dourdain;503;10949919;201001;274;8123792;229;2826127;21769;15843
32366;Saint-Brès;44;957889;27798;18;614255;26;343634;21770;15844
25310;Huanne-Montmartin;52;1132056;54740;30;838783;22;293273;21770;15845
69132;Meys;418;9099991;250251;220;6946791;198;2153200;21770;15846
30021;Aubussargues;180;3918693;168614;95;3031993;85;886700;21771;15847
85209;Saint-Étienne-de-Brillouet;261;5682278;170311;132;4270815;129;1411463;21771;15848
25312;Hyèvre-Magny;35;762016;21291;22;596770;13;165246;21772;15849
44025;Campbon;1975;42999557;1050683;1073;32332883;902;10666674;21772;15850
88497;Vaxoncourt;254;5530078;127988;148;4323209;106;1206869;21772;15851
01409;Songieu;71;1545823;63789;40;1201518;31;344305;21772;15852
27022;Aubevoye;2549;55498569;1880321;1434;43231282;1115;12267287;21773;15853
22286;Saint-Denoual;218;4746459;151330;118;3620774;100;1125685;21773;15854
29143;Mahalon;438;9536495;248113;232;7161981;206;2374514;21773;15855
56090;Inzinzac-Lochrist;3349;72918449;2011057;1958;57608291;1391;15310158;21773;15856
86293;Vivonne;1967;42828787;1780858;1014;33433879;953;9394908;21774;15857
52506;Vaudrémont;56;1219329;88850;26;914756;30;304573;21774;15858
01266;Montrevel-en-Bresse;1377;29983038;1063235;773;23297751;604;6685287;21774;15859
02736;Tartiers;84;1829047;66220;41;1319880;43;509167;21774;15860
01417;Thézillieu;186;4050092;208878;100;3206098;86;843994;21775;15861
33228;Lansac;381;8296262;339204;193;6367401;188;1928861;21775;15862
07339;Vesseaux;954;20773384;680666;526;16062331;428;4711053;21775;15863
81321;Le Vintrou;46;1001681;33419;28;855721;18;145960;21776;15864
89179;Fontenoy;185;4028517;173623;87;2879827;98;1148690;21776;15865
33244;Lignan-de-Bazas;179;3897864;180263;103;3063042;76;834822;21776;15866
33304;Neuffons;85;1850959;45313;44;1328456;41;522503;21776;15867
17341;Saint-Germain-de-Vibrac;112;2438921;149717;54;1859787;58;579134;21776;15868
80076;Béhen;270;5879647;214107;156;4603135;114;1276512;21776;15869
34192;Palavas-les-Flots;4688;102089866;6096326;2535;82243730;2153;19846136;21777;15870
64087;Baigts-de-Béarn;445;9691017;308864;218;7536032;227;2154985;21778;15871
71462;Saint-Maurice-en-Rivière;279;6076174;203776;155;4623780;124;1452394;21778;15872
14083;Bonnebosq;406;8842089;441127;193;6479851;213;2362238;21779;15873
44152;Sainte-Anne-sur-Brivet;1365;29727969;649665;780;22623429;585;7104540;21779;15874
51620;Vienne-la-Ville;108;2352124;88328;70;1981853;38;370271;21779;15875
37190;Pussigny;98;2134360;63545;50;1619297;48;515063;21779;15876
48147;Saint-Étienne-du-Valdonnez;334;7274273;229604;179;5481155;155;1793118;21779;15877
61447;Saint-Pierre-du-Regard;765;16661310;497775;475;13269666;290;3391644;21779;15878
08120;Chevières;29;631608;27359;14;471662;15;159946;21780;15879
56114;Locmaria;500;10889808;505458;274;8456585;226;2433223;21780;15880
24478;Saint-Pardoux-et-Vielvic;92;2003769;121504;37;1487864;55;515905;21780;15881
37278;Villeperdue;490;10672511;330753;276;8174514;214;2497997;21781;15882
59379;Marcq-en-Ostrevent;346;7536129;204187;207;6048672;139;1487457;21781;15883
51014;Arcis-le-Ponsart;183;3985926;292823;83;3364214;100;621712;21781;15884
59652;Wavrechain-sous-Faulx;190;4138479;107269;109;3189434;81;949045;21781;15885
72077;Chenu;243;5292914;205758;115;4037373;128;1255541;21782;15886
13102;Saint-Victoret;3771;82138830;3694597;2076;65454935;1695;16683895;21782;15887
45073;Chantecoq;292;6360287;256806;184;5262900;108;1097387;21782;15888
67191;Herbitzheim;1028;22392394;664229;573;17205575;455;5186819;21782;15889
67075;Climbach;244;5314968;142154;142;4131060;102;1183908;21783;15890
36205;Saint-Pierre-de-Jards;80;1742650;100987;36;1250393;44;492257;21783;15891
56263;Sainte-Anne-d'Auray;1390;30278573;991740;716;22876073;674;7402500;21783;15892
70120;Champagney;2033;44285493;1433078;1106;33632721;927;10652772;21783;15893
61370;Saint-Brice;92;2004076;52743;51;1511497;41;492579;21783;15894
65040;Aspin-en-Lavedan;167;3637891;88168;96;2824239;71;813652;21784;15895
80101;Beuvraignes;425;9258210;379808;230;7099391;195;2158819;21784;15896
54549;Varangéville;2187;47642145;1765516;1267;38618202;920;9023943;21784;15897
2A127;Giuncheto;45;980310;32150;21;657756;24;322554;21785;15898
26316;Saint-Martin-le-Colonel;101;2200293;110417;57;1777876;44;422417;21785;15899
85147;Montournais;880;19170876;519772;500;14794867;380;4376009;21785;15900
71380;Saillenard;421;9171749;357134;236;7180956;185;1990793;21786;15901
45149;Foucherolles;174;3790718;171661;97;2989117;77;801601;21786;15902
18041;La Celette;95;2069661;102390;45;1467557;50;602104;21786;15903
12271;Sévérac-l'Église;219;4771262;165454;125;3802380;94;968882;21787;15904
32332;Préneron;80;1742944;77848;43;1359843;37;383101;21787;15905
29065;Gourlizon;488;10632323;256329;284;8023658;204;2608665;21788;15906
33163;Faleyras;225;4902345;193074;120;3855995;105;1046350;21788;15907
53038;Boulay-les-Ifs;88;1917385;31925;43;1300197;45;617188;21788;15908
48129;Rocles;130;2832508;103020;69;2266249;61;566259;21789;15909
54408;Olley;129;2810771;99199;67;2035456;62;775315;21789;15910
27065;Beuzeville;2592;56477463;2811465;1322;43191757;1270;13285706;21789;15911
25335;Liebvillers;95;2069981;86601;55;1639205;40;430776;21789;15912
61311;Normandel;51;1111273;44417;28;787451;23;323822;21790;15913
18144;Menetou-Râtel;283;6166513;235010;158;4948673;125;1217840;21790;15914
82075;Grisolles;2144;46717475;1779230;1119;36179829;1025;10537646;21790;15915
76676;Sigy-en-Bray;373;8127745;212159;208;6246460;165;1881285;21790;15916
89169;Flogny-la-Chapelle;557;12137401;426953;314;9204083;243;2933318;21791;15917
14206;Crocy;170;3704477;150481;86;2743860;84;960617;21791;15918
62699;Recques-sur-Hem;292;6363298;160861;151;4679590;141;1683708;21792;15919
18027;Bengy-sur-Craon;347;7561894;221134;190;5810620;157;1751274;21792;15920
27064;Berville-sur-Mer;322;7017189;226625;177;5509391;145;1507798;21793;15921
06050;Coursegoules;285;6211085;280649;158;4999431;127;1211654;21793;15922
84026;Cadenet;2452;53438498;2436968;1251;41558347;1201;11880151;21794;15923
89008;Angely;95;2070415;75213;58;1656501;37;413914;21794;15924
10408;Viâpres-le-Petit;68;1481989;61669;38;1140106;30;341883;21794;15925
55435;Robert-Espagne;446;9720366;362220;243;7496945;203;2223421;21795;15926
27513;Saint-Aubin-des-Hayes;78;1699981;71877;39;1230478;39;469503;21795;15927
23177;Saint-Agnant-de-Versillat;637;13883354;616809;297;10376463;340;3506891;21795;15928
62479;Labeuvrière;865;18852759;557193;504;15077352;361;3775407;21795;15929
93005;Aulnay-sous-Bois;41430;902988566;47385171;21356;710926320;20074;192062246;21796;15930
81002;Aiguefonde;1432;31211759;1017573;778;23924809;654;7286950;21796;15931
61446;Saint-Pierre-des-Loges;92;2005232;87711;48;1535503;44;469729;21796;15932
60592;Saint-Pierre-es-Champs;384;8369918;321827;214;6616760;170;1753158;21797;15933
32424;Ségos;141;3073361;130327;79;2466622;62;606739;21797;15934
02159;Champs;155;3378565;113713;86;2650676;69;727889;21797;15935
71012;Artaix;200;4359534;146269;98;3240668;102;1118866;21798;15936
41255;Ternay;195;4250582;149738;107;3209544;88;1041038;21798;15937
86127;Leigné-sur-Usseau;254;5536714;183664;154;4408484;100;1128230;21798;15938
47012;Anzex;153;3335124;87916;75;2452921;78;882203;21798;15939
22219;Plouguenast;1007;21950784;781688;508;16171716;499;5779068;21798;15940
55244;Herméville-en-Woëvre;122;2659399;94626;44;1855958;78;803441;21798;15941
88030;Bainville-aux-Saules;70;1525900;37066;30;1068989;40;456911;21799;15942
85133;Maillezais;567;12360272;589491;256;9036853;311;3323419;21799;15943
58138;Langeron;201;4381739;190015;96;3220286;105;1161453;21800;15944
01218;Lochieu;49;1068186;22717;30;847655;19;220531;21800;15945
88274;Longchamp-sous-Châtenois;43;937400;17860;21;641229;22;296171;21800;15946
14289;Fresné-la-Mère;263;5733422;123070;144;4169471;119;1563951;21800;15947
25070;Bolandoz;184;4011220;99691;98;2814901;86;1196319;21800;15948
33150;Dieulivol;142;3095624;72923;64;2220546;78;875078;21800;15949
88184;Fremifontaine;241;5253852;101230;127;3924475;114;1329377;21800;15950
89352;Saint-Martin-des-Champs;172;3749696;155295;91;2865290;81;884406;21801;15951
09002;Aigues-Vives;318;6932641;250857;175;5361631;143;1571010;21801;15952
85293;Tiffauges;779;16982865;386383;433;12735151;346;4247714;21801;15953
83078;Moissac-Bellevue;174;3793366;177843;81;2811920;93;981446;21801;15954
12252;Salles-Courbatiès;242;5275844;144194;106;3875461;136;1400383;21801;15955
60115;Bulles;482;10508096;393150;276;8482508;206;2025588;21801;15956
76005;Amfreville-la-Mi-Voie;1795;39132986;1598139;1077;31973944;718;7159042;21801;15957
76042;Auvilliers;47;1024654;67984;27;881786;20;142868;21801;15958
21036;Auxant;43;937450;31295;27;743446;16;194004;21801;15959
86191;Pindray;142;3095903;106606;79;2436219;63;659684;21802;15960
53048;Chailland;618;13473984;359884;313;9919396;305;3554588;21803;15961
25166;Côtebrune;31;675886;12563;13;441303;18;234583;21803;15962
86154;Mazeuil;145;3161468;126346;75;2405362;70;756106;21803;15963
71528;Sornay;1102;24027722;779645;588;18183010;514;5844712;21804;15964
49170;Juvardeil;451;9833701;272146;252;7282685;199;2551016;21804;15965
76087;Berville;297;6475870;164150;160;4799375;137;1676495;21804;15966
57244;Garrebourg;279;6083568;207601;144;4362363;135;1721205;21805;15967
48039;Chanac;772;16833471;608107;417;13182086;355;3651385;21805;15968
33027;Barie;151;3292670;192556;80;2521255;71;771415;21806;15969
85233;Saint-Jean-de-Beugné;303;6607190;226939;161;4946294;142;1660896;21806;15970
80348;Fransu;83;1809891;83982;43;1393535;40;416356;21806;15971
61314;Occagnes;336;7326917;228203;173;5376004;163;1950913;21806;15972
04230;Valensole;1886;41127263;1981716;967;31914410;919;9212853;21807;15973
33039;Bègles;15201;331483533;15416847;8926;268835634;6275;62647899;21807;15974
58063;Château-Chinon (Campagne);361;7872233;291755;204;6146098;157;1726135;21807;15975
84123;Sault;829;18078283;856850;390;13907753;439;4170530;21807;15976
57019;Amnéville;5721;124765376;3842478;2886;87939084;2835;36826292;21808;15977
19076;Espartignac;235;5125009;162540;133;3996569;102;1128440;21809;15978
07138;Lavilledieu;1094;23859018;782366;599;18404430;495;5454588;21809;15979
39280;Larrivoire;77;1679319;59639;52;1482586;25;196733;21809;15980
19211;Saint-Hilaire-Peyroux;537;11711657;434853;287;9055920;250;2655737;21809;15981
62353;Frémicourt;158;3445920;151062;78;2528155;80;917765;21810;15982
54307;Lebeuville;79;1722983;36427;44;1234554;35;488429;21810;15983
88224;Hadigny-les-Verrières;206;4492843;110961;126;3575933;80;916910;21810;15984
80754;Thieulloy-l'Abbaye;181;3947665;181351;96;3072158;85;875507;21810;15985
59449;Orchies;4617;100698949;4225065;2485;78839946;2132;21859003;21810;15986
25237;Fesches-le-Châtel;1275;27808867;1172749;738;21779722;537;6029145;21811;15987
11330;Rustiques;228;4973020;122998;127;3884820;101;1088200;21811;15988
86148;Marnay;375;8179590;209378;213;6413280;162;1766310;21812;15989
60329;Laberlière;109;2377663;82683;65;1860867;44;516796;21813;15990
06120;Saint-Étienne-de-Tinée;837;18258076;1014174;464;15048979;373;3209097;21814;15991
41154;Morée;673;14680797;634475;334;10811655;339;3869142;21814;15992
39328;Meussia;234;5104526;150434;138;4019736;96;1084790;21814;15993
76441;Monchaux-Soreng;337;7351437;232704;194;5726554;143;1624883;21814;15994
52422;Richebourg;155;3381297;140208;92;2754274;63;627023;21815;15995
55324;Marville;307;6697291;301106;143;4646306;164;2050985;21815;15996
51218;Val-de-Vière;77;1679843;77659;45;1342837;32;337006;21816;15997
80312;Fins;145;3163343;118430;74;2355630;71;807713;21816;15998
73173;Montricher-Albanne;321;7003014;295913;209;5785803;112;1217211;21816;15999
33345;Le Puy;188;4101943;145381;100;3251408;88;850535;21819;16000
57513;Nousseviller-lès-Bitche;85;1854602;71772;50;1471253;35;383349;21819;16001
67513;Waldersbach;88;1920068;70120;46;1472121;42;447947;21819;16002
16141;Fontenille;188;4101979;157251;103;3194426;85;907553;21819;16003
22157;Le Moustoir;361;7876846;217039;206;6123698;155;1753148;21820;16004
60269;Gaudechart;191;4167537;115547;119;3374279;72;793258;21820;16005
62311;Estevelles;968;21122127;543153;524;16133769;444;4988358;21820;16006
56226;Saint-Malo-de-Beignon;230;5018772;124016;133;3808258;97;1210514;21821;16007
27047;Beaubray;173;3775109;144794;104;3089233;69;685876;21821;16008
25342;Longechaux;30;654644;8049;12;420240;18;234404;21821;16009
68275;Rimbach-près-Masevaux;270;5892041;162384;150;4451927;120;1440114;21822;16010
64332;Lème;87;1898654;79660;49;1439369;38;459285;21824;16011
86122;Lauthiers;37;807488;33481;15;594870;22;212618;21824;16012
16136;La Faye;343;7485652;270286;168;5633016;175;1852636;21824;16013
89122;Courgenay;307;6700032;218984;167;5086914;140;1613118;21824;16014
31100;Calmont;1210;26407510;853312;606;20149490;604;6258020;21824;16015
62823;Torcy;83;1811494;78221;36;1287628;47;523866;21825;16016
62356;Fresnicourt-le-Dolmen;441;9625000;376808;232;7435693;209;2189307;21825;16017
67373;Pfalzweyer;171;3732188;101948;86;2720955;85;1011233;21826;16018
01309;Pouillat;48;1047654;41649;30;821810;18;225844;21826;16019
31428;Polastron;35;763934;30380;18;603966;17;159968;21827;16020
02682;Saint-Mard;71;1549726;87697;38;1253139;33;296587;21827;16021
22084;Jugon-les-Lacs;928;20255606;634958;446;14900553;482;5355053;21827;16022
08149;L'Échelle;68;1484251;42067;29;931981;39;552270;21827;16023
86233;Valdivienne;1527;33330257;1088506;840;25692058;687;7638199;21827;16024
84017;Bédoin;1841;40184101;1903932;910;30642523;931;9541578;21827;16025
33295;Mouillac;53;1156864;44015;25;898274;28;258590;21828;16026
80447;Hyencourt-le-Grand;41;894944;37785;25;673114;16;221830;21828;16027
04241;Villemus;95;2073700;56808;57;1633187;38;440513;21828;16028
31416;Peyssies;285;6221103;215394;155;5045946;130;1175157;21828;16029
59102;Boussières-en-Cambrésis;224;4889572;190425;113;3692930;111;1196642;21828;16030
29142;Lothey;240;5238920;155770;129;3908604;111;1330316;21829;16031
62072;Bailleulmont;143;3121529;80433;73;2456682;70;664847;21829;16032
70341;Menoux;163;3558119;118758;85;2610391;78;947728;21829;16033
46028;Bétaille;558;12180916;465244;302;9410158;256;2770758;21830;16034
71065;Buffières;142;3099832;106556;78;2326883;64;772949;21830;16035
2A285;Sorbollano;39;851368;57407;24;744124;15;107244;21830;16036
83092;Pignans;2055;44860594;2101921;1041;34626480;1014;10234114;21830;16037
49162;Jallais;1684;36761943;897276;879;26834403;805;9927540;21830;16038
21333;Labruyère;111;2423150;70498;58;1764102;53;659048;21830;16039
29052;Esquibien;953;20805152;832579;492;15628637;461;5176515;21831;16040
10229;Maupas;58;1266218;28390;34;994349;24;271869;21831;16041
27470;Pont-Saint-Pierre;645;14081468;488800;358;10890625;287;3190843;21832;16042
66174;Saint-Féliu-d'Avall;1481;32332951;1345268;747;24691259;734;7641692;21832;16043
03166;Mazerier;165;3602257;131440;92;2804705;73;797552;21832;16044
21007;Aisy-sous-Thil;133;2903773;100551;78;2292668;55;611105;21833;16045
24138;Coulounieix-Chamiers;4821;105257275;4893519;2577;83318647;2244;21938628;21833;16046
14628;Saint-Martin-de-Sallen;313;6833884;187642;154;4948143;159;1885741;21833;16047
54568;Ville-au-Montois;149;3253196;85806;62;2054421;87;1198775;21834;16048
35078;Cherrueix;611;13340309;529196;289;9663943;322;3676366;21834;16049
88248;Isches;96;2096041;60852;52;1703025;44;393016;21834;16050
13116;Verquières;444;9694604;299580;229;7359955;215;2334649;21835;16051
27586;Saint-Philbert-sur-Boissey;90;1965142;63848;57;1599805;33;365337;21835;16052
80487;Longavesnes;54;1179096;50823;28;967197;26;211899;21835;16053
65013;Ansost;32;698737;27763;16;538962;16;159775;21836;16054
88457;Sionne;79;1725011;45366;43;1284684;36;440327;21836;16055
12101;Flagnac;587;12818234;500213;297;9786946;290;3031288;21837;16056
59313;Hordain;748;16334213;620904;409;12592635;339;3741578;21837;16057
72224;Nuillé-le-Jalais;246;5372063;116282;145;4121621;101;1250442;21838;16058
72131;Fercé-sur-Sarthe;299;6529578;164335;179;5236149;120;1293429;21838;16059
41073;Danzé;392;8560619;265947;229;6792559;163;1768060;21838;16060
47300;Sérignac-sur-Garonne;612;13365199;489162;324;10252238;288;3112961;21839;16061
03152;Louroux-de-Bouble;147;3210311;153601;69;2496154;78;714157;21839;16062
86156;Messemé;119;2598865;63684;59;1951744;60;647121;21839;16063
54136;Conflans-en-Jarnisy;1365;29810538;1147646;730;22637757;635;7172781;21839;16064
30104;Domessargues;325;7098109;181347;172;5339892;153;1758217;21840;16065
10203;Longchamp-sur-Aujon;244;5329273;226995;130;4267315;114;1061958;21841;16066
02124;Brissy-Hamégicourt;373;8146799;281916;197;6048474;176;2098325;21841;16067
44087;Machecoul;3283;71705979;2468398;1707;54383309;1576;17322670;21842;16068
78335;Limay;8853;193365925;7831284;4944;151384332;3909;41981593;21842;16069
65426;Sinzos;80;1747395;50091;47;1362565;33;384830;21842;16070
21186;Comblanchien;389;8496786;335882;236;6840358;153;1656428;21843;16071
55345;Mont-devant-Sassey;55;1201383;19370;32;902676;23;298707;21843;16072
02719;Sinceny;1175;25665947;1004118;634;19946354;541;5719593;21843;16073
33487;Saint-Vincent-de-Paul;537;11730124;404667;299;8987582;238;2742542;21844;16074
2B050;Calvi;3798;82962971;5286643;2112;66526835;1686;16436136;21844;16075
53022;La Bazouge-de-Chemeré;236;5155165;96561;115;3829146;121;1326019;21844;16076
70190;Cubry-lès-Faverney;85;1856760;40238;56;1510585;29;346175;21844;16077
17192;Jarnac-Champagne;443;9677092;428900;210;7242415;233;2434677;21844;16078
02210;Condé-sur-Aisne;191;4172365;137321;106;3300956;85;871409;21845;16079
45186;Lorcy;306;6684565;209253;157;4809430;149;1875135;21845;16080
54054;Bayon;937;20468933;744059;479;15214118;458;5254815;21845;16081
49075;La Chapelle-Saint-Florent;699;15270172;423034;360;11353568;339;3916604;21846;16082
28263;Montigny-sur-Avre;147;3211348;117234;87;2644036;60;567312;21846;16083
45292;Saint-Maurice-sur-Aveyron;489;10682669;561981;268;8557812;221;2124857;21846;16084
19007;Altillac;535;11687905;587893;295;9168373;240;2519532;21847;16085
29198;Plouider;1055;23048647;683952;547;17295978;508;5752669;21847;16086
33463;Saint-Pierre-d'Aurillac;742;16210969;623458;363;12363063;379;3847906;21848;16087
31001;Agassac;58;1267176;29148;28;985548;30;281628;21848;16088
70062;Belmont;68;1485667;71155;37;1166869;31;318798;21848;16089
49159;Huillé;261;5702452;217163;143;4334585;118;1367867;21848;16090
67066;La Broque;1547;33799865;1241541;846;25911190;701;7888675;21849;16091
62286;Ecquedecques;270;5899163;178685;145;4503572;125;1395591;21849;16092
46042;Cahors;12403;271001177;15150061;6478;217287534;5925;53713643;21850;16093
80489;Longueau;3057;66794529;2453851;1805;53292716;1252;13501813;21850;16094
14453;Mosles;182;3976733;111154;110;3192094;72;784639;21850;16095
79217;Prailles;350;7647575;235008;190;5995295;160;1652280;21850;16096
32162;Jegun;653;14268236;616471;356;11298864;297;2969372;21850;16097
29252;Saint-Jean-Trolimon;529;11558803;380602;274;8778901;255;2779902;21850;16098
59203;Erre;757;16540810;652249;400;12668169;357;3872641;21850;16099
39542;Valfin-sur-Valouse;42;917725;25709;24;727208;18;190517;21851;16100
17389;Sainte-Radegonde;295;6445941;208110;156;4988690;139;1457251;21851;16101
55505;Thierville-sur-Meuse;1621;35420307;1273926;990;28119414;631;7300893;21851;16102
33160;Eynesse;328;7167233;269216;153;5430429;175;1736804;21851;16103
38355;Saint-Andéol;72;1573301;70286;47;1318345;25;254956;21851;16104
46005;Anglars-Juillac;190;4151791;143568;90;3053944;100;1097847;21852;16105
54215;Frouard;3739;81705207;3088635;2161;65196728;1578;16508479;21852;16106
2B327;Tomino;116;2534905;131395;55;1888513;61;646392;21853;16107
57063;Bérig-Vintrange;130;2840847;101566;69;2190007;61;650840;21853;16108
08444;Tétaigne;45;983378;17428;19;652240;26;331138;21853;16109
32013;Auch;13631;297879018;16794149;7250;240261619;6381;57617399;21853;16110
17259;Neulles;92;2010495;106736;44;1495995;48;514500;21853;16111
43018;Bains;660;14423154;439474;352;10822466;308;3600688;21853;16112
10042;Bérulle;146;3190616;125820;83;2467962;63;722654;21854;16113
19263;Soudeilles;192;4195963;168307;111;3316786;81;879177;21854;16114
33078;Cabara;225;4917172;104213;124;3781861;101;1135311;21854;16115
38444;Saint-Pierre-de-Méaroz;69;1507933;50651;38;1198737;31;309196;21854;16116
17202;Landes;316;6905987;224447;154;4868732;162;2037255;21854;16117
60622;Sommereux;218;4764290;137617;118;3673808;100;1090482;21855;16118
61499;Les Ventes-de-Bourse;83;1813928;78970;44;1436146;39;377782;21855;16119
80346;Franqueville;87;1901347;62749;53;1535068;34;366279;21855;16120
69188;Saint-Clément-sur-Valsonne;391;8545333;232997;209;6616804;182;1928529;21855;16121
30320;Seynes;97;2119948;87392;51;1687298;46;432650;21855;16122
33395;Saint-Estèphe;980;21418075;1593622;506;16636029;474;4782046;21855;16123
85272;Saint-Sulpice-le-Verdon;489;10687252;129197;295;8362611;194;2324641;21855;16124
33026;Balizac;257;5616968;179174;141;4246898;116;1370070;21856;16125
89015;Arcy-sur-Cure;304;6644272;240877;151;4809537;153;1834735;21856;16126
49279;Saint-Georges-des-Sept-Voies;359;7846464;235838;170;5729040;189;2117424;21856;16127
47079;Dausse;271;5923115;332184;131;4536171;140;1386944;21857;16128
81129;Lagardiolle;135;2950672;165926;52;1984266;83;966406;21857;16129
02009;Alaincourt;266;5813947;224328;159;4714698;107;1099249;21857;16130
80354;Fresnes-Tilloloy;92;2010862;55135;50;1560308;42;450554;21857;16131
60486;Paillart;329;7191180;316052;191;5835160;138;1356020;21858;16132
85221;Saint-Gervais;1311;28655712;818102;716;21732970;595;6922742;21858;16133
17204;Léoville;166;3628512;134955;63;2565845;103;1062667;21859;16134
09220;Orlu;96;2098418;66840;56;1649848;40;448570;21859;16135
57718;Villers-Stoncourt;123;2688725;57876;59;1756262;64;932463;21860;16136
88226;Hagécourt;69;1508343;82489;40;1202031;29;306312;21860;16137
60526;Ravenel;609;13313078;406194;362;10680541;247;2632537;21861;16138
38326;Prunières;205;4481426;141538;123;3578119;82;903307;21861;16139
38117;Cognin-les-Gorges;351;7673098;245414;190;5995246;161;1677852;21861;16140
85208;Saint-Denis-la-Chevasse;1114;24353013;606563;592;18328375;522;6024638;21861;16141
83104;Rians;2412;52728681;1977018;1324;41835693;1088;10892988;21861;16142
73220;Saint-Alban-des-Hurtières;190;4153738;110725;110;3246027;80;907711;21862;16143
17056;Bougneau;313;6842865;274297;171;5357438;142;1485427;21862;16144
57205;Falck;1440;31481687;1107911;778;24051636;662;7430051;21862;16145
22300;Saint-Hervé;205;4481830;141676;120;3532406;85;949424;21863;16146
81226;Ronel;154;3366849;104270;89;2640982;65;725867;21863;16147
80496;Machiel;107;2339346;152653;49;1845506;58;493840;21863;16148
70322;Mailleroncourt-Charette;165;3607456;125112;94;2873000;71;734456;21863;16149
01352;Saint-Étienne-sur-Reyssouze;289;6318781;215397;172;5133076;117;1185705;21864;16150
38069;Champier;672;14693099;518601;372;11264911;300;3428188;21865;16151
88379;Rehaincourt;184;4023208;83098;108;3121844;76;901364;21865;16152
41247;Soings-en-Sologne;839;18344973;781121;439;13880937;400;4464036;21865;16153
34178;Murviel-lès-Béziers;1632;35684343;1691613;736;26570776;896;9113567;21865;16154
21482;Perrigny-sur-l'Ognon;355;7762256;218458;207;6190498;148;1571758;21866;16155
87023;Le Buis;102;2230302;77872;60;1840791;42;389511;21866;16156
24076;Campagne;221;4832370;179180;105;3473129;116;1359241;21866;16157
61238;Louvières-en-Auge;50;1093297;20995;24;771677;26;321620;21866;16158
01277;Nivollet-Montgriffon;72;1574371;59493;38;1204367;34;370004;21866;16159
80655;Quesnoy-sur-Airaines;244;5335468;218412;137;4146810;107;1188658;21867;16160
50072;Brainville;106;2317890;28072;61;1812517;45;505373;21867;16161
14751;Vignats;146;3192627;87589;82;2504124;64;688503;21867;16162
22354;Tréglamus;518;11327461;337450;288;8684883;230;2642578;21868;16163
17293;Puyravault;328;7172646;193524;185;5552921;143;1619725;21868;16164
29255;Saint-Méen;393;8594304;151130;237;6841595;156;1752709;21868;16165
39570;Villers-les-Bois;117;2558666;84994;70;1999339;47;559327;21869;16166
19070;Darnets;207;4526927;165101;122;3545882;85;981045;21869;16167
85130;Maché;684;14958695;415411;385;11379500;299;3579195;21869;16168
64247;Gotein-Libarrenx;256;5598580;223253;143;4333345;113;1265235;21869;16169
28265;Montlandon;145;3171266;84277;82;2403708;63;767558;21871;16170
80124;Bourseville;408;8923329;396203;216;6880806;192;2042523;21871;16171
63045;Bort-l'Étang;337;7370589;323442;176;5628090;161;1742499;21871;16172
26106;La Coucourde;525;11482641;321054;286;8802198;239;2680443;21872;16173
89272;Moulins-sur-Ouanne;162;3543220;112786;90;2708232;72;834988;21872;16174
51230;Épernay;13932;304720544;18420131;7419;243304960;6513;61415584;21872;16175
2B283;Solaro;411;8989456;420768;227;7161632;184;1827824;21872;16176
53028;Belgeard;265;5796218;100916;170;4637907;95;1158311;21873;16177
05065;Guillestre;1502;32852927;1601413;816;25591311;686;7261616;21873;16178
01403;Serrières-de-Briord;662;14480093;481263;350;10873029;312;3607064;21873;16179
53043;Brée;257;5621559;118690;143;4161047;114;1460512;21874;16180
50189;Fontenay;159;3478010;111793;79;2465659;80;1012351;21874;16181
57698;Vatimont;169;3696757;86304;92;2765554;77;931203;21874;16182
54254;Haucourt-Moulaine;1607;35152195;743121;578;18690272;1029;16461923;21874;16183
50619;Le Vast;174;3806174;196791;87;2895767;87;910407;21875;16184
39379;Nance;280;6125318;149432;159;4715608;121;1409710;21876;16185
17239;Mons;249;5447275;327561;114;4265283;135;1181992;21877;16186
03159;Malicorne;444;9713333;392580;242;7570374;202;2142959;21877;16187
03038;Bransat;304;6650614;317183;176;5459893;128;1190721;21877;16188
49254;Querré;136;2975280;42717;70;2135563;66;839717;21877;16189
71228;Guerfand;98;2143999;46950;61;1706448;37;437551;21878;16190
57490;Moyenvic;179;3916090;143331;86;2834089;93;1082001;21878;16191
28422;Voves;1692;37017110;1690554;933;29095788;759;7921322;21878;16192
77462;Thieux;428;9363811;384224;274;7755515;154;1608296;21878;16193
22034;Cavan;779;17043928;546938;429;13407733;350;3636195;21879;16194
14194;Courtonne-les-Deux-Églises;335;7329654;226455;179;5630462;156;1699192;21880;16195
53272;Villepail;96;2100441;46604;43;1525842;53;574599;21880;16196
28408;Vierville;62;1356559;50451;40;1099768;22;256791;21880;16197
21673;Veuvey-sur-Ouche;102;2231798;55858;61;1707503;41;524295;21880;16198
61037;Bellavilliers;78;1706676;52397;47;1344476;31;362200;21880;16199
57325;Hilsprich;490;10721439;346262;274;8185846;216;2535593;21880;16200
27137;Chaise-Dieu-du-Theil;149;3260207;140641;78;2511243;71;748964;21881;16201
59052;Bauvin;2775;60720805;2188241;1571;47690918;1204;13029887;21881;16202
02339;Gandelu;367;8030464;223697;222;6432550;145;1597914;21881;16203
76680;Sorquainville;98;2144420;73236;48;1572817;50;571603;21882;16204
14245;Ernes;153;3347936;99845;85;2632175;68;715761;21882;16205
55327;Mauvages;151;3304229;141524;66;2340549;85;963680;21882;16206
37087;Courcoué;135;2954121;80215;58;2029658;77;924463;21882;16207
60181;Crisolles;542;11860948;365750;324;9553035;218;2307913;21884;16208
22048;Corseul;1155;25275671;876018;588;19048533;567;6227138;21884;16209
55454;Saint-Aubin-sur-Aire;88;1925808;53553;49;1560451;39;365357;21884;16210
14591;Sainte-Honorine-des-Pertes;314;6871728;232230;179;5171743;135;1699985;21884;16211
79343;Vernoux-sur-Boutonne;99;2166575;66563;47;1569930;52;596645;21885;16212
30054;Brouzet-lès-Quissac;140;3063850;137955;80;2497964;60;565886;21885;16213
66098;La Llagonne;139;3042085;126838;81;2451520;58;590565;21886;16214
65079;Bégole;105;2298003;59048;55;1742991;50;555012;21886;16215
86299;Vouzailles;312;6828476;200419;165;5075609;147;1752867;21886;16216
59448;Oost-Cappel;257;5624835;161237;139;4329333;118;1295502;21887;16217
88434;Saint-Remimont;120;2626406;80314;76;2233609;44;392797;21887;16218
68311;Sondernach;347;7594793;173800;192;5741145;155;1853648;21887;16219
22299;Saint-Hélen;694;15189888;440582;389;11686369;305;3503519;21887;16220
86183;Les Ormes;890;19479921;674599;505;15240433;385;4239488;21888;16221
03179;Montaigu-le-Blin;190;4158683;221428;88;3121207;102;1037476;21888;16222
31156;Cox;179;3917922;181126;90;3008878;89;909044;21888;16223
73167;Montgellafrey;58;1269499;65047;30;873723;28;395776;21888;16224
39065;Bonnefontaine;48;1050645;42502;24;800950;24;249695;21888;16225
46225;Prayssac;1571;34387102;1460320;752;25283152;819;9103950;21889;16226
40092;Dumes;131;2867417;72595;78;2202392;53;665025;21889;16227
39550;Verges;91;1991874;81568;50;1508546;41;483328;21889;16228
88385;Remoncourt;323;7070340;294944;180;5684009;143;1386331;21890;16229
61262;Le Ménil-Ciboult;61;1335312;22314;37;1022240;24;313072;21890;16230
65330;Nouilhan;105;2298534;63154;65;1930191;40;368343;21891;16231
21700;Villers-Patras;61;1335339;43297;38;1053832;23;281507;21891;16232
60258;Fresnières;78;1707498;47849;40;1268286;38;439212;21891;16233
61003;Anceins;123;2692676;114180;67;1999211;56;693465;21892;16234
76067;Beauvoir-en-Lyons;363;7946736;309901;187;6104127;176;1842609;21892;16235
51263;Fromentières;209;4575403;147859;119;3524612;90;1050791;21892;16236
31067;Bezins-Garraux;26;569190;31990;13;449259;13;119931;21892;16237
49372;Le Vieil-Baugé;668;14624442;441218;342;11022238;326;3602204;21893;16238
47201;Le Passage;5547;121441826;4837440;3119;94913395;2428;26528431;21893;16239
57257;Grémecey;56;1226029;40290;29;883671;27;342358;21893;16240
08098;Champigneulle;39;853855;35344;19;645234;20;208621;21894;16241
46298;Sarrazac;307;6721393;375268;146;5172010;161;1549383;21894;16242
83042;Cogolin;7022;153751701;7722694;3911;122651905;3111;31099796;21896;16243
26243;Le Poët-Laval;554;12130255;635635;274;9435364;280;2694891;21896;16244
57748;Wittring;435;9524868;291127;233;7079638;202;2445230;21896;16245
87157;Saint-Laurent-les-Églises;451;9875251;367845;250;7867310;201;2007941;21896;16246
76140;Brametot;95;2080169;75445;62;1739373;33;340796;21897;16247
50473;Saint-Georges-d'Elle;200;4379351;102121;111;3405575;89;973776;21897;16248
03148;Loriges;172;3766332;143540;83;2740531;89;1025801;21897;16249
65356;Péré;29;635022;25138;16;515305;13;119717;21897;16250
65161;Escondeaux;137;2999955;74305;68;2057421;69;942534;21897;16251
39577;Vincent;175;3832087;96372;104;2955887;71;876200;21898;16252
80392;Grouches-Luchuel;303;6635030;222465;174;5199473;129;1435557;21898;16253
88198;Gerbépal;297;6503658;208949;177;5373188;120;1130470;21898;16254
57065;Bermering;115;2518257;51267;68;1921971;47;596286;21898;16255
19161;Perpezac-le-Blanc;250;5474500;208075;140;4253432;110;1221068;21898;16256
89199;Gy-l'Évêque;255;5584100;203904;151;4554160;104;1029940;21898;16257
28252;Miermaigne;125;2737318;120965;68;2117021;57;620297;21899;16258
76506;Pommeréval;193;4226543;141821;103;3293336;90;933207;21899;16259
03163;Mariol;425;9307237;326620;265;7535091;160;1772146;21899;16260
22047;Corlay;595;13030305;553883;249;9351084;346;3679221;21900;16261
80721;Saint-Valery-sur-Somme;1512;33112781;1832101;755;25577947;757;7534834;21900;16262
65188;Gavarnie;73;1598758;101405;39;1263012;34;335746;21901;16263
76125;Bosc-le-Hard;805;17630266;733831;400;13284989;405;4345277;21901;16264
08243;Lalobbe;115;2518758;136708;50;1885588;65;633170;21902;16265
44164;Saint-Hilaire-de-Chaléons;1034;22647130;604433;542;16998905;492;5648225;21902;16266
36025;Briantes;352;7709780;286380;186;6032484;166;1677296;21903;16267
50506;Saint-Malo-de-la-Lande;234;5125382;176376;128;3828244;106;1297138;21903;16268
04161;Méolans-Revel;209;4577908;280535;97;3619779;112;958129;21904;16269
89415;Thory;109;2387577;82866;60;1812822;49;574755;21904;16270
29026;Châteaulin;2914;63829609;2711989;1496;49447501;1418;14382108;21904;16271
76272;Fontaine-le-Dun;487;10667741;532056;266;8412893;221;2254848;21905;16272
63260;Olmet;82;1796236;57038;43;1380684;39;415552;21905;16273
47026;Beauziac;151;3307711;102580;72;2354605;79;953106;21905;16274
46022;Bélaye;113;2475307;112996;58;1961943;55;513364;21905;16275
55552;Vigneul-sous-Montmédy;40;876230;25422;21;642334;19;233896;21906;16276
91692;Les Ulis;12944;283550907;13290886;7513;229482169;5431;54068738;21906;16277
45132;Égry;202;4425019;182192;121;3591529;81;833490;21906;16278
53159;Montourtier;178;3899290;56316;82;2799530;96;1099760;21906;16279
46301;Sauzet;277;6068160;241551;145;4671166;132;1396994;21907;16280
38559;Vinay;2348;51438612;2185849;1245;39927721;1103;11510891;21907;16281
02514;Montigny-Lengrain;368;8061986;248139;211;6270976;157;1791010;21908;16282
52136;Coiffy-le-Haut;74;1621192;74385;34;1216385;40;404807;21908;16283
40085;Commensacq;233;5104626;146085;114;3598275;119;1506351;21908;16284
88470;Le Tholy;891;19520472;577872;523;15408140;368;4112332;21908;16285
72248;Pruillé-l'Éguillé;429;9398758;282592;243;7430227;186;1968531;21909;16286
38090;Château-Bernard;194;4250353;187163;102;3224530;92;1025823;21909;16287
43159;Raucoules;455;9968618;284462;234;7287126;221;2681492;21909;16288
88077;Brû;296;6485125;235058;154;4703169;142;1781956;21909;16289
57409;Lixing-lès-Saint-Avold;378;8281880;283929;207;6503797;171;1778083;21910;16290
62308;Escoeuilles;204;4469607;191091;100;3393762;104;1075845;21910;16291
26213;Moras-en-Valloire;354;7756085;231555;186;5851964;168;1904121;21910;16292
82011;Barry-d'Islemade;426;9333624;321880;240;7388812;186;1944812;21910;16293
55372;Nançois-sur-Ornain;218;4776464;173558;137;3843879;81;932585;21910;16294
39289;Lect;177;3878142;120198;91;2732048;86;1146094;21910;16295
41090;Fortan;144;3155112;96939;87;2539980;57;615132;21911;16296
26034;La Baume-d'Hostun;287;6288341;171945;160;4705872;127;1582469;21911;16297
79330;Tillou;173;3790635;97384;79;2631357;94;1159278;21911;16298
27538;Saint-Étienne-l'Allier;256;5609291;207030;144;4526199;112;1083092;21911;16299
19162;Perpezac-le-Noir;598;13102956;523622;309;9930907;289;3172049;21911;16300
52307;Marac;128;2804659;106276;66;2085672;62;718987;21911;16301
62760;Saint-Martin-d'Hardinghem;160;3505839;167533;82;2698538;78;807301;21911;16302
17235;Migron;365;7998147;291941;174;5928396;191;2069751;21913;16303
10367;La Saulsotte;353;7735291;244694;199;6091482;154;1643809;21913;16304
34147;Magalas;1616;35412079;1451230;761;25841384;855;9570695;21913;16305
71530;Sully;285;6245385;198361;154;4707087;131;1538298;21914;16306
50156;Crosville-sur-Douve;34;745078;27509;13;519877;21;225201;21914;16307
28031;Beaumont-les-Autels;259;5675780;248041;133;4269615;126;1406165;21914;16308
19243;Saint-Sornin-Lavolps;575;12600836;480012;304;9649750;271;2951086;21914;16309
88114;Contrexéville;1960;42952964;1996542;1100;34829829;860;8123135;21915;16310
22180;Plélan-le-Petit;1003;21982883;657742;536;16681823;467;5301060;21917;16311
32027;Barcelonne-du-Gers;751;16460039;613854;398;12671613;353;3788426;21917;16312
88364;Puzieux;89;1950658;61813;48;1499705;41;450953;21918;16313
85254;Saint-Mesmin;926;20296151;580082;514;15628024;412;4668127;21918;16314
49131;Épieds;344;7539841;139533;193;5732760;151;1807081;21918;16315
02584;Papleux;54;1183597;23568;33;926718;21;256879;21918;16316
31464;Sabonnères;157;3441209;148722;83;2693508;74;747701;21919;16317
58292;Tintury;118;2586403;149468;53;1903045;65;683358;21919;16318
32046;Bernède;122;2674084;114385;58;1984206;64;689878;21919;16319
22050;Dinan;7259;159108604;9083167;3373;124654604;3886;34454000;21919;16320
57421;Loutzviller;94;2060403;85263;45;1513062;49;547341;21919;16321
12086;La Cresse;176;3858040;113135;95;3041386;81;816654;21921;16322
09016;Arnave;108;2367438;61140;63;1841098;45;526340;21921;16323
55568;Ville-sur-Saulx;178;3901905;156535;114;3146493;64;755412;21921;16324
27156;Chéronvilliers;282;6181740;270672;162;4953695;120;1228045;21921;16325
50644;Virey;519;11377051;388195;294;8829799;225;2547252;21921;16326
08147;Dricourt;36;789161;29616;20;596234;16;192927;21921;16327
01415;Talissieu;273;5984569;289778;154;5025760;119;958809;21921;16328
57046;Baerenthal;447;9798928;330801;259;7684075;188;2114853;21922;16329
30279;Saint-Laurent-la-Vernède;389;8527518;315880;201;6438241;188;2089277;21922;16330
62815;Tigny-Noyelle;104;2279855;98281;62;1856176;42;423679;21922;16331
64140;Boucau;4776;104698337;4129996;2745;83432895;2031;21265442;21922;16332
45223;Nesploy;218;4779018;176865;113;3653775;105;1125243;21922;16333
07241;Saint-Germain;338;7409742;278500;171;5592611;167;1817131;21922;16334
35143;Landujan;470;10303565;273197;252;7815089;218;2488476;21922;16335
72164;Livet-en-Saosnois;36;789211;22613;22;626101;14;163110;21923;16336
61353;Ronfeugerai;185;4055724;104254;108;3222745;77;832979;21923;16337
24160;Église-Neuve-de-Vergt;247;5415074;138122;146;4324235;101;1090839;21923;16338
18156;Morogues;277;6072873;291171;148;4676371;129;1396502;21924;16339
61104;La Chaux;29;635803;22683;14;458552;15;177251;21924;16340
46185;Martel;973;21332621;908619;474;16044597;499;5288024;21925;16341
88091;Charmois-devant-Bruyères;215;4713892;114673;120;3685326;95;1028566;21925;16342
17313;Saint-Bris-des-Bois;217;4758026;206987;112;3665418;105;1092608;21926;16343
03161;Marcillat-en-Combraille;494;10831851;578044;223;8143211;271;2688640;21927;16344
09228;Perles-et-Castelet;114;2499674;116500;72;2119504;42;380170;21927;16345
80218;Courcelles-sous-Moyencourt;80;1754161;80015;45;1414622;35;339539;21927;16346
60371;Loueuse;87;1907706;83264;47;1494607;40;413099;21928;16347
21641;Touillon;261;5723120;161899;162;4629315;99;1093805;21928;16348
16167;Jarnac;2766;60652141;3108982;1375;46937983;1391;13714158;21928;16349
70204;Denèvre;83;1820090;73326;43;1387895;40;432195;21929;16350
62459;Houvin-Houvigneul;123;2697244;121800;56;1926687;67;770557;21929;16351
71508;Savigny-sur-Seille;232;5087509;195922;115;3628652;117;1458857;21929;16352
57355;Kalhausen;460;10087349;295042;264;7917004;196;2170345;21929;16353
80065;Beaucourt-sur-l'Ancre;42;921025;18986;22;695662;20;225363;21929;16354
02827;Voyenne;174;3815693;185289;78;2854461;96;961232;21929;16355
64217;Esquiule;289;6337693;276502;158;5043745;131;1293948;21930;16356
59273;Gravelines;6367;139626890;6180410;3402;109560867;2965;30066023;21930;16357
58231;Saint-Aubin-les-Forges;252;5526563;212736;152;4401727;100;1124836;21931;16358
31066;Bessières;1920;42107292;1571032;1030;32396410;890;9710882;21931;16359
58251;Saint-Loup;282;6184513;241911;168;5024361;114;1160152;21931;16360
71052;Boyer;402;8816242;399401;216;7132093;186;1684149;21931;16361
81178;Montgaillard;196;4298525;151617;94;3173326;102;1125199;21931;16362
38038;Belmont;215;4715228;79532;116;3372032;99;1343196;21931;16363
71347;Perreuil;273;5987264;223792;160;4791929;113;1195335;21931;16364
86250;Saix;122;2675640;55657;68;2051296;54;624344;21931;16365
16043;Bignac;116;2544127;92462;60;1944218;56;599909;21932;16366
10422;Villeneuve-au-Chemin;109;2390671;81199;62;1931079;47;459592;21933;16367
50316;Le Mesnil-Opac;139;3048756;80028;77;2300300;62;748456;21933;16368
37280;Vou;131;2873292;99371;69;2176411;62;696881;21934;16369
86182;Orches;213;4671902;184820;106;3471809;107;1200093;21934;16370
64502;Sames;355;7786548;265977;171;5809956;184;1976592;21934;16371
37198;Rillé;175;3838444;192411;89;3034931;86;803513;21934;16372
77157;Dhuisy;168;3684937;133661;102;2957256;66;727681;21934;16373
52057;Blumeray;65;1425772;50039;36;1109074;29;316698;21935;16374
40271;Sainte-Marie-de-Gosse;515;11296513;372548;262;8486635;253;2809878;21935;16375
12162;Moyrazès;568;12459077;319032;300;9567549;268;2891528;21935;16376
37093;Crouzilles;322;7063113;316420;180;5614118;142;1448995;21935;16377
34251;Saint-Étienne-de-Gourgas;227;4979279;216250;114;3849293;113;1129986;21935;16378
76302;Goderville;1573;34504171;1341017;866;26759918;707;7744253;21935;16379
10268;Nogent-sur-Seine;3309;72584131;3815723;1750;56942497;1559;15641634;21935;16380
60123;Campremy;235;5154840;157783;124;3718202;111;1436638;21935;16381
47309;Tombeboeuf;252;5527823;275730;123;4338273;129;1189550;21936;16382
30193;Parignargues;321;7041495;274857;176;5537299;145;1504196;21936;16383
07324;Tournon-sur-Rhône;6150;134907425;6308033;3180;105177977;2970;29729448;21936;16384
61296;Moulicent;164;3598031;127916;86;2621442;78;976589;21939;16385
46124;Glanes;160;3510337;121163;87;2684161;73;826176;21940;16386
42127;Mably;4220;92586094;3404959;2431;73547031;1789;19039063;21940;16387
70464;Saint-Germain;767;16827866;674662;447;13659958;320;3167908;21940;16388
38086;Chasselay;221;4848781;144747;127;3833149;94;1015632;21940;16389
88352;Pompierre;136;2983870;80929;68;2254248;68;729622;21940;16390
07234;Saint-Étienne-de-Valoux;124;2720621;57365;62;2023507;62;697114;21940;16391
27082;La Bonneville-sur-Iton;1225;26877649;940540;725;21317584;500;5560065;21941;16392
61268;Ménil-Hubert-en-Exmes;70;1535872;101103;36;1208452;34;327420;21941;16393
41141;Moisy;176;3861677;129887;108;3112170;68;749507;21941;16394
89149;Dyé;112;2457450;74320;69;1951958;43;505492;21942;16395
79014;Argenton-l'Église;893;19594463;1041018;425;14460530;468;5133933;21942;16396
21355;Longvic;4978;109229751;4451645;3006;88720052;1972;20509699;21942;16397
72134;Flée;303;6648578;188010;173;5389720;130;1258858;21943;16398
60332;Labruyère;343;7526380;334934;190;6170677;153;1355703;21943;16399
53015;La Baconnière;788;17291040;380246;432;13327574;356;3963466;21943;16400
01208;Lavours;87;1909040;50873;57;1484044;30;424996;21943;16401
85215;Saint-Fulgent;1912;41955762;1314022;1081;32818773;831;9136989;21943;16402
86131;Lhommaizé;442;9699058;333787;255;7738595;187;1960463;21944;16403
72274;Saint-Christophe-en-Champagne;99;2172483;70953;58;1717622;41;454861;21944;16404
11102;Couffoulens;351;7702517;336509;195;6245977;156;1456540;21944;16405
66211;Tordères;91;1996964;68902;38;1344886;53;652078;21945;16406
82176;La Salvetat-Belmontet;386;8471039;301373;210;6678628;176;1792411;21946;16407
17120;Corme-Royal;910;19970748;667555;476;15401756;434;4568992;21946;16408
64361;Lussagnet-Lusson;87;1909294;52573;45;1473299;42;435995;21946;16409
29169;Plogonnec;1668;36606011;1252598;897;28034332;771;8571679;21946;16410
25021;Arc-et-Senans;848;18610331;596723;431;13694138;417;4916193;21946;16411
80281;Ergnies;94;2062973;76894;49;1568724;45;494249;21947;16412
88381;Relanges;123;2699425;40487;75;2115228;48;584197;21947;16413
21283;Fraignot-et-Vesvrotte;44;965665;30351;23;717471;21;248194;21947;16414
30087;Colognac;116;2545929;124471;53;1939283;63;606646;21948;16415
52499;Vaillant;35;768172;39945;12;439564;23;328608;21948;16416
24341;Proissans;534;11720137;454746;306;9116812;228;2603325;21948;16417
35325;La Selle-Guerchaise;77;1690010;30180;41;1217924;36;472086;21948;16418
01367;Saint-Julien-sur-Reyssouze;379;8318509;278492;201;6251958;178;2066551;21949;16419
65142;Chelle-Debat;115;2524117;123031;55;1843083;60;681034;21949;16420
37168;Neuilly-le-Brignon;167;3665466;175076;89;2862779;78;802687;21949;16421
76251;Étalleville;219;4806969;146565;133;3886780;86;920189;21950;16422
89194;Grimault;81;1777921;97362;43;1462766;38;315155;21950;16423
02056;Beaumont-en-Beine;90;1975503;58225;49;1477813;41;497690;21950;16424
48191;La Tieule;45;987758;31308;25;778353;20;209405;21950;16425
42216;Saint-Denis-sur-Coise;311;6826562;127729;167;5103095;144;1723467;21950;16426
70043;Auvet-et-la-Chapelotte;145;3182876;116263;78;2443034;67;739842;21951;16427
54199;Flin;198;4346335;129223;94;3216815;104;1129520;21951;16428
39538;Uxelles;26;570735;23902;14;467825;12;102910;21951;16429
21293;Gergueil;75;1646385;63840;48;1400718;27;245667;21952;16430
06094;Péone;400;8780737;489269;232;6995511;168;1785226;21952;16431
46172;Lhospitalet;263;5773344;201173;151;4582845;112;1190499;21952;16432
70388;Noidans-lès-Vesoul;1171;25705879;983893;674;20455916;497;5249963;21952;16433
39069;Bourcia;65;1426908;74422;30;1034996;35;391912;21952;16434
14480;Osmanville;290;6366258;279550;151;4937960;139;1428298;21953;16435
89341;Saint-Cyr-les-Colons;246;5400349;202559;141;4225723;105;1174626;21953;16436
55085;Broussey-Raulecourt;145;3183157;108073;77;2387902;68;795255;21953;16437
10382;Traînel;602;13215620;606843;330;10468664;272;2746956;21953;16438
56259;La Trinité-Surzur;693;15213684;347378;425;12063982;268;3149702;21953;16439
46283;Saint-Michel-de-Bannières;164;3600449;107782;78;2560274;86;1040175;21954;16440
24287;Montaut;75;1646575;114024;31;1200873;44;445702;21954;16441
79322;Le Tallud;1113;24435648;651936;608;18731562;505;5704086;21955;16442
62061;Averdoingt;128;2810214;50049;71;2041559;57;768655;21955;16443
89234;Lucy-sur-Yonne;89;1953988;123690;44;1467356;45;486632;21955;16444
22350;Tréduder;110;2415097;110464;61;1941735;49;473362;21955;16445
30170;Molières-Cavaillac;502;11021683;414565;270;8579021;232;2442662;21956;16446
14312;Grandcamp-Maisy;1107;24305697;1133688;539;18665814;568;5639883;21956;16447
76232;Életot;319;7004280;224945;179;5391964;140;1612316;21957;16448
81117;Labessière-Candeil;402;8826804;380056;207;6769010;195;2057794;21957;16449
07174;Peyraud;279;6126246;232693;169;4916632;110;1209614;21958;16450
30276;Saint-Laurent-d'Aigouze;2043;44861251;1980063;1077;34885717;966;9975534;21959;16451
42147;Montbrison;8942;196353232;9147326;4744;154192485;4198;42160747;21959;16452
04145;Peipin;797;17501277;642503;434;13406414;363;4094863;21959;16453
38409;Saint-Just-de-Claix;634;13922018;436481;358;10758972;276;3163046;21959;16454
51454;Reims;98037;2152808488;130853403;52605;1750332969;45432;402475519;21959;16455
62306;Ervillers;229;5028644;160783;120;3920260;109;1108384;21959;16456
69236;Saint-Romain-en-Gier;276;6060872;163138;164;4833827;112;1227045;21960;16457
48099;Le Monastier-Pin-Moriès;541;11880195;410129;316;9343362;225;2536833;21960;16458
21063;Beneuvre;55;1207859;45585;27;910263;28;297596;21961;16459
07304;Salavas;378;8301309;382750;204;6500878;174;1800431;21961;16460
14273;La Folletière-Abenon;76;1669049;70599;39;1309812;37;359237;21961;16461
70302;Lieucourt;32;702759;21614;16;491673;16;211086;21961;16462
85028;Bouillé-Courdault;262;5753890;191052;150;4493477;112;1260413;21961;16463
47133;Lamontjoie;278;6105325;311048;128;4591717;150;1513608;21962;16464
11175;Issel;262;5754015;287506;131;4506017;131;1247998;21962;16465
02533;Muret-et-Crouttes;68;1493409;52648;32;1111601;36;381808;21962;16466
17460;Varzay;431;9465581;238782;241;7325132;190;2140449;21962;16467
50455;Saint-Clair-sur-l'Elle;496;10893219;310497;236;7647000;260;3246219;21962;16468
89173;Fontaines;244;5358887;241744;128;4143987;116;1214900;21963;16469
40001;Aire-sur-l'Adour;3656;80296530;4527688;1864;62238182;1792;18058348;21963;16470
02673;Saint-Christophe-à-Berry;229;5029662;189014;122;3806581;107;1223081;21964;16471
31153;Couladère;257;5644718;252587;128;4328856;129;1315862;21964;16472
76159;Cany-Barville;1765;38766607;1901144;909;29906000;856;8860607;21964;16473
63420;Seychalles;337;7401897;218854;188;5919040;149;1482857;21964;16474
86201;Prinçay;126;2767612;119640;61;2146558;65;621054;21965;16475
89277;Nitry;208;4568761;280708;108;3611300;100;957461;21965;16476
02535;Nampcelles-la-Cour;62;1361877;54156;29;1009322;33;352555;21966;16477
05073;Lazer;198;4349264;176182;113;3505402;85;843862;21966;16478
17387;Saint-Porchaire;916;20122296;636133;468;15227259;448;4895037;21968;16479
35012;Bain-de-Bretagne;3817;83851216;2873064;1964;64120755;1853;19730461;21968;16480
61188;La Genevraie;54;1186268;16409;31;880985;23;305283;21968;16481
06073;Isola;356;7820587;446750;199;6366899;157;1453688;21968;16482
62904;Zouafques;273;5997473;149822;137;4453899;136;1543574;21969;16483
70386;La Neuvelle-lès-Scey;87;1911284;53199;43;1425741;44;485543;21969;16484
57036;Attilloncourt;51;1120410;33038;24;767413;27;352997;21969;16485
59604;Troisvilles;420;9227035;364428;218;7016816;202;2210219;21969;16486
60298;Hanvoile;330;7249816;212835;199;5766298;131;1483518;21969;16487
32197;Larroque-sur-l'Osse;132;2900023;153141;59;2233331;73;666692;21970;16488
49158;L'Hôtellerie-de-Flée;238;5229006;117914;138;4007471;100;1221535;21971;16489
80183;Cerisy-Buleux;160;3515410;297959;68;2736110;92;779300;21971;16490
72010;Asnières-sur-Vègre;205;4504139;111562;121;3546120;84;958019;21971;16491
32353;Sabaillan;75;1647857;98172;31;1203022;44;444835;21971;16492
72135;La Fontaine-Saint-Martin;283;6218026;163130;153;4765846;130;1452180;21972;16493
61513;Yvrandes;80;1757758;66981;34;1237163;46;520595;21972;16494
32302;Ornézan;137;3010194;104008;75;2273342;62;736852;21972;16495
64141;Boueilh-Boueilho-Lasque;202;4438486;207817;92;3324682;110;1113804;21973;16496
40205;Nousse;129;2834517;135193;74;2330360;55;504157;21973;16497
76098;Biville-sur-Mer;368;8086255;235167;211;6334737;157;1751518;21974;16498
35234;Quédillac;604;13272141;484824;317;10059354;287;3212787;21974;16499
25623;Villers-Chief;68;1494262;48316;37;1145975;31;348287;21974;16500
61098;La Chapelle-près-Sées;232;5098141;156395;133;4337529;99;760612;21975;16501
29203;Plounéour-Trez;690;15162792;491844;366;11597551;324;3565241;21975;16502
37056;La Chapelle-aux-Naux;311;6834335;225566;176;5239897;135;1594438;21975;16503
46241;Rouffilhac;109;2395347;108260;46;1761892;63;633455;21976;16504
26233;Piégon;148;3252471;180549;66;2538191;82;714280;21976;16505
55520;Troussey;220;4834778;168384;134;3885430;86;949348;21976;16506
39214;Esserval-Tartre;56;1230687;48858;33;943055;23;287632;21977;16507
02281;L'Épine-aux-Bois;132;2900959;99756;68;2283965;64;616994;21977;16508
24152;Domme;569;12505090;609350;286;9564375;283;2940715;21977;16509
16051;Bonneville;82;1802155;92567;36;1293237;46;508918;21978;16510
51066;Blaise-sous-Arzillières;190;4175728;135923;123;3411502;67;764226;21978;16511
22239;Plumaudan;634;13933973;522294;296;10290941;338;3643032;21978;16512
62813;La Thieuloye;233;5120885;135539;128;4006488;105;1114397;21978;16513
09131;Garanou;96;2109937;71659;62;1746982;34;362955;21979;16514
16121;Douzat;255;5604526;173002;133;4165338;122;1439188;21979;16515
08138;Les Deux-Villes;130;2857228;245711;47;1967220;83;890008;21979;16516
54049;Baslieux;295;6483722;132714;124;3832468;171;2651254;21979;16517
52396;Poinson-lès-Nogent;91;2000093;100978;47;1524033;44;476060;21979;16518
82049;Donzac;507;11143473;378572;259;8481453;248;2662020;21979;16519
24456;Saint-Martin-des-Combes;95;2088038;117762;43;1568637;52;519401;21979;16520
38456;Saint-Sébastien;130;2857328;91155;70;2208823;60;648505;21979;16521
71547;Trivy;145;3187031;126487;73;2420663;72;766368;21980;16522
50598;Tocqueville;160;3516725;138092;80;2679082;80;837643;21980;16523
03261;Sainte-Thérence;109;2395772;59953;61;1869654;48;526118;21980;16524
71184;Dracy-Saint-Loup;322;7077442;219044;186;5543358;136;1534084;21980;16525
72033;Bernay-en-Champagne;225;4945422;113796;109;3739273;116;1206149;21980;16526
85153;Mouchamps;1460;32090316;631152;829;24147631;631;7942685;21980;16527
17147;Écoyeux;660;14506602;521636;357;11028962;303;3477640;21980;16528
17252;Le Mung;153;3362920;111576;75;2547364;78;815556;21980;16529
02557;Noroy-sur-Ourcq;73;1604581;62667;33;1149742;40;454839;21981;16530
04065;Cruis;354;7781119;405451;179;6141382;175;1639737;21981;16531
41038;La Chapelle-Montmartin;232;5099577;191414;137;4127865;95;971712;21981;16532
88085;Champdray;108;2373946;107923;51;1710877;57;663069;21981;16533
89331;Sainpuits;180;3956601;173927;87;2911065;93;1045536;21981;16534
06022;Bouyon;271;5956897;171495;151;4566286;120;1390611;21981;16535
49160;Ingrandes;887;19498149;586116;476;14738953;411;4759196;21982;16536
02169;Châtillon-lès-Sons;50;1099138;65275;22;799526;28;299612;21983;16537
43261;Vézézoux;317;6968781;315360;186;5554187;131;1414594;21984;16538
17465;La Vergne;329;7232801;297531;192;5858995;137;1373806;21984;16539
59436;Noordpeene;406;8925727;296442;199;6645725;207;2280002;21985;16540
46211;Nuzéjouls;197;4330981;192634;106;3441516;91;889465;21985;16541
80125;Boussicourt;40;879392;33590;24;746197;16;133195;21985;16542
21322;Jallanges;175;3847404;135942;98;2986481;77;860923;21985;16543
84045;Faucon;238;5232529;207040;125;4102349;113;1130180;21985;16544
21276;Fontaines-en-Duesmois;71;1561001;43267;44;1224182;27;336819;21986;16545
72357;Thorée-les-Pins;376;8266722;305263;219;6597370;157;1669352;21986;16546
02686;Saint-Paul-aux-Bois;226;4968904;172752;119;3843176;107;1125728;21986;16547
22332;Saint-Trimoël;229;5034882;151537;128;3832249;101;1202633;21986;16548
03065;Châtel-de-Neuvre;309;6793962;421114;147;5143432;162;1650530;21987;16549
89022;Athie;83;1824965;57365;45;1413770;38;411195;21988;16550
37261;Tours;77654;1707479064;104142488;42207;1394180843;35447;313298221;21988;16551
31143;Cier-de-Rivière;152;3342301;151784;80;2644048;72;698253;21989;16552
51243;Faux-Fresnay;193;4244061;167560;101;3187784;92;1056277;21990;16553
73073;Chanaz;309;6794921;301801;160;5136756;149;1658165;21990;16554
07060;Châteauneuf-de-Vernoux;123;2704988;90303;64;2030688;59;674300;21992;16555
40145;Larrivière-Saint-Savin;325;7147470;210960;173;5385106;152;1762364;21992;16556
65267;Lau-Balagnas;306;6729632;245794;175;5227502;131;1502130;21992;16557
46203;Montet-et-Bouxal;116;2551109;116460;46;1746674;70;804435;21992;16558
76319;Grand-Couronne;5064;111371158;4621076;2739;87798737;2325;23572421;21993;16559
27235;Faverolles-la-Campagne;74;1627465;36318;43;1267974;31;359491;21993;16560
61201;La Haute-Chapelle;344;7565568;244151;198;5932183;146;1633385;21993;16561
61071;Camembert;105;2309272;94573;57;1900861;48;408411;21993;16562
42167;Pavezin;174;3826804;86897;105;2963714;69;863090;21993;16563
44187;Saint-Père-en-Retz;2225;48936239;1675201;1229;37839312;996;11096927;21994;16564
07064;Le Cheylard;1900;41789112;1977769;1055;32907780;845;8881332;21994;16565
84063;Lamotte-du-Rhône;236;5191012;245073;137;4372708;99;818304;21996;16566
64116;Bescat;154;3387370;135105;89;2650680;65;736690;21996;16567
12026;Bertholène;547;12031853;414543;318;9476797;229;2555056;21996;16568
21212;Crépand;186;4091298;161773;96;3087857;90;1003441;21996;16569
32095;Caussens;335;7368811;370105;173;5660471;162;1708340;21996;16570
81277;Saussenac;265;5829062;123287;147;4500443;118;1328619;21996;16571
32335;Puycasquier;266;5851150;252449;131;4544662;135;1306488;21997;16572
62856;Villers-Brûlin;157;3453512;92276;86;2575339;71;878173;21997;16573
31396;Nailloux;1863;40980908;1709202;978;32233625;885;8747283;21997;16574
84066;Lioux;133;2925692;111529;70;2221752;63;703940;21998;16575
08219;Hauteville;66;1451860;48841;31;1075441;35;376419;21998;16576
35148;Lanrigan;67;1473861;22074;38;1131097;29;342764;21998;16577
40333;Ygos-Saint-Saturnin;743;16345020;696341;381;12539482;362;3805538;21999;16578
71392;Saint-Boil;273;6005696;226381;135;4239625;138;1766071;21999;16579
47117;Hautefage-la-Tour;425;9349569;288318;235;7314831;190;2034738;21999;16580
80815;Vron;453;9965790;445091;225;7523972;228;2441818;22000;16581
19220;Saint-Martial-de-Gimel;297;6534218;333386;157;5098128;140;1436090;22001;16582
57647;Serémange-Erzange;2293;50450475;1319740;1080;33022094;1213;17428381;22002;16583
45329;Triguères;781;17183558;613999;449;13671047;332;3512511;22002;16584
07076;Cruas;1516;33355099;1149077;824;25676669;692;7678430;22002;16585
07289;Saint-Privat;933;20527967;768609;508;15809328;425;4718639;22002;16586
59345;Lewarde;1364;30010972;1533868;667;23104705;697;6906267;22002;16587
97404;L'Étang-Salé;7514;165326040;7509002;2578;120661883;4936;44664157;22002;16588
04175;Sainte-Croix-à-Lauze;46;1012132;63863;20;750664;26;261468;22003;16589
45001;Adon;112;2464332;101947;64;1992879;48;471453;22003;16590
08316;Neufmanil;627;13796127;672067;335;10377855;292;3418272;22003;16591
58307;Vielmanay;100;2200372;93834;53;1647718;47;552654;22004;16592
05157;Saint-Véran;141;3102526;108974;74;2398615;67;703911;22004;16593
46307;Soturac;375;8251546;424085;186;6359899;189;1891647;22004;16594
16296;Saint-Amant-de-Bonnieure;180;3960766;161595;85;2976495;95;984271;22004;16595
49079;Chartrené;27;594119;27408;11;412023;16;182096;22004;16596
61400;Saint-Gervais-du-Perron;181;3982821;79907;102;2980269;79;1002552;22005;16597
40192;Mont-de-Marsan;17918;394285775;20159026;10243;324953738;7675;69332037;22005;16598
09324;Varilhes;1909;42007903;1944233;1029;32842033;880;9165870;22005;16599
52184;Effincourt;40;880208;40720;22;710920;18;169288;22005;16600
10184;Juzanvigny;68;1496364;71075;37;1121118;31;375246;22005;16601
62775;Sanghen;144;3168771;133557;67;2318223;77;850548;22005;16602
34209;Portiragnes;2013;44297121;2135346;1040;34177318;973;10119803;22006;16603
08233;Imécourt;28;616156;21718;13;484003;15;132153;22006;16604
66195;Le Soler;3918;86219139;3855286;1983;65851184;1935;20367955;22006;16605
53084;Craon;2633;57941708;2581185;1265;43122796;1368;14818912;22006;16606
58148;Luthenay-Uxeloup;327;7196035;323507;176;5591104;151;1604931;22006;16607
47053;Castella;186;4093209;162887;99;3252977;87;840232;22007;16608
12137;Manhac;368;8098403;151975;213;6358599;155;1739804;22007;16609
71498;Santilly;86;1892562;64699;53;1563724;33;328838;22007;16610
14661;Saint-Vaast-sur-Seulles;72;1584482;62014;38;1235646;34;348836;22007;16611
65457;Ugnouas;39;858277;30846;26;767953;13;90324;22007;16612
33407;Saint-Genès-de-Fronsac;368;8098721;238293;205;6153399;163;1945322;22007;16613
33291;Montagoudin;103;2266837;109620;50;1778992;53;487845;22008;16614
42178;Pradines;401;8825387;358737;212;7095594;189;1729793;22008;16615
61055;Boucé;321;7064967;253137;168;5442904;153;1622063;22009;16616
67369;Ottwiller;136;2993373;82423;78;2314731;58;678642;22010;16617
24054;Bouniagues;290;6382955;243764;145;4734319;145;1648636;22010;16618
51316;Larzicourt;182;4005873;178002;109;3170007;73;835866;22010;16619
55040;Beausite;157;3455622;137220;79;2586977;78;868645;22010;16620
71175;Diconne;167;3675748;104869;87;2693506;80;982242;22010;16621
72099;Courceboeufs;287;6317167;157986;156;4780603;131;1536564;22011;16622
11284;Peyrens;225;4952487;177870;125;3902036;100;1050451;22011;16623
76293;Fultot;117;2575316;104666;66;2049947;51;525369;22011;16624
73048;Bonvillard;179;3940019;119359;107;3099901;72;840118;22011;16625
70059;Beaumotte-Aubertans;250;5502979;171058;153;4433151;97;1069828;22012;16626
71029;Bellevesvre;180;3962233;253898;89;2904061;91;1058172;22012;16627
17106;Cierzac;140;3081864;104825;74;2372120;66;709744;22013;16628
58262;Saint-Péreuse;144;3169974;135188;68;2334778;76;835196;22014;16629
21648;Turcey;112;2465751;103714;64;1896823;48;568928;22016;16630
39366;Mont-sur-Monnet;104;2289626;28723;54;1713737;50;575889;22016;16631
02238;Crépy;993;21861678;1044731;512;16880788;481;4980890;22016;16632
14714;Le Tronquay;392;8630233;245670;233;6827009;159;1803224;22016;16633
02105;Bouresches;108;2377792;86232;59;1831420;49;546372;22017;16634
48055;Cultures;78;1717301;42662;46;1366708;32;350593;22017;16635
65406;Sarniguet;142;3126439;118657;83;2446967;59;679472;22017;16636
76299;Gerponville;200;4403468;116053;119;3523264;81;880204;22017;16637
31577;Vignaux;69;1519225;54146;41;1263130;28;256095;22018;16638
31028;Aurignac;701;15434690;1282351;291;12055354;410;3379336;22018;16639
14695;Torteval-Quesnay;185;4073356;123556;97;3123969;88;949387;22018;16640
54577;Villers-lès-Moivrons;65;1431182;40037;37;1097385;28;333797;22018;16641
22070;Guingamp;4386;96572769;8435560;1759;75725141;2627;20847628;22018;16642
66175;Saint-Génis-des-Fontaines;1689;37189368;1828321;891;29093934;798;8095434;22019;16643
49007;Angers;80285;1767770043;98793799;42513;1424282303;37772;343487740;22019;16644
32377;Saint-Georges;94;2069759;75014;51;1627215;43;442544;22019;16645
25018;Anteuil;332;7310247;193617;172;5399884;160;1910363;22019;16646
60702;Welles-Pérennes;129;2840512;117996;62;2111925;67;728587;22019;16647
42219;Saint-Étienne-le-Molard;486;10701573;254398;266;8032545;220;2669028;22020;16648
59439;Noyelles-sur-Sambre;166;3655274;136623;90;2794570;76;860704;22020;16649
12106;Gabriac;253;5570995;243397;134;4343793;119;1227202;22020;16650
54363;Mercy-le-Haut;132;2906629;48460;59;1834420;73;1072209;22020;16651
57686;Vahl-lès-Faulquemont;135;2972770;117548;80;2422847;55;549923;22021;16652
52204;Forcey;42;924883;34172;24;729219;18;195664;22021;16653
69183;Saint-Bonnet-le-Troncy;155;3413336;153743;78;2581544;77;831792;22022;16654
54321;Longlaville;1284;28275900;675131;459;14680740;825;13595160;22022;16655
64445;Pau;47944;1055828785;65403116;25359;854228122;22585;201600663;22022;16656
43062;Chaspuzac;357;7861912;180162;194;5805852;163;2056060;22022;16657
83108;La Roquebrussanne;1360;29950382;1013320;718;23116042;642;6834340;22022;16658
27566;Sainte-Marguerite-en-Ouche;64;1409458;60777;35;1116786;29;292672;22023;16659
42112;Jarnosse;207;4558727;106542;111;3460364;96;1098363;22023;16660
59255;Fressies;269;5924195;244477;143;4567860;126;1356335;22023;16661
32251;Mérens;35;770816;32487;19;652447;16;118369;22023;16662
81008;Almayrac;154;3391641;106387;77;2520313;77;871328;22024;16663
49084;Chaumont-d'Anjou;145;3193443;37210;77;2342049;68;851394;22024;16664
57020;Ancerville;151;3325604;74882;85;2503299;66;822305;22024;16665
89256;Migé;234;5153623;182924;143;4162819;91;990804;22024;16666
55353;Montsec;38;836954;33922;20;568751;18;268203;22025;16667
29182;Plouégat-Guérand;564;12422317;404411;301;9552844;263;2869473;22025;16668
81157;Marzens;167;3678279;161677;82;2966467;85;711812;22026;16669
59613;Vicq;714;15726908;535474;359;12060605;355;3666303;22026;16670
64028;Anoye;79;1740146;65936;38;1303130;41;437016;22027;16671
88285;Mandres-sur-Vair;240;5286629;213426;136;4110665;104;1175964;22028;16672
88014;Arrentès-de-Corcieux;115;2533222;64829;58;1905829;57;627393;22028;16673
80456;Lafresguimont-Saint-Martin;274;6035681;209815;159;4806336;115;1229345;22028;16674
50244;Hérenguerville;113;2489215;66900;62;1908773;51;580442;22028;16675
84097;Richerenches;340;7489734;264173;179;5884994;161;1604740;22029;16676
29206;Plounévez-Lochrist;1353;29804767;788926;606;21850406;747;7954361;22029;16677
85201;Saint-Benoist-sur-Mer;232;5110648;218828;137;4067001;95;1043647;22029;16678
31145;Cintegabelle;1536;33836808;1259087;817;26305616;719;7531192;22029;16679
17128;Courcoury;407;8965986;329057;229;7129015;178;1836971;22029;16680
44098;Missillac;2693;59326050;2084840;1484;45412633;1209;13913417;22030;16681
69038;Chambost-Longessaigne;460;10133835;260824;244;7671218;216;2462617;22030;16682
27218;Épaignes;765;16853011;842568;383;13155699;382;3697312;22030;16683
24412;Saint-Geniès;522;11499821;567032;267;8900550;255;2599271;22030;16684
57495;Narbéfontaine;62;1365890;37740;33;928136;29;437754;22030;16685
37081;Cléré-les-Pins;744;16390726;598471;423;13051544;321;3339182;22031;16686
11209;Luc-sur-Aude;126;2775849;135787;67;2261647;59;514202;22031;16687
18220;Saint-Léger-le-Petit;225;4956962;191440;134;4082944;91;874018;22031;16688
02599;Pierremande;136;2996231;88029;72;2248297;64;747934;22031;16689
88299;Ménil-en-Xaintois;95;2092996;91939;49;1639059;46;453937;22032;16690
59175;Dimont;168;3701308;141070;101;3050173;67;651135;22032;16691
57226;Fontoy;1695;37344576;1066064;684;22586812;1011;14757764;22032;16692
64347;Lonçon;89;1960953;47409;55;1565265;34;395688;22033;16693
70393;Oiselay-et-Grachaux;236;5199928;125196;137;3979474;99;1220454;22034;16694
30094;Corbès;86;1894958;88735;43;1389295;43;505663;22034;16695
89178;Fontenouilles;126;2776413;165967;61;2145125;65;631288;22035;16696
49292;Saint-Lambert-du-Lattay;999;22013098;470339;526;16475800;473;5537298;22035;16697
34043;Buzignargues;141;3106987;96685;70;2226593;71;880394;22035;16698
37256;Theneuil;172;3790219;123326;86;2750565;86;1039654;22036;16699
70125;Champvans;128;2820677;148287;76;2263349;52;557328;22037;16700
81148;Loubers;48;1057756;41913;17;672514;31;385242;22037;16701
84137;Vaison-la-Romaine;3894;85814551;5013769;1850;65576548;2044;20238003;22038;16702
16291;Ruelle-sur-Touvre;4363;96159767;3937137;2526;76824185;1837;19335582;22040;16703
72384;Vouvray-sur-Loir;443;9763654;351329;245;7673247;198;2090407;22040;16704
53247;Saint-Pierre-la-Cour;1021;22503370;555097;590;17161991;431;5341379;22041;16705
66203;Taulis;30;661221;57074;14;504585;16;156636;22041;16706
56152;Le Palais;1650;36367162;1874690;930;29368480;720;6998682;22041;16707
22388;Vildé-Guingalan;609;13423109;368141;335;10308323;274;3114786;22041;16708
80302;Faverolles;89;1961673;52183;52;1579650;37;382023;22041;16709
52305;Mandres-la-Côte;271;5973218;205221;157;4790054;114;1183164;22041;16710
64105;Béguios;142;3129890;149969;68;2325239;74;804651;22041;16711
27108;Bourth;702;15473960;650432;359;11526008;343;3947952;22043;16712
71375;Le Rousset;141;3108220;121722;75;2268850;66;839370;22044;16713
66184;Saint-Martin;27;595194;14719;13;445927;14;149267;22044;16714
80134;Brassy;38;837718;24038;24;685927;14;151791;22045;16715
76205;Crosville-sur-Scie;130;2865934;79206;78;2205045;52;660889;22046;16716
03276;Sussat;62;1366847;44477;36;1005479;26;361368;22046;16717
53207;Saint-Christophe-du-Luat;380;8377578;199936;218;6444720;162;1932858;22046;16718
49071;Chanzeaux;572;12610514;134679;291;9084004;281;3526510;22046;16719
01387;Saint-Sulpice;94;2072406;20514;54;1578694;40;493712;22047;16720
21224;Dampierre-en-Montagne;37;815739;18580;21;642010;16;173729;22047;16721
76521;Rebets;73;1609434;49736;46;1292801;27;316633;22047;16722
71297;Mesvres;453;9987433;426204;237;7483920;216;2503513;22047;16723
52231;Guindrecourt-aux-Ormes;47;1036230;15599;29;799407;18;236823;22047;16724
51016;Arrigny;153;3373304;98191;94;2721711;59;651593;22048;16725
70533;Vellefrey-et-Vellefrange;59;1300874;29840;33;1000888;26;299986;22049;16726
39074;Brans;113;2491550;72028;62;1910464;51;581086;22049;16727
40075;Castets;1158;25533024;1132959;636;20029657;522;5503367;22049;16728
52442;Rupt;188;4145274;156951;102;3100744;86;1044530;22049;16729
49046;Brézé;672;14817151;357073;389;11361016;283;3456135;22049;16730
05023;Briançon;6937;152958738;7852891;3940;122486669;2997;30472069;22050;16731
64500;Salles-Mongiscard;165;3638226;92100;93;2752216;72;886010;22050;16732
26327;Saint-Roman;88;1940407;59227;42;1366549;46;573858;22050;16733
19062;Corrèze;712;15699685;552892;364;11850964;348;3848721;22050;16734
50082;Bricquebec;2393;52766267;2228206;1162;40021528;1231;12744739;22050;16735
17277;Saint-Denis-du-Pin;394;8687808;317783;204;6609726;190;2078082;22050;16736
32391;Saint-Martin-de-Goyne;71;1565577;73251;33;1163931;38;401646;22050;16737
50199;Genêts;268;5909692;264492;144;4593612;124;1316080;22051;16738
55410;Quincy-Landzécourt;88;1940517;74895;46;1458916;42;481601;22051;16739
40298;Serres-Gaston;193;4256001;180652;98;3270169;95;985832;22052;16740
61048;Boëcé;63;1389272;34649;38;1083214;25;306058;22052;16741
21516;Quincerot;43;948256;43033;26;815660;17;132596;22052;16742
22203;Ploeuc-sur-Lié;1792;39518577;1775589;885;30391310;907;9127267;22053;16743
61099;La Chapelle-Souëf;148;3263812;86872;90;2684066;58;579746;22053;16744
2B298;Saint-Florent;1029;22692386;1762003;519;18419914;510;4272472;22053;16745
31018;Arnaud-Guilhem;139;3065359;116851;77;2411461;62;653898;22053;16746
57127;Chanville;63;1389358;40744;35;1109780;28;279578;22053;16747
34236;Rouet;34;749827;47347;17;654863;17;94964;22054;16748
33170;Fontet;420;9262642;420473;197;6956207;223;2306435;22054;16749
53092;Deux-Évailles;93;2051049;18578;44;1373611;49;677438;22054;16750
76674;Sévis;172;3793340;101728;103;3181617;69;611723;22054;16751
03273;Seuillet;259;5712288;165702;157;4685128;102;1027160;22055;16752
88445;Saulcy-sur-Meurthe;1328;29289752;1061435;780;23342389;548;5947363;22056;16753
61042;Bellou-sur-Huisne;261;5756509;213779;147;4356793;114;1399716;22056;16754
32178;Lagardère;43;948396;41379;15;676834;28;271562;22056;16755
87045;Cieux;557;12285057;404810;277;9246975;280;3038082;22056;16756
13055;Marseille;482556;10643192034;699366311;244161;8694125141;238395;1949066893;22056;16757
33176;Gabarnac;176;3881861;141876;84;3019592;92;862269;22056;16758
22015;Bréhand;784;17292176;462560;427;13022079;357;4270097;22056;16759
27106;Bournainville-Faverolles;241;5315625;165227;138;4197418;103;1118207;22057;16760
04094;Gréoux-les-Bains;1868;41202054;1865162;973;31047641;895;10154413;22057;16761
62094;Beaumerie-Saint-Martin;210;4631977;193582;106;3533789;104;1098188;22057;16762
09312;La Tour-du-Crieu;1509;33284090;1148627;863;26381041;646;6903049;22057;16763
55300;Longeaux;121;2668936;87435;69;2140301;52;528635;22057;16764
85067;Cheffois;477;10521504;202279;271;7975505;206;2545999;22058;16765
27299;Gravigny;2292;50557228;2084707;1361;40819648;931;9737580;22058;16766
43020;Bas-en-Basset;2416;53293731;1809739;1293;40346128;1123;12947603;22059;16767
72317;Saint-Rémy-du-Val;298;6574108;187054;169;4956574;129;1617534;22061;16768
18284;Villegenon;118;2603226;101571;58;1925924;60;677302;22061;16769
19101;Laguenne;828;18266867;751380;491;14475173;337;3791694;22061;16770
03215;Rongères;319;7037749;200553;178;5301443;141;1736306;22062;16771
80176;Carrépuis;151;3331397;124857;90;2646642;61;684755;22062;16772
40293;Saubusse;486;10722317;439134;267;8386586;219;2335731;22062;16773
21550;Saint-Germain-lès-Senailly;54;1191376;40507;30;931352;24;260024;22063;16774
54484;Sainte-Pôle;108;2382768;69495;63;1943429;45;439339;22063;16775
2B134;L'Île-Rousse;1988;43860955;3252769;869;33786674;1119;10074281;22063;16776
80628;Le Plessier-Rozainvillers;365;8052999;248596;195;6089955;170;1963044;22063;16777
76542;Routes;124;2735819;86194;64;2028827;60;706992;22063;16778
80393;Gruny;176;3883127;147110;101;3106483;75;776644;22063;16779
02782;Le Verguier;124;2735906;112528;72;2122422;52;613484;22064;16780
89335;Saint-Aubin-sur-Yonne;247;5449752;204192;147;4283039;100;1166713;22064;16781
68217;Moosch;989;21821221;754225;593;17178813;396;4642408;22064;16782
60265;Froissy;487;10745525;520252;273;8497777;214;2247748;22065;16783
26353;Les Tourrettes;525;11584080;393602;307;9215655;218;2368425;22065;16784
10389;Unienville;65;1434220;45007;43;1182536;22;251684;22065;16785
53030;Le Bignon-du-Maine;158;3486395;63794;86;2587075;72;899320;22066;16786
40152;Lesperon;565;12467218;404334;285;9584256;280;2882962;22066;16787
18012;Argenvières;264;5825433;247519;144;4599188;120;1226245;22066;16788
21046;Bard-le-Régulier;44;970935;57896;21;748220;23;222715;22067;16789
57314;Héming;262;5781769;205154;159;4629829;103;1151940;22068;16790
33052;Les Billaux;641;14145583;564435;374;11440115;267;2705468;22068;16791
33343;Pujols-sur-Ciron;442;9754085;307054;247;7732164;195;2021921;22068;16792
42301;Soleymieux;360;7944659;320372;201;6291018;159;1653641;22068;16793
27214;Écouis;449;9909024;486190;211;7494942;238;2414082;22069;16794
61136;Couvains;89;1964203;53845;51;1547258;38;416945;22070;16795
39017;Arlay;446;9843253;356404;249;7824635;197;2018618;22070;16796
60082;Bonneuil-les-Eaux;417;9203363;285376;233;7009571;184;2193792;22070;16797
84070;Malemort-du-Comtat;834;18406857;714895;386;13760736;448;4646121;22071;16798
40212;Orthevielle;503;11101573;394392;259;8442729;244;2658844;22071;16799
79134;Glénay;282;6224025;115943;161;4908560;121;1315465;22071;16800
72368;Vancé;194;4281796;218224;107;3441943;87;839853;22071;16801
83151;Vins-sur-Caramy;469;10351461;380123;245;8001901;224;2349560;22071;16802
57658;Soucht;596;13154529;377032;310;9659318;286;3495211;22071;16803
81064;Castelnau-de-Montmiral;540;11918736;585718;253;9091367;287;2827369;22072;16804
25590;Vaudrivillers;45;993231;40888;29;800657;16;192574;22072;16805
22105;Languenan;566;12492696;350146;321;9675506;245;2817190;22072;16806
17143;Le Douhet;386;8519820;302768;226;6673883;160;1845937;22072;16807
21029;Athie;46;1015322;36680;28;815898;18;199424;22072;16808
49051;Brissarthe;340;7504628;190165;182;5788527;158;1716101;22072;16809
79318;Soutiers;123;2714955;43520;68;2064811;55;650144;22073;16810
70487;Senargent-Mignafans;167;3686209;137438;86;2653284;81;1032925;22073;16811
80272;Épénancourt;64;1412688;49593;39;1146659;25;266029;22073;16812
18070;Concressault;132;2913675;146492;79;2342768;53;570907;22073;16813
16186;Lignières-Sonneville;369;8145179;541891;159;6233989;210;1911190;22074;16814
67380;Printzheim;119;2626776;83693;63;1980570;56;646206;22074;16815
02199;Clastres;333;7350645;278468;182;5656686;151;1693959;22074;16816
39147;Chilly-sur-Salins;53;1169925;35740;30;886799;23;283126;22074;16817
47216;Puymiclan;298;6578227;181163;159;5109708;139;1468519;22075;16818
82090;Lamothe-Capdeville;579;12781300;545950;299;10170080;280;2611220;22075;16819
80380;Gorenflos;133;2935952;124254;70;2266157;63;669795;22075;16820
69070;Cublize;683;15077624;626907;373;11620575;310;3457049;22076;16821
38384;Saint-Étienne-de-Saint-Geoirs;1668;36822549;1378138;909;28392376;759;8430173;22076;16822
50194;Fresville;178;3929583;121943;84;2890086;94;1039497;22076;16823
26194;Montchenu;304;6711267;290838;136;4785579;168;1925688;22077;16824
63456;Vichel;150;3311496;66805;88;2601826;62;709670;22077;16825
57732;Volmunster;436;9625512;344076;238;7523173;198;2102339;22077;16826
02371;Harly;942;20796604;783036;562;16506627;380;4289977;22077;16827
70317;Les Magny;72;1589563;37808;45;1320795;27;268768;22077;16828
35230;Poilley;193;4261088;111550;98;3188736;95;1072352;22078;16829
21100;Brain;25;551957;27895;14;444495;11;107462;22078;16830
44191;Saint-Sulpice-des-Landes;348;7683380;665557;144;5551204;204;2132176;22079;16831
46030;Bio;167;3687266;90002;87;2758070;80;929196;22079;16832
54148;Croismare;329;7264163;221834;188;5548275;141;1715888;22080;16833
61148;Durcet;141;3113294;59038;75;2296926;66;816368;22080;16834
52322;Meures;57;1258570;30947;34;989408;23;269162;22080;16835
85093;Fougeré;582;12850796;364985;333;9936274;249;2914522;22080;16836
65373;Puntous;115;2539293;178657;54;1922585;61;616708;22081;16837
42229;Saint-Germain-la-Montagne;129;2848503;93429;76;2275220;53;573283;22081;16838
27427;Neaufles-Auvergny;238;5255526;279021;130;4269825;108;985701;22082;16839
67531;Wildersbach;168;3709806;104348;104;2893139;64;816667;22082;16840
49060;Chacé;733;16186603;526085;424;12603844;309;3582759;22083;16841
65233;Jarret;157;3467105;106544;93;2679732;64;787373;22083;16842
76107;Bois-Guilbert;131;2892961;54179;68;2086057;63;806904;22084;16843
26019;Aurel;134;2959216;120515;63;2174368;71;784848;22084;16844
18165;Neuvy-sur-Barangeon;727;16054950;703273;373;11363300;354;4691650;22084;16845
46263;Saint-Daunès;127;2804662;136915;67;2175382;60;629280;22084;16846
54483;Saint-Nicolas-de-Port;4271;94321255;3763261;2450;76338135;1821;17983120;22084;16847
11252;Montmaur;175;3864860;111129;93;3000482;82;864378;22085;16848
03031;Bizeneuille;152;3357165;120597;76;2489188;76;867977;22087;16849
49100;Cizay-la-Madeleine;250;5521719;189368;136;4316187;114;1205532;22087;16850
81127;Lacroisille;66;1457749;67735;31;1119648;35;338101;22087;16851
80051;Bailleul;145;3202643;123634;70;2448701;75;753942;22087;16852
35262;Sainte-Colombe;163;3600226;66123;93;2825033;70;775193;22087;16853
84150;Visan;1023;22596097;964141;516;17264688;507;5331409;22088;16854
85190;Rocheservière;1576;34812375;965323;880;26684025;696;8128350;22089;16855
95127;Cergy;31304;691479255;36247160;17817;570756525;13487;120722730;22089;16856
14054;Beaumesnil;96;2120612;22745;54;1566233;42;554379;22090;16857
61182;Gandelain;221;4881873;147443;117;3778729;104;1103144;22090;16858
18273;Venesmes;469;10360286;424886;275;8370728;194;1989558;22090;16859
39061;Boissia;69;1524249;51305;35;1146315;34;377934;22091;16860
54299;Laneuveville-devant-Bayon;127;2805507;147181;71;2285442;56;520065;22091;16861
69001;Affoux;178;3932147;83014;107;3096787;71;835360;22091;16862
41272;Veuves;113;2496283;89543;59;1877416;54;618867;22091;16863
62192;Cagnicourt;215;4749660;152368;106;3596157;109;1153503;22091;16864
57559;Puzieux;101;2231254;64206;51;1661683;50;569571;22092;16865
64245;Goès;330;7290276;241447;193;5865080;137;1425196;22092;16866
34143;Loupian;1196;26421861;986562;624;20357082;572;6064779;22092;16867
88070;Bouxurulles;84;1855719;46727;55;1561172;29;294547;22092;16868
47262;Saint-Nicolas-de-la-Balerme;209;4617214;213476;110;3631917;99;985297;22092;16869
16093;Chazelles;864;19087612;749187;481;14844179;383;4243433;22092;16870
04173;Saint-André-les-Alpes;552;12194904;658999;291;9538463;261;2656441;22092;16871
34224;Puissalicon;631;13940204;471596;319;10452371;312;3487833;22092;16872
89350;Saint-Loup-d'Ordon;161;3556858;177340;90;2976335;71;580523;22092;16873
25116;Champlive;136;3004573;96058;80;2346280;56;658293;22092;16874
76191;Cressy;129;2849936;72685;67;2169676;62;680260;22093;16875
71507;Savigny-sur-Grosne;103;2275589;85197;61;1867054;42;408535;22093;16876
33275;Martres;68;1502337;79510;29;1120289;39;382048;22093;16877
03042;Le Breuil;308;6804724;219631;124;4942250;184;1862474;22093;16878
66162;Rigarda;268;5921057;212817;128;4426993;140;1494064;22093;16879
65353;Ozon;160;3534979;139307;89;2861557;71;673422;22094;16880
70395;Oppenans;35;773321;14039;19;596207;16;177114;22095;16881
76242;Ernemont-la-Villette;107;2364281;86415;64;1903199;43;461082;22096;16882
31045;Barbazan;297;6562717;363690;149;4826564;148;1736153;22097;16883
62068;Ayette;175;3866948;110460;91;2846468;84;1020480;22097;16884
59499;Rexpoëde;953;21058399;493252;513;15945584;440;5112815;22097;16885
27364;Launay;114;2519155;109658;71;2137541;43;381614;22098;16886
73019;Argentine;527;11645715;437272;305;9308056;222;2337659;22098;16887
44083;La Limouzinière;1073;23711514;590092;554;17670194;519;6041320;22098;16888
22226;Ploumilliau;1443;31888371;1078390;736;23928461;707;7959910;22099;16889
32140;Gaujac;32;707162;11315;14;473709;18;233453;22099;16890
13106;Septèmes-les-Vallons;5869;129698378;5663305;3329;104358639;2540;25339739;22099;16891
62352;Framecourt;54;1193346;53726;29;976353;25;216993;22099;16892
64382;Mesplède;164;3624273;114671;82;2771665;82;852608;22099;16893
25471;Provenchère;61;1348075;19020;31;1036936;30;311139;22100;16894
22143;Matignon;996;22012090;1054202;517;16933938;479;5078152;22100;16895
60524;Rantigny;1414;31250707;1294392;886;25655821;528;5594886;22101;16896
22097;La Landec;362;8000581;164519;206;6086253;156;1914328;22101;16897
64429;Orsanco;50;1105053;54930;25;832270;25;272783;22101;16898
11141;Ferran;56;1237662;55303;28;976786;28;260876;22101;16899
30355;Saint-Paul-les-Fonts;522;11536816;332165;285;8817091;237;2719725;22101;16900
55473;Saulx-lès-Champlon;70;1547186;58096;41;1182864;29;364322;22103;16901
38308;Plan;117;2586018;45072;66;1962939;51;623079;22103;16902
27038;Les Barils;132;2917567;129208;81;2384707;51;532860;22103;16903
40332;Ychoux;1136;25109340;1021357;595;19127141;541;5982199;22103;16904
31538;Savères;106;2342952;114803;56;1885275;50;457677;22103;16905
19010;Argentat;1932;42703683;2342053;943;32869658;989;9834025;22103;16906
67527;Westhouse-Marmoutier;147;3249273;77483;87;2616939;60;632334;22104;16907
80003;Acheux-en-Amiénois;299;6609068;253745;142;4936081;157;1672987;22104;16908
12292;Versols-et-Lapeyre;232;5128417;168491;134;4148655;98;979762;22105;16909
07207;Saint-Alban-Auriolles;566;12511593;507404;286;9498005;280;3013588;22105;16910
32255;Miramont-Latour;89;1967376;94095;44;1510014;45;457362;22105;16911
02111;Brancourt-en-Laonnois;386;8532691;321318;221;6967693;165;1564998;22105;16912
70101;Broye-Aubigney-Montseugny;294;6499053;267588;172;5081865;122;1417188;22106;16913
02484;Mézy-Moulins;275;6079154;218028;165;4970920;110;1108234;22106;16914
27437;Nojeon-en-Vexin;172;3802241;98621;97;2887242;75;914999;22106;16915
64426;Orin;128;2829620;78885;70;2241716;58;587904;22106;16916
02695;Saint-Thibaut;37;817942;26039;16;561026;21;256916;22107;16917
10376;Thieffrain;86;1901171;48057;50;1455320;36;445851;22107;16918
22261;Quintenic;184;4067661;148365;101;2988221;83;1079440;22107;16919
25426;Noirefontaine;218;4819310;155612;134;3826027;84;993283;22107;16920
25447;Passonfontaine;159;3515067;114967;87;2803727;72;711340;22107;16921
54086;Boucq;197;4355157;180416;111;3334439;86;1020718;22107;16922
47227;Ruffiac;90;1989691;112123;42;1484694;48;504997;22108;16923
41083;La Ferté-Beauharnais;323;7141085;264112;183;5543427;140;1597658;22109;16924
13041;Gardanne;12151;268643195;12013623;6877;215100823;5274;53542372;22109;16925
34146;Lunel-Viel;1994;44084817;1948511;1051;34277039;943;9807778;22109;16926
57233;Fraquelfing;47;1039120;35903;28;789360;19;249760;22109;16927
08383;Saint-Juvin;58;1282331;48947;28;948022;30;334309;22109;16928
57381;Laneuveville-en-Saulnois;132;2918411;70299;76;2302276;56;616135;22109;16929
57334;Hommert;202;4466081;136122;112;3366934;90;1099147;22109;16930
84053;Grillon;996;22021519;955097;526;16858358;470;5163161;22110;16931
54295;Landres;473;10458395;297862;185;6465761;288;3992634;22111;16932
18085;Dampierre-en-Graçay;127;2808069;106843;69;2171235;58;636834;22111;16933
71483;Saint-Symphorien-des-Bois;227;5019270;135461;136;3982763;91;1036507;22111;16934
18141;Mehun-sur-Yèvre;3995;88335439;3681671;2251;69748767;1744;18586672;22111;16935
12138;Marcillac-Vallon;950;21006192;994926;516;16764265;434;4241927;22112;16936
85274;Saint-Valérien;287;6346118;233254;142;4756648;145;1589470;22112;16937
36115;Menetou-sur-Nahon;76;1680532;105561;41;1243648;35;436884;22112;16938
63166;Gignat;127;2808269;84855;66;2150964;61;657305;22112;16939
71256;Lessard-en-Bresse;283;6257955;143879;156;4815166;127;1442789;22113;16940
62640;Orville;189;4179478;140528;106;3282795;83;896683;22114;16941
49270;Saint-Christophe-la-Couperie;370;8182050;141134;185;5824387;185;2357663;22114;16942
79096;Combrand;595;13157856;282258;320;9941056;275;3216800;22114;16943
18032;Boulleret;811;17935110;801660;434;13914035;377;4021075;22115;16944
43153;Pont-Salomon;1019;22535351;818952;589;17756430;430;4778921;22115;16945
65126;Campuzan;92;2034684;132115;45;1514674;47;520010;22116;16946
39403;Pagnoz;131;2897230;96686;72;2254060;59;643170;22116;16947
17400;Saint-Sever-de-Saintonge;327;7232089;272923;175;5503745;152;1728344;22116;16948
71559;Varennes-sous-Dun;352;7785029;286931;199;5986701;153;1798328;22117;16949
49281;Saint-Georges-des-Gardes;859;18998222;461199;467;14527818;392;4470404;22117;16950
24350;Razac-sur-l'Isle;1346;29770043;1246327;761;23231389;585;6538654;22117;16951
72137;La Fresnaye-sur-Chédouet;493;10904226;337788;276;8458621;217;2445605;22118;16952
79264;Saint-Léger-de-la-Martinière;586;12961244;469056;307;9744152;279;3217092;22118;16953
93078;Villepinte;17064;377424842;16488380;9614;301537315;7450;75887527;22118;16954
54552;Vaudémont;48;1061676;69799;20;749053;28;312623;22118;16955
24394;Sainte-Croix-de-Mareuil;80;1769476;79760;36;1310042;44;459434;22118;16956
67355;Oermingen;583;12895169;425514;335;10048373;248;2846796;22119;16957
51370;Moiremont;119;2632132;60175;75;2027556;44;604576;22119;16958
88084;Chamagne;238;5264281;163851;134;4061376;104;1202905;22119;16959
81304;Trévien;103;2278259;57106;41;1361434;62;916825;22119;16960
72181;Le Mans;83963;1857212175;99687323;46261;1517417961;37702;339794214;22119;16961
73232;Sainte-Foy-Tarentaise;432;9555609;435135;244;7327202;188;2228407;22119;16962
88020;Autreville;78;1725320;28144;40;1214146;38;511174;22119;16963
25304;Hérimoncourt;2072;45831807;1898987;1200;36330937;872;9500870;22120;16964
17107;Ciré-d'Aunis;611;13515157;476979;324;10195698;287;3319459;22120;16965
76632;Saint-Pierre-Bénouville;177;3915306;113623;99;2987689;78;927617;22120;16966
52469;Semoutiers-Montsaon;450;9954180;393276;359;8861077;91;1093103;22120;16967
23092;Glénic;385;8516421;376421;213;6666103;172;1850318;22121;16968
76719;Valmont;537;11878848;654538;256;9079757;281;2799091;22121;16969
32177;Lagarde-Hachan;82;1813924;79672;42;1402647;40;411277;22121;16970
63255;Nonette;189;4180895;212493;103;3548270;86;632625;22121;16971
66208;Théza;811;17940688;807366;412;13995676;399;3945012;22122;16972
73252;Saint-Léger;135;2986468;94060;75;2226176;60;760292;22122;16973
76210;Dampierre-Saint-Nicolas;272;6017492;192371;159;4657864;113;1359628;22123;16974
21138;Champdôtre;315;6969115;203642;191;5459500;124;1509615;22124;16975
71134;Clermain;123;2721279;78500;65;1955893;58;765386;22124;16976
71533;Tancon;288;6371777;164930;164;4980650;124;1391127;22124;16977
09004;Albiès;76;1681464;58439;45;1252487;31;428977;22125;16978
41278;Villechauve;153;3385068;85017;89;2648855;64;736213;22125;16979
69196;Saint-Didier-sur-Beaujeu;318;7035647;212818;188;5635781;130;1399866;22125;16980
34091;Le Cros;28;619496;28213;17;501625;11;117871;22125;16981
47085;Durance;148;3274490;139943;74;2494352;74;780138;22125;16982
54374;Moncel-sur-Seille;252;5575512;218898;140;4581871;112;993641;22125;16983
27040;Barquet;230;5088769;158852;124;3887407;106;1201362;22125;16984
89218;Laroche-Saint-Cydroine;743;16439667;638262;427;13106697;316;3332970;22126;16985
17280;Plassay;376;8319448;252035;203;6318030;173;2001418;22126;16986
60292;Gury;115;2544579;85701;74;2056780;41;487799;22127;16987
25173;Cour-Saint-Maurice;90;1991413;82330;53;1636591;37;354822;22127;16988
62181;Bucquoy;734;16241109;638513;337;11898354;397;4342755;22127;16989
10335;Saint-Benoist-sur-Vanne;139;3075663;144246;65;2279347;74;796316;22127;16990
69178;Souzy;402;8895095;269320;239;6986196;163;1908899;22127;16991
79091;Cirières;469;10377824;262281;254;7813276;215;2564548;22128;16992
88031;Balléville;59;1305532;34325;33;934198;26;371334;22128;16993
54504;Serrouville;347;7678672;60548;108;3378031;239;4300641;22129;16994
46014;Bagat-en-Quercy;108;2389931;82264;51;1780141;57;609790;22129;16995
71580;Vincelles;237;5244651;180343;135;4207840;102;1036811;22129;16996
29233;Quimperlé;7153;158301292;6612858;3821;125064881;3332;33236411;22131;16997
82066;Génébrières;323;7148253;291502;166;5562535;157;1585718;22131;16998
57239;Freybouse;223;4935393;145185;122;3752161;101;1183232;22132;16999
21624;Tellecey;79;1748486;44620;55;1514546;24;233940;22133;17000
57493;Mulcey;121;2678143;97935;76;2210974;45;467169;22133;17001
55336;Merles-sur-Loison;93;2058453;102594;47;1518006;46;540447;22134;17002
46003;Alvignac;388;8588177;392546;203;6574367;185;2013810;22134;17003
40211;Orist;355;7857742;266774;191;6118630;164;1739112;22134;17004
45315;Sully-sur-Loire;3077;68108421;3236526;1588;52685819;1489;15422602;22135;17005
80011;Ailly-sur-Somme;1708;37806541;1347047;1027;30270090;681;7536451;22135;17006
41126;Mareuil-sur-Cher;650;14387744;568188;391;11825344;259;2562400;22135;17007
33282;Mérignas;169;3740871;116088;81;2652229;88;1088642;22135;17008
59359;Loon-Plage;3102;68664008;2206367;1626;52540816;1476;16123192;22135;17009
21026;Asnières-en-Montagne;96;2125088;64765;56;1613610;40;511478;22136;17010
33278;Mauriac;153;3386952;155896;75;2498967;78;887985;22137;17011
86089;Cuhon;213;4715209;188794;106;3550573;107;1164636;22137;17012
42139;Marlhes;732;16204870;672766;348;12202152;384;4002718;22138;17013
59515;Rouvignies;311;6885047;202749;158;5107172;153;1777875;22138;17014
30347;Vestric-et-Candiac;685;15164975;481935;370;11804346;315;3360629;22139;17015
41041;La Chapelle-Vicomtesse;112;2479550;98797;63;2013474;49;466076;22139;17016
49003;Ambillou-Château;471;10427605;461925;232;7787057;239;2640548;22139;17017
27069;Bois-Arnault;392;8678678;303763;249;7030929;143;1647749;22139;17018
56147;Nivillac;2264;50123856;1625899;1208;38373228;1056;11750628;22140;17019
70256;Fresse;407;9010848;399886;215;6767537;192;2243311;22140;17020
03109;Escurolles;391;8656779;312706;223;6791811;168;1864968;22140;17021
64048;Arnos;40;885611;19571;20;605161;20;280450;22140;17022
39368;Morez;2661;58917478;2802823;1414;46057048;1247;12860430;22141;17023
76530;Robertot;104;2302706;83659;57;1743777;47;558929;22141;17024
53077;Cossé-le-Vivien;1582;35027838;850988;814;26209524;768;8818314;22141;17025
08291;Mogues;83;1837759;66739;43;1335604;40;502155;22142;17026
27432;La Neuville-du-Bosc;311;6886090;247063;182;5766879;129;1119211;22142;17027
61241;La Madeleine-Bouvet;225;4981971;147163;128;3876631;97;1105340;22142;17028
41273;Vievy-le-Rayé;290;6421361;265924;170;5110393;120;1310968;22143;17029
71149;Couches;790;17492967;728226;438;13711267;352;3781700;22143;17030
69058;Chiroubles;201;4450797;149674;109;3450807;92;999990;22143;17031
52405;Prauthoy;284;6288757;285385;144;4696753;140;1592004;22144;17032
29228;Primelin;450;9964919;382398;222;7374265;228;2590654;22144;17033
42304;Sury-le-Comtal;2970;65768480;2375133;1594;50514756;1376;15253724;22144;17034
41161;Nouan-le-Fuzelier;1419;31425206;1378098;786;24390866;633;7034340;22146;17035
55265;Labeuville;67;1483784;53939;38;1168253;29;315531;22146;17036
25338;Lizine;51;1129491;44497;25;885813;26;243678;22147;17037
50406;Plomb;239;5293194;335889;125;4203725;114;1089469;22147;17038
49249;La Pouëze;873;19335371;301190;510;14760664;363;4574707;22148;17039
65311;Mingot;51;1129561;61090;32;975640;19;153921;22148;17040
80358;Fresnoy-en-Chaussée;67;1483958;31947;39;1122581;28;361377;22149;17041
43087;Dunières;1589;35195482;1150768;750;26019094;839;9176388;22149;17042
40199;Mouscardès;125;2768713;82392;68;2114443;57;654270;22150;17043
21306;Grenant-lès-Sombernon;91;2015641;53861;57;1601707;34;413934;22150;17044
62875;Wardrecques;541;11983126;263151;312;9052888;229;2930238;22150;17045
08330;Novy-Chevrières;321;7110407;214456;177;5613088;144;1497319;22151;17046
31310;Lux;173;3832235;163061;95;3212986;78;619249;22152;17047
56194;Rieux;1583;35066395;1239106;888;27305470;695;7760925;22152;17048
63164;Gerzat;5630;124716103;4846543;3428;101351444;2202;23364659;22152;17049
37141;Luzillé;500;11076181;389020;274;8538791;226;2537390;22152;17050
35280;Saint-Hilaire-des-Landes;487;10788521;294944;269;8260698;218;2527823;22153;17051
50621;Vaudreville;44;974741;32932;23;792882;21;181859;22153;17052
16269;Pranzac;504;11165266;378871;302;9024196;202;2141070;22153;17053
57442;Many;141;3123682;106898;79;2554518;62;569164;22154;17054
42063;Chirassimont;214;4740917;132457;110;3642687;104;1098230;22154;17055
35089;La Couyère;252;5582819;174643;133;4209306;119;1373513;22154;17056
10369;Semoine;112;2481254;137984;56;1898727;56;582527;22154;17057
11024;Bages;480;10634771;561135;232;8081904;248;2552867;22156;17058
60288;Grémévillers;230;5095836;161107;134;3975515;96;1120321;22156;17059
22281;Saint-Carreuc;772;17104422;435627;469;13636748;303;3467674;22156;17060
64257;Haut-de-Bosdarros;157;3478527;128435;79;2714561;78;763966;22156;17061
10065;Brillecourt;54;1196469;29202;26;883552;28;312917;22157;17062
25056;Besançon;64443;1427853058;82335283;35107;1168059725;29336;259793333;22157;17063
55296;Lisle-en-Rigault;309;6846466;282731;181;5431947;128;1414519;22157;17064
26336;Saou;290;6425536;250151;145;4932864;145;1492672;22157;17065
49023;Beaupréau;3796;84108206;2263414;2002;64435629;1794;19672577;22157;17066
77183;La Ferté-sous-Jouarre;5327;118032443;6277238;3084;96271813;2243;21760630;22157;17067
17175;Germignac;320;7090411;246581;176;5473654;144;1616757;22158;17068
86099;Fleuré;531;11765734;399546;296;8998701;235;2767033;22158;17069
26349;Tersanne;169;3744672;133818;87;2713789;82;1030883;22158;17070
08492;Vrigne-Meuse;121;2681101;65088;75;2139278;46;541823;22158;17071
63358;Saint-Hilaire-la-Croix;193;4276741;138227;109;3423992;84;852749;22159;17072
47035;Bourgougnague;150;3323938;171374;82;2622404;68;701534;22160;17073
17375;Saint-Nazaire-sur-Charente;621;13761106;583049;341;10673018;280;3088088;22160;17074
28144;Les Étilleux;128;2836463;83886;62;2082461;66;754002;22160;17075
09148;Lacave;81;1794978;86289;39;1376269;42;418709;22160;17076
01107;Cleyzieu;77;1706391;56407;51;1415045;26;291346;22161;17077
80588;Neufmoulin;206;4565150;160534;126;3750638;80;814512;22161;17078
54115;Champigneulles;3864;85630081;3670110;2172;69157387;1692;16472694;22161;17079
08407;Séchault;31;686994;25846;15;436908;16;250086;22161;17080
76279;Foucart;189;4188449;124050;104;3160607;85;1027842;22161;17081
50056;Bion;219;4853424;139921;123;3758401;96;1095023;22162;17082
17329;Saint-Froult;197;4365902;151180;111;3552384;86;813518;22162;17083
14020;Argences;1933;42839264;1504986;1065;33551035;868;9288229;22162;17084
57742;Walscheid;878;19458359;636747;492;14895454;386;4562905;22162;17085
70562;Villers-la-Ville;74;1640026;42818;46;1351379;28;288647;22163;17086
22361;Tréguidel;312;6914830;196858;164;5198861;148;1715969;22163;17087
01100;Cheignieu-la-Balme;82;1817383;76899;49;1456771;33;360612;22163;17088
56224;Saint-Laurent-sur-Oust;196;4344196;152041;118;3553888;78;790308;22164;17089
78138;Chanteloup-les-Vignes;4866;107852300;4994766;2526;83652597;2340;24199703;22164;17090
58232;Saint-Benin-d'Azy;723;16024917;594010;383;12349785;340;3675132;22164;17091
22170;Plaine-Haute;760;16845084;455021;449;13470833;311;3374251;22165;17092
24293;Monplaisant;162;3590697;173095;80;2713906;82;876791;22165;17093
85301;Vendrennes;778;17244427;301195;472;13534606;306;3709821;22165;17094
63451;Vernines;213;4721246;142572;112;3569901;101;1151345;22165;17095
80266;Englebelmer;142;3147519;112897;73;2468600;69;678919;22166;17096
87008;La Bazeuge;91;2017074;163520;47;1517337;44;499737;22166;17097
03266;Sanssat;135;2992447;109492;75;2305883;60;686564;22166;17098
05136;Saint-Crépin;400;8866540;431560;226;7110596;174;1755944;22166;17099
02319;Fonsomme;260;5763260;272307;130;4390282;130;1372978;22166;17100
02518;Montlevon;149;3302806;121540;88;2710651;61;592155;22166;17101
29213;Plouzévédé;936;20747875;669624;512;15948950;424;4798925;22167;17102
27388;Marais-Vernier;259;5741142;211130;139;4517795;120;1223347;22167;17103
41248;Souday;297;6583488;229875;168;5135595;129;1447893;22167;17104
59534;Saint-Hilaire-sur-Helpe;438;9709016;387509;242;7745557;196;1963459;22167;17105
08121;Chilly;73;1618202;37826;39;1170159;34;448043;22167;17106
38283;Oris-en-Rattier;77;1706873;68059;46;1406953;31;299920;22167;17107
94002;Alfortville;26670;591204828;34431107;15234;494218282;11436;96986546;22167;17108
34088;Cournonterral;3283;72776409;2796704;1768;57726971;1515;15049438;22168;17109
18122;Lapan;105;2327652;70864;63;1856761;42;470891;22168;17110
24393;Sainte-Croix;52;1152772;49107;20;788277;32;364495;22169;17111
76009;Ancourteville-sur-Héricourt;148;3280997;93064;87;2640637;61;640360;22169;17112
40093;Escalans;133;2948511;152910;81;2493776;52;454735;22169;17113
34056;Castelnau-de-Guers;626;13878376;680708;288;10454633;338;3423743;22170;17114
39034;Balaiseaux;149;3303346;84592;92;2622840;57;680506;22170;17115
76528;Rieux;312;6917255;265626;189;5573326;123;1343929;22171;17116
12234;Sainte-Juliette-sur-Viaur;299;6629085;199182;171;5361175;128;1267910;22171;17117
60227;Évricourt;117;2593990;89214;75;2205462;42;388528;22171;17118
14078;Blay;188;4168250;105891;101;3175391;87;992859;22172;17119
90065;Lepuix;648;14367283;490727;390;11538611;258;2828672;22172;17120
55194;Foucaucourt-sur-Thabas;32;709539;13418;17;571507;15;138032;22173;17121
11151;Fontiès-d'Aude;221;4900276;230292;109;3884217;112;1016059;22173;17122
85202;Sainte-Cécile;769;17052751;601413;390;12440508;379;4612243;22175;17123
29251;Saint-Jean-du-Doigt;359;7961017;292071;191;5980314;168;1980703;22176;17124
51510;Saint-Quentin-les-Marais;72;1596701;47279;50;1375402;22;221299;22176;17125
50333;Les Moitiers-en-Bauptois;167;3703524;124746;89;2802533;78;900991;22177;17126
64503;Samsons-Lion;42;931437;38240;19;673938;23;257499;22177;17127
33203;Hourtin;2060;45685657;2022823;1104;35704315;956;9981342;22178;17128
71428;Saint-Igny-de-Roche;349;7739975;179531;193;5765137;156;1974838;22178;17129
54206;Fraimbois;189;4191590;113133;97;3151014;92;1040576;22178;17130
80144;Brouchy;308;6830745;296856;175;5391293;133;1439452;22178;17131
70483;Scye;75;1663332;50949;48;1360667;27;302665;22178;17132
51032;Bagneux;270;5988261;254755;154;4727981;116;1260280;22179;17133
61470;Serans;121;2683675;81025;66;2089344;55;594331;22179;17134
40113;Goos;288;6387607;303632;154;5088624;134;1298983;22179;17135
52247;Illoud;130;2883325;114682;80;2323343;50;559982;22179;17136
19098;Lagarde-Enval;451;10002958;400252;241;7632389;210;2370569;22180;17137
08283;Mazerny;72;1597050;48132;33;1144381;39;452669;22181;17138
89069;Chailley;315;6987328;334569;183;5565596;132;1421732;22182;17139
01182;Groslée;190;4214657;145154;97;3149559;93;1065098;22182;17140
22214;Plouézec;2005;44475751;1836465;1044;34214151;961;10261600;22182;17141
21581;Samerey;74;1641512;58187;38;1209712;36;431800;22183;17142
80755;Thieulloy-la-Ville;77;1708072;66101;50;1379300;27;328772;22183;17143
85171;Péault;296;6566191;197651;159;5036280;137;1529911;22183;17144
72258;Roullée;128;2839434;140381;65;2111873;63;727561;22183;17145
17337;Saint-Georges-d'Oléron;2520;55901730;2728670;1328;43865987;1192;12035743;22183;17146
62716;Rodelinghem;246;5457351;171471;129;4108255;117;1349096;22184;17147
49212;Montjean-sur-Loire;1642;36427044;956316;839;26778935;803;9648109;22185;17148
18195;Sagonne;120;2662174;102975;61;1967193;59;694981;22185;17149
80236;Davenescourt;277;6145217;272997;139;4677654;138;1467563;22185;17150
46220;Pinsac;430;9539547;423736;237;7597569;193;1941978;22185;17151
49070;Chanteloup-les-Bois;356;7898023;182415;199;6075369;157;1822654;22185;17152
50313;Le Mesnil-Herman;64;1419878;26448;34;1041887;30;377991;22186;17153
12053;La Capelle-Balaguier;156;3460970;86522;85;2571214;71;889756;22186;17154
76746;Vinnemerville;122;2706663;132776;68;2121873;54;584790;22186;17155
89241;Malicorne;96;2129898;108278;55;1714801;41;415097;22186;17156
61317;Orgères;98;2174285;96704;51;1682546;47;491739;22187;17157
28159;La Framboisière;192;4259902;183482;117;3510750;75;749152;22187;17158
61287;Montilly-sur-Noireau;390;8652979;255613;226;6721356;164;1931623;22187;17159
29254;Saint-Martin-des-Champs;2817;62501386;2402844;1603;48721224;1214;13780162;22187;17160
24069;Bussac;193;4282137;176238;106;3367731;87;914406;22187;17161
47221;Réaup-Lisse;341;7566206;360526;173;5705143;168;1861063;22188;17162
16355;Saint-Sulpice-de-Cognac;698;15488162;669414;386;12368128;312;3120034;22189;17163
35003;Andouillé-Neuville;376;8343440;171661;205;6341689;171;2001751;22190;17164
52374;Le Pailly;178;3949838;113209;96;2931478;82;1018360;22190;17165
34299;Sérignan;4086;90669061;4406547;2082;69786202;2004;20882859;22190;17166
64260;Hendaye;9340;207264230;9987669;5160;163851272;4180;43412958;22191;17167
24559;Tursac;196;4349471;219602;101;3399729;95;949742;22191;17168
64510;Sault-de-Navailles;469;10407771;338969;277;8227957;192;2179814;22191;17169
74290;Vallorcine;255;5658948;188728;149;4463518;106;1195430;22192;17170
05004;Ancelle;507;11251650;437797;295;9106721;212;2144929;22193;17171
59395;Mazinghien;162;3595466;203427;76;2751725;86;843741;22194;17172
40239;Puyol-Cazalet;55;1220722;43065;27;914774;28;305948;22195;17173
65189;Gayan;145;3218334;79708;91;2624304;54;594030;22195;17174
80325;Fontaine-lès-Cappy;27;599280;25432;15;446044;12;153236;22196;17175
65371;Préchac;135;2996404;88925;77;2281309;58;715095;22196;17176
65072;Bazet;900;19976320;600962;528;15889586;372;4086734;22196;17177
77207;Gironville;87;1931063;70557;50;1469978;37;461085;22196;17178
57311;Hellimer;304;6747892;214444;177;5284561;127;1463331;22197;17179
80067;Beaufort-en-Santerre;88;1953338;77181;49;1568738;39;384600;22197;17180
70038;Authoison;165;3662519;105324;90;2902605;75;759914;22197;17181
63248;Nébouzat;431;9567193;321456;254;7756120;177;1811073;22198;17182
62035;Annezin;3103;68880104;2927644;1680;54088473;1423;14791631;22198;17183
60287;Grandrû;170;3773709;128548;109;3125097;61;648612;22198;17184
80495;Lucheux;323;7170097;297176;166;5649958;157;1520139;22198;17185
01199;Jujurieux;1185;26305359;968702;671;20377011;514;5928348;22199;17186
89065;Cérilly;25;554966;19260;12;436881;13;118085;22199;17187
02800;Viffort;172;3818279;150235;108;3054302;64;763977;22199;17188
80428;Hem-Monacu;74;1642748;91675;45;1318130;29;324618;22199;17189
18024;Beddes;61;1354174;74182;30;1085775;31;268399;22200;17190
57535;Petit-Réderching;825;18314723;648331;455;13887215;370;4427508;22200;17191
55178;Érize-Saint-Dizier;99;2197767;81112;55;1775252;44;422515;22200;17192
17196;Jazennes;279;6193753;262829;155;4939066;124;1254687;22200;17193
15164;Roffiac;335;7437014;249868;195;5872087;140;1564927;22200;17194
08211;Haraucourt;421;9346303;426804;189;7038710;232;2307593;22200;17195
21678;Vic-sous-Thil;128;2841651;153214;73;2225450;55;616201;22200;17196
71081;Champforgeuil;1253;27817363;1033093;704;21823812;549;5993551;22201;17197
39452;Rans;262;5816608;134273;152;4662016;110;1154592;22201;17198
64430;Orthez;6466;143557988;6935881;3351;112147650;3115;31410338;22202;17199
67234;Keskastel;860;19093801;666710;472;14702854;388;4390947;22202;17200
56149;Noyal-Muzillac;1309;29062870;910102;743;22604781;566;6458089;22202;17201
55260;Julvécourt;43;954718;53648;22;754618;21;200100;22203;17202
21061;Bellenod-sur-Seine;46;1021359;54785;22;796613;24;224746;22203;17203
14120;Cahagnes;659;14632114;420761;341;11037157;318;3594957;22204;17204
84056;Jonquières;2590;57507522;2062854;1405;44396793;1185;13110729;22204;17205
21236;Ébaty;128;2842124;77600;86;2439959;42;402165;22204;17206
49027;Bégrolles-en-Mauges;972;21582570;423940;561;16892833;411;4689737;22204;17207
21640;Torcy-et-Pouligny;104;2309278;82841;61;1787786;43;521492;22205;17208
53273;Villiers-Charlemagne;555;12323586;310429;326;9741771;229;2581815;22205;17209
73323;Villaroger;208;4618570;218546;125;3695010;83;923560;22205;17210
58220;Raveau;400;8881895;344191;260;7407598;140;1474297;22205;17211
32147;Gimont;1811;40213078;2493607;880;31186787;931;9026291;22205;17212
54593;Waville;222;4929563;131617;121;3700222;101;1229341;22205;17213
73081;Le Châtelard;374;8304776;398262;214;6685923;160;1618853;22205;17214
76478;Notre-Dame-du-Parc;84;1865256;53719;43;1352060;41;513196;22205;17215
01357;Saint-Germain-de-Joux;244;5418261;172160;118;4039610;126;1378651;22206;17216
11061;Cambieure;143;3175563;82029;69;2148290;74;1027273;22207;17217
29210;Plouvorn;1461;32444260;1032730;775;24595547;686;7848713;22207;17218
80640;Pozières;137;3042419;99695;80;2479135;57;563284;22207;17219
80100;Bettencourt-Saint-Ouen;302;6707046;134898;179;5386670;123;1320376;22209;17220
27392;Martagny;72;1599036;58838;35;1200975;37;398061;22209;17221
39414;Le Petit-Mercey;58;1288140;35587;40;1099457;18;188683;22209;17222
37251;Souvigné;404;8972849;238531;235;7038979;169;1933870;22210;17223
62786;Selles;168;3731294;175742;82;2863328;86;867966;22210;17224
50585;Surtainville;652;14481128;539277;359;11049170;293;3431958;22210;17225
16163;Hiersac;604;13415264;534979;353;10730552;251;2684712;22211;17226
60109;Brombos;126;2798649;77942;70;2103299;56;695350;22212;17227
25225;Étrabonne;100;2221159;60304;63;1755619;37;465540;22212;17228
73178;La Motte-en-Bauges;252;5597404;189756;139;4330290;113;1267114;22212;17229
80728;Saulchoy-sous-Poix;32;710783;31937;16;563805;16;146978;22212;17230
35326;Sens-de-Bretagne;1179;26188274;731669;602;19519029;577;6669245;22212;17231
63109;Chidrac;244;5419859;171814;138;4181718;106;1238141;22213;17232
57471;Momerstroff;153;3398542;95583;78;2567176;75;831366;22213;17233
59374;Marbaix;266;5908671;203876;133;4513876;133;1394795;22213;17234
89211;Junay;63;1399455;67237;37;1096584;26;302871;22214;17235
71063;Broye;405;8996657;305351;228;6997028;177;1999629;22214;17236
53087;La Cropte;116;2576853;62180;60;1930078;56;646775;22214;17237
39260;Granges-sur-Baume;73;1621712;60264;37;1247065;36;374647;22215;17238
84144;Viens;340;7553217;388112;172;5924887;168;1628330;22215;17239
50595;Le Theil;312;6931257;173192;175;5290873;137;1640384;22216;17240
26119;Érôme;440;9775056;277687;240;7394790;200;2380266;22216;17241
85134;Mallièvre;146;3243553;87196;90;2624315;56;619238;22216;17242
14118;Caen;60704;1348652270;90461113;32755;1115212056;27949;233440214;22217;17243
21034;Autricourt;80;1777353;48425;43;1349796;37;427557;22217;17244
27294;Grainville;287;6376269;175565;179;5247130;108;1129139;22217;17245
42153;Neaux;263;5843113;128801;157;4426021;106;1417092;22217;17246
04088;Forcalquier;2936;65230679;4150350;1366;51136455;1570;14094224;22218;17247
17141;Dompierre-sur-Charente;268;5954332;275248;146;4778931;122;1175401;22218;17248
76566;Sainte-Austreberthe;311;6910038;287914;180;5736941;131;1173097;22219;17249
52347;Narcy;131;2910697;96955;84;2333745;47;576952;22219;17250
63029;Bansat;136;3021810;101230;80;2375759;56;646051;22219;17251
54245;Haigneville;23;511050;7620;12;343916;11;167134;22220;17252
57542;Piblange;428;9510206;117284;223;6633129;205;2877077;22220;17253
64559;Viodos-Abense-de-Bas;418;9288157;368188;235;7306667;183;1981490;22220;17254
76400;Luneray;1285;28553423;1145643;646;21499238;639;7054185;22221;17255
65175;Ferrère;29;644398;29564;15;472485;14;171913;22221;17256
55549;Véry;50;1111043;37995;28;920730;22;190313;22221;17257
05038;Château-Ville-Vieille;207;4599960;184490;127;3791520;80;808440;22222;17258
70017;Anchenoncourt-et-Chazel;132;2933383;99176;82;2466125;50;467258;22223;17259
60244;Fontenay-Torcy;83;1844506;85937;44;1481066;39;363440;22223;17260
67353;Obersteinbach;144;3200129;137364;86;2637174;58;562955;22223;17261
24040;Beynac-et-Cazenac;279;6200309;386729;152;5050254;127;1150055;22223;17262
65002;Adé;429;9533989;341345;257;7608053;172;1925936;22224;17263
44129;Pontchâteau;5443;120964038;4093182;3038;94934113;2405;26029925;22224;17264
88032;Ban-de-Laveline;719;15979003;650570;384;12098829;335;3880174;22224;17265
71128;Chiddes;43;955638;29623;20;731388;23;224250;22224;17266
65346;Oueilloux;86;1911281;52691;44;1418944;42;492337;22224;17267
32368;Sainte-Christie;302;6711773;262175;168;5314860;134;1396913;22224;17268
64417;Nay;1947;43272692;1926622;968;33368201;979;9904491;22225;17269
71496;Sampigny-lès-Maranges;76;1689206;49118;37;1192369;39;496837;22226;17270
52401;Poulangy;207;4600901;121122;120;3633343;87;967558;22227;17271
11026;Baraigne;86;1911495;65521;50;1566979;36;344516;22227;17272
03302;Veauce;24;533465;31128;12;397281;12;136184;22228;17273
07182;Prades;636;14137314;414327;341;10906412;295;3230902;22228;17274
67559;Zittersheim;131;2911972;82897;64;2201791;67;710181;22229;17275
70158;Clans;67;1489364;81039;39;1209810;28;279554;22229;17276
56101;Languidic;4009;89117565;2819200;2235;68601372;1774;20516193;22229;17277
80372;Frucourt;68;1511602;66302;33;1118075;35;393527;22229;17278
14088;Bons-Tassilly;204;4534836;127875;108;3320381;96;1214455;22230;17279
65467;Vier-Bordes;54;1200403;56647;25;918469;29;281934;22230;17280
72144;Gréez-sur-Roc;232;5157456;275432;120;3974411;112;1183045;22230;17281
61426;Saint-Martin-du-Vieux-Bellême;362;8047644;301354;188;6055603;174;1992041;22231;17282
62154;Bonnières;351;7803262;327928;163;5764950;188;2038312;22232;17283
72232;Notre-Dame-du-Pé;265;5891403;68848;158;4422148;107;1469255;22232;17284
46045;Cajarc;718;15962461;1056244;338;12400677;380;3561784;22232;17285
17203;Landrais;383;8514822;310540;204;6840436;179;1674386;22232;17286
51185;Courgivaux;148;3290634;181364;71;2469865;77;820769;22234;17287
25281;Goux-lès-Dambelin;142;3157289;116023;80;2535010;62;622279;22234;17288
21433;Montigny-Mornay-Villeneuve-sur-Vingeanne;215;4780559;184568;117;3749730;98;1030829;22235;17289
12272;Sonnac;239;5314325;200065;144;4390262;95;924063;22236;17290
64103;Bédeille;96;2134650;61734;49;1592806;47;541844;22236;17291
16021;Aubeville;72;1601007;41461;39;1279439;33;321568;22236;17292
46205;Montgesty;177;3935874;147327;88;2875482;89;1060392;22237;17293
29224;Pouldergat;685;15232201;420693;391;11761854;294;3470347;22237;17294
70325;Maizières;159;3535756;132467;96;2911234;63;624522;22237;17295
74123;Faverges;3936;87526940;3608655;2302;69822602;1634;17704338;22238;17296
17246;Moragne;240;5337053;152948;129;4007060;111;1329993;22238;17297
95063;Bezons;15536;345491396;16515155;8925;281825942;6611;63665454;22238;17298
02694;Saint-Simon;318;7071740;256374;173;5486924;145;1584816;22238;17299
53012;Athée;245;5448394;113120;137;4149186;108;1299208;22238;17300
61193;La Gonfrière;163;3624951;128663;95;2864685;68;760266;22239;17301
70021;Andornay;106;2357339;85237;63;1924698;43;432641;22239;17302
53146;Martigné-sur-Mayenne;889;19770556;634314;485;15399238;404;4371318;22239;17303
24426;Saint-Jean-d'Estissac;88;1957080;111370;46;1558640;42;398440;22240;17304
71578;La Villeneuve;128;2846666;131433;65;2164543;63;682123;22240;17305
16412;Villejoubert;171;3803105;94386;95;2993394;76;809711;22240;17306
37165;Neuil;232;5159986;186341;125;3957388;107;1202598;22241;17307
58165;Metz-le-Comte;101;2246449;69258;51;1644103;50;602346;22242;17308
72219;Neuvy-en-Champagne;199;4426196;127153;115;3461600;84;964596;22242;17309
88232;Harmonville;113;2513503;68135;61;1853313;52;660190;22243;17310
70199;Dampvalley-lès-Colombe;51;1134441;39232;30;961290;21;173151;22244;17311
25635;Vyt-lès-Belvoir;90;2001964;60227;56;1609055;34;392909;22244;17312
21119;Bussières;24;533887;23586;11;394601;13;139286;22245;17313
39483;Saint-Hymetière;40;889819;15531;25;725759;15;164060;22245;17314
85135;Mareuil-sur-Lay-Dissais;1451;32278197;1070529;747;24181714;704;8096483;22245;17315
01407;Seyssel;544;12102467;393691;270;9118799;274;2983668;22247;17316
54046;Barisey-au-Plain;204;4538477;164079;110;3401814;94;1136663;22247;17317
14693;Tordouet;130;2892226;77250;70;2110848;60;781378;22248;17318
21439;Montoillot;49;1090150;43062;30;824279;19;265871;22248;17319
21610;Soissons-sur-Nacey;158;3515231;71539;88;2613788;70;901443;22248;17320
61128;Courcerault;96;2135929;87823;44;1706433;52;429496;22249;17321
61039;La Bellière;72;1601947;72271;33;1261704;39;340243;22249;17322
49176;Le Lion-d'Angers;2040;45388839;1482915;1060;34121134;980;11267705;22249;17323
60425;Montreuil-sur-Brêche;266;5918399;183048;150;4651703;116;1266696;22250;17324
59347;Liessies;298;6630625;293315;166;5197178;132;1433447;22250;17325
72012;Assé-le-Riboul;255;5673968;168870;138;4369994;117;1303974;22251;17326
80338;Fouilloy;1051;23386331;799787;608;18727083;443;4659248;22252;17327
46265;Saint-Denis-lès-Martel;192;4272323;156021;93;3254409;99;1017914;22252;17328
11299;Preixan;305;6787001;278747;168;5237764;137;1549237;22252;17329
53121;Javron-les-Chapelles;854;19003610;851960;386;14300802;468;4702808;22252;17330
67044;Bischholtz;136;3026384;71683;80;2374013;56;652371;22253;17331
60192;Cuy;121;2692601;133553;73;2203308;48;489293;22253;17332
33250;Loubens;165;3671762;110967;87;2733159;78;938603;22253;17333
43025;Beauzac;1476;32845807;1042691;816;25263415;660;7582392;22253;17334
62597;Moyenneville;150;3338006;116909;88;2736730;62;601276;22253;17335
40257;Sainte-Eulalie-en-Born;684;15221847;576228;400;12080764;284;3141083;22254;17336
10132;Droupt-Sainte-Marie;141;3137925;91540;84;2451935;57;685990;22255;17337
57027;Arraincourt;69;1535619;58277;36;1128240;33;407379;22255;17338
89454;Villefranche;386;8590673;409194;223;6932602;163;1658071;22256;17339
60443;Muirancourt;297;6609930;153674;169;5340388;128;1269542;22256;17340
33008;Arbis;151;3360623;120560;78;2558223;73;802400;22256;17341
82014;Beaupuy;143;3182607;134981;69;2425711;74;756896;22256;17342
37242;Savigny-en-Véron;778;17315286;700072;400;13334997;378;3980289;22256;17343
27242;Le Fidelaire;556;12374506;444491;315;9559786;241;2814720;22256;17344
12182;Pierrefiche;153;3405369;147415;73;2576247;80;829122;22257;17345
38544;Vienne;17511;389751283;22053608;9293;312067076;8218;77684207;22258;17346
02752;Tugny-et-Pont;145;3227398;164248;78;2487530;67;739868;22258;17347
63392;Saint-Rémy-de-Chargnat;293;6521612;190044;178;5259630;115;1261982;22258;17348
77099;Château-Landon;1817;40443415;1815920;1007;31993108;810;8450307;22258;17349
18084;Dampierre-en-Crot;119;2648810;114185;66;2070942;53;577868;22259;17350
22304;Saint-Jean-Kerdaniel;311;6922538;177885;163;5055748;148;1866790;22259;17351
22110;Lanmérin;231;5141922;130312;130;3909560;101;1232362;22259;17352
03180;Montbeugny;341;7590500;211605;195;6020667;146;1569833;22260;17353
59229;Féron;284;6321784;270714;143;4942878;141;1378906;22260;17354
66188;Saint-Pierre-dels-Forcats;127;2827030;82420;80;2330605;47;496425;22260;17355
27300;Grosley-sur-Risle;305;6789516;245724;163;5212993;142;1576523;22261;17356
21571;Saint-Sauveur;130;2893954;89463;75;2276025;55;617929;22261;17357
57618;Saint-Louis;363;8080835;213221;214;6388353;149;1692482;22261;17358
12165;Muret-le-Château;178;3962561;113426;98;3163695;80;798866;22262;17359
64554;Viellenave-d'Arthez;95;2114962;65813;58;1667732;37;447230;22263;17360
02639;Remigny;195;4341335;186185;106;3498500;89;842835;22263;17361
28412;Villeau;107;2382244;86044;59;1889685;48;492559;22264;17362
05112;Rabou;45;1001897;40893;24;810583;21;191314;22264;17363
82008;Auvillar;507;11288100;493425;253;8721080;254;2567020;22264;17364
58023;Bazoches;113;2516004;143049;56;1903205;57;612799;22266;17365
51492;Saint-Just-Sauvage;821;18280147;884185;444;14210217;377;4069930;22266;17366
2A336;Valle-di-Mezzana;190;4230510;187148;106;3262516;84;967994;22266;17367
42028;Burdignes;206;4587000;127614;105;3484569;101;1102431;22267;17368
89370;Saint-Valérien;933;20775387;984993;491;16094086;442;4681301;22267;17369
65360;Peyrouse;146;3251051;74017;83;2498334;63;752717;22267;17370
37143;Manthelan;746;16611763;622916;398;12587346;348;4024417;22268;17371
80008;Aigneville;410;9129863;299654;221;6898884;189;2230979;22268;17372
02777;Vendières;82;1826063;81293;50;1511624;32;314439;22269;17373
89147;Dracy;140;3117754;153913;89;2614778;51;502976;22270;17374
52121;Chaumont;13310;296411187;15798818;7479;242146082;5831;54265105;22270;17375
72290;Saint-Jean-d'Assé;769;17125741;452420;421;12817798;348;4307943;22270;17376
43200;Saint-Julien-Chapteuil;1057;23540536;966894;533;17920629;524;5619907;22271;17377
38195;Izeron;425;9465291;374183;251;7587303;174;1877988;22271;17378
38087;Chasse-sur-Rhône;2765;61581091;2465742;1587;49078832;1178;12502259;22272;17379
57272;Guermange;56;1247237;49243;33;1003914;23;243323;22272;17380
27430;La Neuve-Grange;153;3407690;49184;88;2531643;65;876047;22272;17381
64071;Athos-Aspis;114;2539092;146530;64;2082694;50;456398;22273;17382
89142;Dixmont;495;11025409;422585;286;8602877;209;2422532;22274;17383
79117;Faye-sur-Ardin;317;7060766;208123;177;5466961;140;1593805;22274;17384
33086;Camiac-et-Saint-Denis;194;4321167;140351;105;3451983;89;869184;22274;17385
45108;Coullons;1436;31985814;1281117;781;24976035;655;7009779;22274;17386
88486;Vagney;2229;49649901;1735693;1163;37515020;1066;12134881;22275;17387
47273;Saint-Robert;110;2450253;86181;53;1812524;57;637729;22275;17388
66177;Saint-Jean-Lasseille;598;13320563;303293;328;10459246;270;2861317;22275;17389
64160;Cambo-les-Bains;3744;83399808;3588113;1974;65889952;1770;17509856;22276;17390
2B162;Moltifao;352;7841070;454793;176;6202378;176;1638692;22276;17391
39290;Légna;99;2205324;61240;51;1551299;48;654025;22276;17392
14580;Saint-Georges-en-Auge;60;1336561;54590;28;941295;32;395266;22276;17393
41146;Monthou-sur-Cher;565;12586306;478642;318;9853862;247;2732444;22277;17394
85239;Saint-Maixent-sur-Vie;476;10604027;256791;282;8243924;194;2360103;22277;17395
22340;Tonquédec;592;13188377;400993;345;10588146;247;2600231;22278;17396
28295;Ozoir-le-Breuil;225;5012544;176436;120;3761133;105;1251411;22278;17397
16405;Vignolles;91;2027312;80460;40;1497815;51;529497;22278;17398
61339;Putanges-Pont-Écrepin;561;12498094;679883;270;9505977;291;2992117;22278;17399
61166;Ferrières-la-Verrerie;97;2160993;98912;52;1732239;45;428754;22278;17400
55009;Ancemont;304;6772657;192320;174;5316129;130;1456528;22278;17401
76445;Montérolier;276;6148884;156181;151;4766782;125;1382102;22279;17402
80834;Yzengremer;279;6215969;276201;152;4945791;127;1270178;22279;17403
76142;Brémontier-Merval;222;4946286;150689;127;3898116;95;1048170;22281;17404
44056;Fay-de-Bretagne;1718;38278493;1061517;941;29330569;777;8947924;22281;17405
06054;Drap;2351;52383989;2366228;1279;41347827;1072;11036162;22282;17406
08183;Fromelennes;573;12767507;498913;317;10008912;256;2758595;22282;17407
29174;Plonéour-Lanvern;3316;73887823;2669161;1790;57769887;1526;16117936;22282;17408
32352;Rozès;74;1648900;79074;37;1243333;37;405567;22282;17409
2B332;Urtaca;114;2540207;189830;60;2127034;54;413173;22283;17410
16036;Bécheresse;147;3275637;106581;79;2574596;68;701041;22283;17411
70152;Choye;232;5169734;160008;124;3947194;108;1222540;22283;17412
45215;Montliard;124;2763198;96631;72;2191868;52;571330;22284;17413
62047;Aubrometz;67;1493025;52351;37;1144113;30;348912;22284;17414
39107;Charcier;71;1582162;95624;45;1329653;26;252509;22284;17415
38213;Longechenal;300;6685211;171211;166;5130396;134;1554815;22284;17416
40278;Saint-Paul-en-Born;502;11186598;483147;289;9075459;213;2111139;22284;17417
02014;Amigny-Rouy;371;8267409;320208;204;6503497;167;1763912;22284;17418
67436;Saulxures;248;5526634;203377;133;4204185;115;1322449;22285;17419
52272;Lanty-sur-Aube;75;1671393;55504;48;1436459;27;234934;22285;17420
85004;Angles;1612;35924779;1382725;912;27738945;700;8185834;22286;17421
32325;Pouydraguin;78;1738302;65198;37;1371082;41;367220;22286;17422
86224;Saint-Gervais-les-Trois-Clochers;708;15778886;610670;336;11475642;372;4303244;22287;17423
76564;Saint-Aubin-sur-Mer;139;3097915;146705;74;2467683;65;630232;22287;17424
46037;Bouziès;44;980655;66075;24;791649;20;189006;22288;17425
21030;Aubaine;56;1248178;59347;30;1003974;26;244204;22289;17426
81292;Tanus;285;6352473;148497;103;4455418;182;1897055;22289;17427
76405;Manéhouville;108;2407272;65594;73;2106060;35;301212;22290;17428
89148;Druyes-les-Belles-Fontaines;174;3878383;253671;82;3003856;92;874527;22290;17429
46293;Saint-Sozy;291;6486269;230657;167;5053621;124;1432648;22290;17430
31063;Benque;91;2028395;87461;46;1613088;45;415307;22290;17431
07345;Vion;487;10855481;344113;298;8835775;189;2019706;22291;17432
22112;Lannebert;242;5394306;211750;121;4093675;121;1300631;22291;17433
85026;La Boissière-des-Landes;708;15782904;537434;424;12597871;284;3185033;22292;17434
24228;Lanquais;290;6464790;279973;142;4760307;148;1704483;22292;17435
27355;Ivry-la-Bataille;1578;35177451;1595017;907;28173790;671;7003661;22292;17436
80535;Le Mesge;93;2073275;63874;55;1657489;38;415786;22293;17437
71251;Laizy;329;7334663;240906;186;5898716;143;1435947;22294;17438
37009;Autrèche;220;4904656;177079;122;3785875;98;1118781;22294;17439
39546;Vaudrey;200;4458857;137121;109;3424759;91;1034098;22294;17440
76540;Rouen;63707;1420305850;99641671;34760;1188406024;28947;231899826;22294;17441
29106;Landrévarzec;915;20399444;568679;515;15688984;400;4710460;22294;17442
56124;Malestroit;1462;32595488;1394843;751;25222541;711;7372947;22295;17443
47077;Cuzorn;510;11370592;442722;248;8903943;262;2466649;22295;17444
72372;Vezot;35;780338;33774;20;648139;15;132199;22295;17445
89485;Voutenay-sur-Cure;123;2742338;75196;72;2167288;51;575050;22295;17446
57250;Goetzenbruck;894;19932318;613233;484;14949426;410;4982892;22296;17447
65242;Lacassagne;144;3210751;139622;81;2559577;63;651174;22297;17448
27518;Saint-Aubin-sur-Quillebeuf;336;7491904;256710;189;5785945;147;1705959;22297;17449
02562;Nouvron-Vingré;109;2430468;54627;60;1848081;49;582387;22298;17450
89031;Beaumont;323;7202317;213654;195;5735775;128;1466542;22298;17451
14458;Les Moutiers-en-Cinglais;226;5039394;209041;110;3838851;116;1200543;22298;17452
30343;Verfeuil;330;7358807;246990;181;5636124;149;1722683;22299;17453
71424;Saint-Gervais-sur-Couches;125;2787454;163528;80;2404283;45;383171;22300;17454
17032;Ballon;407;9075955;289446;240;7211273;167;1864682;22300;17455
71244;Jouvençon;242;5396574;202211;136;4304701;106;1091873;22300;17456
2B049;Calenzana;1242;27697591;1149190;580;21485843;662;6211748;22301;17457
55532;Vaubecourt;178;3969601;152604;96;3020518;82;949083;22301;17458
24409;Saint-Front-de-Pradoux;652;14540483;553423;345;11060485;307;3479998;22301;17459
64158;Cabidos;91;2029467;89219;44;1519519;47;509948;22302;17460
68068;Dannemarie;1249;27855144;1155783;674;21877991;575;5977153;22302;17461
72016;Auvers-le-Hamon;752;16771159;533270;387;12601825;365;4169334;22302;17462
32037;Beaumont;78;1739608;104570;38;1451543;40;288065;22303;17463
55224;Haironville;313;6980792;189410;181;5366679;132;1614113;22303;17464
46229;Puybrun;547;12199718;447417;308;9611872;239;2587846;22303;17465
24044;Blis-et-Born;235;5241199;177903;131;4123179;104;1118020;22303;17466
37098;Draché;373;8319091;268706;199;6335065;174;1984026;22303;17467
17028;Aytré;5490;122445095;6313393;3228;99586586;2262;22858509;22303;17468
10147;Fays-la-Chapelle;76;1695065;58514;36;1169848;40;525217;22303;17469
32188;Lamothe-Goas;42;936765;16884;23;703255;19;233510;22304;17470
88069;Bouxières-aux-Bois;72;1605958;26407;45;1334214;27;271744;22305;17471
05045;Crots;535;11933166;442635;270;9226815;265;2706351;22305;17472
02464;Margival;190;4238019;159386;104;3233413;86;1004606;22305;17473
38018;Auberives-en-Royans;198;4416548;143975;110;3508601;88;907947;22306;17474
59212;Estaires;3204;71468372;2860099;1623;53866809;1581;17601563;22306;17475
81319;Villeneuve-sur-Vère;263;5866484;214456;129;4322407;134;1544077;22306;17476
64551;Verdets;140;3122853;99713;76;2373847;64;749006;22306;17477
45136;Ervauville;315;7026509;252948;192;5697614;123;1328895;22306;17478
39072;Bracon;174;3881336;130141;110;3172709;64;708627;22307;17479
87197;Thouron;297;6625448;219305;173;5387613;124;1237835;22308;17480
76487;Osmoy-Saint-Valery;181;4037754;118664;105;3264137;76;773617;22308;17481
24421;Saint-Geyrac;131;2922496;185726;60;2220946;71;701550;22309;17482
60093;Boulogne-la-Grasse;231;5153663;155234;124;4052297;107;1101366;22310;17483
86079;La Roche-Rigault;302;6737960;295042;161;5193641;141;1544319;22311;17484
08441;Termes;78;1740268;82431;29;1223073;49;517195;22311;17485
40266;Saint-Julien-en-Born;916;20437064;880826;482;15920721;434;4516343;22311;17486
81256;Saint-Jean-de-Vals;43;959382;14576;22;714071;21;245311;22311;17487
86002;Amberre;285;6358767;173006;158;4953056;127;1405711;22311;17488
85140;La Meilleraie-Tillay;789;17603796;484978;462;13728289;327;3875507;22312;17489
64256;Hasparren;3502;78135983;3680403;1857;60633003;1645;17502980;22312;17490
52472;Sexfontaines;74;1651141;76303;45;1345589;29;305552;22313;17491
16102;Cognac;11927;266124762;14100029;6264;216574558;5663;49550204;22313;17492
76075;Belmesnil;242;5399725;146139;141;4303477;101;1096248;22313;17493
93061;Le Pré-Saint-Gervais;9969;222437463;14637903;5605;184621710;4364;37815753;22313;17494
64549;Uzein;674;15038910;486691;455;12543706;219;2495204;22313;17495
46049;Calvignac;112;2499175;110344;50;1886154;62;613021;22314;17496
33248;Listrac-Médoc;1341;29923824;1064325;748;22898184;593;7025640;22315;17497
39024;Audelange;140;3124043;97951;86;2496048;54;627995;22315;17498
49031;Bocé;303;6761469;213641;156;5091340;147;1670129;22315;17499
71199;Flagy;90;2008456;56620;51;1468916;39;539540;22316;17500
37212;Sainte-Catherine-de-Fierbois;361;8056238;252230;220;6454607;141;1601631;22316;17501
46176;Livernon;348;7766140;327767;175;5963806;173;1802334;22316;17502
06136;Sospel;2205;49209632;2102106;1219;39226990;986;9982642;22317;17503
89059;Bussy-en-Othe;440;9819618;463209;264;8075953;176;1743665;22317;17504
62357;Fresnoy;31;691862;20661;14;463952;17;227910;22318;17505
76538;Rosay;145;3236140;127449;82;2629910;63;606230;22318;17506
49049;Brion;585;13056470;419924;305;9773096;280;3283374;22319;17507
65075;Bazus-Aure;85;1897159;73464;51;1568851;34;328308;22320;17508
65098;Boô-Silhen;162;3615978;177500;91;2814782;71;801196;22321;17509
52425;Rivière-les-Fosses;116;2589298;90747;67;1965712;49;623586;22322;17510
89456;Villemanoche;348;7768115;257283;220;6308234;128;1459881;22322;17511
07117;Lablachère;1220;27233589;1201292;604;21173437;616;6060152;22323;17512
85024;Bois-de-Céné;977;21809556;586501;515;16710442;462;5099114;22323;17513
27212;Écauville;57;1272435;35437;30;930155;27;342280;22323;17514
60698;Wacquemoulin;151;3370885;102767;92;2701348;59;669537;22324;17515
45066;Chailly-en-Gâtinais;376;8393914;306344;227;6729932;149;1663982;22324;17516
85043;Chaillé-sous-les-Ormeaux;698;15582332;410731;416;12468189;282;3114143;22324;17517
80142;Briquemesnil-Floxicourt;96;2143165;64289;54;1721521;42;421644;22325;17518
12301;Villeneuve;1153;25741566;1161366;562;19179988;591;6561578;22326;17519
19050;Chauffour-sur-Vell;214;4777733;112860;112;3569738;102;1207995;22326;17520
77480;Valence-en-Brie;442;9868182;470929;260;8528128;182;1340054;22326;17521
46052;Camboulit;125;2790807;103273;62;2080422;63;710385;22326;17522
57163;Dabo;1550;34606462;1345739;855;26983958;695;7622504;22327;17523
82109;Merles;105;2344310;78767;47;1608924;58;735386;22327;17524
19226;Saint-Merd-les-Oussines;74;1652189;74909;28;1251748;46;400441;22327;17525
16240;Nabinaud;43;960059;37548;21;701598;22;258461;22327;17526
89050;Bonnard;492;10985024;359320;310;8985517;182;1999507;22327;17527
37046;Céré-la-Ronde;256;5715901;234882;135;4375263;121;1340638;22328;17528
63155;Estandeuil;222;4956944;161941;130;4057241;92;899703;22329;17529
01176;Le Grand-Abergement;67;1496015;45743;33;1048179;34;447836;22329;17530
54410;Onville;294;6564641;213898;150;5008583;144;1556058;22329;17531
33405;Saint-Genès-de-Blaye;279;6229712;255289;152;5130548;127;1099164;22329;17532
24002;Agonac;957;21368804;825510;543;17045148;414;4323656;22329;17533
39533;Toulouse-le-Château;115;2567832;84498;62;1966976;53;600856;22329;17534
89103;Chevillon;194;4331853;184298;104;3343184;90;988669;22329;17535
80096;Béthencourt-sur-Mer;535;11946211;514884;273;9134041;262;2812170;22329;17536
71441;Saint-Léger-sous-la-Bussière;133;2969832;85657;77;2363749;56;606083;22330;17537
61352;Rônai;82;1831032;49689;52;1506633;30;324399;22330;17538
61208;Irai;310;6922271;261832;176;5504375;134;1417896;22330;17539
70147;Chavanne;113;2523353;64756;70;2076811;43;446542;22331;17540
34047;Campagnan;326;7279920;318365;160;5568504;166;1711416;22331;17541
62655;Pierremont;152;3394439;108846;72;2452200;80;942239;22332;17542
02553;Nizy-le-Comte;139;3104371;245674;55;2347056;84;757315;22334;17543
01284;Ozan;310;6923527;211507;169;5375751;141;1547776;22334;17544
39467;Rotalier;103;2300405;137500;59;1848301;44;452104;22334;17545
46041;Cadrieu;95;2121736;66726;54;1612881;41;508855;22334;17546
14678;Soumont-Saint-Quentin;274;6119640;209281;145;4638061;129;1481579;22334;17547
61052;Bonnefoi;88;1965450;47176;57;1606816;31;358634;22335;17548
55113;Cheppy;75;1675141;67343;47;1424477;28;250664;22335;17549
35151;Lieuron;418;9336133;435825;221;7130167;197;2205966;22335;17550
71445;Saint-Marcel;3299;73684076;2668736;1897;58503255;1402;15180821;22335;17551
50116;Champcey;108;2412224;56780;59;1859914;49;552310;22335;17552
71489;Saint-Vincent-en-Bresse;296;6611675;222426;167;5284320;129;1327355;22337;17553
61061;Bretoncelles;839;18740623;1124605;412;14158567;427;4582056;22337;17554
53218;Sainte-Gemmes-le-Robert;459;10252619;356429;253;7927232;206;2325387;22337;17555
11098;Conilhac-Corbières;468;10453837;434462;239;8083559;229;2370278;22337;17556
71283;Marnay;300;6701215;229146;196;5615973;104;1085242;22337;17557
56030;Camoël;535;11950555;418820;304;9371406;231;2579149;22337;17558
08076;Boulzicourt;516;11526195;407039;313;9455554;203;2070641;22338;17559
08151;Écordal;164;3663455;146633;89;2823116;75;840339;22338;17560
21637;Tichey;95;2122203;39108;41;1376158;54;746045;22339;17561
84122;Sarrians;3235;72266844;3382257;1643;55564215;1592;16702629;22339;17562
72346;La Suze-sur-Sarthe;2365;52832234;1799722;1329;40978142;1036;11854092;22339;17563
57070;Bettange;113;2524356;62028;60;1784143;53;740213;22339;17564
58193;Neuvy-sur-Loire;836;18675948;846824;470;14806061;366;3869887;22340;17565
23206;Saint-Laurent;381;8511589;294518;235;6949133;146;1562456;22340;17566
63005;Antoingt;201;4490437;152585;116;3446142;85;1044295;22340;17567
65011;Les Angles;80;1787263;71521;47;1466550;33;320713;22341;17568
59440;Noyelles-sur-Selle;394;8802450;286996;223;6853074;171;1949376;22341;17569
25450;Pessans;42;938336;20983;25;717587;17;220749;22341;17570
70475;Saint-Valbert;128;2859712;83200;78;2314379;50;545333;22342;17571
69066;Cours-la-Ville;2245;50157477;2007456;1156;37904508;1089;12252969;22342;17572
55495;Sorbey;118;2636422;32083;53;1718420;65;918002;22343;17573
34262;Saint-Guiraud;133;2971628;198712;66;2498224;67;473404;22343;17574
62409;Hannescamps;92;2055563;65566;52;1724048;40;331515;22343;17575
95572;Saint-Ouen-l'Aumône;12651;282663111;13162381;7468;231773763;5183;50889348;22343;17576
50028;La Baleine;51;1139511;76574;28;944531;23;194980;22343;17577
63127;Creste;32;714993;27756;14;483956;18;231037;22344;17578
29163;Pleyber-Christ;1715;38319466;1443183;932;29546204;783;8773262;22344;17579
70037;Autet;165;3686724;164338;89;2825013;76;861711;22344;17580
76703;Touffreville-sur-Eu;115;2569563;90108;65;2051989;50;517574;22344;17581
61034;Beaulieu;115;2569643;79403;63;2034448;52;535195;22345;17582
70198;Dampierre-sur-Salon;742;16580192;843520;391;12975651;351;3604541;22345;17583
02299;Évergnicourt;296;6614263;191266;163;4979463;133;1634800;22345;17584
47118;Hautesvignes;79;1765300;62241;42;1386530;37;378770;22346;17585
31570;Vaux;154;3441228;180069;84;2811936;70;629292;22346;17586
43023;Beaune-sur-Arzon;125;2793273;229644;50;2075738;75;717535;22346;17587
55340;Mognéville;214;4782159;186775;121;3793019;93;989140;22347;17588
40230;Pontonx-sur-l'Adour;1427;31889154;1059987;801;24930480;626;6958674;22347;17589
02370;Hargicourt;290;6480634;272942;149;4930881;141;1549753;22347;17590
50408;Pontaubault;265;5921971;221775;145;4598089;120;1323882;22347;17591
52239;Heuilley-Cotton;149;3329749;84803;88;2659940;61;669809;22347;17592
85082;Les Epesses;1395;31175301;680585;818;23651791;577;7523510;22348;17593
60485;Oursel-Maison;113;2525321;134450;57;1949648;56;575673;22348;17594
85144;Mesnard-la-Barotière;668;14928468;310293;450;12367539;218;2560929;22348;17595
86254;Saulgé;560;12514978;470156;307;9696715;253;2818263;22348;17596
33253;Loupiac;644;14392348;715788;351;11326239;293;3066109;22348;17597
89334;Saint-Aubin-Château-Neuf;281;6280103;210660;158;4890910;123;1389193;22349;17598
03114;La Ferté-Hauterive;157;3508848;124674;91;2807982;66;700866;22349;17599
95633;Vaudherland;52;1162167;89850;30;986581;22;175586;22349;17600
21627;Thenissey;63;1408032;40471;34;1134313;29;273719;22350;17601
77208;Gouaix;752;16807824;608899;450;13618122;302;3189702;22351;17602
17189;Hiers-Brouage;387;8649841;364458;208;6870671;179;1779170;22351;17603
54493;Saulnes;1316;29415031;477288;514;15496083;802;13918948;22352;17604
24447;Sainte-Marie-de-Chignac;313;6996158;227500;187;5583185;126;1412973;22352;17605
50618;Varouville;138;3084652;105026;75;2459899;63;624753;22353;17606
02027;Assis-sur-Serre;135;3017705;140133;62;2122573;73;895132;22353;17607
06098;Puget-Rostang;64;1430632;51152;40;1180313;24;250319;22354;17608
88143;Domèvre-sur-Durbion;154;3442460;111649;87;2635746;67;806714;22354;17609
73216;Rognaix;232;5186072;158933;139;4027309;93;1158763;22354;17610
03246;Saint-Martinien;331;7399119;329730;187;5872998;144;1526121;22354;17611
50615;Valognes;4193;93730933;5053667;1982;72320779;2211;21410154;22354;17612
36170;Reboursin;54;1207127;39247;23;789888;31;417239;22354;17613
10310;Puits-et-Nuisement;119;2660168;89852;64;2076001;55;584167;22354;17614
71411;Saint-Eugène;66;1475432;44328;39;1135196;27;340236;22355;17615
18033;Bourges;39876;891432482;50365693;22080;733449874;17796;157982608;22355;17616
62702;Remilly-Wirquin;185;4135760;163583;115;3439284;70;696476;22355;17617
66059;Corneilla-del-Vercol;1192;26647761;1233892;624;20905247;568;5742514;22356;17618
65449;Tournous-Devant;66;1475512;40166;36;1239478;30;236034;22356;17619
59294;Haynecourt;183;4091220;173123;116;3319762;67;771458;22356;17620
03055;La Chapelaude;560;12519839;582933;316;10000636;244;2519203;22357;17621
70288;Hyet;57;1274353;43058;34;1062829;23;211524;22357;17622
49068;Champtocé-sur-Loire;935;20904069;456789;486;15453630;449;5450439;22357;17623
49350;Torfou;1106;24728108;649876;529;18159950;577;6568158;22358;17624
41110;Langon;479;10710705;354353;291;8659988;188;2050717;22361;17625
34067;Cazilhac;789;17642532;705441;423;13718881;366;3923651;22361;17626
02156;Chalandry;125;2795159;103161;66;2201324;59;593835;22361;17627
33266;Marcenais;381;8519816;248166;205;6591638;176;1928178;22362;17628
52037;Bannes;218;4874939;160660;126;3859312;92;1015627;22362;17629
63411;Sauvagnat-Sainte-Marthe;279;6239135;238941;159;4867336;120;1371799;22362;17630
36011;Bagneux;103;2303369;108669;48;1703547;55;599822;22363;17631
50218;Granville;8035;179685842;10458415;4054;139477694;3981;40208148;22363;17632
73074;La Chapelle;192;4293823;145889;122;3458130;70;835693;22364;17633
10258;Morvilliers;160;3578239;150396;86;2695592;74;882647;22364;17634
73286;Serrières-en-Chautagne;594;13284219;326531;338;10190191;256;3094028;22364;17635
26133;Fay-le-Clos;95;2124706;94053;55;1752363;40;372343;22365;17636
85103;Grosbreuil;1053;23550816;758456;583;18138849;470;5411967;22365;17637
82085;Lacourt-Saint-Pierre;584;13062244;431060;327;10325271;257;2736973;22367;17638
21432;Montigny-sur-Aube;172;3847195;237201;83;2974154;89;873041;22367;17639
67178;Gungwiller;153;3422381;137173;85;2642771;68;779610;22369;17640
01191;Izenave;91;2035542;52374;48;1514597;43;520945;22369;17641
26346;Suze;126;2818478;93837;70;2224759;56;593719;22369;17642
76437;Meulers;289;6464643;229118;167;5197905;122;1266738;22369;17643
29191;Plougonven;1810;40488015;1497002;1009;32029183;801;8458832;22369;17644
12242;Saint-Rémy;179;4004082;161221;98;3066950;81;937132;22369;17645
82194;Villebrumier;657;14696622;726051;343;11362889;314;3333733;22369;17646
51513;Saint-Remy-en-Bouzemont-Saint-Genest-et-Isson;322;7203218;303274;173;5622977;149;1580241;22370;17647
45288;Saint-Loup-des-Vignes;250;5592781;257926;134;4344504;116;1248277;22371;17648
22085;Kerbors;199;4451856;164171;101;3408661;98;1043195;22371;17649
65264;Lascazères;164;3668911;134925;80;2665470;84;1003441;22371;17650
33003;Ambarès-et-Lagrave;7255;162306776;6625676;4126;130536148;3129;31770628;22372;17651
49139;Fontaine-Milon;251;5615371;101175;135;4129221;116;1486150;22372;17652
07277;Saint-Michel-de-Boulogne;75;1677909;52360;38;1311002;37;366907;22372;17653
80780;Vaudricourt;233;5212706;196452;124;3992420;109;1220286;22372;17654
71405;Saint-Didier-en-Bresse;96;2147830;119795;57;1811947;39;335883;22373;17655
59413;Montigny-en-Cambrésis;311;6958174;245596;164;5426162;147;1532012;22374;17656
02649;Rocourt-Saint-Martin;154;3445563;115660;99;2845181;55;600382;22374;17657
45026;Bazoches-sur-le-Betz;553;12372932;486904;337;10002637;216;2370295;22374;17658
04176;Sainte-Croix-du-Verdon;75;1678128;75118;45;1358691;30;319437;22375;17659
02183;Chevregny;108;2416509;87884;58;1907175;50;509334;22375;17660
72272;Sainte-Cérotte;184;4117035;151661;112;3213917;72;903118;22375;17661
55093;Buxières-sous-les-Côtes;172;3848585;164356;103;3170370;69;678215;22375;17662
62031;Andres;700;15663225;448183;370;11937191;330;3726034;22376;17663
76401;La Mailleraye-sur-Seine;1091;24412834;990726;592;18797033;499;5615801;22377;17664
70263;Genevrey;138;3087998;100207;78;2422999;60;664999;22377;17665
14674;Soignolles;52;1163597;11447;30;871217;22;292380;22377;17666
82139;Le Pin;74;1655896;99623;38;1272449;36;383447;22377;17667
49250;La Prévière;126;2819527;70226;68;2160665;58;658862;22377;17668
53255;Sainte-Suzanne;546;12218109;443911;294;9301045;252;2917064;22377;17669
56166;Plouay;3035;67917922;2780080;1602;52878979;1433;15038943;22378;17670
50583;Sourdeval-les-Bois;117;2618273;166378;62;2097929;55;520344;22378;17671
52436;Rouécourt;30;671353;18254;18;523617;12;147736;22378;17672
16010;Ambleville;113;2528863;190996;55;2081539;58;447324;22379;17673
24254;Marnac;108;2417005;141079;52;1863964;56;553041;22380;17674
76308;Gonneville-sur-Scie;220;4923557;106400;121;3916054;99;1007503;22380;17675
2A270;Sari-d'Orcino;166;3715078;205916;74;2941750;92;773328;22380;17676
22077;Hénansal;591;13226970;364042;309;9860172;282;3366798;22381;17677
70095;Breurey-lès-Faverney;281;6288999;151242;164;4890070;117;1398929;22381;17678
63276;Peschadoires;1281;28669872;1278415;773;23364600;508;5305272;22381;17679
25039;Avoudrey;465;10407684;370850;271;8132067;194;2275617;22382;17680
02229;Courtrizy-et-Fussigny;42;940087;30969;23;731630;19;208457;22383;17681
64145;Bourdettes;237;5304804;126329;149;4327522;88;977282;22383;17682
57541;Philippsbourg;309;6916727;181708;171;5150477;138;1766250;22384;17683
27173;Corneville-la-Fouquetière;60;1343084;63930;37;1187789;23;155295;22385;17684
62087;Bayenghem-lès-Éperlecques;464;10386540;265455;241;7918653;223;2467887;22385;17685
41098;Gombergean;102;2283250;44290;59;1746625;43;536625;22385;17686
26330;Saint-Sorlin-en-Valloire;1161;25989002;892537;614;19521933;547;6467069;22385;17687
76750;Yainville;595;13319435;472580;348;10388193;247;2931242;22386;17688
42140;Marols;229;5126367;175415;129;4005213;100;1121154;22386;17689
83110;Rougiers;828;18535719;738839;446;14389019;382;4146700;22386;17690
59184;Ebblinghem;326;7297950;258528;182;5813089;144;1484861;22386;17691
70150;Chenevrey-et-Morogne;142;3178873;79831;87;2427437;55;751436;22386;17692
33331;Pondaurat;237;5305667;164713;110;3839165;127;1466502;22387;17693
33017;Aubiac;133;2977516;112902;75;2364321;58;613195;22387;17694
86174;Naintré;3227;72247666;2775604;1903;57889736;1324;14357930;22388;17695
53193;Ruillé-Froid-Fonds;292;6537581;358525;163;5098300;129;1439281;22389;17696
62262;Cuinchy;918;20553941;629542;497;15481491;421;5072450;22390;17697
62898;Wisques;139;3112205;139008;67;2597429;72;514776;22390;17698
72052;Chahaignes;427;9560594;408094;224;7386956;203;2173638;22390;17699
29089;Kergloff;486;10881646;320699;287;8617369;199;2264277;22390;17700
47244;Sainte-Gemme-Martaillac;203;4545232;162337;108;3546888;95;998344;22390;17701
58302;Varennes-lès-Narcy;515;11531045;426881;292;8778595;223;2752450;22390;17702
85162;Nieul-sur-l'Autise;663;14845327;409044;354;11105764;309;3739563;22391;17703
63333;Saint-Denis-Combarnazat;126;2821302;201751;61;2123350;65;697952;22391;17704
16344;Saint-Projet-Saint-Constant;590;13211011;597966;346;10339677;244;2871334;22392;17705
37040;Brizay;155;3470718;136638;77;2565003;78;905715;22392;17706
85231;Saint-Hilaire-la-Forêt;449;10054015;328428;277;8051699;172;2002316;22392;17707
39015;Ardon;67;1500278;24106;37;1177466;30;322812;22392;17708
34137;Liausson;85;1903353;99790;43;1486092;42;417261;22392;17709
57303;Hauconcourt;308;6896861;215118;180;5239859;128;1657002;22392;17710
85243;Brem-sur-Mer;1524;34126187;1251337;893;27029522;631;7096665;22393;17711
70307;Longevelle;62;1388369;36051;34;981055;28;407314;22393;17712
56097;Landévant;1745;39077221;1049778;956;29813153;789;9264068;22394;17713
43177;Saint-Didier-en-Velay;1837;41137858;1347250;1005;31673383;832;9464475;22394;17714
49319;Saint-Sauveur-de-Flée;137;3068021;56180;72;2055489;65;1012532;22394;17715
08223;Herbeuval;48;1074931;17738;28;855730;20;219201;22394;17716
71391;Saint-Bérain-sur-Dheune;297;6651334;269182;164;5260399;133;1390935;22395;17717
88233;Harol;322;7211252;314716;172;5530642;150;1680610;22395;17718
19031;Brive-la-Gaillarde;28452;637191852;35654210;15200;507313307;13252;129878545;22395;17719
54118;Charency-Vezin;300;6718688;208624;127;4175092;173;2543596;22396;17720
82121;Montauban;34461;771786466;43883235;17570;618414216;16891;153372250;22396;17721
53117;Houssay;236;5285579;113596;146;4123012;90;1162567;22397;17722
32237;Marsan;249;5576818;207885;151;4524558;98;1052260;22397;17723
76748;Vittefleur;375;8399135;328905;202;6545466;173;1853669;22398;17724
11195;Laurabuc;201;4502020;171254;102;3405742;99;1096278;22398;17725
54023;Arracourt;132;2956571;116522;70;2308141;62;648430;22398;17726
59558;Saulzoir;943;21121624;808779;502;16257589;441;4864035;22398;17727
76666;Saumont-la-Poterie;230;5151895;310922;114;4097689;116;1054206;22400;17728
59046;Bambecque;367;8220665;265232;182;6123711;185;2096954;22400;17729
76417;Maucomble;177;3964790;56936;103;3092566;74;872224;22400;17730
69290;Saint-Priest;22925;513520966;21320039;13182;408105071;9743;105415895;22400;17731
79289;Saint-Pierre-des-Échaubrognes;669;14986013;258977;375;11299378;294;3686635;22401;17732
62218;Caucourt;177;3965100;119638;95;2998646;82;966454;22402;17733
88128;Denipaire;147;3293255;107153;88;2719321;59;573934;22403;17734
39292;Lent;71;1590637;45297;42;1297025;29;293612;22403;17735
40282;Saint-Sever;2839;63603412;2911034;1600;50719226;1239;12884186;22403;17736
33010;Arcins;234;5242438;174185;141;4258294;93;984144;22404;17737
85164;Notre-Dame-de-Monts;1284;28766729;1133583;676;22101373;608;6665356;22404;17738
50544;Saint-Rémy-des-Landes;138;3091839;197325;71;2305314;67;786525;22405;17739
32066;Brugnens;139;3114271;124480;67;2181051;72;933220;22405;17740
32362;Saint-Aunix-Lengros;84;1882012;75495;42;1425206;42;456806;22405;17741
18167;Nohant-en-Graçay;160;3584812;171931;85;2744290;75;840522;22405;17742
02086;Bichancourt;537;12031598;415172;325;9892345;212;2139253;22405;17743
47087;Engayrac;71;1590798;73227;35;1261013;36;329785;22406;17744
76535;Roncherolles-en-Bray;256;5735843;270486;136;4505889;120;1229954;22406;17745
76155;Canehan;167;3741794;125535;96;2883078;71;858716;22406;17746
50477;Saint-Germain-des-Vaux;202;4526033;162531;114;3559294;88;966739;22406;17747
80803;Villers-lès-Roye;131;2935279;94338;88;2455562;43;479717;22407;17748
80283;Esclainvillers;86;1927004;74775;52;1595546;34;331458;22407;17749
08341;Poix-Terron;418;9366499;343516;220;7172529;198;2193970;22408;17750
54135;Colombey-les-Belles;693;15529002;451636;366;11612314;327;3916688;22408;17751
60571;Saint-Deniscourt;39;873930;10648;26;632257;13;241673;22408;17752
61065;Bubertré;73;1635827;44027;40;1268674;33;367153;22409;17753
32435;Sirac;88;1971989;95083;48;1528559;40;443430;22409;17754
58100;Dompierre-sur-Héry;45;1008419;48086;25;818172;20;190247;22409;17755
41025;Bracieux;778;17434532;695592;446;13561403;332;3873129;22409;17756
72349;Teillé;273;6117824;239512;155;4799601;118;1318223;22410;17757
25341;Lomont-sur-Crête;80;1792776;49474;44;1402643;36;390133;22410;17758
45278;Sainte-Geneviève-des-Bois;623;13961560;669989;336;10891670;287;3069890;22410;17759
89001;Accolay;288;6454211;421055;160;5020744;128;1433467;22410;17760
17403;Saint-Simon-de-Bordes;386;8650678;425771;201;6748225;185;1902453;22411;17761
22347;Trédarzec;625;14007082;555051;333;10440278;292;3566804;22411;17762
89395;Les Sièges;262;5871856;331831;143;4672186;119;1199670;22412;17763
51001;Ablancourt;83;1860202;56441;49;1453307;34;406895;22412;17764
57754;Xanrey;64;1434410;63846;33;1109149;31;325261;22413;17765
26182;Mirabel-aux-Baronnies;854;19140863;956393;440;15132967;414;4007896;22413;17766
56096;Landaul;1058;23713334;588915;583;17911551;475;5801783;22413;17767
70385;La Neuvelle-lès-Lure;181;4056863;154664;115;3349656;66;707207;22414;17768
32406;Saint-Sauvy;199;4460447;229579;107;3483935;92;976512;22414;17769
21184;Colombier;32;717263;34973;19;567219;13;150044;22414;17770
66026;Brouilla;664;14883987;639926;344;11630149;320;3253838;22416;17771
50137;La Colombe;330;7397255;223983;181;5673283;149;1723972;22416;17772
54350;Marainviller;391;8764647;259079;233;6953890;158;1810757;22416;17773
50177;Étienville;203;4550464;183279;124;3747975;79;802489;22416;17774
83025;Brue-Auriac;642;14392301;488509;334;11135221;308;3257080;22418;17775
49005;Andigné;176;3945625;77722;107;2997447;69;948178;22418;17776
31545;Sepx;122;2735036;114176;63;2160329;59;574707;22418;17777
41199;Saint-Amand-Longpré;675;15132455;550634;359;11460287;316;3672168;22418;17778
30027;Bagard;1357;30421844;1419880;684;23687905;673;6733939;22418;17779
01221;Lompnieu;64;1434788;54397;41;1203152;23;231636;22419;17780
74072;Chevaline;116;2600578;110740;60;1841987;56;758591;22419;17781
49085;La Chaussaire;386;8653686;125861;214;6459147;172;2194539;22419;17782
68044;Le Bonhomme;429;9617755;351741;225;7480089;204;2137666;22419;17783
70113;Cenans;74;1659042;58635;38;1235746;36;423296;22419;17784
39424;Les Planches-en-Montagne;90;2017757;75136;53;1670443;37;347314;22420;17785
42150;Montverdun;608;13631110;317852;307;10010830;301;3620280;22420;17786
61177;Frênes;422;9461111;245885;244;7288606;178;2172505;22420;17787
71055;Brandon;167;3744111;106649;90;2780077;77;964034;22420;17788
62671;Pronville;164;3676861;191617;76;2689460;88;987401;22420;17789
88131;Deycimont;143;3206108;37739;76;2436327;67;769781;22420;17790
85281;Sérigné;529;11860414;400537;295;9214072;234;2646342;22420;17791
43241;Solignac-sur-Loire;650;14573891;396523;328;11094820;322;3479071;22421;17792
47042;Brugnac;89;1995517;65031;44;1554371;45;441146;22422;17793
65174;Estirac;47;1053817;28752;22;750451;25;303366;22422;17794
61414;Saint-Langis-lès-Mortagne;478;10717699;426803;278;8656898;200;2060801;22422;17795
35253;Saint-Aubin-du-Cormier;1804;40449924;1445625;1029;31842912;775;8607012;22422;17796
89406;Talcy;46;1031441;33881;26;743675;20;287766;22423;17797
52129;Cirey-sur-Blaise;56;1255712;38778;28;941301;28;314411;22423;17798
60236;Flavy-le-Meldeux;97;2175096;59530;53;1688925;44;486171;22424;17799
55184;Euville;879;19710460;685635;460;14838202;419;4872258;22424;17800
92007;Bagneux;21708;486777132;27610858;12672;399078118;9036;87699014;22424;17801
08439;Tannay;77;1726638;33328;37;1105814;40;620824;22424;17802
67047;Bissert;82;1838780;55009;50;1503430;32;335350;22424;17803
61184;Gauville;311;6974424;236020;180;5518203;131;1456221;22426;17804
67222;Ingwiller;2291;51378635;2169007;1203;39669502;1088;11709133;22426;17805
25400;Montgesoye;261;5853270;226645;141;4436676;120;1416594;22426;17806
21229;Diancey;46;1031666;55393;23;763941;23;267725;22428;17807
70142;Chaumercenne;95;2130676;88651;56;1703934;39;426742;22428;17808
57670;Thicourt;81;1816698;82710;45;1356980;36;459718;22428;17809
59226;Felleries;733;16440344;701329;370;13102666;363;3337678;22429;17810
08144;Doux;42;942016;36148;27;788974;15;153042;22429;17811
02006;Aisonville-et-Bernoville;150;3364346;147469;70;2532518;80;831828;22429;17812
27356;Jonquerets-de-Livet;171;3835411;150110;89;2946375;82;889036;22429;17813
01400;Seillonnaz;86;1928923;83511;47;1458827;39;470096;22429;17814
76584;Saint-Germain-sur-Eaulne;101;2265374;49661;60;1755929;41;509445;22429;17815
73069;Chamoux-sur-Gelon;505;11326885;450225;283;9049873;222;2277012;22429;17816
61276;Merri;89;1996265;73790;47;1517486;42;478779;22430;17817
30156;Marguerittes;4766;106904480;4049368;2701;84748099;2065;22156381;22431;17818
30122;Gajan;392;8792874;372590;222;7154054;170;1638820;22431;17819
48180;Saint-Rome-de-Dolan;34;762654;8923;17;532141;17;230513;22431;17820
55349;Montigny-devant-Sassey;68;1525337;89231;36;1171757;32;353580;22431;17821
16422;Vouzan;368;8254768;311901;215;6715688;153;1539080;22431;17822
14280;Formentin;129;2893702;116746;71;2295981;58;597721;22432;17823
46092;Esclauzels;129;2893903;146740;71;2264686;58;629217;22433;17824
56225;Saint-Léry;92;2063896;78333;55;1756122;37;307774;22434;17825
57304;Haut-Clocher;184;4127797;118497;107;3274189;77;853608;22434;17826
38332;Renage;1986;44554008;1667849;1108;34684899;878;9869109;22434;17827
56215;Saint-Gonnery;575;12899801;394237;350;10402850;225;2496951;22434;17828
49094;Chênehutte-Trèves-Cunault;579;12990361;484916;315;9849947;264;3140414;22436;17829
39528;Thervay;203;4554610;151672;108;3470515;95;1084095;22437;17830
21530;Rougemont;94;2109041;79474;58;1685086;36;423955;22437;17831
57246;Gelucourt;125;2804627;100269;69;2210396;56;594231;22437;17832
82118;Montaïn;58;1301354;64822;26;968631;32;332723;22437;17833
49381;Yzernay;950;21315565;355820;526;16295598;424;5019967;22437;17834
70085;Boult;280;6282717;174576;171;5065904;109;1216813;22438;17835
80672;Ribemont-sur-Ancre;320;7180419;252881;184;5764697;136;1415722;22439;17836
63161;La Forie;198;4442921;205502;114;3465931;84;976990;22439;17837
24298;Mouzens;137;3074150;89974;74;2204870;63;869280;22439;17838
72188;Marollette;85;1907359;81465;60;1691112;25;216247;22440;17839
71457;Saint-Martin-en-Gâtinois;66;1481027;72893;35;1130401;31;350626;22440;17840
02793;Vézaponin;69;1548376;63491;39;1229488;30;318888;22440;17841
29131;Locmélar;244;5475556;123675;133;4210749;111;1264807;22441;17842
28199;Janville;1030;23114156;1137401;568;18090484;462;5023672;22441;17843
35215;Parigné;626;14048475;271940;337;10526749;289;3521726;22442;17844
28108;Cormainville;128;2872548;112520;76;2318530;52;554018;22442;17845
52535;Villiers-le-Sec;390;8752406;268072;238;7030966;152;1721440;22442;17846
45339;Villemoutiers;262;5879856;205747;151;4534536;111;1345320;22442;17847
62730;Ruminghem;780;17504938;555344;386;13002064;394;4502874;22442;17848
50012;Angoville-sur-Ay;136;3052145;105369;67;2248242;69;803903;22442;17849
60474;Ognolles;148;3321452;156018;80;2604692;68;716760;22442;17850
02068;Berlancourt;48;1077255;26800;23;812256;25;264999;22443;17851
23259;Verneiges;52;1167083;34495;25;879803;27;287280;22444;17852
61206;L'Hôme-Chamondot;142;3187057;142765;77;2503946;65;683111;22444;17853
69217;Saint-Just-d'Avray;400;8977713;261422;224;6906797;176;2070916;22444;17854
59156;Courchelettes;1364;30614101;1287594;724;23551888;640;7062213;22444;17855
80708;Saint-Mard;111;2491379;108004;69;2118544;42;372835;22445;17856
08140;Dom-le-Mesnil;544;12210007;419496;324;9810776;220;2399231;22445;17857
42026;Briennon;964;21637294;693404;557;16819613;407;4817681;22445;17858
88247;Igney;621;13940423;417593;362;10895896;259;3044527;22448;17859
01144;Dommartin;454;10191606;331771;259;7914651;195;2276955;22448;17860
31542;Seilhan;108;2424447;145391;51;1766441;57;658006;22449;17861
05175;Vallouise;498;11179437;550329;270;8737218;228;2442219;22449;17862
09165;Lesparrou;141;3165379;173913;75;2582700;66;582679;22449;17863
14417;Mesnil-Clinchamps;512;11494435;328695;283;8982336;229;2512099;22450;17864
58295;Tracy-sur-Loire;563;12639549;540717;338;10091561;225;2547988;22450;17865
85030;Boulogne;395;8867983;197814;233;6886675;162;1981308;22451;17866
70507;Trésilley;104;2334865;54548;57;1689438;47;645427;22451;17867
24273;Molières;188;4220732;238892;88;3238579;100;982153;22451;17868
16143;Fouquebrune;349;7835582;242140;203;6192467;146;1643115;22452;17869
52082;Bugnières;88;1975782;60863;47;1495532;41;480250;22452;17870
32184;Lalanne;60;1347143;29177;34;1035867;26;311276;22452;17871
76435;Le Mesnil-Réaume;314;7050225;154036;187;5475070;127;1575155;22453;17872
24103;Le Change;343;7701365;292254;203;6233916;140;1467449;22453;17873
09308;Taurignan-Vieux;124;2784195;96517;62;2102845;62;681350;22453;17874
07108;Jaunac;65;1459483;40428;38;1150059;27;309424;22454;17875
32410;Samatan;1395;31322784;1532846;730;24819488;665;6503296;22454;17876
07342;Villevocance;670;15044001;451884;405;11787149;265;3256852;22454;17877
72215;Neufchâtel-en-Saosnois;536;12035296;389011;291;9522088;245;2513208;22454;17878
88449;Savigny;108;2425045;76587;58;1807885;50;617160;22454;17879
73169;Montgirod;261;5860786;176515;167;4726220;94;1134566;22455;17880
03209;Poëzat;72;1616782;31641;45;1338172;27;278610;22455;17881
43218;Saint-Pierre-Eynac;576;12934354;413636;339;10517278;237;2417076;22455;17882
08433;Suzanne;33;741056;22250;15;521598;18;219458;22456;17883
60188;Cuise-la-Motte;1188;26678876;1187062;678;21686702;510;4992174;22457;17884
54550;Vathiménil;177;3974928;107830;104;3146598;73;828330;22457;17885
70503;Traitiéfontaine;80;1796624;49994;49;1485097;31;311527;22458;17886
44176;Saint-Malo-de-Guersac;1706;38313737;1124696;1059;30653871;647;7659866;22458;17887
19085;Gimel-les-Cascades;409;9185500;340818;240;7274354;169;1911146;22458;17888
39053;Bief-du-Fourg;88;1976394;72242;47;1560012;41;416382;22459;17889
39172;Courtefontaine;124;2784919;98293;76;2273992;48;510927;22459;17890
55007;Ambly-sur-Meuse;122;2740013;103723;68;2190705;54;549308;22459;17891
14022;Asnelles;402;9028823;450927;228;7070074;174;1958749;22460;17892
40111;Geloux;368;8265194;247098;212;6580197;156;1684997;22460;17893
71565;Vendenesse-sur-Arroux;299;6715544;196896;183;5449562;116;1265982;22460;17894
39252;Gevry;379;8512370;269276;241;7042827;138;1469543;22460;17895
03098;Désertines;2649;59496758;2652692;1536;47256268;1113;12240490;22460;17896
54534;Trondes;251;5637530;117672;131;4117380;120;1520150;22460;17897
17484;Port-des-Barques;1072;24077476;1143997;598;18807818;474;5269658;22460;17898
37216;Saint-Épain;832;18687105;781493;450;14483889;382;4203216;22460;17899
36188;Saint-Cyran-du-Jambot;99;2223667;117156;50;1693672;49;529995;22461;17900
80750;Tertry;96;2156292;110721;55;1780725;41;375567;22461;17901
50252;Hudimesnil;453;10175039;286600;239;7711399;214;2463640;22461;17902
07265;Saint-Marcel-lès-Annonay;706;15857869;461446;434;12634905;272;3222964;22462;17903
22209;Ploubalay;1686;37870642;1704846;935;29736557;751;8134085;22462;17904
25526;Sainte-Suzanne;883;19834586;996586;519;16016296;364;3818290;22463;17905
33191;Gours;261;5862814;227815;129;4532970;132;1329844;22463;17906
46272;Saint-Jean-Mirabel;129;2897719;114301;70;2226590;59;671129;22463;17907
57018;Amelécourt;73;1639806;35046;38;1276675;35;363131;22463;17908
66185;Saint-Michel-de-Llotes;194;4357892;247981;103;3457543;91;900349;22463;17909
57530;Ottonville;215;4829649;123324;133;3921814;82;907835;22463;17910
59084;Blaringhem;1017;22845386;612181;548;17221910;469;5623476;22464;17911
85302;La Verrie;2021;45398974;1065575;1171;34626270;850;10772704;22464;17912
61053;Bonsmoulins;127;2852914;91300;69;2182343;58;670571;22464;17913
57667;Téterchen;413;9277648;327783;243;7413081;170;1864567;22464;17914
56178;Pontivy;8038;180566817;9537183;4230;145165241;3808;35401576;22464;17915
63252;Neuville;205;4605358;190466;113;3520468;92;1084890;22465;17916
35346;Trimer;90;2021869;69802;48;1525123;42;496746;22465;17917
11166;Gourvieille;36;808766;19836;19;612612;17;196154;22466;17918
85236;Saint-Julien-des-Landes;813;18264711;558999;432;13818249;381;4446462;22466;17919
27564;Saint-Mards-de-Fresne;179;4021392;167938;101;3019381;78;1002011;22466;17920
72085;Cogners;108;2426389;73247;62;1897982;46;528407;22467;17921
38518;Valbonnais;295;6627914;262950;170;5190862;125;1437052;22468;17922
80314;Flers;90;2022154;46068;50;1536137;40;486017;22468;17923
39041;Baume-les-Messieurs;115;2583889;126969;66;2078993;49;504896;22469;17924
03126;Hauterive;681;15301310;627761;395;12149849;286;3151461;22469;17925
53011;Astillé;363;8156236;176906;206;6086790;157;2069446;22469;17926
79199;Paizay-le-Tort;248;5572475;194348;128;4222641;120;1349834;22470;17927
01111;Conand;66;1483022;50532;43;1246896;23;236126;22470;17928
43117;Lavaudieu;141;3168310;147448;71;2412501;70;755809;22470;17929
47036;Bourlens;198;4449131;281360;106;3559770;92;889361;22470;17930
04112;Manosque;13174;296024557;15691464;6799;229062475;6375;66962082;22470;17931
72353;Théligny;119;2674006;81636;76;2292031;43;381975;22471;17932
51095;Le Buisson;49;1101095;54264;28;905517;21;195578;22471;17933
73253;Saint-Marcel;399;8966156;421519;265;7498562;134;1467594;22472;17934
28109;Les Corvées-les-Yys;169;3797776;159384;107;3237546;62;560230;22472;17935
66095;Latour-de-Carol;208;4674261;169979;111;3550825;97;1123436;22472;17936
65080;Bénac;285;6404697;241580;170;5131549;115;1273148;22473;17937
33153;Doulezon;158;3550686;166179;77;2860002;81;690684;22473;17938
76449;Montreuil-en-Caux;255;5730564;183827;140;4469719;115;1260845;22473;17939
71327;Mussy-sous-Dun;183;4112642;112641;105;3093486;78;1019156;22473;17940
59655;Wemaers-Cappel;114;2562070;55084;67;2012489;47;549581;22474;17941
35337;Tinténiac;1768;39736226;1514135;963;31023321;805;8712905;22475;17942
80151;Buire-sur-l'Ancre;166;3730950;92893;99;2947506;67;783444;22476;17943
08023;Artaise-le-Vivier;33;741704;26233;16;518955;17;222749;22476;17944
38093;Châtenay;233;5236889;174100;132;4203279;101;1033610;22476;17945
64214;Espès-Undurein;282;6338246;262167;139;4837450;143;1500796;22476;17946
54217;Gélacourt;94;2112831;117922;45;1587932;49;524899;22477;17947
41243;Selommes;457;10271982;383002;247;7703932;210;2568050;22477;17948
62038;Ardres;2274;51113274;2816306;1054;39058914;1220;12054360;22477;17949
88144;Domèvre-sous-Montfort;36;809199;35373;23;670373;13;138826;22478;17950
81171;Montans;716;16094783;638450;373;12447187;343;3647596;22479;17951
32253;Miradoux;285;6406508;358148;113;4543841;172;1862667;22479;17952
05069;Lagrand;151;3394395;104946;90;2688750;61;705645;22479;17953
55459;Saint-Joire;133;2989813;231887;63;2287231;70;702582;22480;17954
67280;Maisonsgoutte;445;10003565;314147;255;7753549;190;2250016;22480;17955
66041;Cases-de-Pène;398;8947112;421299;208;7117076;190;1830036;22480;17956
72301;Saint-Mars-sous-Ballon;387;8699894;233010;204;6487690;183;2212204;22480;17957
89292;Percey;136;3057355;127701;82;2454052;54;603303;22481;17958
17209;Lonzac;128;2877530;106265;68;2212008;60;665522;22481;17959
16082;Charmant;194;4361350;213109;102;3431327;92;930023;22481;17960
59151;Colleret;901;20255663;893117;504;16212812;397;4042851;22481;17961
72064;La Chapelle-Huon;287;6452308;180861;167;4989808;120;1462500;22482;17962
24334;Pontours;116;2608001;133550;58;2064147;58;543854;22483;17963
32453;Tourrenquets;68;1528920;59009;30;1046567;38;482353;22484;17964
42231;Saint-Germain-Lespinasse;602;13535506;420783;333;10238109;269;3297397;22484;17965
62006;Achiet-le-Petit;183;4114971;181686;99;3163521;84;951450;22486;17966
26301;Saint-Donat-sur-l'Herbasse;2205;49582319;2080254;1212;39102579;993;10479740;22486;17967
63216;Mauzun;59;1326701;37920;32;969622;27;357079;22486;17968
04135;Moustiers-Sainte-Marie;410;9219480;424094;214;6999347;196;2220133;22487;17969
37122;Joué-lès-Tours;20368;458007725;21113620;11746;372363681;8622;85644044;22487;17970
39149;Chissey-sur-Loue;201;4519853;149358;112;3556578;89;963275;22487;17971
11018;Arzens;656;14751457;664294;340;11559169;316;3192288;22487;17972
62043;Les Attaques;999;22464698;828728;514;17134049;485;5330649;22487;17973
78362;Mantes-la-Ville;10550;237243289;10864360;6245;192236354;4305;45006935;22488;17974
62750;Saint-Hilaire-Cottes;414;9309961;366484;215;7356458;199;1953503;22488;17975
38167;Flachères;250;5622008;144031;152;4369347;98;1252661;22488;17976
32171;Labastide-Savès;80;1799083;75486;45;1414751;35;384332;22489;17977
2A271;Sarrola-Carcopino;1343;30202745;1327639;766;24288884;577;5913861;22489;17978
45097;Chuelles;701;15765115;727674;407;12606310;294;3158805;22489;17979
27362;Landepéreuse;194;4363076;201170;110;3580277;84;782799;22490;17980
55121;Combres-sous-les-Côtes;66;1484446;67199;39;1185925;27;298521;22492;17981
23208;Saint-Léger-le-Guérétois;247;5555448;214137;150;4596952;97;958496;22492;17982
55498;Souilly;192;4318486;167244;91;3176373;101;1142113;22492;17983
29105;Landivisiau;5109;114913728;4855889;2767;90139126;2342;24774602;22492;17984
60687;Villers-sur-Auchy;184;4138652;154715;113;3439134;71;699518;22493;17985
72054;Champagné;1886;42421189;1327977;1251;35473818;635;6947371;22493;17986
39189;Damparis;1478;33244603;1181342;860;26613994;618;6630609;22493;17987
84023;Buoux;67;1507036;69417;35;1157181;32;349855;22493;17988
10237;Mesnil-Saint-Loup;294;6613025;178799;150;4775349;144;1837676;22493;17989
69203;Saint-Genis-l'Argentière;529;11899154;334888;309;9443367;220;2455787;22494;17990
79319;Souvigné;457;10279699;303998;256;8054732;201;2224967;22494;17991
41078;Épuisay;384;8637779;288876;224;6881904;160;1755875;22494;17992
71558;Varennes-Saint-Sauveur;599;13474698;535326;317;10440236;282;3034462;22495;17993
30300;Saint-Théodorit;233;5241448;219985;122;3985692;111;1255756;22495;17994
41271;Vernou-en-Sologne;338;7603498;283505;166;5570216;172;2033282;22496;17995
21475;Pagny-le-Château;249;5601504;146673;144;4312618;105;1288886;22496;17996
70042;Autrey-le-Vay;48;1079809;48276;29;882663;19;197146;22496;17997
26198;Montélimar;21649;487016959;26430264;11253;383894371;10396;103122588;22496;17998
80167;Canchy;179;4026871;141390;92;3041166;87;985705;22496;17999
54462;Rosières-aux-Salines;1695;38131576;1933894;895;31872166;800;6259410;22497;18000
88302;Le Ménil;636;14308077;534158;359;11103094;277;3204983;22497;18001
24018;Auriac-du-Périgord;227;5106825;231600;114;3819439;113;1287386;22497;18002
33098;Cardan;245;5511938;180131;138;4184414;107;1327524;22498;18003
24256;Marsac-sur-l'Isle;1605;36109101;1363134;952;29406324;653;6702777;22498;18004
54438;Pulney;32;719946;19656;15;507228;17;212718;22498;18005
79070;La Chapelle-Bâton;201;4522315;113136;99;3199840;102;1322475;22499;18006
09254;Saint-Amadou;138;3104918;125326;74;2350420;64;754498;22499;18007
16360;Salles-de-Barbezieux;233;5242473;209781;130;4089778;103;1152695;22500;18008
44216;Vieillevigne;2021;45472827;1405586;1114;34579755;907;10893072;22500;18009
80420;Harponville;90;2025018;65709;48;1599787;42;425231;22500;18010
88196;Gérardmer;5136;115562174;5491975;2742;91691656;2394;23870518;22500;18011
01155;Évosges;75;1687581;58474;39;1254850;36;432731;22501;18012
25202;Dompierre-les-Tilleuls;118;2655155;66355;60;2010792;58;644363;22501;18013
80017;Allaines;234;5265412;288019;117;4018122;117;1247290;22502;18014
71039;Blanot;92;2070179;82817;50;1646232;42;423947;22502;18015
60577;Saint-Germer-de-Fly;971;21849920;813916;567;17379090;404;4470830;22502;18016
57178;Diffembach-lès-Hellimer;190;4275564;129002;104;3174549;86;1101015;22503;18017
04244;Volonne;973;21895389;918201;514;16821818;459;5073571;22503;18018
58294;Toury-sur-Jour;71;1597711;65173;35;1216297;36;381414;22503;18019
80375;Gauville;209;4703397;217874;112;3727727;97;975670;22504;18020
33467;Saint-Quentin-de-Caplong;144;3240709;98140;82;2458151;62;782558;22505;18021
70185;Cresancey;101;2273030;63471;57;1827335;44;445695;22505;18022
27070;Boisemont;383;8619600;383932;230;6935198;153;1684402;22505;18023
46222;Pomarède;95;2138036;88313;54;1737557;41;400479;22506;18024
02515;Montigny-lès-Condé;36;810204;45571;21;661616;15;148588;22506;18025
57283;Hagondange;5436;122343807;4182112;2695;84745187;2741;37598620;22506;18026
76006;Amfreville-les-Champs;72;1620489;5489;42;1188729;30;431760;22507;18027
17429;Soubise;966;21741615;653320;557;17432911;409;4308704;22507;18028
50562;Saint-Vaast-la-Hougue;1223;27526591;1231364;549;20611635;674;6914956;22507;18029
02208;Concevreux;138;3106035;51529;77;2331313;61;774722;22508;18030
35305;Saint-Péran;197;4434060;122948;123;3647524;74;786536;22508;18031
02743;Le Thuel;85;1913193;64406;40;1302206;45;610987;22508;18032
17097;Le Chay;398;8958800;427007;206;6980927;192;1977873;22510;18033
07150;Mariac;371;8351044;373395;226;6767001;145;1584043;22510;18034
31517;Saint-Sulpice-sur-Lèze;1091;24558086;991545;568;18862181;523;5695905;22510;18035
80435;Hesbécourt;35;787845;41276;13;567513;22;220332;22510;18036
88281;Madonne-et-Lamerey;218;4907586;261300;119;3910258;99;997328;22512;18037
48017;Banassac;518;11661209;528082;285;9292213;233;2368996;22512;18038
70524;Vauchoux;65;1463291;42227;28;1093653;37;369638;22512;18039
25001;Abbans-Dessous;120;2701510;78753;69;2058378;51;643132;22513;18040
30111;Foissac;198;4457554;186338;97;3413037;101;1044517;22513;18041
11432;Villeneuve-lès-Montréal;129;2904178;94041;76;2386946;53;517232;22513;18042
30192;Orthoux-Sérignac-Quilhan;234;5268235;216856;125;4181590;109;1086645;22514;18043
30196;Le Pin;225;5065611;175532;126;4125200;99;940411;22514;18044
05103;Le Poët;417;9388465;341614;212;6796732;205;2591733;22514;18045
88484;Uzemain;582;13103364;493711;314;10243961;268;2859403;22514;18046
07084;Eclassan;481;10829473;295821;263;8223682;218;2605791;22514;18047
14379;Longvillers;179;4030278;146956;103;3153572;76;876706;22516;18048
64505;Sarpourenx;135;3039596;86653;74;2328252;61;711344;22516;18049
24142;Coux-et-Bigaroque;535;12045815;489265;275;9201956;260;2843859;22516;18050
11051;Brézilhac;78;1756226;60751;37;1218322;41;537904;22516;18051
16011;Anais;318;7160128;253966;190;5686160;128;1473968;22516;18052
34128;Laroque;873;19656805;877619;443;14862322;430;4794483;22516;18053
02768;Vauxaillon;239;5381423;139800;131;4053206;108;1328217;22516;18054
71143;Condal;236;5313899;179567;120;3961952;116;1351947;22517;18055
02291;Estrées;218;4908624;226118;111;3806369;107;1102255;22517;18056
64010;Aïcirits-Camou-Suhast;358;8061023;251738;198;6251531;160;1809492;22517;18057
25605;Vernierfontaine;224;5043769;64405;120;3681624;104;1362145;22517;18058
12119;Laguiole;755;17000251;853624;406;13391001;349;3609250;22517;18059
37007;Assay;97;2184140;128206;49;1645455;48;538685;22517;18060
54337;Malavillers;73;1643786;66581;26;1047221;47;596565;22518;18061
54533;Trieux;1180;26571086;572430;493;15997457;687;10573629;22518;18062
65428;Sireix;39;878197;39993;24;740061;15;138136;22518;18063
72128;Évaillé;179;4030808;195947;93;3060645;86;970163;22518;18064
57329;Holling;223;5021641;98457;115;3612577;108;1409064;22519;18065
72084;Clermont-Créans;641;14434416;457301;352;11146903;289;3287513;22519;18066
05174;Val-des-Prés;327;7364351;243175;196;5940535;131;1423816;22521;18067
56054;Erdeven;2087;47002670;1815556;1148;37115931;939;9886739;22522;18068
80494;Louvrechy;94;2117062;66360;53;1695622;41;421440;22522;18069
54207;Fraisnes-en-Saintois;55;1238709;45608;30;905546;25;333163;22522;18070
21317;Is-sur-Tille;2304;51891624;2066863;1258;41183302;1046;10708322;22522;18071
18137;Mareuil-sur-Arnon;348;7837830;387247;186;6088209;162;1749621;22523;18072
80303;Favières;254;5720822;201906;128;4352224;126;1368598;22523;18073
41218;Saint-Julien-sur-Cher;412;9279577;354439;241;7415055;171;1864522;22523;18074
80794;Villecourt;38;855888;30610;24;671820;14;184068;22523;18075
17295;Réaux;274;6171493;307251;152;4894088;122;1277405;22524;18076
35270;Saint-Georges-de-Gréhaigne;203;4572340;192640;113;3499482;90;1072858;22524;18077
10128;Donnement;52;1171249;79462;27;930482;25;240767;22524;18078
38228;Merlas;265;5968871;187908;153;4682490;112;1286381;22524;18079
55386;Nonsard-Lamarche;103;2319990;62940;58;1814739;45;505251;22524;18080
64308;Lalonquette;137;3085860;89387;70;2318501;67;767359;22525;18081
52519;Vesvres-sous-Chalancey;28;630703;13645;15;458902;13;171801;22525;18082
46069;Cézac;100;2252517;109361;51;1706324;49;546193;22525;18083
54386;Moriviller;56;1261427;45182;28;927578;28;333849;22525;18084
16226;Montignac-Charente;434;9776157;431053;231;7583361;203;2192796;22526;18085
07314;Silhac;215;4843035;149554;100;3321782;115;1521253;22526;18086
52126;Choilley-Dardenay;94;2117421;88670;56;1713177;38;404244;22526;18087
72021;Avoise;308;6937959;346059;179;5537913;129;1400046;22526;18088
35260;Saint-Christophe-des-Bois;286;6442462;191998;160;4893497;126;1548965;22526;18089
31087;Bragayrac;136;3063607;110359;75;2376680;61;686927;22527;18090
45143;Feins-en-Gâtinais;26;585691;20991;14;438630;12;147061;22527;18091
83051;Entrecasteaux;638;14372256;529418;271;10642092;367;3730164;22527;18092
83046;Cotignac;1461;32912610;2102154;677;25525410;784;7387200;22527;18093
02403;Landifay-et-Bertaignemont;155;3491765;172868;77;2679364;78;812401;22528;18094
94022;Choisy-le-Roi;23519;529848857;29411631;13716;440958176;9803;88890681;22529;18095
51022;Aulnay-l'Aître;84;1892554;78534;52;1588944;32;303610;22530;18096
34185;Notre-Dame-de-Londres;285;6421343;298722;156;5263035;129;1158308;22531;18097
69275;Décines-Charpieu;14399;324439643;14187639;8480;262569525;5919;61870118;22532;18098
16077;Champmillon;289;6511805;246984;177;5441031;112;1070774;22532;18099
46130;Grézels;120;2703922;117618;51;1918068;69;785854;22533;18100
73030;Barby;1849;41663165;1912576;1114;34229728;735;7433437;22533;18101
71442;Saint-Léger-sur-Dheune;869;19581976;871714;470;15234722;399;4347254;22534;18102
29220;Pont-l'Abbé;5100;114924410;4870111;2610;88713608;2490;26210802;22534;18103
62797;Siracourt;130;2929504;75438;69;2209595;61;719909;22535;18104
64135;Bonnut;372;8382915;271311;208;6542585;164;1840330;22535;18105
27417;Morgny;306;6895642;216892;172;5398171;134;1497471;22535;18106
19204;Saint-Fréjoux;166;3740791;209407;87;2748041;79;992750;22535;18107
01391;Salavre;172;3876121;130765;103;3089334;69;786787;22536;18108
02041;Autreville;450;10141017;363850;264;8090240;186;2050777;22536;18109
84016;Bédarrides;2910;65579209;3034312;1666;52631941;1244;12947268;22536;18110
88295;Mazirot;131;2952197;113029;78;2360410;53;591787;22536;18111
83128;Sillans-la-Cascade;365;8225663;379535;173;6220673;192;2004990;22536;18112
45281;Saint-Hilaire-les-Andrésis;534;12034379;472918;310;9520335;224;2514044;22536;18113
85211;Sainte-Flaive-des-Loups;1138;25646467;808674;644;20083507;494;5562960;22536;18114
21340;Lanthes;116;2614262;129809;56;1872998;60;741264;22537;18115
86237;Saint-Pierre-d'Exideuil;418;9420511;411795;238;7586361;180;1834150;22537;18116
05156;Saint-Sauveur;249;5611783;293635;135;4543648;114;1068135;22537;18117
10410;Villadin;68;1532538;58577;42;1279127;26;253411;22537;18118
21035;Auvillars-sur-Saône;164;3696142;111486;92;2929522;72;766620;22537;18119
89225;Lichères-sur-Yonne;37;833887;43104;21;667179;16;166708;22537;18120
32223;Magnas;39;878966;19128;19;665647;20;213319;22538;18121
49315;Saint-Quentin-lès-Beaurepaire;148;3335736;94058;79;2544460;69;791276;22539;18122
16024;Aussac-Vadalle;286;6446102;264367;168;5185169;118;1260933;22539;18123
80515;Marlers;79;1780595;67537;46;1412988;33;367607;22539;18124
50046;Bérigny;216;4868625;137284;136;4051584;80;817041;22540;18125
12096;Espalion;2711;61106820;3229517;1398;47553608;1313;13553212;22540;18126
76218;Doudeauville;50;1127041;45596;31;940748;19;186293;22541;18127
16208;Mareuil;229;5161956;252616;127;4126727;102;1035229;22541;18128
84039;Courthézon;3140;70780539;3415575;1647;55530816;1493;15249723;22542;18129
47161;Massels;63;1420156;64539;27;1080708;36;339448;22542;18130
19277;Valiergues;90;2028833;45944;48;1608274;42;420559;22543;18131
38344;Roussillon;4399;99165952;4341414;2436;77231726;1963;21934226;22543;18132
88048;Bellefontaine;506;11407186;425152;250;8532564;256;2874622;22544;18133
24171;Eyzerac;331;7462078;341240;187;5854677;144;1607401;22544;18134
02419;Leschelle;158;3562014;180956;78;2701275;80;860739;22544;18135
67147;Froeschwiller;286;6447765;235048;173;5269177;113;1178588;22545;18136
02592;Parpeville;129;2908267;152364;62;2242947;67;665320;22545;18137
14387;Magny-le-Freule;163;3674851;103545;95;2919093;68;755758;22545;18138
62835;Valhuon;292;6583295;224499;150;4945843;142;1637452;22546;18139
07188;Quintenas;799;18014438;543180;472;14016035;327;3998403;22546;18140
64154;Bussunarits-Sarrasquette;78;1758612;67246;46;1407320;32;351292;22546;18141
62909;Ytres;222;5005432;342692;102;3772652;120;1232780;22547;18142
03001;Abrest;1618;36481304;1666526;926;29542401;692;6938903;22547;18143
77482;Varennes-sur-Seine;1810;40810497;1597003;1077;32494495;733;8316002;22547;18144
25633;Vuillafans;388;8748472;326942;228;7022723;160;1725749;22548;18145
76613;Saint-Martin-aux-Buneaux;359;8094773;321964;195;6223623;164;1871150;22548;18146
53082;Courbeveille;283;6381129;107915;169;4816581;114;1564548;22548;18147
85012;La Barre-de-Monts;1413;31860924;1290576;727;24315990;686;7544934;22548;18148
82018;Bioule;561;12650333;530712;287;9719800;274;2930533;22550;18149
65324;Moulédous;103;2322622;72677;57;1831979;46;490643;22550;18150
21371;Les Maillys;437;9854309;353955;219;7310051;218;2544258;22550;18151
29158;Penmarch;3524;79466535;3684308;1810;61296118;1714;18170417;22550;18152
80179;Caulières;118;2661022;115337;61;2150317;57;510705;22551;18153
26241;Le Poët-Célard;67;1510942;35770;37;1148033;30;362909;22551;18154
57310;Hellering-lès-Fénétrange;96;2164947;63770;57;1676922;39;488025;22552;18155
71066;Burgy;59;1330549;45795;35;1062504;24;268045;22552;18156
62841;Vendin-lès-Béthune;1318;29724102;1358458;739;23583497;579;6140605;22552;18157
80444;Huchenneville;346;7803145;273631;194;6223553;152;1579592;22552;18158
10062;Briel-sur-Barse;115;2593569;96389;65;1951650;50;641919;22553;18159
72105;Courgenard;256;5773528;155349;154;4617767;102;1155761;22553;18160
62004;Achicourt;4348;98062531;4259507;2458;78542417;1890;19520114;22553;18161
52244;Humbécourt;396;8931266;198488;224;6807086;172;2124180;22554;18162
64127;Bielle;240;5412895;192557;127;4101984;113;1310911;22554;18163
77057;Bussières;244;5503157;262190;142;4534017;102;969140;22554;18164
81291;Taïx;212;4781566;127190;119;3699893;93;1081673;22555;18165
57098;Bourgaltroff;128;2886990;136886;63;2134461;65;752529;22555;18166
62580;Monchy-Breton;212;4781595;162270;114;3703584;98;1078011;22555;18167
38020;Auris;113;2548690;99508;71;2139317;42;409373;22555;18168
85256;Saint-Michel-le-Cloucq;677;15269588;469466;397;12188322;280;3081266;22555;18169
21282;Forléans;57;1285623;42319;38;1127627;19;157996;22555;18170
30178;Montfaucon;755;17029733;523082;404;12882687;351;4147046;22556;18171
50014;Anneville-sur-Mer;146;3293179;190274;70;2624146;76;669033;22556;18172
59450;Ors;354;7984893;274914;181;6258310;173;1726583;22556;18173
08397;Saint-Remy-le-Petit;31;699247;35047;17;534299;14;164948;22556;18174
55153;Dieppe-sous-Douaumont;100;2255665;63920;53;1709630;47;546035;22557;18175
54389;Mouaville;50;1127854;36568;28;882379;22;245475;22557;18176
88154;Domrémy-la-Pucelle;70;1579062;90975;36;1236765;34;342297;22558;18177
33532;Tizac-de-Lapouyade;275;6203563;228449;149;4749859;126;1453704;22558;18178
39007;Alièze;80;1804692;67290;39;1259803;41;544889;22559;18179
57275;Guessling-Hémering;473;10670366;309162;288;8477824;185;2192542;22559;18180
45222;Nargis;805;18160271;722734;463;14574337;342;3585934;22559;18181
34218;Prades-sur-Vernazobre;157;3541823;180061;73;2580610;84;961213;22559;18182
54159;Dombasle-sur-Meurthe;5276;119027237;4280358;3065;95081250;2211;23945987;22560;18183
64458;Préchacq-Josbaig;148;3338910;129690;77;2479167;71;859743;22560;18184
37101;Épeigné-sur-Dême;95;2143234;120711;49;1635041;46;508193;22560;18185
61304;Neuilly-le-Bisson;129;2910501;69212;69;2137292;60;773209;22562;18186
39576;Vincelles;213;4805753;161112;130;3892254;83;913499;22562;18187
19057;Collonges-la-Rouge;276;6227194;267948;141;4884817;135;1342377;22562;18188
24288;Montazeau;183;4128954;182988;104;3311931;79;817023;22563;18189
76424;Ménonval;94;2120907;56955;58;1810700;36;310207;22563;18190
76156;Canouville;149;3361868;101780;77;2618021;72;743847;22563;18191
89460;Villeneuve-la-Guyard;1722;38853490;1309227;1011;30713609;711;8139881;22563;18192
50403;Pirou;926;20893809;1207389;479;16031867;447;4861942;22564;18193
35221;Pléchâtel;1356;30596656;937128;745;23700687;611;6895969;22564;18194
55315;Mandres-en-Barrois;74;1669786;88776;39;1302372;35;367414;22565;18195
34113;Gigean;2991;67492114;2135187;1640;52614082;1351;14878032;22565;18196
72124;Écommoy;2524;56954458;2291565;1369;43961523;1155;12992935;22565;18197
64369;Maspie-Lalonquère-Juillacq;144;3249450;188197;69;2515741;75;733709;22566;18198
57010;Alaincourt-la-Côte;71;1602171;64731;41;1251415;30;350756;22566;18199
34048;Campagne;152;3430007;121537;89;2736849;63;693158;22566;18200
71281;Marly-sur-Arroux;179;4039334;124026;90;2847781;89;1191553;22566;18201
02070;Bernot;235;5303051;195975;121;4086914;114;1216137;22566;18202
76015;Angiens;318;7176132;331989;162;5579270;156;1596862;22566;18203
89262;Molosmes;107;2414695;86253;62;1984705;45;429990;22567;18204
49156;Grugé-l'Hôpital;139;3136867;114643;72;2405631;67;731236;22567;18205
17076;Celles;181;4084832;120242;96;3147462;85;937370;22568;18206
40186;Misson;403;9095683;356461;207;6996474;196;2099209;22570;18207
08472;Viel-Saint-Remy;137;3092087;91354;70;2329486;67;762601;22570;18208
14350;La Lande-sur-Drôme;35;789984;20476;16;595146;19;194838;22571;18209
73032;La Bâthie;1256;28349880;1216392;752;22703235;504;5646645;22572;18210
59078;Beugnies;308;6952168;272962;158;5278346;150;1673822;22572;18211
24252;Marcillac-Saint-Quentin;439;9909108;343371;267;8004784;172;1904324;22572;18212
62460;Hubersent;136;3069846;117622;76;2457084;60;612762;22572;18213
59630;Wahagnies;1406;31737229;1306772;805;25429535;601;6307694;22573;18214
49364;Vaudelnay;598;13498562;346367;329;10194159;269;3304403;22573;18215
37249;Sonzay;690;15575458;455400;417;12475655;273;3099803;22573;18216
19188;Saint-Bonnet-l'Enfantier;186;4198605;195046;102;3248733;84;949872;22573;18217
29087;Le Juch;389;8781508;220594;216;6780619;173;2000889;22575;18218
54181;Errouville;384;8668695;83920;112;3566581;272;5102114;22575;18219
56261;La Vraie-Croix;688;15531586;509968;366;11811658;322;3719928;22575;18220
52146;Coupray;96;2167401;88941;47;1549355;49;618046;22577;18221
71079;Champagnat;257;5802369;191553;156;4553574;101;1248795;22577;18222
46230;Puyjourdes;43;970828;39981;19;674204;24;296624;22577;18223
61367;Saint-Aubin-de-Courteraie;80;1806195;82385;39;1388935;41;417260;22577;18224
27571;Saint-Martin-Saint-Firmin;145;3273788;100592;90;2709532;55;564256;22578;18225
02662;Rozet-Saint-Albin;160;3612491;140085;92;2760999;68;851492;22578;18226
57468;Mittelbronn;376;8489468;317610;229;6783565;147;1705903;22578;18227
31167;Encausse-les-Thermes;362;8173643;365665;210;6709859;152;1463784;22579;18228
72298;Saint-Mars-de-Locquenay;283;6389902;187243;162;5127779;121;1262123;22579;18229
38427;Saint-Michel-de-Saint-Geoirs;167;3770733;144723;97;2848317;70;922416;22579;18230
16055;Bouëx;504;11380037;505283;283;9050837;221;2329200;22579;18231
45147;Fleury-les-Aubrais;11468;258945915;11375674;6846;212706554;4622;46239361;22580;18232
27138;Chamblac;224;5057942;243468;126;4026208;98;1031734;22580;18233
66027;La Cabanasse;355;8015952;275477;211;6330014;144;1685938;22580;18234
57175;Diane-Capelle;123;2777363;64561;80;2223242;43;554121;22580;18235
45018;Auxy;518;11696677;422745;268;8863706;250;2832971;22580;18236
33156;Escoussans;164;3703197;205801;79;2766793;85;936404;22580;18237
65439;Tarasteix;138;3116109;96357;69;2450854;69;665255;22581;18238
22140;La Malhoure;251;5667974;140264;156;4596224;95;1071750;22582;18239
47134;Lannes;247;5577677;365366;114;4301772;133;1275905;22582;18240
27425;Nassandres;780;17614090;737233;419;13497973;361;4116117;22582;18241
47286;Sauméjan;49;1106530;67975;19;839695;30;266835;22582;18242
60538;Ricquebourg;129;2913301;105623;79;2367490;50;545811;22584;18243
81315;Vielmur-sur-Agout;760;17164236;640697;406;13192159;354;3972077;22585;18244
05046;Embrun;3998;90293711;4887480;2108;70109617;1890;20184094;22585;18245
39401;Oussières;127;2868288;69311;69;2226343;58;641945;22585;18246
64043;Argelos;130;2936123;75476;77;2279410;53;656713;22586;18247
62844;Verchocq;321;7249973;276992;151;5266944;170;1983029;22586;18248
14251;Esson;246;5556263;200904;147;4400117;99;1156146;22586;18249
14075;Bissières;96;2168301;87008;54;1716398;42;451903;22586;18250
34343;Viols-le-Fort;635;14342447;610172;328;11298627;307;3043820;22587;18251
22098;Landéhen;666;15042783;387505;389;11641230;277;3401553;22587;18252
35294;Sainte-Marie;1193;26946342;997529;676;21060746;517;5885596;22587;18253
26165;Livron-sur-Drôme;4922;111173663;3982289;2711;86143816;2211;25029847;22587;18254
55211;Gincrey;33;745393;34429;12;430203;21;315190;22588;18255
59070;Bermeries;206;4653073;161576;114;3651242;92;1001831;22588;18256
30273;Saint-Julien-de-Peyrolas;711;16059935;683136;382;12875767;329;3184168;22588;18257
54152;Damelevières;1657;37428524;1229323;949;29265645;708;8162879;22588;18258
38125;Cordéac;114;2575142;141744;52;1925734;62;649408;22589;18259
59043;Bailleul;8279;187017191;8042719;4788;150609351;3491;36407840;22589;18260
80395;Guerbigny;159;3591824;257513;82;2831929;77;759895;22590;18261
61087;Champeaux-sur-Sarthe;92;2078338;73881;43;1476266;49;602072;22591;18262
57319;Herny;250;5647729;199456;137;4269171;113;1378558;22591;18263
61315;Omméel;72;1626633;54466;34;1188491;38;438142;22592;18264
71388;Saint-Aubin-en-Charollais;238;5377086;101744;119;4007576;119;1369510;22593;18265
70522;Varogne;73;1649292;54392;39;1235844;34;413448;22593;18266
32276;Montadet;52;1174852;42605;26;903408;26;271444;22593;18267
67003;Albé;267;6032491;204751;168;4999191;99;1033300;22594;18268
30308;Sanilhac-Sagriès;484;10935320;523988;266;8766580;218;2168740;22594;18269
81196;Noailhac;458;10348391;362210;227;7530413;231;2817978;22595;18270
57300;Haselbourg;178;4021900;144597;103;3074328;75;947572;22595;18271
02473;Mayot;98;2214381;70371;57;1745313;41;469068;22596;18272
40099;Fargues;168;3796187;106521;93;3019988;75;776199;22596;18273
36114;Mauvières;188;4248199;160667;104;3355281;84;892918;22597;18274
57583;Richeval;77;1739974;58834;43;1352254;34;387720;22597;18275
21348;Licey-sur-Vingeanne;54;1220246;53293;24;865245;30;355001;22597;18276
71161;Curdin;169;3818924;101709;109;3130889;60;688035;22597;18277
70126;Chancey;92;2078962;62712;50;1661280;42;417682;22597;18278
28015;Auneau;2312;52245710;2130299;1433;42648496;879;9597214;22598;18279
19195;Saint-Cyprien;208;4700355;135822;134;3919900;74;780455;22598;18280
01216;Lhuis;483;10914798;420956;259;8467209;224;2447589;22598;18281
24020;La Bachellerie;496;11208776;458920;260;8706657;236;2502119;22598;18282
31133;Cazeaux-de-Larboust;54;1220318;70033;34;1052849;20;167469;22598;18283
33308;Omet;146;3299393;114406;87;2631447;59;667946;22599;18284
11383;Souilhe;159;3593332;132176;91;2772544;68;820788;22600;18285
42283;Saint-Romain-en-Jarez;592;13379149;354329;340;10435801;252;2943348;22600;18286
32248;Mauroux;65;1469010;67675;35;1168708;30;300302;22600;18287
32442;Terraube;201;4542662;360091;92;3441122;109;1101540;22600;18288
52070;Brennes;77;1740227;82467;47;1433872;30;306355;22600;18289
09268;Saint-Lizier;920;20792380;1153965;477;16860439;443;3931941;22600;18290
18285;Villeneuve-sur-Cher;253;5718061;280177;158;4760816;95;957245;22601;18291
38387;Saint-Geoirs;276;6237926;171580;168;4916114;108;1321812;22601;18292
28421;Voise;151;3412810;127202;94;2759864;57;652946;22601;18293
51415;Omey;142;3209507;141464;92;2685928;50;523579;22602;18294
14572;Saint-Denis-de-Méré;438;9899866;326874;275;7910136;163;1989730;22602;18295
54026;Athienville;91;2056845;66575;47;1578515;44;478330;22603;18296
87167;Saint-Martin-Terressus;292;6600183;213830;159;5165045;133;1435138;22603;18297
86228;Saint-Laurent-de-Jourdes;99;2237752;87695;50;1733900;49;503852;22604;18298
38065;Châbons;996;22514341;610222;558;17356276;438;5158065;22605;18299
2A276;Serra-di-Ferro;276;6238947;435836;131;4975525;145;1263422;22605;18300
38089;Chassignieu;116;2622192;95206;65;2089378;51;532814;22605;18301
61458;Saint-Victor-de-Réno;127;2870975;114258;71;2234847;56;636128;22606;18302
64173;Casteide-Doat;66;1492035;51289;34;1235522;32;256513;22607;18303
24484;Saint-Pierre-de-Chignac;461;10422418;320934;240;7903523;221;2518895;22608;18304
72070;Chassillé;136;3074746;84116;85;2431158;51;643588;22608;18305
43155;Prades;43;972168;55884;26;785822;17;186346;22609;18306
76162;Le Catelier;117;2645239;65027;66;2084866;51;560373;22609;18307
01444;Villebois;641;14492728;582792;367;11315941;274;3176787;22610;18308
05040;Chorges;1553;35112664;1327879;869;27516813;684;7595851;22610;18309
41004;Artins;162;3662912;175154;88;2800295;74;862617;22611;18310
41236;Sasnières;54;1220973;45197;31;983928;23;237045;22611;18311
04079;L'Escale;762;17229338;682902;446;13700404;316;3528934;22611;18312
56015;Berric;800;18088630;413030;459;14307947;341;3780683;22611;18313
01379;Saint-Maurice-de-Rémens;374;8456554;249892;246;6884465;128;1572089;22611;18314
28166;Friaize;129;2916985;128508;76;2316417;53;600568;22612;18315
59087;Boëseghem;359;8117902;245395;203;6210117;156;1907785;22613;18316
49089;Chazé-sur-Argos;498;11261095;286818;254;8475361;244;2785734;22613;18317
17258;Neuillac;158;3572828;169735;83;2797346;75;775482;22613;18318
10083;Chappes;182;4115580;168056;111;3369050;71;746530;22613;18319
80195;Chuignolles;91;2057809;97026;45;1557925;46;499884;22613;18320
35135;Irodouër;1031;23314743;602573;604;18344480;427;4970263;22614;18321
82048;Dieupentale;746;16870172;512259;409;12874697;337;3995475;22614;18322
57001;Aboncourt;171;3867066;100063;81;2797053;90;1070013;22614;18323
40103;Gaillères;288;6513183;192127;171;5208795;117;1304388;22615;18324
12217;Sainte-Croix;385;8707078;373410;194;6714079;191;1992999;22616;18325
61154;Eperrais;55;1243874;29332;28;896322;27;347552;22616;18326
70258;Froideconche;1101;24901471;845773;635;19701585;466;5199886;22617;18327
24096;Champagnac-de-Belair;402;9092415;363139;226;7297738;176;1794677;22618;18328
03250;Saint-Pierre-Laval;200;4523606;75817;89;3335845;111;1187761;22618;18329
14422;Le Mesnil-Mauger;549;12417354;474153;277;9267615;272;3149739;22618;18330
60155;Cires-lès-Mello;1978;44738891;1983692;1174;37489495;804;7249396;22618;18331
15233;Teissières-de-Cornet;137;3098715;129758;88;2650275;49;448440;22618;18332
54057;Beaumont;32;723789;16619;18;530489;14;193300;22618;18333
93050;Neuilly-sur-Marne;18614;421024496;21086019;11271;351152670;7343;69871826;22619;18334
61330;Planches;106;2397595;90900;62;1905618;44;491977;22619;18335
08041;Baâlons;114;2578604;94544;55;1939941;59;638663;22619;18336
45021;Barville-en-Gâtinais;170;3845375;125788;103;3021176;67;824199;22620;18337
60320;Ivors;141;3189452;172231;79;2540114;62;649338;22620;18338
64380;Méracq;130;2940674;112045;68;2341110;62;599564;22621;18339
16352;Saint-Simon;132;2985944;185193;67;2339388;65;646556;22621;18340
62809;Ternas;73;1651390;98551;39;1287920;34;363470;22622;18341
44222;La Roche-Blanche;566;12803932;275322;348;10212484;218;2591448;22622;18342
64033;Araux;62;1402561;27013;34;1089297;28;313264;22622;18343
62200;Cambrin;527;11921972;554599;275;9154008;252;2767964;22622;18344
52427;Robert-Magny;136;3076758;89730;64;2196057;72;880701;22623;18345
41235;Sargé-sur-Braye;571;12917867;443226;338;10077556;233;2840311;22623;18346
65388;Saint-Lary-Soulan;485;10972386;688864;285;8783337;200;2189049;22623;18347
45177;Laas;117;2646964;51791;76;2017354;41;629610;22624;18348
87203;Vicq-sur-Breuilh;711;16085709;657427;370;12506873;341;3578836;22624;18349
73289;La Table;223;5045178;172423;131;3957628;92;1087550;22624;18350
40019;Aureilhan;592;13393763;486116;372;10894396;220;2499367;22625;18351
61282;Monnai;122;2760213;105371;64;2060230;58;699983;22625;18352
05060;Furmeyer;81;1832625;56970;46;1349032;35;483593;22625;18353
08047;Barbaise;62;1402752;62445;34;1109206;28;293546;22625;18354
08159;Euilly-et-Lombut;63;1425396;39104;31;977604;32;447792;22625;18355
21235;Duesme;32;724046;24451;18;515330;14;208716;22626;18356
39395;Orbagna;110;2488961;78543;64;2042760;46;446201;22627;18357
33091;Cantenac;739;16721533;581653;464;13710263;275;3011270;22627;18358
49126;Drain;1082;24483517;710013;597;18741338;485;5742179;22628;18359
01304;Pont-d'Ain;1461;33060995;1358666;828;26202939;633;6858056;22629;18360
72359;Torcé-en-Vallée;642;14527914;427527;355;11135037;287;3392877;22629;18361
30003;Aigues-Mortes;5197;117603899;6308079;2802;93812461;2395;23791438;22629;18362
13103;Salon-de-Provence;25173;569650548;29937591;13747;459999965;11426;109650583;22629;18363
70415;Polaincourt-et-Clairefontaine;378;8554799;396320;192;6639817;186;1914982;22632;18364
50355;Montviron;189;4277477;111413;114;3438350;75;839127;22632;18365
63387;Saint-Priest-Bramefant;450;10184533;349996;266;8083014;184;2101519;22632;18366
48030;Brenoux;197;4458578;127458;128;3751506;69;707072;22632;18367
27113;Brétigny;88;1991658;83596;51;1614643;37;377015;22632;18368
84082;Mormoiron;1016;22994645;1053889;501;17412288;515;5582357;22633;18369
46080;Crayssac;397;8985252;286677;233;7192433;164;1792819;22633;18370
36143;Nohant-Vic;281;6359912;278084;146;4475252;135;1884660;22633;18371
42126;Luriecq;580;13127419;396130;326;10157908;254;2969511;22633;18372
67372;Pfaffenhoffen;1440;32592586;1240704;826;25687495;614;6905091;22634;18373
27551;Saint-Jean-de-la-Léqueraye;29;656403;14932;17;488800;12;167603;22635;18374
66021;Bompas;4026;91130398;4644249;2119;71539796;1907;19590602;22635;18375
64053;Arrien;79;1788210;62638;43;1388517;36;399693;22636;18376
31303;Longages;1428;32323619;1147540;790;25692057;638;6631562;22636;18377
55467;Sampigny;394;8918651;336046;217;7044120;177;1874531;22636;18378
33183;Gauriaguet;561;12698926;348173;320;9848083;241;2850843;22636;18379
31474;Saint-Christaud;138;3123817;149088;73;2445696;65;678121;22636;18380
2B188;Olmeta-di-Tuda;242;5478117;305091;114;4330666;128;1147451;22637;18381
84106;Sainte-Cécile-les-Vignes;1306;29564808;1516626;686;23391187;620;6173621;22638;18382
59562;Sémeries;282;6383889;219214;156;5023823;126;1360066;22638;18383
08271;Manre;56;1267785;50334;29;913763;27;354022;22639;18384
51170;Corfélix;57;1290435;57417;29;873537;28;416898;22639;18385
22218;Plougrescant;811;18360781;1042377;393;13884708;418;4476073;22640;18386
16312;Saint-Cybardeaux;455;10301122;590935;213;7878738;242;2422384;22640;18387
42129;Maclas;969;21938024;837394;565;17452517;404;4485507;22640;18388
33424;Saint-Laurent-Médoc;2393;54177338;2126753;1327;42203896;1066;11973442;22640;18389
66181;Sainte-Léocadie;67;1516875;70078;36;1198226;31;318649;22640;18390
57006;Achen;517;11704895;325680;292;8971123;225;2733772;22640;18391
35265;Saint-Domineuc;1214;27485917;749430;685;21402136;529;6083781;22641;18392
01279;Oncieu;52;1177334;39795;36;967375;16;209959;22641;18393
64537;Trois-Villes;82;1856566;93979;52;1496085;30;360481;22641;18394
62176;Bréxent-Énocq;353;7992293;295969;196;6120059;157;1872234;22641;18395
08267;Mairy;120;2716947;90469;60;2035644;60;681303;22641;18396
66186;Saint-Nazaire;1373;31086533;1348617;749;24319373;624;6767160;22641;18397
54436;Preutin-Higny;75;1698102;59510;38;1168426;37;529676;22641;18398
60160;Conchy-les-Pots;330;7471677;326901;183;5897777;147;1573900;22641;18399
02617;Pouilly-sur-Serre;253;5728328;246232;138;4394213;115;1334115;22642;18400
59348;Lieu-Saint-Amand;673;15237843;527022;389;12149462;284;3088381;22642;18401
16123;Échallat;261;5909496;189803;144;4595855;117;1313641;22642;18402
62598;Muncq-Nieurlet;330;7471877;230752;162;5444032;168;2027845;22642;18403
31280;Latrape;189;4279380;221138;98;3459532;91;819848;22642;18404
88368;Ramecourt;87;1969897;64357;49;1507350;38;462547;22642;18405
77325;Mouy-sur-Seine;233;5275737;287475;128;4193014;105;1082723;22643;18406
89434;Vaumort;181;4098329;121538;116;3224962;65;873367;22643;18407
32429;Sempesserre;166;3758732;183365;90;3115199;76;643533;22643;18408
66171;Saint-Cyprien;7095;160652996;9431040;3740;128054327;3355;32598669;22643;18409
01348;Saint-Didier-sur-Chalaronne;1446;32741985;1192348;815;25800120;631;6941865;22643;18410
88306;Le Mont;34;769885;73617;18;592520;16;177365;22644;18411
52182;Éclaron-Braucourt-Sainte-Livière;1081;24478345;834365;621;19125213;460;5353132;22644;18412
77258;Lognes;7349;166412447;7828402;4462;137958851;2887;28453596;22644;18413
54489;Saint-Supplet;80;1811565;47828;32;1179238;48;632327;22645;18414
16233;Mosnac;244;5525279;192612;137;4223505;107;1301774;22645;18415
97206;Le Diamant;3391;76788566;3793340;1294;55799072;2097;20989494;22645;18416
27208;Duranville;96;2173907;106750;48;1668416;48;505491;22645;18417
62776;Sapignies;99;2241863;61132;54;1709756;45;532107;22645;18418
56055;Étel;1347;30503930;1564506;706;23863461;641;6640469;22646;18419
50062;Boisyvon;52;1177594;18781;23;848995;29;328599;22646;18420
88177;La Forge;329;7450571;227231;169;5410356;160;2040215;22646;18421
35347;Val-d'Izé;1245;28194872;791759;665;20962099;580;7232773;22646;18422
70032;Attricourt;24;543529;32926;13;418545;11;124984;22647;18423
64480;Saint-Gladie-Arrive-Munein;102;2310025;65449;48;1542728;54;767297;22647;18424
57457;Menskirch;80;1811842;56955;42;1288326;38;523516;22648;18425
33149;Daubèze;86;1947760;80846;47;1529547;39;418213;22648;18426
66050;Claira;2127;48173164;2262467;1181;38774817;946;9398347;22648;18427
22194;Plestin-les-Grèves;2226;50415872;2177981;1155;38728416;1071;11687456;22649;18428
57242;Gandrange;1453;32908511;726462;711;22179629;742;10728882;22649;18429
29195;Plouguerneau;3690;83573677;3017702;1979;64254323;1711;19319354;22649;18430
56001;Allaire;1910;43259178;1576470;1021;33306029;889;9953149;22649;18431
62182;Buire-au-Bois;120;2717868;102321;58;2056362;62;661506;22649;18432
71421;Saint-Germain-en-Brionnais;98;2219642;65780;56;1715449;42;504193;22649;18433
19066;Cublac;935;21177524;871596;517;16423027;418;4754497;22650;18434
02400;Laffaux;81;1834673;57599;48;1431349;33;403324;22650;18435
02026;Artonges;102;2310368;89207;54;1794519;48;515849;22651;18436
02466;Marizy-Sainte-Geneviève;72;1630872;62131;38;1225738;34;405134;22651;18437
2B235;Pioggiola;47;1064603;135046;21;874433;26;190170;22651;18438
52507;Vauxbons;32;724843;31803;16;547225;16;177618;22651;18439
07270;Saint-Martin-sur-Lavezon;241;5459103;159939;133;4119459;108;1339644;22652;18440
40011;Arsague;192;4349177;166917;102;3298966;90;1050211;22652;18441
70233;Les Fessey;78;1766869;57480;39;1468067;39;298802;22652;18442
62507;Liencourt;138;3126009;79842;82;2427661;56;698348;22652;18443
70286;Hugier;71;1608319;44310;38;1197812;33;410507;22652;18444
26219;Mureils;199;4507827;148968;109;3411656;90;1096171;22652;18445
85168;Oulmes;404;9151636;252454;224;6941521;180;2210115;22653;18446
60365;Lihus;208;4711770;155370;124;3776422;84;935348;22653;18447
57578;Rezonville;189;4281387;169005;113;3490380;76;791007;22653;18448
41202;Saint-Avit;56;1268561;57488;32;992319;24;276242;22653;18449
37078;Ciran;202;4575901;120236;112;3433536;90;1142365;22653;18450
30197;Les Plans;112;2537163;103994;57;1899444;55;637719;22653;18451
38022;Les Avenières;2981;67530608;2844875;1675;53276731;1306;14253877;22654;18452
56013;Belz;2197;49772303;2065712;1213;38938113;984;10834190;22655;18453
55195;Fouchères-aux-Bois;81;1835034;75440;43;1350426;38;484608;22655;18454
80645;Puchevillers;280;6343340;214966;161;5098182;119;1245158;22655;18455
50461;Saint-Cyr;106;2401417;77030;66;2034138;40;367279;22655;18456
44111;Notre-Dame-des-Landes;1017;23041164;608462;622;18687512;395;4353652;22656;18457
33298;Moulon;518;11736002;522894;274;9148449;244;2587553;22656;18458
14346;Juaye-Mondaye;367;8315288;313694;210;6747621;157;1567667;22657;18459
53165;Niafles;167;3783893;78109;105;3117240;62;666653;22658;18460
68201;Masevaux;1935;43844100;1915751;1101;34777221;834;9066879;22658;18461
24435;Saint-Laurent-des-Bâtons;127;2877677;169113;57;2276530;70;601147;22659;18462
22222;Plouha;2931;66414222;3083579;1525;50672800;1406;15741422;22659;18463
47050;Cassignas;66;1495531;52214;37;1131180;29;364351;22660;18464
85216;Sainte-Gemme-la-Plaine;1033;23407807;837793;589;18327201;444;5080606;22660;18465
62791;Séricourt;29;657164;4320;16;513733;13;143431;22661;18466
45340;Villemurlin;344;7795358;354390;185;6030250;159;1765108;22661;18467
02581;Paars;137;3104555;77403;77;2247305;60;857250;22661;18468
01383;Saint-Paul-de-Varax;756;17131977;559958;428;13294303;328;3837674;22661;18469
67543;Wisches;1154;26151508;970394;672;20389915;482;5761593;22662;18470
71337;Oyé;158;3580590;99187;82;2723153;76;857437;22662;18471
55466;Salmagne;168;3807284;134850;95;2976081;73;831203;22662;18472
70239;Fondremand;109;2470243;107405;51;1806224;58;664019;22663;18473
28366;Santeuil;164;3716730;95210;107;3003016;57;713714;22663;18474
65001;Adast;149;3376817;132792;99;2841916;50;534901;22663;18475
67071;Bust;234;5303280;160939;116;3618040;118;1685240;22664;18476
41233;Sambin;484;10969259;324673;283;8593477;201;2375782;22664;18477
22177;Pléguien;636;14414334;447925;373;11377470;263;3036864;22664;18478
38567;Chamrousse;291;6595345;331088;182;5431378;109;1163967;22664;18479
60532;Ressons-l'Abbaye;55;1246550;53013;34;1012501;21;234049;22665;18480
85244;Saint-Martin-de-Fraigneau;415;9405800;301661;245;7493896;170;1911904;22665;18481
21272;Flée;96;2175818;95182;48;1608877;48;566941;22665;18482
71219;Gigny-sur-Saône;290;6572866;221464;188;5489196;102;1083670;22665;18483
76124;Bosc-Hyons;215;4873010;144277;127;3892319;88;980691;22665;18484
17452;La Tremblade;3120;70715542;4197976;1570;54941938;1550;15773604;22665;18485
41256;Theillay;797;18064407;826085;448;14156952;349;3907455;22666;18486
64099;Bastanès;54;1223941;40397;30;915969;24;307972;22666;18487
08074;Bouconville;32;725307;29751;14;440211;18;285096;22666;18488
63030;Bas-et-Lezat;139;3150616;97568;75;2385083;64;765533;22666;18489
60153;Choqueuse-les-Bénards;54;1223981;36192;32;958909;22;265072;22666;18490
95541;Saint-Clair-sur-Epte;498;11287948;471935;263;8552802;235;2735146;22667;18491
01108;Coligny;677;15345383;794533;351;11883694;326;3461689;22667;18492
10214;Magnicourt;50;1133345;83235;29;979171;21;154174;22667;18493
37011;Avoine;1012;22938952;866502;588;18384237;424;4554715;22667;18494
2A128;Granace;40;906681;57368;22;721019;18;185662;22667;18495
81248;Saint-Gauzens;428;9701783;354290;233;7732441;195;1969342;22668;18496
60340;Lagny;260;5893615;220104;150;4678538;110;1215077;22668;18497
08400;Sapogne-et-Feuchères;276;6256327;229215;172;5059258;104;1197069;22668;18498
62865;Vitry-en-Artois;2512;56941773;2731565;1336;44648421;1176;12293352;22668;18499
24508;Saint-Victor;113;2561492;81429;66;2082943;47;478549;22668;18500
30036;Bernis;1784;40440106;1654971;993;31954820;791;8485286;22668;18501
33307;Noaillan;810;18361600;610011;423;14045757;387;4315843;22669;18502
25602;Vergranne;56;1269472;31700;30;981968;26;287504;22669;18503
29287;Tréflez;484;10971873;367017;247;8089726;237;2882147;22669;18504
88335;Offroicourt;77;1745560;58838;45;1317888;32;427672;22670;18505
02002;Achery;295;6688028;243673;160;5125208;135;1562820;22671;18506
89133;Cudot;187;4239559;182887;104;3311375;83;928184;22671;18507
38293;Panissage;232;5259843;162031;137;4153903;95;1105940;22672;18508
66005;Angoustrine-Villeneuve-des-Escaldes;302;6846916;213750;197;5588058;105;1258858;22672;18509
34112;Garrigues;88;1995133;84384;42;1469976;46;525157;22672;18510
31207;Galié;53;1201622;55890;32;1093207;21;108415;22672;18511
07051;Champagne;305;6915118;225405;176;5551730;129;1363388;22673;18512
56042;Colpo;1107;25098571;738796;609;19147119;498;5951452;22673;18513
58075;Chitry-les-Mines;140;3174174;132211;83;2553971;57;620203;22673;18514
80513;Maricourt;101;2289960;80829;59;1811762;42;478198;22673;18515
62749;Saint-Georges;177;4013166;216272;91;3034106;86;979060;22673;18516
76757;Yvecrique;334;7572933;245338;195;5945384;139;1627549;22673;18517
76297;Gancourt-Saint-Étienne;120;2720830;108104;74;2198564;46;522266;22674;18518
21533;Rouvres-sous-Meilly;58;1315083;57513;39;1117047;19;198036;22674;18519
05036;Châteauroux-les-Alpes;629;14261934;562684;350;11197678;279;3064256;22674;18520
34005;Agonès;129;2924977;109578;63;2228125;66;696852;22674;18521
22127;Lézardrieux;968;21949010;917814;496;16803161;472;5145849;22675;18522
72241;Montfort-le-Gesnois;1624;36824476;1124138;970;29154396;654;7670080;22675;18523
80058;Bayonvillers;182;4126960;152946;99;3187556;83;939404;22676;18524
64471;Saint-Boès;200;4535163;156446;110;3577359;90;957804;22676;18525
46284;Saint-Michel-Loubéjou;198;4489847;201594;112;3593051;86;896796;22676;18526
64342;Licq-Athérey;118;2675798;112453;67;2172440;51;503358;22676;18527
79210;Le Pin;545;12358583;389997;296;9559910;249;2798673;22676;18528
69039;Chamelet;363;8231647;271087;203;6313945;160;1917702;22677;18529
70294;Lantenot;186;4217921;141582;98;3288271;88;929650;22677;18530
80497;Machy;74;1678197;85401;45;1423993;29;254204;22678;18531
76171;La Chapelle-Saint-Ouen;55;1247328;23996;30;924057;25;323271;22679;18532
67105;Drulingen;780;17689386;815644;382;13132870;398;4556516;22679;18533
52391;Planrupt;149;3379240;83706;90;2757252;59;621988;22679;18534
32165;Juilles;130;2948353;116463;71;2337824;59;610529;22680;18535
85011;Barbâtre;1119;25378742;1104383;636;19695019;483;5683723;22680;18536
30261;Saint-Hippolyte-de-Caton;116;2630886;87236;59;1891697;57;739189;22680;18537
41244;Semerville;57;1292782;40048;34;975851;23;316931;22680;18538
79144;Juscorps;180;4082489;106371;105;3218862;75;863627;22680;18539
44134;Pouillé-les-Côteaux;462;10478799;223227;293;8455621;169;2023178;22681;18540
29120;Lanvéoc;987;22386878;750033;581;17260979;406;5125899;22682;18541
88271;Lignéville;176;3992021;140225;107;3411922;69;580099;22682;18542
54187;Euvezin;60;1360931;67215;37;1134070;23;226861;22682;18543
57606;Saint-Avold;9320;211409036;12259643;4844;166306501;4476;45102535;22683;18544
83140;Tourves;2751;62402781;3022542;1434;48594784;1317;13807997;22684;18545
76490;Ourville-en-Caux;578;13111351;911085;288;9999288;290;3112063;22684;18546
53172;Origné;185;4196638;84868;108;3280835;77;915803;22685;18547
76427;Mesnières-en-Bray;440;9981503;322204;251;7765001;189;2216502;22685;18548
64469;Saint-Abit;151;3425498;92460;84;2542152;67;883346;22685;18549
32020;Aux-Aussat;128;2903744;99280;59;2197419;69;706325;22686;18550
17339;Saint-Germain-de-Lusignan;708;16061508;656588;381;12760151;327;3301357;22686;18551
35273;Saint-Germain-en-Coglès;1041;23616499;686655;578;18340663;463;5275836;22686;18552
28282;Nonvilliers-Grandhoux;239;5422122;136656;144;4232950;95;1189172;22687;18553
82157;Saint-Beauzeil;61;1383917;67133;24;1035741;37;348176;22687;18554
30076;Cavillargues;460;10436129;466967;247;8225074;213;2211055;22687;18555
56120;Locqueltas;828;18785631;517764;494;15074128;334;3711503;22688;18556
54566;Vilcey-sur-Trey;62;1406659;49335;33;1000498;29;406161;22688;18557
64263;L'Hôpital-d'Orion;79;1792358;63690;43;1471211;36;321147;22688;18558
84012;Beaumes-de-Venise;1380;31309734;1595264;694;24489234;686;6820500;22688;18559
67185;Hattmatt;363;8235847;233545;215;6509660;148;1726187;22688;18560
80400;Guillaucourt;206;4673933;174485;106;3550000;100;1123933;22689;18561
16095;Chenon;81;1837825;52788;44;1353453;37;484372;22689;18562
86111;Ingrandes;999;22666978;917072;608;18456686;391;4210292;22690;18563
53005;Andouillé;1127;25571354;788052;615;19617807;512;5953547;22690;18564
80018;Allenay;141;3199282;106505;95;2715385;46;483897;22690;18565
59589;Thiant;1437;32605471;1737288;752;25759845;685;6845626;22690;18566
62189;Bus;62;1406779;50518;30;999081;32;407698;22690;18567
65020;Arcizac-ez-Angles;139;3153909;91115;84;2566128;55;587781;22690;18568
57255;Gosselming;318;7215488;216462;197;5709050;121;1506438;22690;18569
02545;La Neuville-Bosmont;85;1928738;83579;41;1461997;44;466741;22691;18570
80070;Beauquesne;688;15611472;655856;367;12236743;321;3374729;22691;18571
55387;Nouillonpont;125;2836466;81909;60;1928478;65;907988;22692;18572
01012;Aranc;189;4288912;186522;118;3493329;71;795583;22693;18573
16290;Rouzède;142;3222455;193792;66;2479150;76;743305;22693;18574
45305;Seichebrières;93;2110492;83403;47;1500815;46;609677;22693;18575
10074;Chamoy;273;6195363;264553;156;4905610;117;1289753;22694;18576
76461;Neufbosc;191;4334602;85126;109;3390711;82;943891;22694;18577
67229;Jetterswiller;107;2428322;79765;58;1806234;49;622088;22695;18578
58298;Tronsanges;215;4879354;164142;138;4042732;77;836622;22695;18579
79337;Le Vanneau-Irleau;474;10757555;427647;280;8564876;194;2192679;22695;18580
64208;Escoubès;174;3949109;95201;84;2976852;90;972257;22696;18581
38360;Saint-Appolinard;206;4675393;155511;116;3671227;90;1004166;22696;18582
80110;Boismont;275;6241429;347150;149;4883699;126;1357730;22696;18583
32056;Blanquefort;24;544707;4794;12;424147;12;120560;22696;18584
85238;Saint-Laurent-sur-Sèvre;1900;43122933;1541184;987;34150675;913;8972258;22696;18585
57463;Metz;67100;1522960910;95545268;34640;1202350729;32460;320610181;22697;18586
88312;Morelmaison;102;2315163;67260;61;1790794;41;524369;22698;18587
74225;Rumilly;7815;177383940;6475725;4705;141981114;3110;35402826;22698;18588
24476;Saint-Pantaly-d'Excideuil;97;2201728;84140;55;1830066;42;371662;22698;18589
33471;Saint-Sauveur;688;15616563;578289;403;12437019;285;3179544;22698;18590
48025;Les Bessons;224;5084481;227078;127;4191504;97;892977;22699;18591
63257;Olby;379;8602847;264029;217;6755262;162;1847585;22699;18592
39477;Saint-Baraing;131;2973589;77967;92;2508458;39;465131;22699;18593
59479;Quarouble;1688;38317683;1432866;934;29902134;754;8415549;22700;18594
39075;Bréry;116;2633419;136623;63;2087001;53;546418;22702;18595
73013;Albiez-Montrond;235;5334967;258872;134;4455984;101;878983;22702;18596
52001;Ageville;162;3677792;103720;103;3018209;59;659583;22702;18597
11211;Magrie;292;6629155;369339;162;5380902;130;1248253;22703;18598
62112;Berles-au-Bois;294;6674815;261739;158;5449442;136;1225373;22703;18599
71500;Sarry;75;1702791;84023;39;1241288;36;461503;22704;18600
39559;La Vieille-Loye;225;5108397;184752;136;4040469;89;1067928;22704;18601
24523;Saussignac;222;5040380;235311;106;3773120;116;1267260;22704;18602
59279;Halluin;10553;239603848;9574877;5837;189499181;4716;50104667;22705;18603
11405;Ventenac-en-Minervois;272;6175757;343072;135;4747648;137;1428109;22705;18604
33206;Isle-Saint-Georges;291;6607196;280590;152;5028075;139;1579121;22705;18605
39473;Saffloz;50;1135324;53977;24;840166;26;295158;22706;18606
30211;Redessan;1966;44641661;1583147;1039;33938094;927;10703567;22707;18607
58068;Chaumard;148;3360670;166884;86;2839182;62;521488;22707;18608
10101;Coclois;99;2248039;151357;49;1680305;50;567734;22707;18609
54402;Norroy-le-Sec;192;4359886;156300;74;2677239;118;1682647;22708;18610
14153;La Chapelle-Haute-Grue;34;772068;28577;15;550436;19;221632;22708;18611
60599;Saint-Thibault;157;3565174;235055;80;2873130;77;692044;22708;18612
84054;L'Isle-sur-la-Sorgue;11831;268661045;14033982;6178;213185911;5653;55475134;22708;18613
34280;Saint-Nazaire-de-Pézan;345;7834504;380146;188;6137289;157;1697215;22709;18614
02118;Braye;62;1407949;54951;38;1157683;24;250266;22709;18615
50451;Saint-Brice;70;1589683;38847;41;1253940;29;335743;22710;18616
09309;Teilhet;79;1794083;65164;38;1344525;41;449558;22710;18617
67061;Bouxwiller;2083;47305117;1852522;1138;36979974;945;10325143;22710;18618
60564;Sains-Morainvillers;145;3292989;136762;79;2541593;66;751396;22710;18619
17412;Saint-Vaize;294;6676902;248273;159;5192358;135;1484544;22711;18620
46216;Payrignac;390;8857262;365374;203;6882651;187;1974611;22711;18621
80215;Coulonvillers;118;2679986;104465;46;1905130;72;774856;22712;18622
83028;Callas;1026;23302659;1168749;552;18661058;474;4641601;22712;18623
02004;Agnicourt-et-Séchelles;105;2384794;132976;42;1686295;63;698499;22712;18624
51583;Trois-Fontaines-l'Abbaye;125;2839054;124540;77;2298031;48;541023;22712;18625
88354;Pont-sur-Madon;79;1794289;69447;46;1475327;33;318962;22713;18626
27035;Bailleul-la-Vallée;71;1612591;74130;43;1346773;28;265818;22713;18627
71027;Beaurepaire-en-Bresse;309;7018438;229249;192;5668467;117;1349971;22713;18628
61411;Saint-Jouin-de-Blavou;151;3429748;116114;83;2669773;68;759975;22714;18629
64052;Arricau-Bordes;54;1226536;84443;27;969085;27;257451;22714;18630
69187;Saint-Clément-les-Places;320;7268450;279295;183;5809638;137;1458812;22714;18631
14207;Croisilles;288;6541674;202447;163;5019473;125;1522201;22714;18632
70431;Quenoche;130;2952902;161370;79;2391156;51;561746;22715;18633
53026;Beaulieu-sur-Oudon;222;5042670;82816;129;3907217;93;1135453;22715;18634
57091;Bliesbruck;554;12584324;454717;313;9838684;241;2745640;22715;18635
21158;Chaume-et-Courchamp;82;1862669;59025;41;1348062;41;514607;22715;18636
35133;Iffendic;2132;48429682;1294500;1200;37145148;932;11284534;22716;18637
64273;Irissarry;407;9245392;422763;198;7165614;209;2079778;22716;18638
61365;Saint-Aubin-d'Appenai;212;4815820;119442;112;3574480;100;1241340;22716;18639
02292;Étampes-sur-Marne;671;15242741;588161;412;12347787;259;2894954;22716;18640
30059;Le Cailar;1378;31303342;1566698;735;24634688;643;6668654;22717;18641
07169;Ozon;197;4475236;100786;116;3482718;81;992518;22717;18642
17093;Le Château-d'Oléron;2591;58859700;3344870;1382;46234319;1209;12625381;22717;18643
27371;Livet-sur-Authou;97;2203579;75153;56;1743671;41;459908;22717;18644
85046;La Chaize-le-Vicomte;1754;39846272;1196236;1025;31410918;729;8435354;22717;18645
07034;Bidon;120;2726118;109573;63;2064230;57;661888;22718;18646
64191;Coarraze;1120;25443834;1057429;571;19856779;549;5587055;22718;18647
26148;Hauterives;924;20991212;715163;495;16140250;429;4850962;22718;18648
25079;Boujailles;211;4793472;126003;102;3474880;109;1318592;22718;18649
35094;Dingé;830;18855923;631438;458;14883372;372;3972551;22718;18650
23033;La Brionne;218;4952575;192576;129;3997689;89;954886;22718;18651
59326;Killem;483;10972955;375658;261;8550162;222;2422793;22718;18652
85099;Le Girouard;471;10700436;359030;281;8522971;190;2177465;22719;18653
89067;Cézy;631;14336026;541070;374;11292851;257;3043175;22720;18654
72051;Cérans-Foulletourte;1577;35829056;922358;946;28527987;631;7301069;22720;18655
85052;La Chapelle-Achard;907;20607735;482247;542;16205947;365;4401788;22721;18656
57724;Vitry-sur-Orne;1621;36830918;1544056;737;25651123;884;11179795;22721;18657
33542;Vérac;446;10133940;368874;243;7883700;203;2250240;22722;18658
51298;Igny-Comblizy;232;5271519;279880;136;4295852;96;975667;22722;18659
57555;Prévocourt;56;1272503;56142;30;970118;26;302385;22723;18660
62757;Saint-Martin-au-Laërt;2169;49286786;2412666;1091;38309620;1078;10977166;22723;18661
64420;Ogenne-Camptort;115;2613185;84651;60;1972773;55;640412;22723;18662
60232;Ferrières;254;5771789;233586;138;4441014;116;1330775;22724;18663
40034;Bélus;310;7044320;238172;161;5419839;149;1624481;22724;18664
12225;Saint-Georges-de-Luzençon;825;18747050;616027;473;14719607;352;4027443;22724;18665
60124;Candor;144;3272242;137989;85;2663424;59;608818;22724;18666
62423;Helfaut;890;20224768;969057;472;15582405;418;4642363;22724;18667
38055;Brangues;316;7181225;288529;164;5378095;152;1803130;22725;18668
63400;Saint-Sylvestre-Pragoulin;601;13658001;405200;348;10780822;253;2877179;22725;18669
12066;Clairvaux-d'Aveyron;630;14317429;516148;322;11118967;308;3198462;22726;18670
81215;Puybegon;327;7431504;199748;174;5705404;153;1726100;22726;18671
31556;Les Tourreilles;213;4840918;221837;117;3866638;96;974280;22727;18672
46075;Corn;113;2568219;116014;62;2041538;51;526681;22728;18673
01095;Chavannes-sur-Suran;350;7954805;255985;206;6225960;144;1728845;22728;18674
60242;Fontaine-Lavaganne;220;5000240;86296;134;3969187;86;1031053;22728;18675
36202;Saint-Maur;1775;40344162;1849889;982;33476350;793;6867812;22729;18676
41196;Ruan-sur-Egvonne;47;1068269;56693;23;877107;24;191162;22729;18677
72327;Sarcé;157;3568485;153434;83;2648820;74;919665;22729;18678
67537;Wingen;248;5636912;166987;152;4509268;96;1127644;22729;18679
19236;Saint-Priest-de-Gimel;283;6432458;331715;167;5203272;116;1229186;22730;18680
37032;Bournan;145;3295784;171621;79;2613809;66;681975;22730;18681
71436;Saint-Laurent-d'Andenay;546;12410658;411231;337;9897407;209;2513251;22730;18682
32065;Le Brouilh-Monbert;126;2864063;162795;66;2302998;60;561065;22731;18683
40288;Sarbazan;604;13729425;424548;354;10660823;250;3068602;22731;18684
34148;Maraussan;2170;49326118;2029459;1118;37514605;1052;11811513;22731;18685
11238;Molleville;54;1227480;48135;29;973840;25;253640;22731;18686
77512;Villeneuve-sur-Bellot;614;13957022;590103;343;11056472;271;2900550;22731;18687
01026;Bâgé-le-Châtel;467;10615621;481992;254;8452492;213;2163129;22732;18688
72026;Beaufay;728;16548670;489131;400;12680270;328;3868400;22732;18689
80566;Fieffes-Montrelet;186;4228226;195219;112;3518277;74;709949;22732;18690
25025;Arc-sous-Cicon;339;7706317;260964;184;5869397;155;1836920;22732;18691
73139;Jarsy;146;3319044;127621;91;2671137;55;647907;22733;18692
62022;Alincthun;162;3682811;91422;83;2702835;79;979976;22733;18693
10234;Mesgrigny;136;3091747;74653;83;2488223;53;603524;22733;18694
40297;Le Sen;109;2477949;124057;57;1985331;52;492618;22733;18695
70358;Montcey;130;2955379;99890;75;2303991;55;651388;22734;18696
63033;Beaumont-lès-Randan;140;3182788;91527;81;2510770;59;672018;22734;18697
26033;La Baume-de-Transit;446;10139555;490518;239;7995720;207;2143835;22734;18698
22150;Le Merzer;484;11004046;382440;281;8708654;203;2295392;22736;18699
07312;Sécheras;248;5638454;147348;139;4311379;109;1327075;22736;18700
80163;Cambron;393;8935179;306289;229;7050824;164;1884355;22736;18701
72108;Cré;388;8821656;287374;216;6723289;172;2098367;22736;18702
50602;Tourlaville;9110;207128561;8691971;5323;167278773;3787;39849788;22736;18703
88118;Coussey;384;8730821;385341;211;6827031;173;1903790;22737;18704
64254;Hagetaubin;275;6252735;176158;148;4777082;127;1475653;22737;18705
35183;Mondevert;388;8822373;179564;232;6875971;156;1946402;22738;18706
14239;Englesqueville-la-Percée;48;1091438;75366;23;868964;25;222474;22738;18707
53158;Montjean;496;11278505;235696;293;8759494;203;2519011;22739;18708
57277;Guinkirchen;86;1955548;63177;51;1637966;35;317582;22739;18709
45017;Auvilliers-en-Gâtinais;212;4820844;220901;120;3925008;92;895836;22740;18710
89339;Sainte-Colombe;110;2501394;131240;60;1969698;50;531696;22740;18711
15219;Salers;220;5002923;353605;110;3854851;110;1148072;22741;18712
61242;Le Mage;131;2979081;102071;81;2421484;50;557597;22741;18713
62297;Éperlecques;1663;37819146;1648469;821;28460757;842;9358389;22742;18714
03220;Saint-Bonnet-de-Rochefort;342;7777613;319159;182;6044447;160;1733166;22742;18715
08001;Acy-Romance;242;5503469;220017;138;4610417;104;893052;22742;18716
71103;Charmoy;144;3274800;124767;76;2526149;68;748651;22742;18717
25474;Le Puy;44;1000647;25355;31;867441;13;133206;22742;18718
60098;Bouvresse;94;2137768;72902;56;1769339;38;368429;22742;18719
39474;Sainte-Agnès;173;3934413;116072;94;3112917;79;821496;22742;18720
02733;Suzy;167;3797963;130276;104;3147479;63;650484;22742;18721
74060;La Chapelle-Saint-Maurice;73;1660232;53909;42;1322588;31;337644;22743;18722
34181;Neffiès;541;12303952;567890;239;9122326;302;3181626;22743;18723
33128;Civrac-en-Médoc;339;7709947;329401;169;5900135;170;1809812;22743;18724
33107;Castillon-de-Castets;149;3388764;120283;69;2544864;80;843900;22743;18725
69014;Aveize;515;11712877;320708;293;9006879;222;2705998;22743;18726
88183;Frebécourt;173;3934671;161675;97;3132746;76;801925;22744;18727
71164;Curtil-sous-Burnand;73;1660306;60361;41;1311033;32;349273;22744;18728
39223;La Ferté;106;2410913;100901;65;2023816;41;387097;22744;18729
26070;Chamaret;316;7187554;365652;168;5706018;148;1481536;22745;18730
22109;Lanloup;148;3366350;152715;81;2628233;67;738117;22746;18731
02152;Cerseuil;45;1023556;30298;29;891102;16;132454;22746;18732
33172;Fours;170;3866805;173611;93;3131843;77;734962;22746;18733
68196;Magny;146;3320931;146264;78;2543974;68;776957;22746;18734
22381;Trézény;179;4071567;113170;111;3377089;68;694478;22746;18735
22162;Paimpol;4819;109618299;6325566;2355;84793224;2464;24825075;22747;18736
28271;Morvilliers;79;1797033;43401;47;1367686;32;429347;22747;18737
62331;Feuchy;550;12511036;441909;318;10001951;232;2509085;22747;18738
76390;Les Loges;600;13648770;489008;349;10829250;251;2819520;22748;18739
03124;Gouise;125;2843508;122734;61;2068575;64;774933;22748;18740
84043;Entraigues-sur-la-Sorgue;4681;106485094;4353695;2665;84806753;2016;21678341;22748;18741
62312;Estrée;147;3344096;137346;84;2639146;63;704950;22749;18742
62468;Humières;134;3048412;153730;67;2364549;67;683863;22749;18743
82020;Bouillac;295;6711288;259280;155;5218252;140;1493036;22750;18744
61431;Saint-Michel-des-Andaines;209;4754848;144261;106;3747355;103;1007493;22750;18745
57592;Romelfing;198;4504597;150107;110;3418371;88;1086226;22750;18746
27573;Saint-Nicolas-d'Attez;82;1865549;77132;57;1596933;25;268616;22751;18747
89276;Neuvy-Sautour;582;13240880;580423;341;10527708;241;2713172;22751;18748
39412;Peseux;164;3731139;146559;112;3171995;52;559144;22751;18749
21652;Vandenesse-en-Auxois;161;3662965;205410;90;2860360;71;802605;22751;18750
85196;Saint-André-Goule-d'Oie;877;19953060;503714;556;15895451;321;4057609;22751;18751
30125;Garons;2395;54490416;2081461;1288;42456187;1107;12034229;22752;18752
67340;Oberbronn;851;19361759;747785;483;15469692;368;3892067;22752;18753
62798;Sombrin;125;2843983;129401;65;2124431;60;719552;22752;18754
55165;Doulcon;243;5528764;185676;127;4115955;116;1412809;22752;18755
42189;Roche-la-Molière;5540;126047870;4804379;3215;100456760;2325;25591110;22752;18756
59242;Fontaine-au-Bois;354;8054370;357665;197;6391709;157;1662661;22752;18757
40264;Saint-Jean-de-Marsacq;726;16518402;639625;406;12960224;320;3558178;22753;18758
55320;Marchéville-en-Woëvre;33;750884;21755;21;606763;12;144121;22754;18759
37027;Bléré;3034;69036405;3430052;1647;53889855;1387;15146550;22754;18760
11285;Peyriac-de-Mer;644;14653964;811727;312;11520318;332;3133646;22755;18761
64556;Vielleségure;197;4482716;166995;107;3384271;90;1098445;22755;18762
82053;Escazeaux;139;3162951;119388;67;2348900;72;814051;22755;18763
80554;Molliens-Dreuil;458;10421872;435588;258;8283081;200;2138791;22755;18764
02228;Courtemont-Varennes;161;3663667;135235;94;2894877;67;768790;22756;18765
57581;Richeling;179;4073337;116733;96;3017537;83;1055800;22756;18766
16419;Vouharte;197;4483016;216674;103;3486109;94;996907;22756;18767
24415;Saint-Géraud-de-Corps;99;2252919;94555;47;1692135;52;560784;22757;18768
67088;Dehlingen;197;4483089;133018;105;3355784;92;1127305;22757;18769
62792;Serques;586;13335566;397331;328;10292492;258;3043074;22757;18770
18289;Vornay;291;6622658;232853;174;5307599;117;1315059;22758;18771
01034;Belley;5177;117819887;5976203;2704;92090498;2473;25729389;22758;18772
79240;Sainte-Blandine;347;7897351;211270;211;6362999;136;1534352;22759;18773
60626;Talmontiers;377;8580188;325011;232;7071713;145;1508475;22759;18774
66044;Castelnou;203;4620120;245657;97;3569458;106;1050662;22759;18775
33100;Cars;639;14543953;664214;327;11192618;312;3351335;22760;18776
76582;Saint-Germain-d'Étables;154;3505216;125961;94;2866667;60;638549;22761;18777
44181;Saint-Même-le-Tenu;598;13611471;290780;339;10496521;259;3114950;22762;18778
58044;La Celle-sur-Loire;496;11289912;447884;261;8816178;235;2473734;22762;18779
36140;Neuvy-Pailloux;702;15978947;679673;418;12661224;284;3317723;22762;18780
04192;Saint-Michel-l'Observatoire;683;15546919;768912;361;12363538;322;3183381;22763;18781
66045;Catllar;436;9924541;464842;243;8059774;193;1864767;22763;18782
27487;Radepont;375;8536141;337098;230;6925477;145;1610664;22763;18783
49311;Saint-Philbert-du-Peuple;620;14113106;414883;350;11138248;270;2974858;22763;18784
08286;Ménil-Annelles;59;1343049;32662;31;1071274;28;271775;22764;18785
64244;Geüs-d'Oloron;117;2663358;117147;66;2180743;51;482615;22764;18786
65160;Escaunets;59;1343077;63806;32;1061575;27;281502;22764;18787
81101;Le Garric;682;15525724;596653;395;12355334;287;3170390;22765;18788
68334;Thann;4623;105243127;5748531;2522;83591176;2101;21651951;22765;18789
50106;Cavigny;128;2914050;124162;71;2319619;57;594431;22766;18790
64338;Lespourcy;93;2117280;68407;51;1646410;42;470870;22766;18791
34094;Espondeilhan;530;12066485;538596;272;9456567;258;2609918;22767;18792
76209;Dampierre-en-Bray;242;5509683;205014;142;4435579;100;1074104;22767;18793
76326;Greny;66;1502641;51102;36;1156238;30;346403;22767;18794
48081;Lanuéjols;152;3460631;116616;92;2849032;60;611599;22767;18795
10393;Vallentigny;110;2504412;138269;54;1892240;56;612172;22767;18796
42086;Écoche;258;5874032;184142;135;4468024;123;1406008;22768;18797
28156;Fontaine-Simon;506;11520529;367492;308;9163083;198;2357446;22768;18798
71187;Écuisses;925;21061106;787053;524;16576997;401;4484109;22769;18799
02433;Lislet;127;2891756;71011;67;2181912;60;709844;22770;18800
80434;Hervilly;89;2026527;89466;49;1608267;40;418260;22770;18801
62146;Boiry-Saint-Martin;146;3324444;103583;91;2692772;55;631672;22770;18802
89223;Lézinnes;445;10132782;503482;257;8165518;188;1967264;22770;18803
58261;Saint-Père;654;14891832;569197;410;12124224;244;2767608;22770;18804
53219;Saint-Georges-Buttavent;745;16964427;511972;436;13420104;309;3544323;22771;18805
17267;Nuaillé-d'Aunis;573;13048784;318593;341;10289600;232;2759184;22773;18806
78089;Bonnières-sur-Seine;2469;56226120;2400625;1482;45720959;987;10505161;22773;18807
47120;Jusix;59;1343600;61924;24;996478;35;347122;22773;18808
71425;Saint-Gilles;171;3894222;197193;95;2995831;76;898391;22773;18809
42316;Unieux;4643;105742019;3681804;2581;81536057;2062;24205962;22775;18810
70390;Noroy-le-Bourg;270;6149221;258408;155;4860660;115;1288561;22775;18811
30084;Codolet;362;8244568;345529;196;6441937;166;1802631;22775;18812
80502;Maison-Roland;56;1275406;52914;28;935217;28;340189;22775;18813
85083;L'Épine;1072;24416382;1275418;549;18930116;523;5486266;22776;18814
04069;Demandolx;56;1275516;66258;30;966719;26;308797;22777;18815
57288;Ham-sous-Varsberg;1548;35259347;1545942;855;27601556;693;7657791;22777;18816
72376;Villaines-sous-Lucé;327;7448208;193133;179;5723482;148;1724726;22777;18817
12239;Saint-Martin-de-Lenne;151;3439422;134760;77;2637872;74;801550;22778;18818
86258;Scorbé-Clairvaux;1248;28426496;1133274;751;23536771;497;4889725;22778;18819
57201;Etting;402;9156638;241354;231;6960750;171;2195888;22778;18820
72286;Saint-Gervais-de-Vic;212;4828902;148253;131;3775897;81;1053005;22778;18821
26078;Charols;408;9293549;229807;203;6746392;205;2547157;22778;18822
70348;Moffans-et-Vacheresse;352;8017981;295145;205;6342544;147;1675437;22778;18823
30166;Meynes;1260;28700894;1303663;676;22694717;584;6006177;22778;18824
12056;Baraqueville;1634;37220588;1330329;901;28972895;733;8247693;22779;18825
24566;Varennes;246;5603664;243698;134;4409709;112;1193955;22779;18826
64292;Labatmale;130;2961313;96162;80;2379073;50;582240;22779;18827
16393;Vars;1106;25195139;1077373;629;20145202;477;5049937;22780;18828
81220;Rabastens;3067;69870304;2921137;1616;55015456;1451;14854848;22781;18829
64546;Urt;1251;28499796;1048837;685;22432216;566;6067580;22782;18830
25051;Belleherbe;326;7426866;309930;174;5779959;152;1646907;22782;18831
61356;La Rouge;369;8406532;294233;228;6739594;141;1666938;22782;18832
87047;Compreignac;965;21985068;766327;571;17510152;394;4474916;22782;18833
39229;Fontainebrux;98;2232687;78829;59;1776953;39;455734;22783;18834
68348;Vieux-Thann;1594;36315727;1374910;927;28505455;667;7810272;22783;18835
50360;Morville;136;3098474;78704;73;2354255;63;744219;22783;18836
88165;Étival-Clairefontaine;1414;32215256;1249655;846;26005158;568;6210098;22783;18837
21503;Pouilly-sur-Vingeanne;66;1503719;56207;33;1102035;33;401684;22784;18838
24175;Les Farges;161;3668195;153669;94;3046664;67;621531;22784;18839
13076;Plan-d'Orgon;1615;36796332;1540436;852;28624751;763;8171581;22784;18840
54372;Moivrons;240;5468188;201483;145;4445312;95;1022876;22784;18841
14331;Hiéville;153;3486008;163490;90;2860961;63;625047;22784;18842
39085;Cerniébaud;36;820238;30121;21;685376;15;134862;22784;18843
39364;Montrond;244;5559602;135253;141;4271021;103;1288581;22785;18844
57756;Xouaxange;165;3759597;149414;101;2987839;64;771758;22785;18845
10397;Vauchonvilliers;82;1868419;77288;41;1381165;41;487254;22786;18846
11259;Moussoulens;513;11689264;385251;269;9078664;244;2610600;22786;18847
31278;Latoue;189;4306602;246772;99;3379113;90;927489;22786;18848
37090;Crissay-sur-Manse;62;1412755;70169;26;1004691;36;408064;22786;18849
81004;Albi;28850;657387232;39370523;14736;526754766;14114;130632466;22786;18850
38193;L'Isle-d'Abeau;7263;165497738;6586108;3996;129452699;3267;36045039;22786;18851
39365;Mont-sous-Vaudrey;700;15950742;781830;356;12367134;344;3583608;22787;18852
38497;Sousville;84;1914183;79792;48;1539774;36;374409;22788;18853
62023;Allouagne;1556;35458140;1415383;824;27133046;732;8325094;22788;18854
68040;Bitschwiller-lès-Thann;1155;26320157;1287894;636;20544284;519;5775873;22788;18855
21331;Labergement-lès-Auxonne;191;4352532;114672;103;3099726;88;1252806;22788;18856
27291;Gournay-le-Guérin;70;1595218;67676;45;1284780;25;310438;22789;18857
31449;Régades;68;1549650;42470;38;1183110;30;366540;22789;18858
61442;Saint-Patrice-du-Désert;106;2415659;82486;55;1786499;51;629160;22789;18859
81159;Massac-Séran;183;4170494;130306;87;3231149;96;939345;22790;18860
25226;Étrappe;110;2506861;102945;64;1880668;46;626193;22790;18861
39488;Saint-Laurent-la-Roche;166;3783113;137836;105;3159275;61;623838;22790;18862
86145;Marçay;524;11942166;345008;308;9444876;216;2497290;22790;18863
02620;Presles-et-Boves;187;4261824;275863;86;3044366;101;1217458;22791;18864
02148;Celles-sur-Aisne;137;3122331;119496;81;2494961;56;627370;22791;18865
42090;Essertines-en-Donzy;261;5948395;211956;139;4494705;122;1453690;22791;18866
01187;Hotonnes;166;3783291;153695;89;2947592;77;835699;22791;18867
50203;La Glacerie;3052;69557922;2743957;1750;55243426;1302;14314496;22791;18868
70238;Fleurey-lès-Saint-Loup;72;1640955;33662;36;1154713;36;486242;22791;18869
08274;Marcq;52;1185138;49774;19;806997;33;378141;22791;18870
06153;Valdeblore;480;10939841;520264;287;9076916;193;1862925;22791;18871
24124;Clermont-d'Excideuil;144;3282021;146661;71;2468907;73;813114;22792;18872
80141;Brie;197;4490016;186576;124;3756754;73;733262;22792;18873
72062;La Chapelle-du-Bois;433;9869012;284915;276;8087217;157;1781795;22792;18874
11181;Labécède-Lauragais;238;5424541;303146;116;4225080;122;1199461;22792;18875
80209;Contoire;233;5310604;235489;140;4342454;93;968150;22792;18876
30223;Rousson;2104;47955752;1843811;1241;38629147;863;9326605;22793;18877
64508;Saucède;62;1413175;43908;38;1208627;24;204548;22793;18878
59086;Boeschepe;1143;26053416;946025;629;20480067;514;5573349;22794;18879
80462;Lamotte-Buleux;179;4080190;151089;105;3301109;74;779081;22794;18880
28057;Bouville;284;6473661;191738;162;5018463;122;1455198;22795;18881
61147;Dorceau;239;5447917;271305;140;4431213;99;1016704;22795;18882
72197;Mézières-sous-Lavardin;343;7818697;242139;204;6196373;139;1622324;22795;18883
57082;Biding;168;3829642;132463;97;2942501;71;887141;22795;18884
86166;Montreuil-Bonnin;371;8457147;234320;217;6717698;154;1739449;22796;18885
88294;Mazeley;149;3396539;113746;93;2761807;56;634732;22796;18886
14523;Proussy;192;4376785;96279;107;3273282;85;1103503;22796;18887
01296;Pirajoux;194;4422402;100554;115;3505549;79;916853;22796;18888
86105;Gizay;205;4673174;163570;120;3741575;85;931599;22796;18889
38155;Entre-deux-Guiers;941;21451833;799393;538;16658903;403;4792930;22797;18890
21424;Montagny-lès-Seurre;64;1459016;55427;39;1149789;25;309227;22797;18891
60187;Cuigy-en-Bray;541;12333308;487150;326;10099974;215;2233334;22797;18892
25536;Sauvagney;87;1983372;70652;53;1571033;34;412339;22797;18893
89029;Bassou;484;11034105;492715;298;8909801;186;2124304;22798;18894
44143;Rezé;22460;512038523;21526786;13359;416046966;9101;95991557;22798;18895
15088;Lacapelle-Viescamp;271;6178227;206437;156;4934109;115;1244118;22798;18896
57605;Sailly-Achâtel;133;3032126;87939;82;2489220;51;542906;22798;18897
38398;Saint-Jean-d'Avelanne;459;10464260;385019;252;7983413;207;2480847;22798;18898
80532;Méricourt-sur-Somme;114;2598974;117389;60;2021261;54;577713;22798;18899
86262;Sillars;354;8070576;308701;201;6382663;153;1687913;22798;18900
49178;Loiré;435;9917253;214919;212;7304415;223;2612838;22798;18901
21151;Chassey;59;1345135;76830;33;1091291;26;253844;22799;18902
07223;Saint-Cirgues-de-Prades;71;1618750;62179;39;1268758;32;349992;22799;18903
46110;Fontanes-du-Causse;39;889188;25658;20;630680;19;258508;22800;18904
69286;Rillieux-la-Pape;15238;347423807;18466407;7746;271770394;7492;75653413;22800;18905
64350;Louhossoa;421;9598945;291481;234;7642498;187;1956447;22800;18906
21598;Seigny;97;2211647;102234;62;1909118;35;302529;22800;18907
69263;Villechenève;418;9530725;240678;241;7344554;177;2186171;22801;18908
36102;Luçay-le-Libre;59;1345283;68705;31;1067679;28;277604;22801;18909
38005;Allemond;557;12700652;543744;353;10426783;204;2273869;22802;18910
02396;Jumigny;37;843678;50515;17;665435;20;178243;22802;18911
19182;Saint-Aulaire;454;10352199;474527;241;7879450;213;2472749;22802;18912
88202;Gircourt-lès-Viéville;97;2211834;48260;61;1822264;36;389570;22802;18913
54597;Xirocourt;244;5563846;178410;144;4330694;100;1233152;22803;18914
65437;Tajan;92;2097867;130092;45;1695607;47;402260;22803;18915
29176;Plonévez-Porzay;1005;22917022;785329;562;18048026;443;4868996;22803;18916
65276;Lizos;62;1413798;55892;32;1062494;30;351304;22803;18917
31114;Castelbiague;126;2873317;121134;76;2357849;50;515468;22804;18918
54052;Battigny;57;1299850;30198;27;992092;30;307758;22804;18919
50167;Dragey-Ronthon;424;9669200;388666;214;7302213;210;2366987;22805;18920
73049;Bonvillaret;72;1641963;59898;45;1345275;27;296688;22805;18921
30089;Comps;902;20570652;791234;527;16567051;375;4003601;22806;18922
35027;Boisgervilly;780;17788473;543175;455;14017496;325;3770977;22806;18923
61412;Saint-Julien-sur-Sarthe;355;8096202;351982;171;5836954;184;2259248;22806;18924
31093;Le Burgaud;442;10080559;348571;240;8007063;202;2073496;22807;18925
18049;La Chapelle-Montlinard;304;6933279;250610;185;5633687;119;1299592;22807;18926
38121;Commelle;447;10194658;385867;245;7911333;202;2283325;22807;18927
51543;Somme-Bionne;43;980722;28493;24;703685;19;277037;22807;18928
33202;Hostens;692;15782822;603948;342;12110166;350;3672656;22808;18929
71023;Baudrières;452;10309273;319573;252;7971891;200;2337382;22808;18930
45210;Montbouy;426;9716488;468585;244;7912546;182;1803942;22809;18931
14100;Bretteville-sur-Laize;886;20209595;696682;506;15942207;380;4267388;22810;18932
28127;Dangeau;528;12043922;495398;286;9227599;242;2816323;22810;18933
80168;Candas;518;11815834;448087;286;9197296;232;2618538;22810;18934
69010;L'Arbresle;3293;75115763;2992839;1926;60364727;1367;14751036;22811;18935
55193;Forges-sur-Meuse;62;1414278;47612;39;1135037;23;279241;22811;18936
57280;Guntzviller;200;4562189;152710;114;3514510;86;1047679;22811;18937
38307;Pisieu;266;6067745;245670;150;4720958;116;1346787;22811;18938
33097;Carcans;1435;32734754;1484695;773;25298371;662;7436383;22812;18939
49349;Tillières;905;20644684;755940;485;15668413;420;4976271;22812;18940
28161;Frazé;276;6296097;276090;149;4909740;127;1386357;22812;18941
09096;Château-Verdun;30;684364;26801;15;469285;15;215079;22812;18942
44120;Le Pellerin;2403;54817704;1717457;1397;43132985;1006;11684719;22812;18943
40252;Sainte-Colombe;319;7277341;230829;186;5873807;133;1403534;22813;18944
10225;Marnay-sur-Seine;155;3536037;184633;96;2806876;59;729161;22813;18945
11138;Fendeille;285;6501869;225417;176;5383383;109;1118486;22814;18946
03174;Molles;440;10037985;330366;249;7927023;191;2110962;22814;18947
80177;Cartigny;376;8578030;391229;203;6705382;173;1872648;22814;18948
62259;Croisilles;803;18319679;771519;419;14146853;384;4172826;22814;18949
60653;Valescourt;146;3330899;107711;92;2780233;54;550666;22814;18950
21092;Bouilland;125;2851874;87842;75;2273606;50;578268;22815;18951
70208;Échenoz-le-Sec;166;3787294;141134;108;3137264;58;650030;22815;18952
29298;Tréogat;294;6707804;237813;159;5151057;135;1556747;22816;18953
88409;Saint-Amé;1207;27538817;871570;705;21795263;502;5743554;22816;18954
26058;Bourg-lès-Valence;10973;250370321;11065402;6234;200735802;4739;49634519;22817;18955
26246;Ponet-et-Saint-Auban;78;1779817;66459;41;1375965;37;403852;22818;18956
88509;Villoncourt;60;1369107;46941;31;1028269;29;340838;22818;18957
08475;Villers-Cernay;178;4061755;118089;109;3186048;69;875707;22819;18958
35300;Saint-M'Hervé;687;15676691;508591;378;11785803;309;3890888;22819;18959
14735;Vendeuvre;377;8603160;368934;197;6447378;180;2155782;22820;18960
60410;Mondescourt;131;2989593;128701;73;2338207;58;651386;22821;18961
27442;Notre-Dame-du-Hamel;135;3080907;127068;84;2540340;51;540567;22822;18962
81212;Prades;82;1871380;84377;45;1510857;37;360523;22822;18963
11293;Pomas;424;9676464;390762;229;7734506;195;1941958;22822;18964
54293;Landécourt;55;1255230;39563;30;945786;25;309444;22822;18965
89041;Beugnon;187;4267888;178471;106;3383121;81;884767;22823;18966
85182;Pouzauges;3027;69085513;2843171;1675;53986956;1352;15098557;22823;18967
59454;Oxelaëre;287;6550236;303472;164;5118634;123;1431602;22823;18968
60611;Senantes;334;7622941;249243;188;5795169;146;1827772;22823;18969
27541;Saint-Georges-du-Mesnil;64;1460692;66592;35;1122755;29;337937;22823;18970
38399;Saint-Jean-de-Bournay;2548;58153995;2589690;1453;46309304;1095;11844691;22823;18971
57387;Laumesfeld;137;3127048;41033;59;1801462;78;1325586;22825;18972
02307;La Ferté-Milon;1224;27938339;1393583;671;21801639;553;6136700;22825;18973
2A189;Olmeto;749;17096523;1319684;354;13410216;395;3686307;22826;18974
44110;Nort-sur-Erdre;4154;94821248;2888485;2302;73841027;1852;20980221;22826;18975
22136;Loudéac;5503;125616650;5291554;2959;99842758;2544;25773892;22827;18976
60624;Sully;91;2077289;89191;58;1717997;33;359292;22827;18977
21367;Magny-Montarlot;134;3058877;93248;83;2428401;51;630476;22827;18978
88322;La Neuveville-devant-Lépanges;230;5250327;136254;148;4252173;82;998154;22828;18979
22111;Lanmodez;248;5661346;251955;116;4164970;132;1496376;22828;18980
21073;Bierre-lès-Semur;58;1324030;49248;41;1151914;17;172116;22828;18981
30136;Junas;612;13970949;764845;316;10823029;296;3147920;22828;18982
45069;Chambon-la-Forêt;471;10752159;377367;269;8355147;202;2397012;22828;18983
56213;Saint-Gérand;545;12441978;390297;331;9956015;214;2485963;22829;18984
85219;Saint-Germain-l'Aiguiller;208;4748516;119008;125;3728717;83;1019799;22829;18985
65285;Louit;96;2191650;52888;56;1789896;40;401754;22830;18986
17082;Champagnac;283;6460887;288733;160;5205704;123;1255183;22830;18987
54455;Remenoville;78;1780794;16363;42;1347733;36;433061;22831;18988
83154;Saint-Antonin-du-Var;387;8835496;364752;198;6835130;189;2000366;22831;18989
10362;Sainte-Savine;6377;145604162;8008071;3706;117836765;2671;27767397;22833;18990
59455;Paillencourt;495;11302247;437071;279;8980985;216;2321262;22833;18991
50549;Saint-Sauveur-la-Pommeraye;169;3858753;106733;97;3041548;72;817205;22833;18992
35159;Lourmais;168;3835927;123824;81;2819301;87;1016626;22833;18993
14358;Léaupartie;48;1096008;37890;31;904121;17;191887;22834;18994
68063;Cernay;6309;144058153;6384575;3421;114407185;2888;29650968;22834;18995
63453;Vertaizon;1567;35781292;1350165;902;29104525;665;6676767;22834;18996
36211;Sassierges-Saint-Germain;250;5708711;177418;147;4436156;103;1272555;22835;18997
25306;L'Hôpital-Saint-Lieffroy;51;1164603;25094;31;871472;20;293131;22835;18998
45205;Mézières-en-Gâtinais;150;3425323;171606;92;2872988;58;552335;22835;18999
81079;Dénat;382;8723255;268713;220;6987247;162;1736008;22836;19000
28346;Saint-Lubin-de-Cravant;34;776421;31708;20;610935;14;165486;22836;19001
35340;Treffendel;594;13564636;294412;342;10595455;252;2969181;22836;19002
16178;Lagarde-sur-le-Né;88;2009582;66067;47;1554879;41;454703;22836;19003
76263;La Feuillie;686;15665962;714736;373;12263345;313;3402617;22837;19004
30129;Générargues;395;9020524;477107;194;6751647;201;2268877;22837;19005
51632;Villers-en-Argonne;133;3037298;98414;67;2249124;66;788174;22837;19006
62860;Villers-Sir-Simon;67;1530079;54820;35;1201879;32;328200;22837;19007
02175;Chavigny;76;1735622;64009;42;1276340;34;459282;22837;19008
45239;Oussoy-en-Gâtinais;247;5640811;249778;142;4570029;105;1070782;22837;19009
31246;Labarthe-Inard;479;10939321;468994;276;8819813;203;2119508;22838;19010
88190;Frizon;246;5618117;179903;150;4537311;96;1080806;22838;19011
50010;Angoville-au-Plain;30;685154;18286;19;538826;11;146328;22838;19012
27565;Sainte-Marguerite-de-l'Autel;266;6075221;236683;129;4651574;137;1423647;22839;19013
25273;Glamondans;111;2535179;77145;61;1897417;50;637762;22839;19014
73034;Beaufort;1256;28686489;1138682;759;23478549;497;5207940;22840;19015
84014;Beaumont-de-Pertuis;604;13795139;596258;308;10549533;296;3245606;22840;19016
49283;Saint-Georges-sur-Loire;1762;40243913;1300762;986;31818580;776;8425333;22840;19017
49358;Turquant;301;6874931;289915;149;5294462;152;1580469;22840;19018
85255;Saint-Michel-en-l'Herm;1353;30903022;1155937;769;23493553;584;7409469;22840;19019
30048;Bouquet;112;2558123;163124;49;1844693;63;713430;22840;19020
57382;Langatte;280;6395382;194107;177;5311976;103;1083406;22841;19021
92024;Clichy;35090;801489470;53500456;20526;672639705;14564;128849765;22841;19022
25026;Arc-sous-Montenot;110;2512566;80869;56;1764493;54;748073;22842;19023
61112;Colonard-Corubert;136;3106461;119198;77;2590771;59;515690;22842;19024
14700;Tour-en-Bessin;305;6966735;228888;177;5611978;128;1354757;22842;19025
09207;Montgaillard;818;18684602;775264;466;14872801;352;3811801;22842;19026
21104;Brémur-et-Vaurois;34;776629;28885;21;671449;13;105180;22842;19027
57705;Velving;114;2604028;73651;60;1991082;54;612946;22842;19028
63332;Saint-Clément-de-Régnat;281;6418759;248067;153;4944045;128;1474714;22843;19029
41179;Le Poislay;112;2558506;112874;57;1939216;55;619290;22844;19030
21194;Corgoloin;522;11924568;531554;319;9754039;203;2170529;22844;19031
54008;Allain;238;5437064;146161;154;4477002;84;960062;22845;19032
34023;Balaruc-les-Bains;4295;98121913;5059066;2424;78890779;1871;19231134;22846;19033
40276;Saint-Michel-Escalus;183;4180882;191534;109;3491518;74;689364;22846;19034
42104;La Gresle;445;10166670;379053;228;7605328;217;2561342;22846;19035
88044;Bazoilles-sur-Meuse;334;7630739;280685;186;6057376;148;1573363;22847;19036
49086;Chavagnes;547;12497266;257415;293;9439507;254;3057759;22847;19037
67111;Durstel;232;5300545;192702;142;4242454;90;1058091;22847;19038
60204;Écuvilly;148;3381393;146852;90;2697437;58;683956;22847;19039
76060;Beaubec-la-Rosière;232;5300630;159684;137;4053995;95;1246635;22848;19040
76383;Lestanville;45;1028153;27059;27;789904;18;238249;22848;19041
60556;Royaucourt;117;2673251;141925;64;2126842;53;546409;22848;19042
43110;Lamothe;438;10007576;372940;254;8102109;184;1905467;22848;19043
89338;Saint-Clément;1679;38362566;1800367;945;30797870;734;7564696;22848;19044
85073;Corpe;514;11744345;559088;294;9114028;220;2630317;22849;19045
60044;Balagny-sur-Thérain;816;18645067;640320;517;15276981;299;3368086;22849;19046
76736;Veulettes-sur-Mer;193;4410047;239489;109;3501922;84;908125;22850;19047
79079;Mauléon;4289;98007679;3092310;2245;73796558;2044;24211121;22851;19048
73321;Villarlurin;196;4478913;190340;124;3722082;72;756831;22852;19049
31232;Grenade;4581;104684633;4363159;2664;84628919;1917;20055714;22852;19050
25369;Marvelise;82;1873863;67388;52;1563203;30;310660;22852;19051
82056;Espinas;84;1919684;104243;38;1457063;46;462621;22853;19052
56157;Plaudren;898;20522620;589656;499;15843652;399;4678968;22854;19053
2A004;Ajaccio;35860;819541362;53244898;19875;678453254;15985;141088108;22854;19054
85277;Saint-Vincent-sur-Graon;707;16157848;483145;384;12477819;323;3680029;22854;19055
38517;Tullins;4262;97405127;4160596;2389;77193381;1873;20211746;22854;19056
55399;Pareid;54;1234145;21362;26;843110;28;391035;22855;19057
68352;Volgelsheim;1325;30282291;1282856;764;23979149;561;6303142;22855;19058
65016;Antist;70;1599884;41886;44;1290299;26;309585;22855;19059
80313;Flaucourt;162;3702652;197470;88;2819209;74;883443;22856;19060
45258;Puiseaux;1878;42925091;1914228;1120;34172924;758;8752167;22857;19061
24115;Château-l'Évêque;1203;27497245;1075994;716;22718786;487;4778459;22857;19062
76342;Hattenville;314;7177243;204472;172;5540364;142;1636879;22857;19063
17304;Rouffiac;233;5325884;189408;130;4146644;103;1179240;22858;19064
86071;Cheneché;186;4251568;122777;127;3617237;59;634331;22858;19065
61081;Chailloué;293;6697411;214763;173;5238770;120;1458641;22858;19066
52429;Roches-sur-Marne;313;7154682;260409;203;5819914;110;1334768;22858;19067
33092;Cantois;109;2491650;65395;61;1990730;48;500920;22859;19068
29100;Lanarvily;201;4594825;89779;126;3634531;75;960294;22860;19069
41225;Saint-Martin-des-Bois;345;7886771;290675;202;6203854;143;1682917;22860;19070
27230;Ézy-sur-Eure;1922;43937495;1814356;1157;35485261;765;8452234;22860;19071
76213;Daubeuf-Serville;189;4320655;104266;117;3405698;72;914957;22861;19072
88388;Renauvoid;75;1714565;73583;46;1464903;29;249662;22861;19073
35180;Miniac-sous-Bécherel;369;8435801;227160;212;6586839;157;1848962;22861;19074
51213;Dommartin-sous-Hans;30;685840;21595;17;495144;13;190696;22861;19075
57061;Béning-lès-Saint-Avold;675;15431886;733950;384;12290690;291;3141196;22862;19076
37178;Panzoult;342;7818872;346752;203;6331416;139;1487456;22862;19077
35110;Feins;469;10722780;280214;250;8236837;219;2485943;22863;19078
72048;Briosne-lès-Sables;245;5601461;113447;161;4616213;84;985248;22863;19079
50358;Morsalines;112;2560708;106606;56;1938002;56;622706;22863;19080
42243;Saint-Julien-d'Oddes;132;3018038;99285;69;2340695;63;677343;22864;19081
21498;Posanges;33;754525;15372;17;549985;16;204540;22864;19082
83095;Pontevès;404;9237384;376407;213;7142835;191;2094549;22865;19083
17220;Marignac;222;5076052;300202;114;4011231;108;1064821;22865;19084
11039;La Bezole;25;571634;23828;14;453418;11;118216;22865;19085
55544;Velosnes;82;1874987;69800;41;1412155;41;462832;22866;19086
52170;Dommarien;90;2057926;70374;49;1547497;41;510429;22866;19087
24572;Vergt-de-Biron;108;2469533;220242;50;1929650;58;539883;22866;19088
01093;Châtillon-sur-Chalaronne;2846;65081071;2768099;1571;51044120;1275;14036951;22868;19089
41020;Bonneveau;269;6151384;181528;168;5036366;101;1115018;22868;19090
76202;Croixdalle;134;3064274;240360;71;2478655;63;585619;22868;19091
21167;Cheuge;59;1349217;51060;37;1079216;22;270001;22868;19092
76598;Saint-Léger-aux-Bois;275;6288752;212332;146;4861615;129;1427137;22868;19093
66196;Sorède;1902;43498798;2157974;1020;34262041;882;9236757;22870;19094
07005;Alba-la-Romaine;791;18090199;908369;415;14138784;376;3951415;22870;19095
14585;Saint-Germain-du-Crioult;478;10932090;324176;276;8590190;202;2341900;22870;19096
08358;Remilly-les-Pothées;126;2881709;107867;63;2199851;63;681858;22871;19097
62227;Clenleu;100;2287080;102204;48;1742013;52;545067;22871;19098
36248;Vouillon;144;3293468;122221;91;2765561;53;527907;22871;19099
72322;Saint-Ulphace;132;3019054;145600;74;2397571;58;621483;22872;19100
26239;Plaisians;114;2607417;216862;49;2020764;65;586653;22872;19101
41181;Pouillé;448;10246877;400954;251;7889128;197;2357749;22872;19102
18074;Couargues;126;2881952;172188;67;2349092;59;532860;22873;19103
65292;Luquet;203;4643149;126917;121;3734295;82;908854;22873;19104
14618;Sainte-Marie-Laumont;337;7708298;243483;193;6005158;144;1703140;22873;19105
73299;Traize;164;3751273;109686;96;3057918;68;693355;22874;19106
70090;Boursières;38;869209;21834;25;735192;13;134017;22874;19107
57734;Voyer;233;5329628;161895;150;4299220;83;1030408;22874;19108
71381;Sailly;41;937835;35328;19;675536;22;262299;22874;19109
50613;Valcanville;198;4529090;145370;95;3202583;103;1326507;22874;19110
17300;La Rochelle;45911;1050185661;65596808;24389;851358658;21522;198827003;22874;19111
09300;Soula;103;2356106;105736;53;1826945;50;529161;22875;19112
70138;Chassey-lès-Scey;71;1624114;62927;44;1241612;27;382502;22875;19113
34084;Corneilhan;970;22188653;1045860;511;17331452;459;4857201;22875;19114
02491;Monceau-le-Neuf-et-Faucouzy;178;4071807;274335;80;3053021;98;1018786;22875;19115
18166;Nohant-en-Goût;318;7274379;313780;166;5635455;152;1638924;22875;19116
04160;Reillanne;916;20954391;1043223;439;16383139;477;4571252;22876;19117
71011;Anzy-le-Duc;248;5673696;247846;118;4183334;130;1490362;22878;19118
46242;Rudelle;110;2516710;86239;55;1831952;55;684758;22879;19119
37262;Trogues;194;4438648;201023;107;3476365;87;962283;22880;19120
31395;Muret;14298;327135322;17277156;7852;265051021;6446;62084301;22880;19121
88261;Laval-sur-Vologne;333;7618975;301421;192;5920075;141;1698900;22880;19122
81235;Saint-Affrique-les-Montagnes;359;8213865;207890;214;6523831;145;1690034;22880;19123
32089;Castillon-Massas;130;2974395;97891;76;2322096;54;652299;22880;19124
15234;Teissières-lès-Bouliès;173;3958258;195173;86;3090058;87;868200;22880;19125
33311;Paillet;654;14963923;629349;390;12140725;264;2823198;22881;19126
52492;Torcenay;318;7276168;259883;198;5785353;120;1490815;22881;19127
40303;Solférino;187;4278779;284091;89;3196060;98;1082719;22881;19128
44003;Ancenis;4169;95394801;4505512;2234;75631221;1935;19763580;22882;19129
88500;Ventron;485;11097775;410953;268;8520437;217;2577338;22882;19130
62025;Ambleteuse;1084;24805242;1247507;564;19804126;520;5001116;22883;19131
88415;Saint-Étienne-lès-Remiremont;2141;48993428;2244728;1139;38329568;1002;10663860;22883;19132
59318;Houtkerque;508;11624839;354869;286;9142149;222;2482690;22884;19133
45077;La Chapelle-sur-Aveyron;307;7025297;245350;181;5539688;126;1485609;22884;19134
85282;Sigournais;441;10091740;271070;256;7931331;185;2160409;22884;19135
40168;Magescq;1035;23684763;865386;574;18708624;461;4976139;22884;19136
25289;Grandfontaine-sur-Creuse;33;755173;18082;17;556063;16;199110;22884;19137
72145;Le Grez;215;4920100;169705;112;3648929;103;1271171;22884;19138
38342;Roissard;157;3592832;166620;99;3055568;58;537264;22884;19139
91016;Angerville;2196;50254455;1851900;1302;40365144;894;9889311;22885;19140
46102;Figeac;5955;136278476;6675893;3168;109834911;2787;26443565;22885;19141
41216;Saint-Jean-Froidmentel;288;6590945;299350;157;5006104;131;1584841;22885;19142
30224;La Rouvière;324;7414874;329684;184;6090999;140;1323875;22885;19143
73315;Villard-Léger;246;5629833;177593;147;4540220;99;1089613;22886;19144
79353;Vitré;277;6339289;205795;157;4826441;120;1512848;22886;19145
55015;Aulnois-en-Perthois;250;5721419;192196;148;4514805;102;1206614;22886;19146
22215;Ploufragan;6004;137408646;4879848;3523;111279024;2481;26129622;22886;19147
80411;Le Hamel;270;6179328;261333;157;5069449;113;1109879;22886;19148
50450;Saint-Barthélemy;186;4256898;113150;108;3437101;78;819797;22887;19149
39391;Nozeroy;192;4394252;128325;103;3358214;89;1036038;22887;19150
47131;Lagupie;368;8422498;299788;210;6775370;158;1647128;22887;19151
72139;Fyé;525;12015879;481074;293;9096191;232;2919688;22887;19152
36041;La Chapelle-Saint-Laurian;76;1739445;95794;41;1334107;35;405338;22887;19153
28354;Saint-Maurice-Saint-Germain;205;4692079;179149;118;3736891;87;955188;22888;19154
49134;Faye-d'Anjou;707;16181964;477396;407;12501567;300;3680397;22888;19155
64171;Casteide-Cami;114;2609299;59209;66;1933796;48;675503;22889;19156
29232;Quimper;37961;868875335;45742179;21325;707237979;16636;161637356;22889;19157
45025;Bazoches-les-Gallerandes;787;18013409;594812;465;14174311;322;3839098;22889;19158
42325;Vendranges;160;3662200;74981;100;2906052;60;756148;22889;19159
55125;Contrisson;393;8995310;320544;252;7573577;141;1421733;22889;19160
24166;Eyliac;395;9041130;373674;236;7417389;159;1623741;22889;19161
86208;Le Rochereau;406;9292966;356983;232;7552861;174;1740105;22889;19162
62759;Saint-Martin-Choquel;223;5104363;175451;121;4007945;102;1096418;22890;19163
26183;Mirabel-et-Blacons;540;12360436;496164;290;9598608;250;2761828;22890;19164
76047;Auzouville-sur-Saâne;84;1922829;76953;45;1480372;39;442457;22891;19165
40070;Castandet;224;5127621;190927;125;4107065;99;1020556;22891;19166
76455;Morville-sur-Andelle;137;3136116;72002;71;2241480;66;894636;22891;19167
54286;Labry;863;19757078;798373;453;15006065;410;4751013;22893;19168
38190;Hières-sur-Amby;607;13896355;544770;383;11257842;224;2638513;22894;19169
86281;Vendeuvre-du-Poitou;1618;37042645;1482120;927;29229829;691;7812816;22894;19170
79042;Bougon;97;2220736;76625;52;1714778;45;505958;22894;19171
51478;Saint-Eulien;226;5174192;169835;127;4158848;99;1015344;22895;19172
80669;Rethonvillers;183;4189755;196588;97;3218036;86;971719;22895;19173
38242;Monestier-de-Clermont;694;15889205;417465;407;12292738;287;3596467;22895;19174
10328;Rouilly-Sacey;222;5082770;205724;134;4171850;88;910920;22895;19175
61269;Ménil-Hubert-sur-Orne;242;5540721;227179;142;4417187;100;1123534;22896;19176
52064;Bourmont;263;6021555;317941;136;4699912;127;1321643;22896;19177
87122;Razès;640;14653398;447412;364;11360136;276;3293262;22896;19178
68151;Husseren-Wesserling;564;12913316;495704;327;10377565;237;2535751;22896;19179
87002;Ambazac;3091;70772175;2808239;1780;57019005;1311;13753170;22896;19180
62275;Douriez;189;4327566;211661;98;3402786;91;924780;22897;19181
33179;Galgon;1600;36635920;1420664;906;28959285;694;7676635;22897;19182
21567;Saint-Prix-lès-Arnay;135;3091207;169224;74;2344427;61;746780;22898;19183
88086;Champ-le-Duc;303;6938124;271226;172;5408437;131;1529687;22898;19184
76288;Freulleville;191;4373549;184367;112;3604773;79;768776;22898;19185
39130;Chaux-des-Prés;101;2312759;78273;54;1682002;47;630757;22899;19186
39246;Gendrey;198;4534068;154103;122;3668691;76;865377;22899;19187
39022;Asnans-Beauvoisin;382;8747548;388010;232;7136876;150;1610672;22899;19188
63340;Saint-Étienne-sur-Usson;160;3664003;170980;85;2878403;75;785600;22900;19189
53240;Saint-Martin-du-Limet;238;5450208;133149;136;4146182;102;1304026;22900;19190
26305;Saint-Gervais-sur-Roubion;473;10832001;380172;260;8337256;213;2494745;22901;19191
13005;Aubagne;27288;624914736;34996267;14748;502589530;12540;122325206;22901;19192
57115;Brulange;54;1236644;48638;31;992867;23;243777;22901;19193
01402;Sermoyer;357;8175716;311091;206;6449508;151;1726208;22901;19194
01457;Vonnas;1491;34146688;1388331;806;26381405;685;7765283;22902;19195
35062;La Chapelle-Janson;716;16397796;558070;409;12769071;307;3628725;22902;19196
41022;Bouffry;86;1969577;90764;53;1547110;33;422467;22902;19197
21199;Corsaint;82;1877971;73983;50;1576376;32;301595;22902;19198
59542;Saint-Remy-Chaussée;256;5862975;239015;151;4880591;105;982384;22902;19199
02214;Contescourt;34;778687;61945;15;544426;19;234261;22903;19200
76546;Royville;135;3091875;110731;81;2389150;54;702725;22903;19201
76458;Muchedent;67;1534523;47531;32;1195994;35;338529;22903;19202
80439;Heuzecourt;85;1946805;101607;44;1505777;41;441028;22904;19203
89151;Égriselles-le-Bocage;743;17017459;764186;467;14282461;276;2734998;22904;19204
49312;Saint-Philbert-en-Mauges;178;4076908;47750;113;3263655;65;813253;22904;19205
54107;Buriville;31;710028;15183;19;583983;12;126045;22904;19206
65004;Agos-Vidalos;229;5245093;221096;142;4401319;87;843774;22904;19207
29171;Plomeur;2071;47435220;1736312;1175;37368213;896;10067007;22905;19208
38520;Valencogne;321;7352389;222047;187;5645469;134;1706920;22905;19209
72261;Ruillé-en-Champagne;172;3939632;110645;88;2931184;84;1008448;22905;19210
18125;Léré;719;16468629;876282;404;13176659;315;3291970;22905;19211
45322;Thorailles;89;2038597;61126;54;1638829;35;399768;22906;19212
53111;La Haie-Traversaine;240;5497439;152500;145;4320655;95;1176784;22906;19213
70253;Frasne-le-Château;136;3115344;63202;68;2304810;68;810534;22907;19214
40049;Bordères-et-Lamensans;192;4398141;173847;116;3608358;76;789783;22907;19215
61338;Prépotin;72;1649323;46951;48;1353680;24;295643;22907;19216
13052;Maillane;1410;32300003;1614773;734;25612044;676;6687959;22908;19217
44145;Rouans;1385;31728910;848091;757;24361113;628;7367797;22909;19218
27292;Gouttières;119;2726179;135424;71;2302150;48;424029;22909;19219
39159;Colonne;133;3046913;111067;71;2413796;62;633117;22909;19220
21201;Coulmier-le-Sec;148;3390650;157016;72;2495942;76;894708;22910;19221
62124;Beutin;233;5338104;216028;124;4048124;109;1289980;22910;19222
41280;Villefranche-sur-Cher;1532;35098715;1518837;902;28553164;630;6545551;22910;19223
89141;Dissangis;65;1489176;48130;39;1178843;26;310333;22910;19224
26192;Montbrison-sur-Lez;183;4192665;247482;87;3269722;96;922943;22911;19225
62045;Aubigny-en-Artois;811;18580898;938883;409;14484372;402;4096526;22911;19226
81323;Viterbe;184;4215675;129877;102;3268885;82;946790;22911;19227
50095;Canisy;574;13151180;597957;296;10237843;278;2913337;22911;19228
84042;Cucuron;1167;26737734;1462160;580;21232739;587;5504995;22912;19229
25243;Flangebouche;376;8614758;310194;205;6649725;171;1965033;22912;19230
02732;Surfontaine;45;1031029;50393;22;781431;23;249598;22912;19231
45176;Juranville;246;5636446;212728;135;4302919;111;1333527;22912;19232
49063;Chalonnes-sur-Loire;3414;78223494;2589718;1872;61058557;1542;17164937;22913;19233
62393;Guemps;487;11158527;512441;242;8343187;245;2815340;22913;19234
66124;Font-Romeu-Odeillo-Via;1110;25433250;1431740;657;20905836;453;4527414;22913;19235
60116;Bury;1595;36546799;1437531;985;29784394;610;6762405;22913;19236
26149;Hostun;507;11617148;415216;290;9237667;217;2379481;22914;19237
18194;Rians;549;12580077;535954;319;9916805;230;2663272;22915;19238
24259;Maurens;564;12923871;501705;319;10277664;245;2646207;22915;19239
61441;Saint-Ouen-sur-Maire;59;1352035;32189;31;1026749;28;325286;22916;19240
57681;Tromborn;192;4399928;158053;105;3364678;87;1035250;22916;19241
14209;Crouay;277;6347855;183704;167;5160315;110;1187540;22916;19242
89432;Vaudeurs;272;6233316;293323;151;4899048;121;1334268;22917;19243
89130;Cravant;506;11595882;522279;276;9046201;230;2549681;22917;19244
31288;Layrac-sur-Tarn;185;4239638;179837;97;3349884;88;889754;22917;19245
54042;Bainville-aux-Miroirs;188;4308412;151878;116;3487776;72;820636;22917;19246
59367;Lys-lez-Lannoy;7082;162300177;6082222;4176;130699504;2906;31600673;22917;19247
52088;Ceffonds;345;7906509;310972;189;6047791;156;1858718;22917;19248
46156;Laroque-des-Arcs;302;6921123;302907;182;5748387;120;1172736;22918;19249
60625;Suzoy;287;6577377;240351;182;5405433;105;1171944;22918;19250
60189;Cuts;526;12054716;530717;277;9346886;249;2707830;22918;19251
57462;Metting;195;4469001;137511;113;3441621;82;1027380;22918;19252
17125;Courcelles;244;5592019;215440;145;4458064;99;1133955;22918;19253
54513;Tantonville;354;8113030;289697;214;6462766;140;1650264;22918;19254
62493;Lebucquière;134;3071064;117024;68;2220930;66;850134;22918;19255
88462;Le Syndicat;999;22895727;635566;589;17810856;410;5084871;22919;19256
49148;Gené;192;4400555;61275;115;3397098;77;1003457;22920;19257
14667;Saon;118;2704528;111947;71;2156282;47;548246;22920;19258
27609;Saint-Victor-d'Épine;175;4011094;212153;93;3153794;82;857300;22921;19259
76457;Moulineaux;493;11300213;437031;307;9319335;186;1980878;22921;19260
42148;Montchal;250;5730332;226140;135;4309717;115;1420615;22921;19261
41250;Sougé;285;6532949;325566;154;5094386;131;1438563;22923;19262
27445;Noyers;109;2498570;75848;69;1981549;40;517021;22923;19263
14069;Beuvillers;744;17054877;605857;428;13687879;316;3366998;22923;19264
56184;Questembert;3915;89745264;3589801;2193;71301722;1722;18443542;22923;19265
65394;Saint-Paul;159;3644847;155628;99;3054338;60;590509;22924;19266
49091;Chemellier;380;8711126;190012;217;6910934;163;1800192;22924;19267
85064;Chauché;1254;28747187;712648;743;22591833;511;6155354;22924;19268
39332;Mirebel;128;2934333;78776;81;2373277;47;561056;22924;19269
89284;Pacy-sur-Armançon;122;2796802;125149;70;2205133;52;591669;22925;19270
26319;Saint-Michel-sur-Savasse;287;6579390;257139;153;5043627;134;1535763;22925;19271
18124;Lazenay;191;4378714;254958;99;3456462;92;922252;22925;19272
40233;Pouillon;1656;37964748;1816252;859;29875636;797;8089112;22926;19273
72299;Saint-Mars-d'Outillé;1160;26594249;701912;682;20711931;478;5882318;22926;19274
64481;Saint-Goin;114;2613592;73452;70;2165008;44;448584;22926;19275
16177;Ladiville;70;1604854;106985;40;1354724;30;250130;22926;19276
80572;Morlancourt;209;4791740;190892;110;3629956;99;1161784;22927;19277
2B109;Farinole;129;2957847;187307;75;2474564;54;483283;22929;19278
21094;Bourberain;189;4333590;172580;108;3431496;81;902094;22929;19279
73065;Chambéry;32986;756359907;42820631;18183;611689136;14803;144670771;22930;19280
39285;Lavans-lès-Dole;173;3967058;202291;97;3091794;76;875264;22931;19281
35342;Trémeheuc;165;3783616;73238;93;3004703;72;778913;22931;19282
53059;La Chapelle-Rainsouin;179;4104805;73755;111;3237006;68;867799;22932;19283
62198;Cambligneul;171;3921378;111933;92;3110356;79;811022;22932;19284
55419;Récicourt;85;1949306;85996;45;1421945;40;527361;22933;19285
39167;Cosges;180;4127959;145855;93;3114719;87;1013240;22933;19286
54140;Courcelles;45;1031995;15258;22;782180;23;249815;22933;19287
56050;La Croix-Helléan;408;9356937;269044;209;6885785;199;2471152;22934;19288
04086;Faucon-de-Barcelonnette;174;3990478;170457;102;3210024;72;780454;22934;19289
57172;Denting;141;3233701;82419;78;2463230;63;770471;22934;19290
44107;Mouzeil;831;19058505;366734;483;14759881;348;4298624;22934;19291
21329;Juilly;26;596299;27485;13;468791;13;127508;22935;19292
57041;Aumetz;1205;27636340;641477;397;13946060;808;13690280;22935;19293
65280;Loubajac;225;5160389;168986;136;4188493;89;971896;22935;19294
01405;Servas;574;13164727;466025;340;10606369;234;2558358;22935;19295
58243;Saint-Gratien-Savigny;59;1353170;86454;27;1079055;32;274115;22935;19296
51440;Pontfaverger-Moronvilliers;832;19082135;542866;484;15062483;348;4019652;22935;19297
49224;Neuillé;495;11353056;399902;265;8612690;230;2740366;22935;19298
30042;Boisset-et-Gaujac;1286;29495168;1216568;627;22303650;659;7191518;22936;19299
65202;Gez;178;4082552;113578;107;3135412;71;947140;22936;19300
41241;Selles-Saint-Denis;786;18027662;783584;420;14016493;366;4011169;22936;19301
68014;Aubure;201;4610182;184319;120;3787114;81;823068;22936;19302
33276;Masseilles;82;1880778;75423;37;1377576;45;503202;22936;19303
69216;Saint-Julien-sur-Bibost;304;6972750;239473;166;5422095;138;1550655;22937;19304
61346;Le Renouard;105;2408355;123425;58;2014042;47;394313;22937;19305
64325;Lasseubetat;105;2408364;70952;51;1850444;54;557920;22937;19306
12005;Alpuech;45;1032188;67165;13;735469;32;296719;22938;19307
43236;La Séauve-sur-Semène;739;16951199;522086;437;13384238;302;3566961;22938;19308
38006;Allevard;2367;54294972;2288888;1440;44450325;927;9844647;22938;19309
45131;Échilleuses;214;4908849;167872;128;3726534;86;1182315;22939;19310
72114;Dehault;134;3073767;88710;85;2544456;49;529311;22939;19311
65471;Vignec;132;3027904;162494;74;2430184;58;597720;22939;19312
76355;Héricourt-en-Caux;462;10597927;540920;236;8569130;226;2028797;22939;19313
18233;Saint-Satur;957;21952984;1254807;493;17374853;464;4578131;22939;19314
38394;Saint-Hilaire-du-Rosier;1068;24499280;900669;603;19082656;465;5416624;22939;19315
17340;Saint-Germain-de-Marencennes;608;13947211;488199;337;10874021;271;3073190;22939;19316
32333;Projan;78;1789337;90334;42;1447656;36;341681;22940;19317
31456;Riolas;27;619386;26390;13;504656;14;114730;22940;19318
28077;La Chapelle-Fortin;94;2156455;57130;51;1633082;43;523373;22941;19319
37038;Bréhémont;416;9543699;360913;237;7649788;179;1893911;22942;19320
21527;La Rochepot;161;3693624;129466;95;2925594;66;768030;22942;19321
57723;Virming;155;3556057;155166;73;2683811;82;872246;22942;19322
89111;Les Clérimois;162;3716714;134407;105;3098869;57;617845;22943;19323
55326;Maulan;59;1353638;42330;40;1140256;19;213382;22943;19324
16370;Sireuil;670;15372465;598222;414;12603712;256;2768753;22944;19325
41180;Pontlevoy;880;20190924;891296;493;15840456;387;4350468;22944;19326
59010;Anneux;141;3235208;102558;89;2727415;52;507793;22945;19327
45209;Montbarrois;161;3694165;112277;106;3125078;55;569087;22945;19328
55485;Sepvigny;42;963723;28203;20;739862;22;223861;22946;19329
21711;Vix;63;1445585;46196;44;1250016;19;195569;22946;19330
64359;Lucq-de-Béarn;486;11152008;414310;246;8536951;240;2615057;22947;19331
52452;Saint-Martin-lès-Langres;61;1399851;37560;41;1155885;20;243966;22948;19332
56223;Saint-Jean-la-Poterie;815;18703059;695301;464;14985668;351;3717391;22949;19333
32170;Labarthète;85;1950653;93616;44;1560098;41;390555;22949;19334
02234;Craonne;41;940914;39526;18;676925;23;263989;22949;19335
41195;Rougeou;68;1560542;51956;38;1263059;30;297483;22949;19336
38386;Saint-Geoire-en-Valdaine;1236;28365356;1169493;674;22110822;562;6254534;22949;19337
70516;Vallerois-le-Bois;137;3144079;99058;81;2420199;56;723880;22949;19338
79303;Salles;179;4107994;87738;96;3131034;83;976960;22950;19339
70178;La Côte;279;6403204;307547;161;5118807;118;1284397;22951;19340
61197;Guêprei;72;1652444;29077;40;1229247;32;423197;22951;19341
55013;Arrancy-sur-Crusne;257;5898470;144566;121;3858799;136;2039671;22951;19342
69261;Vernay;32;734445;35063;16;554650;16;179795;22951;19343
27228;Éturqueraye;159;3649373;202477;90;2927372;69;722001;22952;19344
14651;Saint-Pierre-du-Jonquet;110;2524757;87091;69;2136077;41;388680;22952;19345
55525;Vadelaincourt;37;849245;39263;22;678565;15;170680;22953;19346
80378;Ginchy;37;849252;26319;24;718292;13;130960;22953;19347
10348;Saint-Lupien;123;2823244;103677;64;2160003;59;663241;22953;19348
43181;Saint-Étienne-Lardeyrol;387;8883082;357119;228;7071244;159;1811838;22954;19349
53067;Chémeré-le-Roi;219;5027023;282365;92;3860454;127;1166569;22954;19350
25107;Cendrey;100;2295475;96132;60;1810321;40;485154;22955;19351
31525;Salles-sur-Garonne;282;6473300;315009;158;5235107;124;1238193;22955;19352
59500;Ribécourt-la-Tour;202;4636968;167952;110;3583442;92;1053526;22955;19353
73110;Esserts-Blay;437;10031493;388100;272;7977100;165;2054393;22955;19354
68239;Oberbruck;231;5302697;224202;126;4183252;105;1119445;22955;19355
76262;Fesques;70;1606879;62649;31;1211515;39;395364;22955;19356
62032;Angres;2126;48804915;2939811;1035;37701134;1091;11103781;22956;19357
51500;Saint-Mard-sur-le-Mont;70;1606944;53874;44;1298080;26;308864;22956;19358
24427;Saint-Jean-d'Eyraud;111;2548206;197090;52;1972167;59;576039;22957;19359
01110;Colomieu;79;1813600;81111;51;1546849;28;266751;22957;19360
62453;Hézecques;55;1262643;36733;29;999909;26;262734;22957;19361
10399;Vaudes;369;8471337;320029;219;6881620;150;1589717;22958;19362
17091;Charron;1009;23164750;920288;577;18636034;432;4528716;22958;19363
37003;Amboise;7246;166354710;8306563;3978;131877834;3268;34476876;22958;19364
17453;Trizay;739;16966719;648453;394;13136956;345;3829763;22959;19365
60029;Auneuil;1456;33430003;1279716;847;26856051;609;6573952;22960;19366
41157;Mur-de-Sologne;774;17771677;552099;425;13772820;349;3998857;22961;19367
39554;Vers-en-Montagne;116;2663542;70634;69;2097133;47;566409;22962;19368
14405;Martigny-sur-l'Ante;174;3995374;136241;101;3145265;73;850109;22962;19369
89316;Provency;132;3031047;149898;74;2429057;58;601990;22962;19370
14532;Le Reculey;127;2916243;67437;75;2339034;52;577209;22963;19371
53124;Laigné;386;8863900;117739;225;6799829;161;2064071;22963;19372
32309;Pellefigue;59;1354846;56785;28;1046788;31;308058;22963;19373
82135;Nohic;625;14352324;437685;350;10768431;275;3583893;22964;19374
65125;Campistrous;191;4386071;205703;112;3566638;79;819433;22964;19375
27613;Saint-Vincent-du-Boulay;169;3880895;144728;96;3105777;73;775118;22964;19376
24448;Saint-Martial-d'Albarède;256;5878964;208993;143;4541152;113;1337812;22965;19377
45047;Bouzonville-aux-Bois;222;5098226;158015;145;4192054;77;906172;22965;19378
2B042;Borgo;4101;94179661;5723087;2162;75041843;1939;19137818;22965;19379
52280;Lecey;129;2962543;108944;91;2567030;38;395513;22965;19380
25531;Santoche;35;803799;12479;21;626602;14;177197;22966;19381
56118;Locmiquélic;2384;54750348;2146992;1390;43543568;994;11206780;22966;19382
88325;La Neuveville-sous-Montfort;93;2135822;54347;59;1778868;34;356954;22966;19383
63330;Saint-Cirgues-sur-Couze;177;4065004;197540;95;3179287;82;885717;22966;19384
21011;Ampilly-les-Bordes;45;1033505;61293;23;793569;22;239936;22967;19385
77240;Jouy-sur-Morin;1155;26526826;1078863;710;21818617;445;4708209;22967;19386
76236;Envronville;169;3881574;123650;92;3034727;77;846847;22968;19387
60393;Mello;319;7326855;220847;218;6174720;101;1152135;22968;19388
71238;Iguerande;536;12310988;467443;275;9456339;261;2854649;22968;19389
16280;Rivières;931;21383638;786058;540;16741418;391;4642220;22968;19390
47045;Calignac;263;6040982;278224;143;4854950;120;1186032;22970;19391
33060;Bommes;264;6064085;252444;149;4951239;115;1112846;22970;19392
14652;Saint-Pierre-du-Mont;40;918818;41140;18;686828;22;231990;22970;19393
30096;Cornillon;510;11714967;544062;272;9504603;238;2210364;22971;19394
02261;Dercy;201;4617125;204032;108;3557798;93;1059327;22971;19395
10228;Mathaux;121;2779603;87651;67;2091540;54;688063;22972;19396
89085;Charmoy;659;15138826;583830;432;12763917;227;2374909;22972;19397
02297;Étrépilly;60;1378352;45352;39;1156516;21;221836;22973;19398
68376;Wittenheim;7813;179488253;7473472;4577;142707094;3236;36781159;22973;19399
46191;Mercuès;616;14151588;645399;354;11267269;262;2884319;22973;19400
33552;Virelade;523;12015280;428923;299;9688214;224;2327066;22974;19401
45008;Artenay;1047;24053811;1158918;611;19455896;436;4597915;22974;19402
62505;Leulinghen-Bernes;204;4686876;140216;121;3735916;83;950960;22975;19403
33042;Belin-Béliet;2561;58841829;2511968;1294;45142464;1267;13699365;22976;19404
82010;Bardigues;129;2963926;77185;58;2293752;71;670174;22976;19405
54082;Boncourt;96;2205731;62565;63;1835120;33;370611;22976;19406
34335;Villemagne-l'Argentière;246;5652236;324940;129;4523136;117;1129100;22977;19407
07205;Saint-Alban-d'Ay;674;15486222;540916;377;11984774;297;3501448;22977;19408
84089;Pertuis;11520;264697304;13520444;6238;213701744;5282;50995560;22977;19409
46320;Tour-de-Faure;184;4227883;199382;99;3355152;85;872731;22978;19410
93047;Montfermeil;12483;286832810;15013242;6716;235004391;5767;51828419;22978;19411
45104;Corquilleroy;1414;32490913;1131642;865;26414188;549;6076725;22978;19412
18263;Thénioux;367;8433040;434227;213;6754568;154;1678472;22978;19413
12263;Savignac;368;8456311;303715;209;6587130;159;1869181;22979;19414
61436;Sainte-Opportune;111;2550738;89934;60;1905201;51;645537;22980;19415
12084;Creissels;835;19188132;602035;487;15011109;348;4177023;22980;19416
02083;Beuvardes;383;8801283;351122;223;7031993;160;1769290;22980;19417
36091;Lacs;368;8456871;326827;217;6636749;151;1820122;22981;19418
57235;Freistroff;564;12961099;360096;314;9746032;250;3215067;22981;19419
43213;Saint-Pal-de-Mons;1136;26106277;747384;632;20112722;504;5993555;22981;19420
27146;La Chapelle-Bayvel;170;3906824;98809;102;3104309;68;802515;22981;19421
81162;Maurens-Scopont;86;1976463;87777;35;1400604;51;575859;22982;19422
52495;Trémilly;45;1034197;50197;18;541111;27;493086;22982;19423
87188;Saint-Yrieix-sous-Aixe;226;5194047;189151;150;4449982;76;744065;22983;19424
05009;Aspres-lès-Corps;57;1310045;59578;28;1010184;29;299861;22983;19425
03002;Agonges;176;4045147;165497;83;3086092;93;959055;22984;19426
01316;Pugieu;85;1953636;64482;49;1488414;36;465222;22984;19427
62621;Nortkerque;774;17789581;493754;414;13597556;360;4192025;22984;19428
89242;Maligny;468;10756560;420214;278;8625028;190;2131532;22984;19429
59549;Salesches;164;3769422;181588;87;2932392;77;837030;22984;19430
76260;Ferrières-en-Bray;950;21835157;966093;567;17646689;383;4188468;22984;19431
44142;Remouillé;861;19789605;523881;509;15547302;352;4242303;22984;19432
53130;Laval;28349;651593371;35244562;15589;530058111;12760;121535260;22985;19433
17285;Port-d'Envaux;634;14572388;546634;363;11776977;271;2795411;22985;19434
35359;Visseiche;435;9998426;233397;219;7563432;216;2434994;22985;19435
65197;Ger;98;2252524;81619;62;1826602;36;425922;22985;19436
30018;Aspères;264;6068047;244599;139;4682234;125;1385813;22985;19437
85172;Le Perrier;1024;23536858;860382;544;18120141;480;5416717;22985;19438
27618;Sébécourt;239;5493614;267016;130;4391569;109;1102045;22986;19439
61047;Bocquencé;76;1746964;55946;40;1253859;36;493105;22986;19440
01033;Bellegarde-sur-Valserine;6330;145505598;4434352;3091;102666608;3239;42838990;22987;19441
84030;Caromb;1869;42962866;1846649;950;32818662;919;10144204;22987;19442
02790;Vesles-et-Caumont;119;2735528;110391;65;2073745;54;661783;22988;19443
39225;Le Fied;110;2528774;106036;52;1903207;58;625567;22989;19444
55500;Spincourt;428;9839531;292426;208;6694323;220;3145208;22990;19445
24561;Valeuil;211;4850820;250116;119;4002141;92;848679;22990;19446
59152;Comines;6523;149961841;5693225;3597;118423087;2926;31538754;22990;19447
82103;Marignac;55;1264449;53733;26;934792;29;329657;22990;19448
43022;Beaumont;158;3632481;180960;90;2945168;68;687313;22990;19449
35322;Le Sel-de-Bretagne;424;9747927;218136;247;7607394;177;2140533;22990;19450
38377;Saint-Clair-de-la-Tour;1777;40854447;1660471;1013;32394551;764;8459896;22991;19451
89221;Leugny;223;5126984;305037;121;4143879;102;983105;22991;19452
03167;Mazirat;158;3632720;79161;68;2819482;90;813238;22992;19453
29286;Tréflévénez;138;3172916;104908;76;2384620;62;788296;22992;19454
62391;Guarbecque;707;16255516;549773;386;12488100;321;3767416;22992;19455
02816;Villers-sur-Fère;257;5909030;222000;143;4637346;114;1271684;22992;19456
49161;La Jaille-Yvon;159;3655924;75278;94;2806936;65;848988;22993;19457
02119;Brécy;177;4069812;143483;91;3016754;86;1053058;22993;19458
37229;Saint-Nicolas-des-Motets;136;3127278;140620;84;2609851;52;517427;22995;19459
02440;Lor;77;1770592;45469;31;1202715;46;567877;22995;19460
68262;Ranspach;465;10692722;413137;290;8624339;175;2068383;22995;19461
88011;Arches;956;21983623;904127;599;18201058;357;3782565;22995;19462
35318;Saint-Thual;394;9060214;297294;210;6971431;184;2088783;22995;19463
26270;Rochechinard;66;1517717;64106;37;1202300;29;315417;22996;19464
08264;Machault;252;5795128;185576;132;4417172;120;1377956;22997;19465
59372;Malincourt;279;6416086;253576;146;5022545;133;1393541;22997;19466
42021;Boisset-Saint-Priest;610;14028185;413550;353;11144143;257;2884042;22997;19467
35025;Billé;525;12073740;366819;299;9370405;226;2703335;22998;19468
35277;Saint-Gonlay;170;3909648;140751;94;3024629;76;885019;22998;19469
73040;Bessans;197;4530610;273406;108;3516217;89;1014393;22998;19470
21696;Villeneuve-sous-Charigny;56;1287922;63548;31;1027814;25;260108;22999;19471
76640;Saint-Pierre-lès-Elbeuf;4507;103655186;4199532;2792;85007583;1715;18647603;22999;19472
25290;La Grange;50;1149938;40781;27;925728;23;224210;22999;19473
24266;Mensignac;814;18721658;800427;449;15034341;365;3687317;23000;19474
34300;Servian;2341;53843166;2606014;1099;41139170;1242;12703996;23000;19475
40312;Tarnos;7133;164061865;6605948;4368;134563366;2765;29498499;23000;19476
42143;Mizérieux;198;4554185;150075;107;3625586;91;928599;23001;19477
54491;Sancy;180;4140230;78835;81;2688882;99;1451348;23001;19478
82114;Monbéqui;313;7199407;197972;176;5589632;137;1609775;23001;19479
76493;Paluel;234;5382330;221862;134;4377979;100;1004351;23001;19480
38297;Passins;579;13317824;518984;329;10373092;250;2944732;23001;19481
39572;Villette-lès-Arbois;204;4692296;159432;115;3660840;89;1031456;23001;19482
38337;Rives;3489;80252556;3673810;2057;64053001;1432;16199555;23002;19483
71456;Saint-Martin-en-Bresse;994;22864098;891589;569;18053938;425;4810160;23002;19484
80512;Mareuil-Caubert;480;11041059;622427;243;8785953;237;2255106;23002;19485
57519;Obervisse;89;2047242;66666;48;1554604;41;492638;23003;19486
38185;Grenoble;90808;2088892294;131158645;52984;1752739669;37824;336152625;23003;19487
10139;Épothémont;91;2093345;58150;61;1740666;30;352679;23004;19488
53135;Livré-la-Touche;374;8603478;164932;206;6504151;168;2099327;23004;19489
11274;Pauligne;177;4071767;170451;91;3169096;86;902671;23004;19490
39035;Balanod;174;4002771;157790;106;3253736;68;749035;23004;19491
27077;Boissey-le-Châtel;434;9984795;370190;244;7973002;190;2011793;23006;19492
02778;Vendresse-Beaulne;56;1288363;63979;30;1009536;26;278827;23006;19493
08165;Faux;29;667196;22003;14;492492;15;174704;23007;19494
08212;Harcy;253;5820768;259187;137;4722840;116;1097928;23007;19495
02218;Coucy-lès-Eppes;302;6948167;240276;170;5502881;132;1445286;23007;19496
54333;Mailly-sur-Seille;123;2829925;105188;67;2122394;56;707531;23008;19497
89186;Germigny;316;7270393;261301;203;5970414;113;1299979;23008;19498
65045;Aucun;151;3474151;150395;91;2930132;60;544019;23008;19499
39406;Le Pasquier;137;3152062;101195;80;2494283;57;657779;23008;19500
44072;Herbignac;3242;74591789;2291791;1808;57012769;1434;17579020;23008;19501
57755;Xocourt;36;828292;18303;20;612718;16;215574;23008;19502
57518;Oberstinzel;163;3750433;127774;85;2827083;78;923350;23009;19503
67435;Sarrewerden;506;11642900;547273;288;9143469;218;2499431;23010;19504
77027;Beaumont-du-Gâtinais;625;14381537;646170;340;11214326;285;3167211;23010;19505
55276;Landrecourt-Lempire;113;2600197;80160;67;2000276;46;599921;23011;19506
60345;Lamécourt;104;2393203;77308;68;1983629;36;409574;23012;19507
28103;Cloyes-sur-le-Loir;1646;37877082;1870251;901;29882470;745;7994612;23012;19508
16383;Tourriers;389;8951570;218375;221;7164566;168;1787004;23012;19509
17003;Aigrefeuille-d'Aunis;2036;46854776;1746358;1179;37452420;857;9402356;23013;19510
49064;Chambellay;176;4050395;151108;92;3077389;84;973006;23014;19511
25587;Vauchamps;66;1518905;29721;37;1176806;29;342099;23014;19512
02174;Chavignon;398;9159508;348896;218;7173857;180;1985651;23014;19513
01390;Saint-Vulbas;550;12657790;514699;315;10031876;235;2625914;23014;19514
55175;Érize-la-Brûlée;94;2163340;81603;57;1695696;37;467644;23014;19515
30150;Logrian-Florian;146;3360118;155324;70;2545488;76;814630;23015;19516
54271;Igney;66;1518973;32245;36;1151451;30;367522;23015;19517
69143;Neuville-sur-Saône;4234;97444855;4963087;2481;79085879;1753;18358976;23015;19518
2A139;Lecci;760;17491316;1012378;396;13698998;364;3792318;23015;19519
65073;Bazillac;182;4188768;199350;106;3365608;76;823160;23015;19520
68154;Illzach;7808;179702964;8333100;4445;142154583;3363;37548381;23015;19521
42130;Magneux-Haute-Rive;228;5247574;98902;150;4359754;78;887820;23016;19522
31423;Plagnole;164;3774681;204895;92;3045959;72;728722;23016;19523
24284;Montagnac-d'Auberoche;78;1795309;129804;36;1310293;42;485016;23017;19524
02166;Chartèves;221;5086737;229817;135;4307602;86;779135;23017;19525
61244;Mahéru;133;3061273;125536;65;2322239;68;739034;23017;19526
08355;Regniowez;193;4442596;199733;106;3560416;87;882180;23019;19527
07222;Saint-Cierge-sous-le-Cheylard;122;2808362;98037;83;2444857;39;363505;23019;19528
62763;Saint-Michel-sur-Ternoise;502;11555825;400699;270;8904013;232;2651812;23020;19529
79207;La Petite-Boissière;321;7389369;176574;182;5682733;139;1706636;23020;19530
04143;Oraison;3262;75091141;3503253;1812;59518350;1450;15572791;23020;19531
11153;La Force;115;2647328;78782;59;1994774;56;652554;23020;19532
17112;La Clisse;313;7205534;293477;186;5796784;127;1408750;23021;19533
59293;Haverskerque;783;18025383;646384;424;14098872;359;3926511;23021;19534
19150;Noailhac;216;4972557;228989;127;3976750;89;995807;23021;19535
30158;Martignargues;204;4696304;165568;114;3610815;90;1085489;23021;19536
62196;La Calotterie;331;7620103;316784;172;5931092;159;1689011;23021;19537
01098;Chazey-Bons;433;9969060;441730;262;8112359;171;1856701;23023;19538
53147;Mayenne;7525;173250728;8774865;4102;140766704;3423;32484024;23023;19539
21253;Étalante;93;2141179;101723;54;1670792;39;470387;23023;19540
26003;Aleyrac;26;598644;34567;12;470255;14;128389;23025;19541
34318;Vacquières;231;5318760;239213;121;4320944;110;997816;23025;19542
05149;Saint-Léger-les-Mélèzes;161;3707033;161085;92;2919123;69;787910;23025;19543
51601;Vavray-le-Grand;91;2095297;58962;49;1652768;42;442529;23025;19544
29097;Lampaul-Guimiliau;1077;24799201;738475;620;19236448;457;5562753;23026;19545
82040;Cayriech;128;2947352;94389;66;2205005;62;742347;23026;19546
25143;Chay;100;2302643;56873;55;1726958;45;575685;23026;19547
38073;Chantelouve;44;1013180;43594;24;795187;20;217993;23027;19548
08169;Flaignes-Havys;63;1450705;87530;27;967683;36;483022;23027;19549
59594;Thun-Saint-Amand;560;12895329;460062;293;10106128;267;2789201;23027;19550
27207;Drucourt;311;7161632;324660;187;6020154;124;1141478;23028;19551
42202;Saint-Barthélemy-Lestra;346;7967645;332139;187;6130379;159;1837266;23028;19552
08095;Chagny;93;2141607;81472;44;1454475;49;687132;23028;19553
73114;Flumet;484;11145723;524426;278;9089278;206;2056445;23028;19554
11217;Marcorignan;651;14991460;588569;344;11721503;307;3269957;23028;19555
60634;Thieux;204;4697844;128756;117;3679026;87;1018818;23029;19556
21269;Flammerans;221;5089540;175689;127;3972660;94;1116880;23030;19557
02240;Croix-Fonsomme;111;2556308;74967;59;2032098;52;524210;23030;19558
52075;Briaucourt;106;2441161;71595;69;2051449;37;389712;23030;19559
57154;Coume;347;7991455;235725;194;6028316;153;1963139;23030;19560
31124;Castillon-de-Saint-Martory;200;4606027;182061;123;3797427;77;808600;23030;19561
35118;Gahard;662;15246027;325037;380;11929198;282;3316829;23030;19562
44006;Assérac;1008;23214977;794548;526;17425626;482;5789351;23031;19563
03218;Saint-Aubin-le-Monial;156;3592848;137141;86;2964695;70;628153;23031;19564
25007;Adam-lès-Vercel;44;1013368;20555;30;823288;14;190080;23031;19565
94037;Gentilly;10009;230522988;15043721;5887;193885202;4122;36637786;23032;19566
49313;Saint-Pierre-Montlimart;1765;40651133;1432905;911;29900794;854;10750339;23032;19567
65335;Ordizan;283;6518143;306767;177;5626650;106;891493;23032;19568
39531;Thoiria;104;2395388;87967;59;1916298;45;479090;23033;19569
48105;Naussac;112;2579663;98426;70;2216305;42;363358;23033;19570
70445;Rignovelle;55;1266808;43590;31;1051266;24;215542;23033;19571
32108;Corneillan;64;1474129;54977;34;1103522;30;370607;23033;19572
02137;Bussiares;66;1520218;33747;33;1138662;33;381556;23034;19573
39247;Genod;33;760118;34148;14;545877;19;214241;23034;19574
35087;Cornillé;452;10411467;236336;276;8175318;176;2236149;23034;19575
76289;Fréville;466;10734663;400943;257;8281556;209;2453107;23036;19576
89181;Fournaudin;71;1635562;67178;44;1388188;27;247374;23036;19577
29204;Plounéventer;1035;23842484;623597;622;19248569;413;4593915;23036;19578
59198;Eppe-Sauvage;142;3271320;170786;78;2574598;64;696722;23037;19579
73121;Frontenex;985;22692050;972885;572;18197450;413;4494600;23038;19580
85218;Saint-Georges-de-Pointindoux;813;18729589;629501;489;15022279;324;3707310;23038;19581
91657;Vigneux-sur-Seine;15399;354770034;16776229;9133;291975507;6266;62794527;23039;19582
45257;Pressigny-les-Pins;248;5713685;188196;157;4635250;91;1078435;23039;19583
70477;Saulnot;397;9146620;388743;218;6968740;179;2177880;23039;19584
71166;Cuzy;74;1704943;65793;38;1287217;36;417726;23040;19585
12206;Roussennac;278;6405168;228430;151;4892146;127;1513022;23040;19586
33517;Soussans;834;19215620;805546;479;15507138;355;3708482;23040;19587
02348;Glennes;113;2603587;120665;60;2003085;53;600502;23041;19588
62499;Lépine;160;3686638;182673;81;2710996;79;975642;23041;19589
26001;Aix-en-Diois;194;4470114;151856;112;3514627;82;955487;23042;19590
88315;Mortagne;86;1981638;65441;52;1622941;34;358697;23042;19591
17155;Étaules;1365;31452805;1491123;730;24663286;635;6789519;23042;19592
80781;Vauvillers;134;3087677;157315;73;2365796;61;721881;23042;19593
38032;Beaufort;308;7097148;337309;172;5471644;136;1625504;23043;19594
54176;Einville-au-Jard;668;15394793;480753;370;12035996;298;3358797;23046;19595
41116;Lisle;110;2535086;94691;69;2063942;41;471144;23046;19596
70367;Mont-le-Vernois;78;1797669;52267;45;1387266;33;410403;23047;19597
43012;Aurec-sur-Loire;3147;72529106;3066883;1726;56599584;1421;15929522;23047;19598
38335;Revel-Tourdan;576;13275289;630601;312;10206309;264;3068980;23047;19599
85298;Vairé;819;18875880;609043;434;14535239;385;4340641;23047;19600
26261;Réauville;222;5116556;202307;121;4070179;101;1046377;23048;19601
30295;Saint-Quentin-la-Poterie;1777;40956341;2066013;933;32833567;844;8122774;23048;19602
49207;Montfort;60;1382891;33018;35;1031005;25;351886;23048;19603
33260;Lugos;435;10026042;296600;245;7650120;190;2375922;23048;19604
82159;Saint-Cirq;267;6154135;127773;144;4454105;123;1700030;23049;19605
53234;Saint-Loup-du-Gast;163;3757025;70327;86;2793012;77;964013;23049;19606
41132;Méhers;190;4379383;102367;97;3217654;93;1161729;23049;19607
52147;Courcelles-en-Montagne;50;1152480;48688;26;930523;24;221957;23050;19608
54353;Mars-la-Tour;515;11870568;441123;270;8985004;245;2885564;23050;19609
60533;Ressons-sur-Matz;871;20076274;1041630;485;16215847;386;3860427;23050;19610
24366;Saint-André-d'Allas;454;10464654;468884;258;8371974;196;2092680;23050;19611
37163;Nazelles-Négron;2104;48498280;1904447;1281;39098197;823;9400083;23051;19612
60078;Blincourt;65;1498307;72956;47;1318441;18;179866;23051;19613
76588;Saint-Hellier;236;5440084;239799;119;4054134;117;1385950;23051;19614
13066;Noves;3027;69776470;3289292;1590;55276999;1437;14499471;23051;19615
62888;Wierre-au-Bois;119;2743114;138871;71;2257352;48;485762;23051;19616
32269;Monfort;279;6431445;355497;160;5220201;119;1211244;23052;19617
88075;La Bresse;2536;58459738;2203683;1439;45601620;1097;12858118;23052;19618
55258;Geville;300;6915799;271315;151;5293977;149;1621822;23053;19619
69119;Longes;437;10074578;275998;261;7885908;176;2188670;23054;19620
88197;Gerbamont;186;4288071;104248;101;3248706;85;1039365;23054;19621
47069;Colayrac-Saint-Cirq;1649;38016420;2124650;875;30265425;774;7750995;23054;19622
88017;Aulnois;74;1706039;51186;42;1375694;32;330345;23055;19623
76459;Nesle-Hodeng;176;4057712;192782;90;3209254;86;848458;23055;19624
39218;Étrepigney;218;5026100;137048;130;4010062;88;1016038;23056;19625
82065;Gasques;235;5418075;174512;131;4197392;104;1220683;23056;19626
11085;Cavanac;468;10790066;477931;272;8693833;196;2096233;23056;19627
35056;La Chapelle-aux-Filtzméens;373;8600255;250423;200;6553614;173;2046641;23057;19628
45248;Patay;1098;25317088;937516;646;19602726;452;5714362;23057;19629
10333;Saint-André-les-Vergers;6948;160208507;8592147;4148;131149133;2800;29059374;23058;19630
15083;Jussac;1139;26263672;913165;613;19997108;526;6266564;23059;19631
72383;Vouvray-sur-Huisne;56;1291281;35200;33;1019175;23;272106;23059;19632
59101;Bousignies-sur-Roc;235;5418828;309650;137;4403131;98;1015697;23059;19633
27543;Saint-Georges-Motel;518;11944772;548978;313;10102402;205;1842370;23059;19634
66172;Saint-Estève;6647;153283673;7937646;3679;122425894;2968;30857779;23061;19635
38531;Velanne;276;6364743;222028;162;5049532;114;1315211;23061;19636
60167;Couloisy;277;6387807;305275;158;5095723;119;1292084;23061;19637
51010;Angluzelles-et-Courcelles;84;1937133;95997;45;1568994;39;368139;23061;19638
18213;Saint-Germain-du-Puy;2696;62172793;2742508;1600;50339174;1096;11833619;23061;19639
38058;Brézins;936;21585911;684754;525;16648637;411;4937274;23062;19640
83014;Baudinard-sur-Verdon;100;2306269;112011;54;1846549;46;459720;23063;19641
38425;Saint-Maurice-l'Exil;3069;70779535;2845340;1760;56599822;1309;14179713;23063;19642
17035;Bazauges;82;1891167;132772;33;1464766;49;426401;23063;19643
62515;Ligny-Thilloy;286;6596259;226682;164;5211227;122;1385032;23064;19644
35015;Balazé;1070;24678557;554401;644;19092478;426;5586079;23064;19645
17296;Rétaud;596;13746385;610710;318;10775073;278;2971312;23064;19646
76277;Le Fossé;247;5697009;225374;149;4703682;98;993327;23065;19647
2B224;Pietracorbara;357;8234247;507851;175;6349563;182;1884684;23065;19648
39539;Vadans;142;3275252;102156;71;2291271;71;983981;23065;19649
80633;Ponthoile;339;7819097;368235;174;6047325;165;1771772;23065;19650
60174;Crapeaumesnil;85;1960546;57493;51;1523689;34;436857;23065;19651
54475;Saint-Germain;81;1868286;68214;44;1414752;37;453534;23065;19652
14076;Blainville-sur-Orne;2978;68691800;2925100;1886;56943199;1092;11748601;23066;19653
40238;Pujo-le-Plan;302;6966091;224323;177;5542021;125;1424070;23067;19654
54015;Anderny;132;3044863;53400;46;1534831;86;1510032;23067;19655
25038;Avilley;86;1983787;58434;44;1361492;42;622295;23067;19656
80037;Aubvillers;65;1499376;52355;40;1250720;25;248656;23067;19657
60041;Bailleul-sur-Thérain;1086;25051982;1012387;653;20240566;433;4811416;23068;19658
60071;Biermont;85;1960841;70964;57;1611821;28;349020;23069;19659
29148;Mespaul;487;11234521;464420;232;8184970;255;3049551;23069;19660
14107;Bricqueville;84;1937782;93013;54;1694772;30;243010;23069;19661
24361;Saint-Agne;230;5305875;253741;130;4146141;100;1159734;23069;19662
14563;Saint-Benoît-d'Hébertot;214;4936912;161466;118;3747041;96;1189871;23070;19663
27505;Saint-Agnan-de-Cernières;85;1960931;129709;47;1648855;38;312076;23070;19664
64209;Escout;233;5375298;216689;139;4338634;94;1036664;23070;19665
22306;Saint-Judoce;295;6805882;213464;162;5388487;133;1417395;23071;19666
66145;Ponteilla;1444;33315410;1268519;800;26135375;644;7180035;23072;19667
38198;Jarcieu;568;13104765;549235;325;10455341;243;2649424;23072;19668
68292;Saint-Amarin;1307;30155055;1400951;768;24162947;539;5992108;23072;19669
39188;Dammartin-Marpain;153;3530095;95468;90;2742358;63;787737;23073;19670
60667;Verberie;2174;50160344;2414357;1284;40374507;890;9785837;23073;19671
79269;Saint-Maixent-de-Beugné;189;4360813;91231;96;3053363;93;1307450;23073;19672
01057;Boz;245;5652938;192666;150;4615764;95;1037174;23073;19673
52014;Aprey;103;2376547;78647;54;1799906;49;576641;23073;19674
38523;Varacieux;438;10106345;377206;246;7863181;192;2243164;23074;19675
65244;Lagarde;256;5906946;193209;142;4556422;114;1350524;23074;19676
18170;Oizon;420;9691258;521463;246;7910533;174;1780725;23074;19677
09147;Labatut;74;1707514;52861;50;1471684;24;235830;23075;19678
61200;Haleine;133;3068954;108207;83;2421642;50;647312;23075;19679
14687;Le Theil-en-Auge;89;2053818;95548;64;1849406;25;204412;23077;19680
22364;Trélivan;1382;31892216;1124948;818;25629034;564;6263182;23077;19681
25535;Saules;121;2792343;91631;76;2263294;45;529049;23077;19682
62488;Landrethun-lès-Ardres;346;7984821;244442;183;6235145;163;1749676;23078;19683
08371;Rubécourt-et-Lamécourt;84;1938559;95180;42;1535062;42;403497;23078;19684
87110;Oradour-sur-Glane;1285;29655658;1285022;701;23418817;584;6236841;23078;19685
58280;Sougy-sur-Loire;349;8054484;351619;221;6670551;128;1383933;23079;19686
36117;Le Menoux;269;6208313;347588;152;4910621;117;1297692;23079;19687
30235;Saint-Bonnet-du-Gard;411;9485688;417000;206;7237447;205;2248241;23080;19688
29145;Confort-Meilars;467;10778316;324884;274;8588683;193;2189633;23080;19689
65357;Peyraube;83;1915660;61098;48;1512922;35;402738;23080;19690
59284;Hasnon;2005;46276334;2005620;1117;37153978;888;9122356;23080;19691
74081;Cluses;9875;227922765;10315962;5625;180114698;4250;47808067;23081;19692
80789;Vermandovillers;72;1661826;84415;39;1272633;33;389193;23081;19693
68283;Rombach-le-Franc;478;11032788;427982;295;9118112;183;1914676;23081;19694
52529;Villegusien-le-Lac;443;10224959;408999;258;8095547;185;2129412;23081;19695
72202;Monhoudou;120;2769747;96659;68;2062905;52;706842;23081;19696
35330;Taillis;470;10848305;173700;247;7921149;223;2927156;23082;19697
76144;Bretteville-Saint-Laurent;92;2123548;53399;54;1668555;38;454993;23082;19698
57398;Leyviller;245;5655364;215057;137;4392148;108;1263216;23083;19699
71188;Épertully;36;830994;37448;22;664627;14;166367;23083;19700
26118;Épinouze;750;17312433;563855;417;13454742;333;3857691;23083;19701
54130;Clayeures;96;2216080;84814;51;1698342;45;517738;23084;19702
30182;Montpezat;529;12211543;592233;264;9606684;265;2604859;23084;19703
63151;Escoutoux;727;16782253;570374;425;13198698;302;3583555;23084;19704
10432;Villiers-sous-Praslin;40;923377;48412;23;702529;17;220848;23084;19705
62567;Mentque-Nortbécourt;305;7040821;228650;166;5451460;139;1589361;23085;19706
39481;Saint-Germain-en-Montagne;237;5471088;143775;142;4257083;95;1214005;23085;19707
76086;Bertrimont;109;2516276;57585;68;2034288;41;481988;23085;19708
58256;Saint-Martin-sur-Nohain;217;5009566;222939;121;3921222;96;1088344;23086;19709
39011;Annoire;216;4986643;254070;121;3966950;95;1019693;23086;19710
55011;Andernay;133;3070491;112780;76;2415832;57;654659;23086;19711
76192;Criel-sur-Mer;1672;38600833;1882995;944;31220881;728;7379952;23087;19712
64089;Baleix;79;1823860;99108;46;1466361;33;357499;23087;19713
89219;Lasson;80;1847050;72815;49;1502580;31;344470;23088;19714
62173;Brebières;2507;57882393;2283399;1400;45423577;1107;12458816;23088;19715
29053;Le Faou;1019;23527955;870405;545;17884077;474;5643878;23089;19716
40117;Grenade-sur-l'Adour;1363;31471019;1357926;773;25071461;590;6399558;23090;19717
73262;Saint-Nicolas-la-Chapelle;246;5680149;254579;148;4626623;98;1053526;23090;19718
88163;Essegney;394;9097499;317582;213;6960800;181;2136699;23090;19719
01114;Confort;335;7735298;229847;168;5545674;167;2189624;23090;19720
08392;Saint-Morel;116;2678518;117791;70;2177504;46;501014;23091;19721
43211;Saint-Maurice-de-Lignon;1256;29001990;967660;666;22143088;590;6858902;23091;19722
80367;Frise;94;2170562;82099;52;1697905;42;472657;23091;19723
02552;Neuvillette;99;2286100;109559;53;1813122;46;472978;23092;19724
57081;Bidestroff;68;1570251;66149;36;1195691;32;374560;23092;19725
82027;Campsas;588;13578263;440546;305;10426462;283;3151801;23092;19726
53187;Ravigny;123;2840356;70021;68;2212359;55;627997;23092;19727
27415;Morainville-Jouveaux;218;5034337;259371;124;4120219;94;914118;23093;19728
60350;Lassigny;734;16950566;820178;422;13571175;312;3379391;23093;19729
56141;Moustoir-Ac;897;20715256;703912;518;16484884;379;4230372;23094;19730
80288;Estrées-Deniécourt;168;3879790;210268;90;3012798;78;866992;23094;19731
09209;Montjoie-en-Couserans;618;14272167;641396;335;11262855;283;3009312;23094;19732
22258;Quessoy;1907;44040982;1607227;1137;35354457;770;8686525;23094;19733
33301;Naujan-et-Postiac;291;6720493;228859;158;5237965;133;1482528;23094;19734
28255;Moinville-la-Jeulin;63;1454972;45373;41;1191394;22;263578;23095;19735
62271;Dohem;365;8429738;379372;197;6500846;168;1928892;23095;19736
52294;Louvemont;377;8707315;343447;208;6611930;169;2095385;23096;19737
76452;Montville;2591;59842776;2456649;1494;48175505;1097;11667271;23096;19738
39458;Revigny;161;3718533;207786;103;3080580;58;637953;23096;19739
50371;Le Neufbourg;246;5681744;236461;136;4403365;110;1278379;23097;19740
85101;Le Givre;232;5358405;177153;125;4165720;107;1192685;23097;19741
22082;Le Hinglé;472;10901802;408643;276;8583525;196;2318277;23097;19742
54268;Housséville;91;2101851;62055;50;1626676;41;475175;23097;19743
65256;Lanespède;87;2009466;108964;46;1654400;41;355066;23097;19744
80593;La Neuville-lès-Bray;160;3695616;107585;104;3095607;56;600009;23098;19745
31086;Bouzin;44;1016295;24726;25;742653;19;273642;23098;19746
77468;Torcy;12083;279089124;13744194;7264;230463004;4819;48626120;23098;19747
51520;Saint-Utin;49;1131807;47327;26;818054;23;313753;23098;19748
33495;Salignac;802;18524795;643115;447;14685897;355;3838898;23098;19749
59422;Naves;336;7761193;319563;189;6231814;147;1529379;23099;19750
85131;Les Magnils-Reigniers;806;18617863;671351;502;14943533;304;3674330;23099;19751
25584;Valoreille;54;1247355;20335;30;929125;24;318230;23099;19752
76129;Boudeville;100;2309949;76499;53;1811707;47;498242;23099;19753
62117;Bertincourt;478;11041963;486380;237;8199358;241;2842605;23100;19754
50089;Brucheville;76;1755702;90158;35;1301331;41;454371;23101;19755
74110;Entremont;352;8131841;274687;219;6640747;133;1491094;23102;19756
88469;Thiraucourt;57;1316806;53516;35;1011326;22;305480;23102;19757
80778;Vauchelles-lès-Domart;63;1455421;47664;41;1217682;22;237739;23102;19758
64530;Susmiou;175;4042875;130176;99;3244397;76;798478;23102;19759
37002;Ambillou;894;20653510;748231;503;16565914;391;4087596;23102;19760
73023;Aussois;413;9541361;386174;258;7772260;155;1769101;23103;19761
50057;Biville;270;6237701;189355;168;5036299;102;1201402;23103;19762
18013;Arpheuilles;183;4227842;137153;112;3265330;71;962512;23103;19763
01125;Corveissiat;339;7831954;313047;207;6334473;132;1497481;23103;19764
70444;La Résie-Saint-Martin;73;1686534;64714;36;1172373;37;514161;23103;19765
46106;Floirac;162;3742807;181817;75;2891886;87;850921;23104;19766
47155;Madaillan;353;8155892;344567;189;6589499;164;1566393;23105;19767
52397;Poiseul;41;947305;41030;27;829031;14;118274;23105;19768
39207;Écrille;34;785586;24246;14;505694;20;279892;23105;19769
59351;Limont-Fontaine;296;6839252;304763;171;5520936;125;1318316;23106;19770
10092;Chauffour-lès-Bailly;62;1432547;39967;42;1180950;20;251597;23106;19771
62425;Hendecourt-lès-Ransart;70;1617400;62966;33;1245630;37;371770;23106;19772
73021;Arvillard;453;10467231;488574;260;8449596;193;2017635;23106;19773
22030;Caouënnec-Lanvézéac;433;10005228;283943;251;7828836;182;2176392;23107;19774
70506;Trémoins;195;4505880;169943;129;3774203;66;731677;23107;19775
07152;Mauves;646;14927361;599186;378;11906180;268;3021181;23107;19776
76387;Lindebeuf;178;4113146;115554;100;3252497;78;860649;23108;19777
41019;Boisseau;60;1386508;58787;30;1042808;30;343700;23108;19778
55554;Villécloye;137;3165923;124437;72;2284891;65;881032;23109;19779
18229;Saint-Palais;344;7949510;309300;198;6424099;146;1525411;23109;19780
88140;Dombrot-le-Sec;203;4691154;171550;114;3609584;89;1081570;23109;19781
85104;Grues;512;11831899;599365;286;9408674;226;2423225;23109;19782
05148;Saint-Laurent-du-Cros;287;6632371;224282;138;4812400;149;1819971;23109;19783
02798;Viels-Maisons;568;13126121;550429;319;10398381;249;2727740;23109;19784
17441;Tesson;547;12641039;625956;300;10198265;247;2442774;23110;19785
55037;Beaufort-en-Argonne;90;2079895;110550;46;1605128;44;474767;23110;19786
27303;Guernanville;46;1063058;32557;25;794274;21;268784;23110;19787
81185;Montvalen;131;3027433;149402;70;2383843;61;643590;23110;19788
42313;Trelins;322;7441825;305696;191;5920104;131;1521721;23111;19789
50135;Clitourps;91;2103231;62513;48;1611080;43;492151;23112;19790
54452;Reillon;39;901391;23640;23;655739;16;245652;23113;19791
39288;Lavigny;199;4599487;178926;120;3699762;79;899725;23113;19792
10238;Mesnil-Saint-Père;250;5778257;230088;142;4622596;108;1155661;23113;19793
27379;Mainneville;214;4946279;132369;136;4046461;78;899818;23113;19794
65291;Lugagnan;89;2057102;117136;48;1668179;41;388923;23114;19795
14588;Saint-Germain-Langot;159;3675363;117572;86;2842394;73;832969;23115;19796
41183;Prénouvellon;129;2981911;161278;72;2362095;57;619816;23116;19797
35108;Essé;536;12390487;236487;306;9530269;230;2860218;23117;19798
56053;Elven;2802;64773997;2185982;1571;50658465;1231;14115532;23117;19799
19153;Objat;2210;51088897;2067107;1152;39470597;1058;11618300;23117;19800
80823;Warvillers;72;1664447;52247;34;1240523;38;423924;23117;19801
27578;Saint-Ouen-d'Attez;141;3259576;113316;81;2714338;60;545238;23118;19802
38104;Chimilin;748;17292932;598948;456;13934496;292;3358436;23119;19803
33019;Audenge;3942;91135337;3903470;2289;72917636;1653;18217701;23119;19804
56004;Arzal;806;18634097;651966;456;14523749;350;4110348;23119;19805
32142;Gavarret-sur-Aulouste;80;1849542;78957;42;1502038;38;347504;23119;19806
59622;Villers-en-Cauchies;656;15166839;779203;342;11771203;314;3395636;23120;19807
62901;Wittes;419;9687966;294582;237;7687021;182;2000945;23122;19808
86020;Bellefonds;128;2959582;109925;78;2365999;50;593583;23122;19809
62024;Alquines;424;9803660;474579;189;7122203;235;2681457;23122;19810
62483;Lacres;121;2797745;88988;63;2102341;58;695404;23122;19811
95101;Bray-et-Lû;473;10937168;358086;274;8413695;199;2523473;23123;19812
35279;Saint-Guinoux;506;11700229;318352;299;9138905;207;2561324;23123;19813
80649;Quend;876;20257262;1037857;460;16095299;416;4161963;23125;19814
72277;Saint-Denis-des-Coudrais;67;1549401;35015;39;1271011;28;278390;23125;19815
79025;Azay-sur-Thouet;573;13250881;574320;289;9962452;284;3288429;23125;19816
73087;Cognin;3433;79391799;3710066;2072;64429306;1361;14962493;23126;19817
32189;Lannemaignan;66;1526339;79562;35;1160899;31;365440;23126;19818
57208;Farschviller;754;17437403;624867;392;12940611;362;4496792;23127;19819
57276;Guinglange;142;3283986;60255;85;2501097;57;782889;23127;19820
76480;Ocqueville;233;5388523;181678;123;4009380;110;1379143;23127;19821
47255;Saint-Martin-de-Beauville;100;2312672;132026;46;1755598;54;557074;23127;19822
72270;Saint-Calez-en-Saosnois;89;2058292;59625;59;1805261;30;253031;23127;19823
08225;Herpy-l'Arlésienne;111;2567153;116174;65;2053251;46;513902;23128;19824
22376;Trévé;827;19126463;703316;469;15245200;358;3881263;23128;19825
61070;Caligny;464;10731481;369023;278;8522930;186;2208551;23128;19826
29279;Taulé;1656;38300572;1720337;889;30036813;767;8263759;23128;19827
67165;Grandfontaine;219;5065141;212845;124;3944799;95;1120342;23128;19828
04021;Barras;72;1665276;31433;43;1252288;29;412988;23129;19829
65451;Trébons;412;9529152;344332;249;7838445;163;1690707;23129;19830
39310;Mantry;268;6199077;234987;148;4826837;120;1372240;23131;19831
17201;La Laigne;219;5065757;281842;99;3858487;120;1207270;23131;19832
61127;La Courbe;29;670835;34281;14;512749;15;158086;23132;19833
33054;Blaignac;150;3469871;158408;88;2832851;62;637020;23132;19834
07229;Saint-Didier-sous-Aubenas;474;10964849;380978;278;8692693;196;2272156;23133;19835
70155;Citers;422;9762017;259033;243;7602941;179;2159076;23133;19836
08473;Vieux-lès-Asfeld;161;3724536;125197;95;2968146;66;756390;23134;19837
02532;Moÿ-de-l'Aisne;554;12816132;599454;288;9812288;266;3003844;23134;19838
71216;Germagny;98;2267198;53501;53;1684581;45;582617;23135;19839
94028;Créteil;49350;1141809403;70260672;27820;950584654;21530;191224749;23137;19840
03029;Billy;473;10943894;515550;279;8896844;194;2047050;23137;19841
40183;Mimbaste;564;13049381;602259;307;10144776;257;2904605;23137;19842
59645;Wasnes-au-Bac;286;6617307;280891;145;4977407;141;1639900;23137;19843
27267;Freneuse-sur-Risle;205;4743196;242201;123;3898364;82;844832;23138;19844
30187;Navacelles;167;3864009;260553;76;2874514;91;989495;23138;19845
15266;Yolet;303;7010833;217510;181;5705520;122;1305313;23138;19846
39338;Molay;283;6548124;233128;188;5425771;95;1122353;23138;19847
86144;Maisonneuve;179;4141748;215307;90;3205579;89;936169;23138;19848
46024;Belmont-Bretenoux;209;4835907;222452;125;4040250;84;795657;23138;19849
67371;La Petite-Pierre;392;9070257;417529;213;6936363;179;2133894;23138;19850
08222;Haybes;1046;24202925;791985;554;18096865;492;6106060;23139;19851
11356;Saint-Martin-Lalande;566;13096433;481477;330;10490937;236;2605496;23139;19852
50243;Heugueville-sur-Sienne;297;6872185;304438;155;5152677;142;1719508;23139;19853
54457;Remoncourt;23;532197;17688;11;400463;12;131734;23139;19854
57620;Sainte-Marie-aux-Chênes;2082;48176021;1875782;1156;37109346;926;11066675;23139;19855
60278;Golancourt;201;4651090;192330;118;3778965;83;872125;23140;19856
68204;Metzeral;585;13536776;488586;331;10709398;254;2827378;23140;19857
54174;Écrouves;2175;50329431;1836559;1360;41387238;815;8942193;23140;19858
62067;Avroult;276;6386651;288567;145;4961395;131;1425256;23140;19859
58265;Saint-Quentin-sur-Nohain;74;1712370;84393;41;1411894;33;300476;23140;19860
80571;Morisel;272;6294193;254702;166;5092051;106;1202142;23140;19861
88501;Le Vermont;42;971898;38971;26;754482;16;217416;23140;19862
41070;Couture-sur-Loir;264;6109198;259881;153;4819378;111;1289820;23141;19863
73236;Saint-Genix-sur-Guiers;1289;29829600;1490251;704;23621436;585;6208164;23142;19864
39076;La Bretenière;106;2453068;66781;64;1914955;42;538113;23142;19865
37183;Perrusson;814;18838052;848267;449;14854262;365;3983790;23143;19866
61149;Échalou;180;4165684;122764;100;3146685;80;1018999;23143;19867
57354;Juville;70;1620008;63530;41;1307449;29;312559;23143;19868
56175;Plumergat;1932;44714118;1291691;1124;35997663;808;8716455;23144;19869
51121;Champvoisy;134;3101310;157813;73;2400339;61;700971;23144;19870
30093;Conqueyrac;52;1203507;52455;28;915143;24;288364;23144;19871
18066;Civray;533;12335956;481655;341;10225216;192;2110740;23144;19872
62099;Beaurains;2813;65105925;2829862;1656;53100638;1157;12005287;23145;19873
14699;Touques;2556;59158491;3504589;1478;48520360;1078;10638131;23145;19874
29167;Plogastel-Saint-Germain;1005;23260906;792718;584;18790084;421;4470822;23145;19875
73039;Belmont-Tramonet;296;6851448;321873;159;5442459;137;1408989;23147;19876
70192;Cugney;95;2198951;109668;53;1777144;42;421807;23147;19877
73207;Presle;245;5671099;208667;148;4600635;97;1070464;23147;19878
41101;Herbault;665;15393344;604595;405;12292820;260;3100524;23148;19879
02393;Jouaignes;82;1898236;60926;45;1465511;37;432725;23149;19880
64036;Arbouet-Sussaute;151;3495592;91692;77;2649657;74;845935;23150;19881
64491;Saint-Médard;109;2523518;74237;53;1944657;56;578861;23152;19882
22042;Coatréven;253;5857409;283286;125;4395593;128;1461816;23152;19883
21382;Marcilly-Ogny;117;2708764;141220;58;2033452;59;675312;23152;19884
27083;Bonneville-Aptot;126;2917272;106812;78;2380537;48;536735;23153;19885
21507;Premières;71;1643862;39269;49;1416456;22;227406;23153;19886
27274;Gaillardbois-Cressenville;212;4908703;198019;127;3949776;85;958927;23154;19887
76474;Notre-Dame-de-Bondeville;3854;89237529;3899870;2249;74524157;1605;14713372;23155;19888
14697;L'Oudon;744;17227428;683176;409;13384612;335;3842816;23155;19889
46046;Calamane;244;5649874;218383;140;4451896;104;1197978;23155;19890
89324;Rogny-les-Sept-Écluses;458;10605228;559434;260;8579098;198;2026130;23156;19891
28287;Orgères-en-Beauce;549;12712410;687484;275;9438801;274;3273609;23156;19892
64156;Buziet;241;5580534;203695;129;4251008;112;1329526;23156;19893
03045;Busset;485;11230694;401332;258;8852581;227;2378113;23156;19894
39564;Villechantria;70;1620925;120932;35;1244261;35;376664;23156;19895
41036;Chaon;266;6159583;238990;139;4878715;127;1280868;23156;19896
05071;Lardier-et-Valença;170;3936693;164829;87;3088403;83;848290;23157;19897
71137;Cluny;2510;58124302;2957444;1378;46042757;1132;12081545;23157;19898
88400;Rouvres-en-Xaintois;169;3913609;115937;88;3003292;81;910317;23157;19899
88040;Bayecourt;137;3172731;96189;84;2542434;53;630297;23159;19900
11264;Névian;697;16141625;582704;351;12182163;346;3959462;23159;19901
85295;Treize-Septiers;1525;35317406;994197;924;28009588;601;7307818;23159;19902
45150;Fréville-du-Gâtinais;106;2454860;107748;64;1961882;42;492978;23159;19903
54024;Arraye-et-Han;157;3635988;123074;95;3010336;62;625652;23159;19904
88458;Socourt;134;3103362;104624;78;2315345;56;788017;23159;19905
80468;Laviéville;81;1875924;37306;44;1425063;37;450861;23160;19906
18223;Saint-Martin-d'Auxigny;1253;29019352;1132181;753;23794135;500;5225217;23160;19907
59054;Bavinchove;492;11395007;500634;265;8742905;227;2652102;23161;19908
32216;Lourties-Monbrun;68;1574923;51514;42;1331331;26;243592;23161;19909
83127;Signes;1574;36455002;1702779;839;28740305;735;7714697;23161;19910
52194;Eurville-Bienville;1138;26357023;1221272;623;20426205;515;5930818;23161;19911
49355;Trémentines;1485;34393837;871659;896;27182726;589;7211111;23161;19912
29205;Plounévézel;593;13734771;469452;360;11117720;233;2617051;23162;19913
47253;Sainte-Marthe;257;5952555;160853;134;4605738;123;1346817;23162;19914
76704;Tourville-la-Chapelle;287;6647549;223588;171;5163584;116;1483965;23162;19915
80687;Rubescourt;71;1644518;84379;40;1272385;31;372133;23162;19916
81128;Lacrouzette;972;22513859;1123747;464;16855286;508;5658573;23162;19917
64231;Garindein;277;6415995;238591;158;4932685;119;1483310;23162;19918
62758;Saint-Martin-Boulogne;6284;145553245;8084778;3262;115887908;3022;29665337;23163;19919
83066;Ginasservis;781;18090167;639928;396;13620665;385;4469502;23163;19920
32328;Pouy-Roquelaure;77;1783552;84484;33;1301624;44;481928;23163;19921
39513;Sermange;138;3196536;128941;74;2437443;64;759093;23163;19922
83149;Villecroze;798;18484379;869354;421;14319925;377;4164454;23163;19923
40329;Le Vignau;265;6138438;313000;144;4937775;121;1200663;23164;19924
54442;Quevilloncourt;60;1389848;68172;37;1166721;23;223127;23164;19925
60470;Noyers-Saint-Martin;407;9427858;456524;232;7558018;175;1869840;23164;19926
69186;Saint-Clément-de-Vers;120;2779751;143678;61;2184641;59;595110;23165;19927
50433;Réville;691;16007242;712731;354;12334744;337;3672498;23165;19928
22235;Plouzélambre;118;2733559;77357;59;1946637;59;786922;23166;19929
59520;Rumilly-en-Cambrésis;780;18069591;797371;416;14199643;364;3869948;23166;19930
04138;Niozelles;165;3822451;153813;95;2900622;70;921829;23166;19931
73106;École;168;3891976;173544;99;3151785;69;740191;23167;19932
02471;Martigny-Courpierre;65;1505836;39969;35;1147862;30;357974;23167;19933
83099;Puget-sur-Argens;4157;96304639;5012656;2305;77729001;1852;18575638;23167;19934
88126;Darnieulles;758;17560659;530195;464;14220166;294;3340493;23167;19935
58222;Rix;108;2502054;125874;70;2100407;38;401647;23167;19936
27681;Vernon;13723;317923805;18337906;7363;257948008;6360;59975797;23167;19937
76327;Greuville;192;4448156;154988;111;3563872;81;884284;23167;19938
73063;Cevins;410;9498819;556844;263;7868533;147;1630286;23168;19939
72136;Fontenay-sur-Vègre;169;3915371;148549;88;3040781;81;874590;23168;19940
51157;Coizard-Joches;61;1413253;82178;37;1151792;24;261461;23168;19941
17364;Saint-Martial-sur-Né;225;5212832;213400;117;4021845;108;1190987;23168;19942
38356;Saint-André-en-Royans;183;4239876;169591;101;3281438;82;958438;23169;19943
63092;Charbonnières-les-Varennes;868;20110701;728894;545;16698804;323;3411897;23169;19944
11368;Sallèles-Cabardès;58;1343849;70883;28;1045960;30;297889;23170;19945
17018;Ardillières;408;9453326;281959;232;7485080;176;1968246;23170;19946
28150;La Ferté-Villeneuil;236;5468271;246170;139;4468050;97;1000221;23171;19947
54010;Allamps;263;6094041;144231;152;4783070;111;1310971;23171;19948
70184;Couthenans;428;9917483;350296;270;8200369;158;1717114;23172;19949
31323;Martres-de-Rivière;206;4773413;156304;123;3843102;83;930311;23172;19950
40036;Bénesse-Maremne;1362;31560457;1328601;784;25423240;578;6137217;23172;19951
03076;Chézy;112;2595350;82288;73;2230823;39;364527;23173;19952
39431;Poids-de-Fiole;164;3800334;131248;97;3026607;67;773727;23173;19953
41135;Mennetou-sur-Cher;523;12119400;513872;284;9470729;239;2648671;23173;19954
27304;Guerny;91;2108835;77504;59;1738369;32;370466;23174;19955
57599;Roupeldange;195;4518963;152483;112;3443024;83;1075939;23174;19956
59060;Beaurain;103;2386959;78187;55;1920165;48;466794;23174;19957
18090;Étréchy;245;5677834;203155;135;4485782;110;1192052;23175;19958
26337;Saulce-sur-Rhône;980;22711918;574327;534;17597231;446;5114687;23175;19959
21257;Étormay;31;718451;11748;13;469903;18;248548;23176;19960
39354;Montholier;190;4403462;191954;101;3444053;89;959409;23176;19961
38370;Saint-Bonnet-de-Chavagne;330;7648135;217297;172;5818339;158;1829796;23176;19962
86030;Blaslay;300;6952875;287867;166;5592561;134;1360314;23176;19963
17009;Angliers;412;9548930;276165;259;7800858;153;1748072;23177;19964
57666;Terville;3766;87285873;2748514;1649;54961813;2117;32324060;23177;19965
76360;Heugleville-sur-Scie;314;7277813;244492;174;5664524;140;1613289;23178;19966
38174;La Frette;601;13930203;631159;338;11004073;263;2926130;23178;19967
13043;Gignac-la-Nerthe;5408;125352188;5682609;3143;103540737;2265;21811451;23179;19968
64485;Saint-Jean-Pied-de-Port;923;21394539;981248;418;16610301;505;4784238;23179;19969
72185;Mareil-sur-Loir;307;7116086;270434;181;5700971;126;1415115;23179;19970
77519;Villiers-Saint-Georges;613;14209337;754316;304;10673521;309;3535816;23180;19971
09163;Lescousse;52;1205362;206854;14;856230;38;349132;23180;19972
22275;Saint-Barnabé;668;15484967;566104;396;12358325;272;3126642;23181;19973
63466;Vodable;108;2503575;88994;63;1873033;45;630542;23181;19974
79127;La Foye-Monjault;425;9852097;310647;239;7760889;186;2091208;23181;19975
66094;Latour-Bas-Elne;1243;28815949;1200466;697;22641539;546;6174410;23183;19976
63003;Ambert;4095;94933737;4657159;2148;75076972;1947;19856765;23183;19977
88079;Bulgnéville;807;18708929;820043;483;15026847;324;3682082;23183;19978
89279;Noyers;403;9343190;594373;191;7015783;212;2327407;23184;19979
54067;Beuveille;396;9181574;146257;167;5145562;229;4036012;23186;19980
61004;Antoigny;66;1530270;43385;32;1144366;34;385904;23186;19981
41175;Pezou;616;14282750;520374;358;11376933;258;2905817;23186;19982
40283;Saint-Vincent-de-Paul;1693;39254485;1776590;958;31550201;735;7704284;23186;19983
34017;Aumes;232;5379233;283426;115;4117327;117;1261906;23186;19984
10384;Trannes;137;3176618;171824;77;2585211;60;591407;23187;19985
55409;Pretz-en-Argonne;35;811545;26449;19;643382;16;168163;23187;19986
59664;Wulverdinghe;137;3176722;129744;77;2556203;60;620519;23188;19987
05099;Oze;45;1043511;27772;25;820565;20;222946;23189;19988
65459;Uzer;50;1159460;32112;28;858491;22;300969;23189;19989
58098;Dirol;72;1669685;77125;36;1344328;36;325357;23190;19990
60462;Noailles;1471;34114241;1684258;863;27438617;608;6675624;23191;19991
22375;Tressignaux;339;7861919;309167;180;6023078;159;1838841;23192;19992
59077;Bettrechies;132;3061283;142877;73;2444094;59;617189;23192;19993
25339;Lods;131;3038118;163572;71;2360328;60;677790;23192;19994
76254;Étretat;939;21777175;1367020;513;17499657;426;4277518;23192;19995
49198;Meigné;161;3733917;158260;81;2906857;80;827060;23192;19996
89118;Coulanges-la-Vineuse;502;11643059;407718;258;8913332;244;2729727;23193;19997
57122;Cappel;379;8790466;294317;223;6815948;156;1974518;23194;19998
73278;Saint-Rémy-de-Maurienne;703;16305420;613597;423;13215317;280;3090103;23194;19999
60173;Cramoisy;490;11365244;503495;316;9725014;174;1640230;23194;20000
59560;Seclin;6801;157746389;8325932;3845;129003025;2956;28743364;23195;20001
45187;Lorris;1687;39129704;2299147;840;30062706;847;9066998;23195;20002
55553;Vignot;696;16143738;765359;384;12634697;312;3509041;23195;20003
89378;Sauvigny-le-Bois;414;9602835;429257;266;7990221;148;1612614;23195;20004
64112;Bérenx;236;5474190;274916;135;4323811;101;1150379;23196;20005
72347;Tassé;135;3131503;63944;74;2381642;61;749861;23196;20006
52312;Mardor;32;742290;23866;19;571017;13;171273;23197;20007
38304;Pierre-Châtel;811;18812500;730147;469;15156305;342;3656195;23197;20008
2A115;Foce;75;1739758;101236;44;1491780;31;247978;23197;20009
81225;Rivières;501;11621604;414164;302;9513708;199;2107896;23197;20010
76456;Motteville;389;9023644;313085;211;7009227;178;2014417;23197;20011
89063;La Celle-Saint-Cyr;464;10764217;422612;290;8704428;174;2059789;23199;20012
70254;Frédéric-Fontaine;128;2969494;104308;66;2287754;62;681740;23199;20013
24282;Monsaguel;90;2087981;58696;44;1516613;46;571368;23200;20014
79049;Bressuire;9988;231719725;9779618;5366;182484348;4622;49235377;23200;20015
37067;Cheillé;907;21042572;636608;534;16837731;373;4204841;23200;20016
17444;Thénac;813;18861771;726075;464;14951178;349;3910593;23200;20017
80043;Authie;137;3178431;132764;68;2383449;69;794982;23200;20018
64346;Lombia;114;2644870;128749;58;2062268;56;582602;23201;20019
08384;Saint-Lambert-et-Mont-de-Jeux;102;2366504;160866;51;1872704;51;493800;23201;20020
40148;Lauret;43;997650;35913;24;840185;19;157465;23201;20021
40157;Lit-et-Mixe;971;22528463;1113383;551;18041500;420;4486963;23201;20022
31292;Lescuns;41;951288;62054;19;745105;22;206183;23202;20023
33303;Nérigean;472;10951432;473303;250;8632555;222;2318877;23202;20024
30356;Rodilhan;1580;36659500;1427614;922;29857768;658;6801732;23202;20025
32411;Sansan;52;1206605;54297;31;957078;21;249527;23204;20026
34182;Nézignan-l'Évêque;880;20419652;770254;467;16031448;413;4388204;23204;20027
80321;Folleville;74;1717128;21600;44;1309313;30;407815;23204;20028
37120;Ingrandes-de-Touraine;283;6566887;299656;164;5179530;119;1387357;23205;20029
47006;Allez-et-Cazeneuve;337;7819963;296093;200;6317009;137;1502954;23205;20030
09175;Ludiès;37;858577;19795;24;708860;13;149717;23205;20031
80216;Courcelette;80;1856420;76828;44;1450888;36;405532;23205;20032
06114;Saint-André-de-la-Roche;2830;65675610;3490272;1580;53450420;1250;12225190;23207;20033
80080;Belloy-en-Santerre;91;2111842;91318;53;1680463;38;431379;23207;20034
16201;Mainfonds;106;2459981;106360;59;1970186;47;489795;23207;20035
18214;Saint-Hilaire-de-Court;360;8354668;292700;226;6863248;134;1491420;23207;20036
39296;Lombard;110;2552836;87696;73;2184794;37;368042;23208;20037
84149;Violès;882;20469583;927658;476;16003645;406;4465938;23208;20038
10089;Châtres;377;8749613;359854;213;6903502;164;1846111;23209;20039
85084;Les Essarts;2656;61645686;2123174;1477;48465717;1179;13179969;23210;20040
33076;Budos;407;9446720;354397;238;7473599;169;1973121;23211;20041
31026;Auriac-sur-Vendinelle;562;13044857;597664;308;10225356;254;2819501;23211;20042
70536;Velle-le-Châtel;80;1856928;60438;48;1461824;32;395104;23212;20043
64200;Doazon;94;2181897;79738;53;1758644;41;423253;23212;20044
89156;Esnon;211;4897739;173154;140;4023238;71;874501;23212;20045
28259;Montboissier;172;3992694;143400;106;3218715;66;773979;23213;20046
73212;Randens;482;11188858;380546;303;9138587;179;2050271;23213;20047
68215;Montreux-Vieux;483;11212306;475507;278;9015431;205;2196875;23214;20048
59514;Rousies;2360;54785172;3045457;1246;43398811;1114;11386361;23214;20049
14002;Acqueville;87;2019692;53390;53;1666708;34;352984;23215;20050
14489;Ouville-la-Bien-Tournée;131;3041159;133358;72;2372655;59;668504;23215;20051
28119;La Croix-du-Perche;113;2623384;150106;57;2056598;56;566786;23216;20052
61043;Berd'huis;581;13488612;510509;377;10879585;204;2609027;23216;20053
94076;Villejuif;30706;712893166;43550136;18244;603660696;12462;109232470;23217;20054
54120;Charmes-la-Côte;188;4364756;188370;116;3504511;72;860245;23217;20055
59209;Esnes;365;8474272;334193;202;6647510;163;1826762;23217;20056
11340;Sainte-Eulalie;244;5665206;263204;140;4488358;104;1176848;23218;20057
29172;Plomodiern;1298;30137653;1196587;669;23177209;629;6960444;23219;20058
28302;Pontgouin;561;13025597;582103;333;10782560;228;2243037;23219;20059
71068;Burzy;46;1068058;50325;23;839035;23;229023;23219;20060
24471;Sainte-Nathalène;329;7639075;345977;191;6213715;138;1425360;23219;20061
80654;Quesnoy-le-Montant;304;7058615;291253;163;5417621;141;1640994;23219;20062
39190;Dampierre;596;13838909;514472;358;11180830;238;2658079;23220;20063
01115;Confrançon;625;14513170;451517;398;11833630;227;2679540;23221;20064
03268;Saulzet;193;4481712;200465;108;3562579;85;919133;23221;20065
37024;Benais;516;11982495;417723;283;9619237;233;2363258;23222;20066
63271;Paslières;832;19321164;631144;488;15579392;344;3741772;23223;20067
77317;Mormant;2390;55502969;2319564;1466;45377893;924;10125076;23223;20068
56022;Brandivy;640;14862808;549691;361;11713687;279;3149121;23223;20069
40044;Biaudos;448;10403987;307358;269;8320310;179;2083677;23223;20070
21121;Bussy-la-Pesle;48;1114764;63468;30;927147;18;187617;23224;20071
89281;Les Ormes;165;3832065;152913;91;2972950;74;859115;23225;20072
33051;Biganos;5484;127364446;4957249;3345;103262087;2139;24102359;23225;20073
97118;Petit-Bourg;12641;293592858;12198180;4966;214474173;7675;79118685;23225;20074
88424;Sainte-Marguerite;1385;32167652;1227570;785;25032303;600;7135349;23226;20075
25457;Plaimbois-Vennes;47;1091639;26330;29;865371;18;226268;23226;20076
39547;Vaux-lès-Saint-Claude;389;9035231;313556;232;7214516;157;1820715;23227;20077
68193;Luttenbach-près-Munster;447;10382400;431118;258;8139324;189;2243076;23227;20078
50061;Boisroger;111;2578182;143025;59;1991145;52;587037;23227;20079
32323;Ponsampère;60;1393614;52283;33;1145558;27;248056;23227;20080
83061;Fréjus;32396;752464611;42956428;18078;610103148;14318;142361463;23227;20081
16298;Saint-Amant-de-Nouère;238;5528062;250806;136;4550588;102;977474;23227;20082
61360;Saint-Agnan-sur-Sarthe;63;1463321;77285;38;1221785;25;241536;23227;20083
10200;La Loge-aux-Chèvres;50;1161366;42939;34;1019806;16;141560;23227;20084
31419;Le Pin-Murelet;91;2113759;100135;51;1671780;40;441979;23228;20085
50531;Saint-Ovin;378;8780411;288486;200;6680139;178;2100272;23229;20086
07255;Saint-Julien-en-Saint-Alban;707;16422632;550877;383;12240279;324;4182353;23229;20087
37033;Boussay;149;3461153;200670;72;2605784;77;855369;23229;20088
01163;Foissiat;1042;24205084;972532;585;19142018;457;5063066;23229;20089
52497;Troisfontaines-la-Ville;245;5691236;237345;140;4581684;105;1109552;23230;20090
60445;Nampcel;162;3763228;200438;82;2990035;80;773193;23230;20091
04013;Aubignosc;304;7062245;339958;172;5600911;132;1461334;23231;20092
02090;Billy-sur-Ourcq;105;2439280;94193;59;1941049;46;498231;23231;20093
06149;La Trinité;5525;128353246;5670338;3379;105672198;2146;22681048;23231;20094
34268;Saint-Jean-de-la-Blaquière;314;7294684;391664;138;5435109;176;1859575;23231;20095
24493;Saint-Raphaël;62;1440368;66883;31;1146320;31;294048;23232;20096
42329;La Versanne;203;4716195;215724;117;3777631;86;938564;23232;20097
84104;Sablet;733;17029581;863951;367;13426042;366;3603539;23233;20098
24567;Vaunac;153;3554792;179328;79;2776164;74;778628;23234;20099
67265;Lichtenberg;298;6923814;227717;161;5420961;137;1502853;23234;20100
14155;Cheffreville-Tonnencourt;134;3113488;77101;84;2567357;50;546131;23235;20101
62056;Audresselles;364;8457541;453046;183;6585314;181;1872227;23235;20102
07159;Mirabel;262;6087674;198424;152;4947113;110;1140561;23235;20103
79290;Saint-Pompain;483;11222939;340649;271;8787668;212;2435271;23236;20104
85021;La Bernardière;808;18774660;384601;521;15376321;287;3398339;23236;20105
37135;Louestault;159;3694800;147282;99;3083710;60;611090;23238;20106
74091;La Côte-d'Arbroz;144;3346307;107824;83;2653063;61;693244;23238;20107
71131;Ciel;392;9109425;326838;217;6984174;175;2125251;23238;20108
76653;Saint-Vaast-Dieppedalle;209;4856961;185616;107;3619526;102;1237435;23239;20109
73274;Saint-Pierre-d'Entremont;223;5182348;239543;114;3914159;109;1268189;23239;20110
88309;Monthureux-le-Sec;87;2021872;53734;55;1663539;32;358333;23240;20111
09243;Régat;52;1208476;33157;34;1023961;18;184515;23240;20112
36120;Mers-sur-Indre;363;8436149;548340;180;6734313;183;1701836;23240;20113
44221;La Chevallerais;641;14897149;283294;396;11645088;245;3252061;23240;20114
77287;Meilleray;252;5856639;231009;141;4579103;111;1277536;23241;20115
02226;Courmelles;908;21102539;814999;550;16878470;358;4224069;23241;20116
42220;Saint-Forgeux-Lespinasse;289;6716584;182288;166;5334911;123;1381673;23241;20117
56193;Riantec;2897;67328567;2668570;1697;53965340;1200;13363227;23241;20118
30155;Manduel;3322;77207126;3236684;1858;61496159;1464;15710967;23241;20119
08428;Sorcy-Bauthémont;92;2138239;111329;51;1698704;41;439535;23242;20120
26251;Portes-en-Valdaine;240;5578086;230718;131;4366826;109;1211260;23242;20121
26028;Bathernay;122;2835718;77477;61;2121249;61;714469;23244;20122
27007;Ajou;157;3649284;168705;90;2832642;67;816642;23244;20123
64541;Urdès;146;3393603;99025;80;2619491;66;774112;23244;20124
02633;Quincy-sous-le-Mont;36;836788;38762;23;735107;13;101681;23244;20125
63138;Dorat;377;8763043;299849;228;7107618;149;1655425;23244;20126
37252;Souvigny-de-Touraine;204;4741810;159610;127;3915841;77;825969;23244;20127
73188;Notre-Dame-des-Millières;550;12784302;443289;329;10338139;221;2446163;23244;20128
26382;Saint-Vincent-la-Commanderie;258;5997047;237769;151;4882307;107;1114740;23244;20129
26096;Clérieux;1043;24244222;971410;566;18733647;477;5510575;23245;20130
21074;Billey;130;3021813;97834;80;2471794;50;550019;23245;20131
71304;Montagny-sur-Grosne;57;1324968;42674;39;1141448;18;183520;23245;20132
62395;Guigny;86;1999082;27174;36;1521450;50;477632;23245;20133
03070;Chavenon;78;1813139;88598;39;1495137;39;318002;23245;20134
73226;Saint-Béron;869;20201810;753895;493;15774732;376;4427078;23247;20135
40169;Maillas;64;1487850;103771;27;1189847;37;298003;23248;20136
81151;Magrin;64;1487898;42639;33;1177571;31;310327;23248;20137
64299;Lacommande;113;2627121;86539;67;2144948;46;482173;23249;20138
56247;Sulniac;1674;38918593;1191336;982;31066103;692;7852490;23249;20139
72378;Vion;687;15972117;446338;450;13231127;237;2740990;23249;20140
44059;Fresnay-en-Retz;620;14414457;406242;356;11202821;264;3211636;23249;20141
54253;Hatrize;408;9485688;325169;234;7475148;174;2010540;23249;20142
2A247;Porto-Vecchio;8062;187437383;11565417;4066;147059128;3996;40378255;23249;20143
10180;Joncreuil;48;1115988;68080;24;819460;24;296528;23250;20144
62740;Sains-lès-Pernes;138;3208474;136870;67;2440113;71;768361;23250;20145
73215;La Rochette;1999;46480388;1893215;1138;36712021;861;9768367;23252;20146
18119;Jussy-Champagne;118;2743752;138298;64;2138182;54;605570;23252;20147
33548;Villegouge;645;14997714;752447;352;11799165;293;3198549;23252;20148
64381;Méritein;170;3952888;207706;89;3037867;81;915021;23252;20149
27591;Saint-Pierre-de-Cormeilles;339;7882551;345806;187;6247787;152;1634764;23252;20150
10093;Chaumesnil;43;999853;37312;28;833369;15;166484;23252;20151
47228;Saint-Antoine-de-Ficalba;398;9254724;372455;213;7426823;185;1827901;23253;20152
73020;Arith;242;5627307;252354;149;4532449;93;1094858;23253;20153
54149;Crusnes;823;19138099;163928;253;8627517;570;10510582;23254;20154
76732;Butot-Vénesville;138;3209144;120406;68;2459283;70;749861;23255;20155
61303;Nécy;263;6116157;224186;136;4712212;127;1403945;23255;20156
70099;Brotte-lès-Ray;45;1046502;44572;28;860873;17;185629;23256;20157
71282;Marmagne;696;16186283;630242;414;13110653;282;3075630;23256;20158
38009;Anjou;548;12744481;530761;286;9664121;262;3080360;23256;20159
37057;La Chapelle-Blanche-Saint-Martin;349;8116538;268892;190;6110935;159;2005603;23257;20160
77109;Chenoise;706;16419410;738468;395;13295147;311;3124263;23257;20161
02028;Athies-sous-Laon;1415;32908947;1208554;867;26919249;548;5989698;23257;20162
36178;Saint-Aigny;158;3674662;138757;95;2958621;63;716041;23257;20163
43224;Sainte-Sigolène;3131;72819575;2813152;1637;54879008;1494;17940567;23258;20164
14271;Fleury-sur-Orne;2510;58383773;2883261;1342;47310904;1168;11072869;23260;20165
31220;Gibel;160;3721731;135989;95;3072557;65;649174;23261;20166
13064;Mollégès;1380;32100305;1482565;768;25714271;612;6386034;23261;20167
07292;Saint-Romain-d'Ay;547;12723905;416653;324;9962891;223;2761014;23261;20168
74041;Bonnevaux;167;3884797;228014;105;3259819;62;624978;23262;20169
71264;Lournand;191;4443136;156328;114;3621911;77;821225;23262;20170
80760;Tilloy-Floriville;191;4443189;169047;112;3653246;79;789943;23263;20171
30085;Collias;593;13794956;698550;312;10698949;281;3096007;23263;20172
29042;Crozon;4698;109290596;4758626;2630;85930765;2068;23359831;23263;20173
12170;Naussac;191;4443307;190739;108;3489618;83;953689;23263;20174
44088;Maisdon-sur-Sèvre;1416;32941101;886892;903;26949943;513;5991158;23263;20175
26282;Romeyer;113;2628791;124757;57;2058281;56;570510;23264;20176
55243;Herbeuville;91;2117005;86035;45;1555378;46;561627;23264;20177
85031;Le Boupère;1616;37595606;1769969;877;29064493;739;8531113;23265;20178
76346;Hautot-l'Auvray;195;4536776;426073;107;3803822;88;732954;23266;20179
29284;Treffiagat;1406;32711682;1358879;793;25570324;613;7141358;23266;20180
76603;Saint-Maclou-la-Brière;230;5351204;141319;134;4277592;96;1073612;23266;20181
57687;Vallerange;117;2722143;114519;65;2105120;52;617023;23266;20182
02269;Dorengt;82;1907844;77980;49;1503296;33;404548;23266;20183
73094;Crest-Voland;233;5421072;279045;131;4387264;102;1033808;23266;20184
24117;Chavagnac;199;4630112;217486;109;3578950;90;1051162;23267;20185
21669;Verrey-sous-Drée;33;767831;16187;22;662814;11;105017;23268;20186
70221;Étobon;167;3885762;141084;108;3236985;59;648777;23268;20187
17315;Saint-Christophe;635;14775419;424373;384;11921025;251;2854394;23268;20188
76132;Bourdainville;224;5212307;182516;135;4180357;89;1031950;23269;20189
64451;Ponson-Debat-Pouts;47;1093683;25863;24;816827;23;276856;23270;20190
49132;Étriché;709;16498636;356079;415;12791448;294;3707188;23270;20191
89154;Escamps;479;11146699;402063;294;9104210;185;2042489;23271;20192
89391;Sergines;693;16127078;672817;406;12692709;287;3434369;23271;20193
83004;Les Arcs;4024;93644206;4758741;2202;75847540;1822;17796666;23271;20194
54182;Essey-et-Maizerais;189;4398320;156197;116;3665613;73;732707;23272;20195
68344;Urbès;243;5655171;206144;150;4525351;93;1129820;23272;20196
80416;Hangest-sur-Somme;385;8959911;340775;235;7401658;150;1558253;23272;20197
40315;Téthieu;387;9006622;322628;238;7400441;149;1606181;23273;20198
10286;Petit-Mesnil;131;3048815;122267;77;2467207;54;581608;23273;20199
14698;Touffréville;150;3491021;133376;84;2781857;66;709164;23273;20200
07296;Saint-Sernin;864;20108321;759335;471;15736242;393;4372079;23274;20201
28020;Baignolet;70;1629192;52429;46;1389186;24;240006;23274;20202
11005;Alairac;616;14337240;524205;373;11810809;243;2526431;23275;20203
35320;Saint-Uniac;251;5842021;130217;164;4552056;87;1289965;23275;20204
89382;Seignelay;878;20435461;755650;557;16711751;321;3723710;23275;20205
65370;Pouzac;657;15291781;837260;392;12334801;265;2956980;23275;20206
29173;Plonéis;1035;24090198;709890;631;19372708;404;4717490;23276;20207
51542;Soizy-aux-Bois;73;1699135;73441;38;1299287;35;399848;23276;20208
68375;Wittelsheim;5495;127905134;4850312;3414;104179649;2081;23725485;23277;20209
49177;Liré;1315;30609774;976181;774;24179127;541;6430647;23277;20210
60477;Ons-en-Bray;725;16876230;783113;413;13704267;312;3171963;23278;20211
69149;Oullins;15279;355663275;16865822;9554;296656051;5725;59007224;23278;20212
89010;Annay-sur-Serein;138;3212363;128632;76;2487832;62;724531;23278;20213
30151;Lussan;289;6727363;401329;138;5235715;151;1491648;23278;20214
57330;Holving;708;16480877;661452;400;12715018;308;3765859;23278;20215
41037;La Chapelle-Enchérie;103;2397666;90724;62;1986230;41;411436;23278;20216
18181;Plou;278;6471469;251943;175;5280877;103;1190592;23279;20217
02367;Happencourt;75;1745901;116712;40;1330638;35;415263;23279;20218
35028;Boistrudan;316;7356082;273565;170;5554410;146;1801672;23279;20219
79347;Viennay;554;12896665;410124;333;10293890;221;2602775;23279;20220
17134;Crazannes;244;5680237;280354;125;4355554;119;1324683;23280;20221
44126;La Plaine-sur-Mer;2322;54057743;2142963;1364;42975156;958;11082587;23281;20222
04167;La Robine-sur-Galabre;167;3887892;194045;91;3080606;76;807286;23281;20223
81070;Coufouleux;1298;30220257;1064284;738;24327027;560;5893230;23282;20224
64241;Géronce;242;5634535;219280;141;4560887;101;1073648;23283;20225
45113;Courtemaux;159;3702038;181583;90;3072128;69;629910;23283;20226
49333;Seiches-sur-le-Loir;1530;35623585;1188877;792;27208795;738;8414790;23283;20227
38046;Bizonnes;432;10058526;261180;271;8015771;161;2042755;23284;20228
57392;Lemud;168;3911733;108093;101;3020878;67;890855;23284;20229
62618;Nordausques;483;11246996;296847;249;8427769;234;2819227;23286;20230
87174;Saint-Paul;682;15880852;609065;373;12573120;309;3307732;23286;20231
70523;Vars;99;2305317;109418;52;1726372;47;578945;23286;20232
02376;Hauteville;93;2165669;130246;48;1735710;45;429959;23287;20233
28080;Charbonnières;146;3399964;164925;85;2724900;61;675064;23287;20234
27027;Les Authieux;151;3516414;118164;90;2816994;61;699420;23288;20235
32347;Roquefort;153;3563028;157441;88;2781090;65;781938;23288;20236
79051;Le Breuil-Bernard;235;5472656;150970;137;4321433;98;1151223;23288;20237
52262;Lamothe-en-Blaisy;37;861702;8680;21;634151;16;227551;23289;20238
34213;Poussan;2984;69496039;3289088;1625;55587675;1359;13908364;23290;20239
02614;Pontru;143;3330438;169641;78;2698617;65;631821;23290;20240
72250;Rahay;111;2585265;180294;61;2075734;50;509531;23291;20241
50545;Saint-Romphaire;373;8687701;248292;237;7118372;136;1569329;23291;20242
39286;Lavans-lès-Saint-Claude;1038;24176792;915252;628;19107663;410;5069129;23292;20243
77396;Rupéreux;55;1281113;73487;34;1104256;21;176857;23293;20244
27163;Colletot;79;1840145;59182;48;1508031;31;332114;23293;20245
88012;Archettes;620;14441668;557008;377;11749936;243;2691732;23293;20246
16045;Birac;173;4029692;145074;100;3247116;73;782576;23293;20247
60353;Lavacquerie;100;2329304;62077;53;1800274;47;529030;23293;20248
76735;Veules-les-Roses;388;9038010;483508;221;7239129;167;1798881;23294;20249
01432;Verjon;147;3424236;81083;95;2808520;52;615716;23294;20250
14599;Saint-Julien-de-Mailloc;248;5776962;221546;137;4437458;111;1339504;23294;20251
22346;Trédaniel;477;11111344;315890;275;8545521;202;2565823;23294;20252
03149;Louchy-Montfand;249;5800580;221789;140;4468005;109;1332575;23296;20253
67314;Natzwiller;333;7757636;326542;183;6055956;150;1701680;23296;20254
45255;Préfontaines;251;5847402;264101;155;4780198;96;1067204;23296;20255
88512;Viménil;118;2748984;67981;69;2192274;49;556710;23296;20256
33143;Cubzac-les-Ponts;1219;28398415;1179788;693;22794408;526;5604007;23296;20257
71453;Saint-Martin-du-Lac;135;3145054;118334;75;2444228;60;700826;23297;20258
64421;Ogeu-les-Bains;641;14933496;524510;367;12061123;274;2872373;23297;20259
54041;Bagneux;79;1840511;59657;42;1394434;37;446077;23298;20260
70447;Rioz;993;23134818;766884;580;18351781;413;4783037;23298;20261
29240;Rosnoën;532;12394576;477489;274;9692371;258;2702205;23298;20262
89018;Armeau;430;10018285;488163;264;8088397;166;1929888;23298;20263
03232;Saint-Félix;162;3774345;122163;101;3056611;61;717734;23298;20264
26010;Anneyron;2125;49510510;1917711;1248;39188904;877;10321606;23299;20265
31076;Bordes-de-Rivière;266;6197570;255597;164;5113545;102;1084025;23299;20266
74001;Abondance;753;17544699;744447;440;14151374;313;3393325;23300;20267
06127;Saint-Martin-Vésubie;772;17988485;1246892;426;14751506;346;3236979;23301;20268
22197;Pleudihen-sur-Rance;1571;36606366;1445879;828;28070147;743;8536219;23301;20269
68287;Rouffach;2430;56624199;2505576;1417;46081964;1013;10542235;23302;20270
34076;Ceyras;636;14820364;616806;343;11858128;293;2962236;23302;20271
01411;Souclin;139;3239079;122688;84;2570146;55;668933;23303;20272
79350;Villiers-en-Bois;71;1654525;61823;37;1256364;34;398161;23303;20273
28410;Villampuy;163;3798535;112457;89;2966613;74;831922;23304;20274
37108;Ferrière-sur-Beaulieu;391;9111936;322648;223;7019373;168;2092563;23304;20275
41144;Monteaux;440;10253846;403163;254;7902126;186;2351720;23304;20276
36026;Brion;280;6525351;328928;152;4972434;128;1552917;23305;20277
33356;La Rivière;202;4707732;227290;120;3953225;82;754507;23306;20278
57321;Hesse;323;7527712;261481;197;5957826;126;1569886;23306;20279
55442;Raival;140;3262802;127733;75;2562503;65;700299;23306;20280
26100;Combovin;236;5500287;224442;136;4440772;100;1059515;23306;20281
64270;Igon;492;11466784;486155;271;9184130;221;2282654;23306;20282
80009;Ailly-le-Haut-Clocher;497;11583449;451202;286;9328407;211;2255042;23307;20283
14506;Planquery;125;2913373;161045;62;2268383;63;644990;23307;20284
72254;Rouessé-Fontaine;151;3519396;201277;88;2846044;63;673352;23307;20285
62298;Épinoy;261;6083198;226798;139;4734510;122;1348688;23307;20286
32005;Arblade-le-Haut;174;4055486;251155;104;3430080;70;625406;23307;20287
88336;Ollainville;47;1095466;17454;28;866763;19;228703;23308;20288
36157;La Pérouille;242;5640537;228204;148;4420964;94;1219573;23308;20289
62273;Doudeauville;250;5827079;237312;138;4397538;112;1429541;23308;20290
79053;Le Breuil-sous-Argenton;243;5664071;191609;131;4435513;112;1228558;23309;20291
80048;Avesnes-Chaussoy;34;792515;24567;21;644514;13;148001;23309;20292
68249;Orbey;1986;46292728;1927521;1179;37516016;807;8776712;23310;20293
24189;Fougueyrolles;246;5734995;253708;124;4511696;122;1223299;23313;20294
12218;Saint-Cyprien-sur-Dourdou;499;11633263;616561;264;9109774;235;2523489;23313;20295
59453;Oudezeele;320;7460300;259727;185;5978547;135;1481753;23313;20296
49185;Lué-en-Baugeois;155;3613658;54414;88;2755423;67;858235;23314;20297
61331;Le Plantis;70;1631985;67802;36;1316543;34;315442;23314;20298
08226;Hierges;107;2494614;105955;57;2002907;50;491707;23314;20299
21338;Lamargelle;81;1888453;53739;47;1480110;34;408343;23314;20300
41030;Cellé;142;3310626;155106;88;2754987;54;555639;23314;20301
76037;Auquemesnil;155;3613731;318844;75;2846129;80;767602;23314;20302
62092;Beaufort-Blavincourt;204;4756222;126101;122;3853935;82;902287;23315;20303
81076;Cuq-Toulza;378;8813131;409406;196;6950267;182;1862864;23315;20304
88410;Sainte-Barbe;143;3334074;92585;65;2387931;78;946143;23315;20305
94017;Champigny-sur-Marne;42781;997457076;58140974;23985;825792193;18796;171664883;23315;20306
40256;Saint-Étienne-d'Orthe;336;7834667;195097;199;6312216;137;1522451;23317;20307
14240;Épaney;237;5526302;178640;138;4396963;99;1129339;23318;20308
72377;Villaines-sous-Malicorne;480;11193067;317742;299;9113161;181;2079906;23319;20309
51579;Tréfols;98;2285318;96416;58;1884337;40;400981;23320;20310
68210;Mittlach;178;4150922;108381;96;3124729;82;1026193;23320;20311
27066;Bézu-la-Forêt;142;3311498;153731;73;2511566;69;799932;23320;20312
18185;Presly;139;3241587;157144;70;2311975;69;929612;23321;20313
37030;Le Boulay;390;9095461;246310;245;7460920;145;1634541;23322;20314
15237;Tiviers;96;2238890;98844;53;1820358;43;418532;23322;20315
57230;Fouligny;110;2565397;91033;64;2062645;46;502752;23322;20316
85198;Saint-Aubin-des-Ormeaux;667;15555876;398320;405;12295229;262;3260647;23322;20317
32394;Saint-Médard;174;4058137;135077;94;3263250;80;794887;23323;20318
68066;Colmar;38096;888505484;55137987;20716;719152577;17380;169352907;23323;20319
37095;Dame-Marie-les-Bois;174;4058262;167004;99;3223780;75;834482;23323;20320
41014;Beauchêne;93;2169131;105578;54;1720532;39;448599;23324;20321
55352;Montplonne;85;1982547;81897;45;1515697;40;466850;23324;20322
50465;Saint-Ébremond-de-Bonfossé;397;9259805;250496;247;7528678;150;1731127;23324;20323
86207;La Roche-Posay;953;22228223;1248529;503;17522087;450;4706136;23324;20324
60665;Venette;1589;37063123;1797387;991;30714891;598;6348232;23325;20325
35324;La Selle-en-Luitré;262;6111118;98402;160;4747358;102;1363760;23325;20326
83021;Bras;1297;30252560;1127035;681;22839191;616;7413369;23325;20327
59530;Saint-Aybert;183;4268488;160065;111;3569348;72;699140;23325;20328
08361;Renwez;850;19826721;710582;496;16210146;354;3616575;23326;20329
13056;Martigues;27310;637055273;35902744;15475;524205615;11835;112849658;23327;20330
47304;Taillebourg;37;863104;32368;22;665725;15;197379;23327;20331
14011;Anctoville;541;12620321;495769;337;10378482;204;2241839;23328;20332
37031;Bourgueil;2207;51484526;2310248;1181;41070256;1026;10414270;23328;20333
19047;Chartrier-Ferrière;199;4642319;205859;99;3612431;100;1029888;23328;20334
72183;Marçon;590;13763725;830011;297;10725788;293;3037937;23328;20335
89012;Annoux;54;1259762;46172;34;1039004;20;220758;23329;20336
04081;Esparron-de-Verdon;240;5599007;304536;121;4270971;119;1328036;23329;20337
08476;Villers-devant-le-Thour;191;4456012;142296;104;3366176;87;1089836;23330;20338
88201;Girancourt;457;10662822;416276;289;8740594;168;1922228;23332;20339
89035;Bellechaume;229;5343233;197833;140;4248805;89;1094428;23333;20340
34222;Puilacher;199;4643273;152025;89;3307003;110;1336270;23333;20341
37207;Saint-Aubin-le-Dépeint;175;4083382;337530;77;3007599;98;1075783;23334;20342
10380;Torcy-le-Petit;43;1003361;39940;22;745525;21;257836;23334;20343
33505;La Sauve;746;17407157;714225;437;14110947;309;3296210;23334;20344
37131;Limeray;687;16030649;668108;408;12834550;279;3196099;23334;20345
85016;Beaulieu-sous-la-Roche;1119;26111179;899602;588;20363233;531;5747946;23334;20346
82006;Auterive;36;840043;32675;19;721408;17;118635;23335;20347
61486;Tinchebray;1616;37710189;1410104;728;28816824;888;8893365;23336;20348
71287;Massilly;201;4690521;176012;131;3863287;70;827234;23336;20349
70282;Gy;574;13395160;608267;300;10569629;274;2825531;23337;20350
05132;Saint-Bonnet-en-Champsaur;941;21960303;988733;503;17005549;438;4954754;23337;20351
79241;Saint-Christophe-sur-Roc;291;6791194;172169;171;5232100;120;1559094;23337;20352
34316;Usclas-du-Bosc;71;1656965;74974;36;1269278;35;387687;23338;20353
73025;Avressieux;245;5717705;184950;133;4504994;112;1212711;23338;20354
40261;Saint-Geours-de-Maremne;1307;30502232;1216939;786;24945089;521;5557143;23338;20355
57095;Boucheporn;316;7374844;257285;199;6229246;117;1145598;23338;20356
14587;Saint-Germain-la-Blanche-Herbe;1218;28426207;1331360;750;23672621;468;4753586;23338;20357
14493;Percy-en-Auge;128;2987359;94899;74;2334970;54;652389;23339;20358
54241;Gugney;43;1003574;47772;20;762445;23;241129;23339;20359
05098;Les Orres;278;6488246;413950;161;5303726;117;1184520;23339;20360
17214;Luchat;225;5251810;181343;122;4063198;103;1188612;23341;20361
60176;Crépy-en-Valois;8318;194156477;9325048;4850;158202949;3468;35953528;23342;20362
57668;Teting-sur-Nied;706;16479550;639738;393;12849773;313;3629777;23342;20363
88037;Basse-sur-le-Rupt;463;10807510;313119;278;8538132;185;2269378;23342;20364
71285;Martigny-le-Comte;236;5508863;201413;118;3932265;118;1576598;23343;20365
04197;Sainte-Tulle;1917;44749520;1688355;1029;35664010;888;9085510;23344;20366
34110;Galargues;349;8146990;442065;182;6532965;167;1614025;23344;20367
51557;Soulanges;245;5719263;178812;159;4725319;86;993944;23344;20368
73255;Sainte-Marie-de-Cuines;414;9664595;305338;257;7818222;157;1846373;23344;20369
35085;Combourg;3119;72811575;2675991;1575;56435381;1544;16376194;23345;20370
02246;Cugny;310;7236848;312714;179;5705699;131;1531149;23345;20371
58122;Garchy;249;5812897;255225;148;4537327;101;1275570;23345;20372
52310;Marbéville;62;1447503;73398;36;1189054;26;258449;23347;20373
27008;Alizay;747;17440253;658200;484;14549705;263;2890548;23347;20374
67522;Weislingen;292;6817464;199291;147;5137708;145;1679756;23347;20375
49138;Fontaine-Guérin;491;11463845;399771;265;8880789;226;2583056;23348;20376
65339;Orincles;175;4086004;142995;102;3304144;73;781860;23349;20377
33411;Saint-Germain-de-Grave;79;1844584;75839;37;1356160;42;488424;23349;20378
86062;Chasseneuil-du-Poitou;2355;54988873;2384989;1535;45911445;820;9077428;23350;20379
61078;Cerisy-Belle-Étoile;372;8686277;238342;228;6984045;144;1702232;23350;20380
43189;Saint-Georges-Lagricol;247;5767623;195367;120;4385429;127;1382194;23351;20381
27237;Le Favril;92;2148333;96177;54;1785564;38;362769;23351;20382
83037;La Celle;707;16510029;782993;394;13589929;313;2920100;23352;20383
39476;Saint-Aubin;910;21250582;864070;517;16661580;393;4589002;23352;20384
76020;Anneville-Ambourville;620;14478806;522364;371;11539009;249;2939797;23353;20385
56130;Merlevenez;1592;37178210;1181262;962;29823850;630;7354360;23353;20386
62607;Neuville-au-Cornet;37;864081;29370;21;694612;16;169469;23354;20387
41077;Épiais;61;1424567;69681;31;1103833;30;320734;23354;20388
70102;Brussey;147;3433061;136408;89;2745082;58;687979;23354;20389
03052;Chamblet;567;13241807;462084;346;10698210;221;2543597;23354;20390
60319;La Houssoye;306;7146391;271935;178;5548861;128;1597530;23354;20391
02099;Bonnesvalyn;128;2989382;118520;79;2399503;49;589879;23355;20392
83100;Puget-Ville;2171;50703725;2273275;1176;39935944;995;10767781;23355;20393
49006;Andrezé;923;21557465;397699;529;16209934;394;5347531;23356;20394
62592;Moringhem;249;5815633;182025;127;4406774;122;1408859;23356;20395
14056;Bauquay;135;3153138;59979;82;2496134;53;657004;23357;20396
76723;Vassonville;191;4461109;145500;117;3631113;74;829996;23357;20397
29146;Melgven;1880;43910728;1491343;1114;34935728;766;8975000;23357;20398
54105;Bulligny;258;6026198;217438;154;4798244;104;1227954;23357;20399
24145;Creysse;1006;23497810;1113584;543;18675693;463;4822117;23358;20400
80331;Forest-l'Abbaye;158;3690563;156199;85;2837343;73;853220;23358;20401
81067;Cestayrols;274;6400109;256013;150;5021452;124;1378657;23358;20402
10224;Marigny-le-Châtel;894;20882256;913253;512;16550061;382;4332195;23358;20403
33070;Brach;248;5792911;131550;153;4735800;95;1057111;23359;20404
40231;Port-de-Lanne;519;12123071;489568;293;9628574;226;2494497;23359;20405
01408;Simandre-sur-Suran;357;8339118;298491;221;6815575;136;1523543;23359;20406
73229;Saint-Christophe;296;6914525;317830;156;5303962;140;1610563;23360;20407
61300;Moutiers-au-Perche;254;5933571;264750;132;4679544;122;1254027;23361;20408
63012;Artonne;481;11236690;526305;261;8966945;220;2269745;23361;20409
63111;Clémensat;61;1425142;46783;36;1118037;25;307105;23363;20410
81169;Missècle;49;1144828;51547;24;879843;25;264985;23364;20411
17242;Montils;447;10443765;419920;227;8049960;220;2393805;23364;20412
76544;Rouvray-Catillon;118;2756994;83271;76;2226299;42;530695;23364;20413
65124;Camparan;37;864503;47420;18;664335;19;200168;23365;20414
34310;Thézan-lès-Béziers;1511;35304820;1573483;782;27652515;729;7652305;23365;20415
38236;Miribel-les-Échelles;932;21776455;926606;539;17652998;393;4123457;23365;20416
41131;Mazangé;500;11682838;400768;295;9379508;205;2303330;23366;20417
14412;Le Mesnil-au-Grain;43;1004752;52974;27;805809;16;198943;23366;20418
71158;Cuisery;987;23062696;977727;489;17570000;498;5492696;23366;20419
02775;Vendeuil;513;11987004;559772;279;9467346;234;2519658;23366;20420
13047;Istres;23413;547083966;26291723;13915;452705500;9498;94378466;23367;20421
70129;La Chapelle-Saint-Quillain;79;1845974;104173;44;1467653;35;378321;23367;20422
14341;Ifs;5806;135667894;5891859;3528;111869670;2278;23798224;23367;20423
42285;Saint-Romain-le-Puy;1928;45052290;1566038;1143;35456329;785;9595961;23367;20424
08480;Villers-Semeuse;1952;45613545;1882276;1143;36382145;809;9231400;23368;20425
76181;Cléville;86;2009686;95263;46;1623989;40;385697;23368;20426
55010;Ancerville;1491;34842404;1553681;906;28384833;585;6457571;23368;20427
67455;Schoenenbourg;361;8436592;323439;226;6939840;135;1496752;23370;20428
80613;Oust-Marest;356;8319791;362310;222;6863477;134;1456314;23370;20429
41259;Thoré-la-Rochette;520;12152506;497942;323;9898553;197;2253953;23370;20430
86298;Vouneuil-sur-Vienne;1086;25380167;1011897;625;20534432;461;4845735;23370;20431
44048;Couffé;1124;26268953;624021;683;20991557;441;5277396;23371;20432
01338;Saint-Benoît;420;9815834;431351;240;7861209;180;1954625;23371;20433
10290;Planty;126;2944778;121381;62;2221185;64;723593;23371;20434
76255;Eu;4386;102506711;5146868;2361;82023016;2025;20483695;23371;20435
21664;Verdonnet;52;1215313;54445;28;936195;24;279118;23371;20436
64512;Sauvelade;119;2781204;97598;57;2041056;62;740148;23371;20437
41217;Saint-Julien-de-Chédon;426;9956481;373440;273;8109916;153;1846565;23372;20438
61437;Saint-Ouen-de-la-Cour;31;724535;28318;19;575200;12;149335;23372;20439
25435;Orsans;78;1823061;53051;43;1380395;35;442666;23373;20440
57715;Vigny;156;3646178;111818;92;2910406;64;735772;23373;20441
88489;Valleroy-aux-Saules;143;3342378;119308;100;2871054;43;471324;23373;20442
70408;Pesmes;652;15239414;872061;323;11617108;329;3622306;23373;20443
86074;Chiré-en-Montreuil;463;10822022;423430;256;8323188;207;2498834;23374;20444
30281;Saint-Mamert-du-Gard;782;18278974;620133;456;14550012;326;3728962;23375;20445
17481;Voissay;81;1893378;65897;40;1379398;41;513980;23375;20446
10188;Lantages;141;3295910;200218;88;2775494;53;520416;23375;20447
22385;La Vicomté-sur-Rance;517;12085069;522805;291;9621972;226;2463097;23375;20448
51071;Bouchy-Saint-Genest;109;2547927;92479;67;2090356;42;457571;23375;20449
35063;La Chapelle-Saint-Aubert;214;5002398;202370;117;3890442;97;1111956;23376;20450
86247;Saint-Saviol;265;6194797;201433;143;4907810;122;1286987;23377;20451
01032;Béligneux;1975;46169196;1814089;1339;38684850;636;7484346;23377;20452
62500;Lespesses;208;4862429;199051;118;3877401;90;985028;23377;20453
37161;Mosnes;445;10402876;550818;250;8241217;195;2161659;23377;20454
77467;La Tombe;147;3436456;170524;92;2872995;55;563461;23377;20455
88063;Bocquegney;69;1613038;53696;47;1381261;22;231777;23377;20456
51433;Plichancourt;111;2595038;90675;68;2069717;43;525321;23379;20457
64075;Audaux;85;1987258;92318;51;1687406;34;299852;23380;20458
33297;Moulis-en-Médoc;946;22117450;1106113;546;17747513;400;4369937;23380;20459
50409;Pont-Hébert;951;22234363;1024613;555;17752408;396;4481955;23380;20460
01184;Hautecourt-Romanèche;436;10193901;386000;277;8421843;159;1772058;23381;20461
64201;Dognen;101;2361450;89340;54;1879242;47;482208;23381;20462
79173;Mazières-sur-Béronne;227;5307512;192527;119;4119093;108;1188419;23381;20463
62010;Affringues;117;2735613;97425;67;2206293;50;529320;23381;20464
10331;Rumilly-lès-Vaudes;286;6687084;282057;161;5320616;125;1366468;23381;20465
65344;Ossun;1258;29413835;1106451;709;23445878;549;5967957;23381;20466
76166;Le Caule-Sainte-Beuve;237;5541414;206963;120;4228652;117;1312762;23381;20467
10253;Montmorency-Beaufort;75;1753627;89161;41;1402042;34;351585;23382;20468
35302;Saint-Onen-la-Chapelle;510;11924845;230885;320;9707118;190;2217727;23382;20469
71431;Saint-Jean-de-Trézy;192;4489462;151841;114;3517763;78;971699;23383;20470
01175;Gorrevod;415;9703883;364816;242;7662093;173;2041790;23383;20471
67462;Sélestat;10932;255629601;13622586;6271;206712269;4661;48917332;23384;20472
02117;Bray-Saint-Christophe;37;865225;31685;22;702543;15;162682;23384;20473
80766;Toutencourt;256;5986566;243171;149;4756426;107;1230140;23385;20474
64400;Montaut;565;13213342;480363;325;10698043;240;2515299;23386;20475
60032;Autrêches;370;8653235;325633;216;6904202;154;1749033;23387;20476
47023;Beaugas;164;3835538;161040;84;2936652;80;898886;23387;20477
80638;Potte;58;1356482;32510;28;1035506;30;320976;23388;20478
76745;Villy-sur-Yères;104;2432340;99008;51;1832474;53;599866;23388;20479
25399;Montfort;52;1216203;48352;32;1000715;20;215488;23389;20480
76665;Sauchay;227;5309240;186378;137;4234138;90;1075102;23389;20481
79265;Saint-Léger-de-Montbrun;632;14781722;429532;382;11865424;250;2916298;23389;20482
46228;Prudhomat;399;9332241;343277;231;7456766;168;1875475;23389;20483
80830;Yaucourt-Bussus;110;2572818;61308;65;2007143;45;565675;23389;20484
17227;Mazerolles;134;3134165;137752;72;2516715;62;617450;23389;20485
60418;Montiers;210;4911759;138594;123;3863991;87;1047768;23389;20486
70210;Écromagny;92;2151821;80940;53;1794843;39;356978;23389;20487
03233;Saint-Genest;194;4537572;167235;110;3604284;84;933288;23390;20488
37080;Civray-sur-Esves;101;2362423;81470;53;1783604;48;578819;23390;20489
35161;Louvigné-de-Bais;883;20653738;851944;506;16162818;377;4490920;23390;20490
76602;Saint-Maclou-de-Folleville;311;7274576;256560;182;5842775;129;1431801;23391;20491
51389;Mourmelon-le-Petit;383;8958742;295630;216;6895051;167;2063691;23391;20492
94004;Boissy-Saint-Léger;8547;199922764;10954778;5063;167645337;3484;32277427;23391;20493
33415;Saint-Gervais;894;20911668;803253;528;17016537;366;3895131;23391;20494
59026;Aubigny-au-Bac;621;14525915;567352;347;11654469;274;2871446;23391;20495
08406;Savigny-sur-Aisne;196;4584896;212543;99;3522196;97;1062700;23392;20496
18053;Charentonnay;178;4163942;228988;93;3288098;85;875844;23393;20497
68372;Willer-sur-Thur;1018;23814213;907397;588;18780094;430;5034119;23393;20498
62132;Billy-Berclau;2342;54790068;1952503;1371;44158175;971;10631893;23395;20499
71480;Saint-Sernin-du-Plain;327;7650065;331524;182;6149189;145;1500876;23395;20500
69030;Brullioles;426;9966156;383694;265;8250702;161;1715454;23395;20501
39184;Les Crozets;127;2971151;103983;82;2446835;45;524316;23395;20502
34161;Montady;2032;47540865;1943947;1094;37296853;938;10244012;23396;20503
25275;Glère;130;3041520;198594;74;2552738;56;488782;23396;20504
27042;Barville;42;982682;53943;23;750979;19;231703;23397;20505
86080;Cloué;237;5545578;159779;146;4530886;91;1014692;23399;20506
26256;Propiac;67;1567756;71396;31;1150552;36;417204;23399;20507
18091;Farges-Allichamps;116;2714338;161483;62;2157997;54;556341;23399;20508
62384;Graincourt-lès-Havrincourt;357;8354034;378660;212;6807027;145;1547007;23401;20509
40280;Saint-Perdon;840;19656712;605204;528;16244224;312;3412488;23401;20510
24146;Creyssensac-et-Pissot;136;3182520;120628;81;2614222;55;568298;23401;20511
59065;Bellignies;463;10834682;504016;254;8719153;209;2115529;23401;20512
25198;Désandans;359;8401114;309593;199;6595857;160;1805257;23401;20513
33444;Saint-Martin-de-Sescas;290;6786423;270348;159;5232277;131;1554146;23401;20514
71366;Ratenelle;213;4984556;198560;131;4001670;82;982886;23402;20515
26295;Saint-Barthélemy-de-Vals;1006;23542270;856301;596;18699084;410;4843186;23402;20516
76403;Malleville-les-Grès;95;2223212;102495;57;1791374;38;431838;23402;20517
28105;Combres;254;5944311;285184;140;4662628;114;1281683;23403;20518
80293;Ételfay;206;4821055;190639;128;4041812;78;779243;23403;20519
27512;Saint-Aubin-de-Scellon;170;3978609;156988;100;3258500;70;720109;23404;20520
61351;Roiville;68;1591457;80462;41;1335974;27;255483;23404;20521
86277;Varennes;180;4212718;157732;108;3399907;72;812811;23404;20522
02017;Anguilcourt-le-Sart;163;3814877;221039;85;3010592;78;804285;23404;20523
56155;Pénestin;1243;29091691;1536826;682;22865864;561;6225827;23404;20524
89424;Trucy-sur-Yonne;85;1989389;88348;55;1653593;30;335796;23405;20525
31092;Burgalays;79;1848963;88578;46;1493028;33;355935;23405;20526
70481;Savoyeux;113;2644795;88800;76;2170462;37;474333;23405;20527
85191;La Roche-sur-Yon;29571;692129823;35532954;16303;566092289;13268;126037534;23406;20528
89244;Marmeaux;51;1193708;36522;29;845084;22;348624;23406;20529
85213;Saint-Florent-des-Bois;1378;32254179;1202400;777;25257736;601;6996443;23407;20530
88459;Soncourt;36;842644;56191;18;685083;18;157561;23407;20531
08024;Asfeld;576;13482396;555449;299;10505201;277;2977195;23407;20532
50342;Montfarville;465;10884519;486833;244;8651127;221;2233392;23408;20533
33504;Sauternes;387;9058743;365400;220;7378589;167;1680154;23408;20534
64548;Uzan;83;1942884;73893;39;1413308;44;529576;23408;20535
82073;Goudourville;500;11704133;493198;254;9192331;246;2511802;23408;20536
59297;Hélesmes;939;21980482;890776;489;16766926;450;5213556;23408;20537
62599;Nabringhen;93;2176989;120017;50;1764888;43;412101;23408;20538
94077;Villeneuve-le-Roi;10858;254173919;12604401;6695;212953292;4163;41220627;23409;20539
80580;Nampont;143;3347486;221305;67;2576427;76;771059;23409;20540
14191;Courseulles-sur-Mer;2967;69457483;3950042;1701;56036352;1266;13421131;23410;20541
10277;Palis;356;8333974;340634;206;6546166;150;1787808;23410;20542
80401;Guillemont;70;1638758;45585;44;1366672;26;272086;23411;20543
64005;Abos;299;6999999;276375;197;5825293;102;1174706;23411;20544
10151;Fontaine-les-Grès;490;11471627;622479;279;9114816;211;2356811;23411;20545
47320;Villefranche-du-Queyran;223;5220804;359846;98;3996566;125;1224238;23412;20546
80541;Mesnil-Saint-Georges;86;2013435;81799;58;1691314;28;322121;23412;20547
02755;Urcel;289;6766331;293253;168;5388035;121;1378296;23413;20548
59665;Wylder;136;3184260;71524;74;2323852;62;860408;23414;20549
59633;Wallers-en-Fagne;146;3418414;143556;88;2843284;58;575130;23414;20550
71522;Simandre;828;19387061;703621;477;15250997;351;4136064;23414;20551
71464;Saint-Maurice-lès-Couches;103;2411759;100856;63;2028317;40;383442;23415;20552
28206;Laons;369;8640319;303150;214;6861391;155;1778928;23415;20553
33157;Espiet;350;8195507;240093;201;6315826;149;1879681;23416;20554
50624;La Vendelée;214;5011025;152200;120;3951393;94;1059632;23416;20555
35146;Langouet;306;7165576;298441;187;5941717;119;1223859;23417;20556
55286;Lemmes;112;2622768;98903;67;2074864;45;547904;23418;20557
22277;Saint-Brandan;1263;29577165;1133785;748;23743165;515;5834000;23418;20558
29192;Plougoulm;992;23231318;1424821;523;18280724;469;4950594;23419;20559
45334;Vieilles-Maisons-sur-Joudry;318;7447198;247453;179;5750458;139;1696740;23419;20560
37016;Azay-sur-Indre;217;5081899;180695;127;3999891;90;1082008;23419;20561
54451;Réhon;1985;46487035;741600;802;25602412;1183;20884623;23419;20562
80542;Mesnil-Saint-Nicaise;307;7189759;371430;169;5618643;138;1571116;23419;20563
21004;Aignay-le-Duc;189;4426272;267276;88;3209108;101;1217164;23419;20564
37232;Saint-Patrice;375;8782351;485948;211;7178783;164;1603568;23420;20565
14390;Maisoncelles-sur-Ajon;96;2248384;75450;56;1836326;40;412058;23421;20566
77242;Jutigny;291;6815417;244153;186;5723521;105;1091896;23421;20567
67339;Betschdorf;2235;52345774;2087204;1357;42958530;878;9387244;23421;20568
59107;Bray-Dunes;2748;64361378;3122083;1557;51449642;1191;12911736;23421;20569
77167;Égligny;154;3606885;130501;101;3124082;53;482803;23421;20570
89138;Dicy;193;4520330;261291;115;3714593;78;805737;23421;20571
10287;Piney;780;18269474;800563;407;13824922;373;4444552;23422;20572
63267;Palladuc;293;6862987;260218;162;5337562;131;1525425;23423;20573
25211;Échevannes;43;1007198;23042;25;769152;18;238046;23423;20574
73256;Saint-Martin-d'Arc;196;4590993;165914;123;3665353;73;925640;23423;20575
56151;Noyal-Pontivy;1976;46286014;1632398;1137;37242261;839;9043753;23424;20576
73311;Le Verneil;56;1311753;63559;34;1066729;22;245024;23424;20577
33333;Le Porge;1462;34247886;1514872;853;27738694;609;6509192;23425;20578
46065;Cavagnac;227;5317658;252441;116;4184329;111;1133329;23426;20579
14149;Cesny-aux-Vignes;197;4614925;87425;127;3675352;70;939573;23426;20580
48018;Barjac;373;8737911;337103;215;7104366;158;1633545;23426;20581
49301;Saint-Macaire-en-Mauges;3540;82932159;2579532;1995;64494082;1545;18438077;23427;20582
31391;Montsaunès;233;5458627;229981;132;4330674;101;1127953;23428;20583
28037;Bérou-la-Mulotière;200;4685544;189794;122;3762164;78;923380;23428;20584
62732;Sachin;162;3795395;128845;87;2966352;75;829043;23428;20585
02212;Condren;389;9113643;438219;227;7313240;162;1800403;23428;20586
21394;Massingy-lès-Semur;87;2038279;78529;53;1633961;34;404318;23428;20587
14703;Tournebu;176;4123520;104495;110;3307509;66;816011;23429;20588
61382;Saint-Denis-sur-Sarthon;586;13729560;626141;326;10902126;260;2827434;23429;20589
29272;Saint-Yvi;1526;35753297;1164060;959;29308691;567;6444606;23429;20590
54016;Andilly;152;3561382;123105;92;2812399;60;748983;23430;20591
40050;Bostens;98;2296156;72031;61;1874519;37;421637;23430;20592
14529;Ranchy;98;2296189;52557;62;1873735;36;422454;23431;20593
65363;Pinas;267;6256257;296378;171;5214599;96;1041658;23432;20594
65069;La Barthe-de-Neste;682;15980501;647610;403;12670214;279;3310287;23432;20595
57112;Brouck;48;1124742;40144;25;849800;23;274942;23432;20596
66147;Porté-Puymorens;68;1593403;75211;33;1209591;35;383812;23432;20597
21634;Thorey-sur-Ouche;87;2038663;127964;45;1583629;42;455034;23433;20598
21103;Brazey-en-Plaine;1286;30135097;1313004;717;23658247;569;6476850;23433;20599
55546;Verneuil-Grand;117;2741753;132257;61;2138341;56;603412;23434;20600
53156;Montflours;118;2765216;62574;80;2367093;38;398123;23434;20601
80044;Authieule;205;4804047;179610;112;3714426;93;1089621;23434;20602
05135;Sainte-Colombe;34;796773;29139;20;563801;14;232972;23435;20603
31492;Saint-Julien-sur-Garonne;255;5975878;280805;142;4784556;113;1191322;23435;20604
21196;Corpeau;529;12397308;414723;326;9824057;203;2573251;23435;20605
33549;Villenave-de-Rions;175;4101225;157134;113;3372195;62;729030;23436;20606
40217;Parentis-en-Born;3020;70775830;2665691;1798;57150660;1222;13625170;23436;20607
08348;Puiseux;58;1359285;36820;31;1036803;27;322482;23436;20608
42239;Saint-Jean-Saint-Maurice-sur-Loire;580;13592879;461727;342;10727742;238;2865137;23436;20609
61222;Landisacq;413;9679104;371924;246;7772298;167;1906806;23436;20610
10222;Maraye-en-Othe;255;5976204;229867;150;4784960;105;1191244;23436;20611
17205;Loire-les-Marais;181;4241976;127180;108;3482034;73;759942;23436;20612
61375;Saint-Christophe-le-Jajolet;122;2859237;93914;66;2232467;56;626770;23436;20613
28231;La Mancelière;98;2296785;75817;55;1772790;43;523995;23437;20614
55220;Grimaucourt-près-Sampigny;47;1101537;46858;29;861200;18;240337;23437;20615
44013;Besné;1370;32108903;847686;858;25924361;512;6184542;23437;20616
71152;Cressy-sur-Somme;104;2437492;158390;54;1999473;50;438019;23437;20617
01196;Jayat;542;12705020;424714;335;10272104;207;2432916;23441;20618
46335;Villesèque;227;5321262;253863;121;4177729;106;1143533;23442;20619
63300;Riom;11026;258469310;14165547;6250;213628681;4776;44840629;23442;20620
15182;Saint-Étienne-Cantalès;64;1500276;74967;31;1157207;33;343069;23442;20621
39527;Taxenne;54;1265929;41488;39;1127251;15;138678;23443;20622
80046;Avelesges;27;632966;26339;15;513136;12;119830;23443;20623
40091;Duhort-Bachen;365;8556830;453975;190;6783801;175;1773029;23443;20624
59550;Salomé;1544;36197037;1468495;876;28916970;668;7280067;23444;20625
03011;Aurouër;204;4782586;165354;111;3677116;93;1105470;23444;20626
73258;Saint-Martin-de-la-Porte;388;9096437;346925;250;7394374;138;1702063;23444;20627
50481;Saint-Germain-sur-Ay;572;13410280;718396;307;10778885;265;2631395;23445;20628
76504;Pleine-Sève;74;1734900;43143;44;1330545;30;404355;23445;20629
86095;Dissay;1670;39153343;1312428;1053;32207746;617;6945597;23445;20630
02054;Bazoches-sur-Vesles;225;5275194;147788;139;4208656;86;1066538;23445;20631
69120;Longessaigne;309;7244728;314595;157;5668489;152;1576239;23446;20632
60056;Beaurepaire;35;820608;35017;21;633542;14;187066;23446;20633
73305;Valezan;119;2790101;118196;78;2293521;41;496580;23446;20634
34081;Colombiers;1283;30081547;1476137;665;23260251;618;6821296;23446;20635
30274;Saint-Julien-les-Rosiers;1729;40538765;1689334;990;32575663;739;7963102;23446;20636
32008;Armentieux;50;1172320;97461;20;872085;30;300235;23446;20637
02130;Bucilly;105;2461895;153527;56;1954124;49;507771;23447;20638
65220;Hibarette;122;2860493;129630;63;2255781;59;604712;23447;20639
37167;Neuillé-Pont-Pierre;1029;24127576;1111776;577;19017497;452;5110079;23448;20640
07041;Boulieu-lès-Annonay;1220;28606530;1171516;757;23480873;463;5125657;23448;20641
67538;Wingen-sur-Moder;874;20494332;975183;494;16309248;380;4185084;23449;20642
02310;Fieulaine;152;3564252;184531;81;2728465;71;835787;23449;20643
32176;Lagarde;65;1524203;45228;28;1083546;37;440657;23449;20644
72205;Montbizot;832;19509902;479654;470;15238070;362;4271832;23449;20645
45216;Mormant-sur-Vernisson;68;1594650;77138;43;1354267;25;240383;23451;20646
32021;Avensac;34;797340;51398;18;653626;16;143714;23451;20647
2B074;Casanova;197;4619967;254834;109;3724637;88;895330;23452;20648
27096;Les Bottereaux;177;4150970;179187;106;3280871;71;870099;23452;20649
69082;Émeringes;112;2626605;91143;61;2046144;51;580461;23452;20650
54255;Haudonville;49;1149149;33412;31;952020;18;197129;23452;20651
67334;Niedersteinbach;91;2134135;102179;54;1711224;37;422911;23452;20652
76019;Anneville-sur-Scie;227;5323752;207135;143;4471132;84;852620;23453;20653
16160;Guimps;271;6355715;292052;148;4920307;123;1435408;23453;20654
57003;Abreschviller;783;18363803;809151;438;14257097;345;4106706;23453;20655
08062;Bertoncourt;82;1923164;72501;44;1498682;38;424482;23453;20656
45107;Coudroy;177;4151269;155237;112;3415970;65;735299;23453;20657
77137;Courtacon;107;2509627;55494;61;2064938;46;444689;23454;20658
44112;Noyal-sur-Brutz;280;6567304;177326;167;5304572;113;1262732;23455;20659
23126;Masbaraud-Mérignat;193;4526801;200071;104;3638652;89;888149;23455;20660
57188;Éguelshardt;224;5253925;182197;126;4119632;98;1134293;23455;20661
73157;Modane;1911;44826207;2168785;1151;36215416;760;8610791;23457;20662
65396;Saint-Savin;223;5230972;229677;137;4271148;86;959824;23457;20663
29292;Tréguennec;190;4457071;232518;105;3544352;85;912719;23458;20664
10252;Montmartin-le-Haut;35;821043;52265;17;632704;18;188339;23458;20665
24082;Carsac-Aillac;898;21065783;1060239;523;17123109;375;3942674;23459;20666
82195;Villemade;405;9500794;423220;230;7427271;175;2073523;23459;20667
17435;Taillant;89;2087857;106615;44;1583655;45;504202;23459;20668
72341;Soulitré;325;7624403;271143;198;6091338;127;1533065;23460;20669
28398;Unverre;638;14967731;635273;366;11824134;272;3143597;23460;20670
10038;Bercenay-le-Hayer;96;2252220;119621;57;1879541;39;372679;23461;20671
28382;Terminiers;494;11589710;460215;267;8858531;227;2731179;23461;20672
60605;Sarnois;171;4011834;137727;101;3100168;70;911666;23461;20673
66064;Égat;264;6193953;268815;161;5127258;103;1066695;23462;20674
05180;Les Vigneaux;263;6170602;260412;145;4818031;118;1352571;23462;20675
59580;Steenvoorde;2260;53027817;2261564;1236;42128040;1024;10899777;23464;20676
61123;Coulonces;107;2510615;82733;58;1938087;49;572528;23464;20677
31318;Marignac-Laspeyres;101;2369870;67498;54;1775709;47;594161;23464;20678
02577;Ostel;43;1008961;67788;25;807570;18;201391;23464;20679
61060;Brethel;84;1971005;157430;46;1565093;38;405912;23464;20680
09210;Montoulieu;193;4528954;187124;107;3473931;86;1055023;23466;20681
65366;Poueyferré;456;10700540;364505;271;8496798;185;2203742;23466;20682
38060;Brion;75;1759969;89816;46;1477287;29;282682;23466;20683
62429;Henneveux;138;3238391;92979;65;2346418;73;891973;23467;20684
50292;Marigny;1232;28912208;1242916;642;22516196;590;6396012;23468;20685
81307;Valdurenque;410;9622001;289887;240;7586063;170;2035938;23468;20686
38182;Le Grand-Lemps;1619;37995185;1515103;899;29921557;720;8073628;23468;20687
26002;Albon;931;21849770;818135;551;17460167;380;4389603;23469;20688
17148;Écurat;245;5749989;155355;138;4379803;107;1370186;23469;20689
23101;Jouillat;251;5890863;266696;137;4712788;114;1178075;23470;20690
27130;Capelle-les-Grands;211;4952168;189771;115;3778474;96;1173694;23470;20691
02462;Mareuil-en-Dôle;118;2769531;84029;66;2130716;52;638815;23471;20692
49280;Saint-Georges-du-Bois;195;4576797;54151;103;3133596;92;1443201;23471;20693
27632;Le Thil;204;4788037;149857;115;3738159;89;1049878;23471;20694
46032;Boissières;199;4670889;170556;109;3645059;90;1025830;23472;20695
37014;Azay-le-Rideau;1854;43518172;1841778;1070;35229295;784;8288877;23473;20696
90089;Rougemont-le-Château;827;19411844;834903;482;15666068;345;3745776;23473;20697
76096;Biville-la-Baignarde;329;7722527;220838;182;5821308;147;1901219;23473;20698
88525;Vroville;75;1760485;72503;42;1344410;33;416075;23473;20699
28391;Toury;1450;34036535;1463549;882;27640758;568;6395777;23473;20700
87140;Saint-Brice-sur-Vienne;885;20774050;859696;535;16951735;350;3822315;23474;20701
26023;Barbières;469;11009261;322989;279;8598705;190;2410556;23474;20702
57466;Metzing;357;8380198;359211;226;6956539;131;1423659;23474;20703
15252;Velzic;228;5352069;233662;122;4234719;106;1117350;23474;20704
76376;Intraville;128;3004710;75771;84;2378683;44;626027;23474;20705
84151;Vitrolles-en-Lubéron;117;2746626;126386;69;2234303;48;512323;23475;20706
52509;Vaux-sous-Aubigny;374;8779818;396412;209;6914508;165;1865310;23475;20707
67472;Soufflenheim;2698;63336851;2643544;1630;51427684;1068;11909167;23475;20708
31527;La Salvetat-Lauragais;69;1619816;72103;37;1277607;32;342209;23476;20709
21564;Saint-Nicolas-lès-Cîteaux;231;5422912;310285;132;4653281;99;769631;23476;20710
85279;Saligny;911;21386786;547413;569;17303223;342;4083563;23476;20711
18282;Villabon;307;7207358;352015;169;5697016;138;1510342;23477;20712
80006;Agenvillers;97;2277255;94817;53;1824006;44;453249;23477;20713
41281;Villefrancoeur;267;6268335;305854;155;5243042;112;1025293;23477;20714
56125;Malguénac;977;22937254;1070279;586;18647119;391;4290135;23477;20715
57324;Hilbesheim;295;6925853;218293;169;5482082;126;1443771;23477;20716
33062;Bonzac;401;9414852;344886;242;7699201;159;1715651;23478;20717
57340;Hundling;750;17609023;790375;408;13668612;342;3940411;23479;20718
74093;Cran-Gevrier;9860;231503577;9320800;6343;189772948;3517;41730629;23479;20719
35048;Campel;273;6410006;127257;135;4906152;138;1503854;23480;20720
84083;Mornas;1256;29491030;1311477;710;23708924;546;5782106;23480;20721
27061;Berthouville;162;3803803;149198;96;3079262;66;724541;23480;20722
38289;Oz;115;2700232;117910;83;2332656;32;367576;23480;20723
42266;Saint-Nizier-de-Fornas;342;8030397;269228;188;6170209;154;1860188;23481;20724
41017;Binas;367;8617624;334856;219;6810659;148;1806965;23481;20725
31539;Sédeilhac;41;962738;131170;19;760078;22;202660;23481;20726
38537;La Verpillière;3328;78146297;3350965;2012;63341048;1316;14805249;23481;20727
25627;Villers-sous-Chalamont;143;3357905;112170;72;2573558;71;784347;23482;20728
66178;Saint-Jean-Pla-de-Corts;1138;26723060;1326142;599;21127735;539;5595325;23482;20729
85280;Sallertaine;1484;34848438;1286913;825;27271778;659;7576660;23483;20730
64101;Baudreix;261;6129005;253246;146;4916454;115;1212551;23483;20731
50444;Saint-Amand;1198;28132413;1015099;726;22501467;472;5630946;23483;20732
80217;Courcelles-au-Bois;36;845391;28702;17;601710;19;243681;23483;20733
80421;Hattencourt;143;3358112;212988;80;2633652;63;724460;23483;20734
38349;Sablons;1082;25409167;963970;676;20672011;406;4737156;23484;20735
71433;Saint-Julien-de-Civry;281;6598957;219480;149;4872732;132;1726225;23484;20736
2A041;Bonifacio;1980;46498182;3591789;968;35763559;1012;10734623;23484;20737
33211;Labarde;333;7820266;367312;206;6540792;127;1279474;23484;20738
72110;Crosmières;450;10568569;276726;265;8297120;185;2271449;23486;20739
45055;Bricy;341;8008879;338485;266;7040204;75;968675;23486;20740
51286;Hauteville;120;2818413;86502;76;2316836;44;501577;23487;20741
66160;Reynès;781;18343424;900663;401;14388669;380;3954755;23487;20742
29280;Telgruc-sur-Mer;1214;28514095;1255287;687;22902560;527;5611535;23488;20743
38052;Le Bourg-d'Oisans;1960;46036123;1894879;1164;36932925;796;9103198;23488;20744
67401;Rimsdorf;163;3828568;111373;96;3034598;67;793970;23488;20745
80498;Mailly-Maillet;331;7774589;518659;169;6183061;162;1591528;23488;20746
51351;Marigny;63;1479772;96686;32;1140681;31;339091;23488;20747
69214;Saint-Jean-la-Bussière;578;13576426;481518;344;10823837;234;2752589;23489;20748
42005;Andrézieux-Bouthéon;5164;121299717;6093113;2721;96583602;2443;24716115;23489;20749
59477;Provin;2093;49164517;1684155;1204;38958323;889;10206194;23490;20750
12070;Compeyre;294;6906097;220048;170;5470682;124;1435415;23490;20751
72087;Conflans-sur-Anille;301;7070700;304739;174;5644279;127;1426421;23491;20752
56249;Taupont;1195;28072578;1048408;677;22305547;518;5767031;23492;20753
55282;Lavallée;45;1057128;21327;28;851303;17;205825;23492;20754
72156;Lamnay;499;11722518;579605;295;9399910;204;2322608;23492;20755
71064;Bruailles;536;12592139;550507;329;10389737;207;2202402;23493;20756
80691;Saigneville;212;4980530;174059;119;3822723;93;1157807;23493;20757
38161;Faramans;510;11981554;490792;273;9241751;237;2739803;23493;20758
25434;Ornans;2376;55820970;2540864;1411;45099154;965;10721816;23494;20759
60595;Saint-Remy-en-l'Eau;221;5192133;196329;140;4208311;81;983822;23494;20760
26054;Bouchet;669;15717561;665766;359;12325249;310;3392312;23494;20761
27493;Romilly-sur-Andelle;1640;38530517;1408979;1003;31271424;637;7259093;23494;20762
80327;Fontaine-sur-Maye;77;1809179;95713;35;1319967;42;489212;23496;20763
27435;La Noë-Poulain;112;2631536;150150;63;2145017;49;486519;23496;20764
49067;Champteussé-sur-Baconne;112;2631550;50176;57;1936648;55;694902;23496;20765
58303;Varennes-Vauzelles;5629;132264457;7265154;3305;107605258;2324;24659199;23497;20766
60662;Le Vauroux;255;5991744;217110;158;4958581;97;1033163;23497;20767
67130;Erstein;6400;150382900;7299427;3977;126534779;2423;23848121;23497;20768
83050;Draguignan;21917;514991473;28132970;12063;417465172;9854;97526301;23497;20769
93064;Rosny-sous-Bois;24566;577247051;33298655;14291;484402322;10275;92844729;23498;20770
02772;Vaux-en-Vermandois;72;1692018;63704;43;1402117;29;289901;23500;20771
01272;Neuville-les-Dames;821;19293862;751839;488;15472810;333;3821052;23500;20772
63090;Chaptuzat;269;6321629;217987;161;5091654;108;1229975;23500;20773
67358;Offwiller;434;10199536;331608;258;8074240;176;2125296;23501;20774
45110;Courcelles;159;3736795;135902;89;2872182;70;864613;23502;20775
76637;Saint-Pierre-en-Port;463;10881386;483816;261;8688402;202;2192984;23502;20776
65332;Oléac-Debat;69;1621670;52271;43;1371618;26;250052;23502;20777
87030;Chaillac-sur-Vienne;647;15206468;566428;402;12442299;245;2764169;23503;20778
71491;Saint-Yan;643;15112500;627306;363;11984156;280;3128344;23503;20779
24077;Campsegret;222;5217692;197962;105;3966265;117;1251427;23503;20780
39519;Soucia;93;2185869;62423;52;1634084;41;551785;23504;20781
39439;Port-Lesney;303;7121859;393027;163;5701783;140;1420076;23504;20782
02629;Puisieux-et-Clanlieu;156;3666701;209216;72;2796955;84;869746;23504;20783
21032;Aubigny-la-Ronce;90;2115442;91726;43;1576311;47;539131;23505;20784
16166;L'Isle-d'Espagnac;3040;71456241;3265697;1765;57792518;1275;13663723;23505;20785
61321;Pacé;202;4748180;167408;126;3837482;76;910698;23506;20786
14359;Lécaude;77;1809950;37353;46;1422127;31;387823;23506;20787
65115;Cabanac;145;3408410;85462;85;2639713;60;768697;23506;20788
61139;Crouttes;138;3243881;104534;72;2413759;66;830122;23506;20789
54290;Laix;115;2703294;59600;47;1425231;68;1278063;23507;20790
19019;Beaulieu-sur-Dordogne;800;18805735;1494092;355;14492693;445;4313042;23507;20791
21374;Maligny;123;2891433;118906;77;2367842;46;523591;23508;20792
63422;Solignat;249;5853435;262284;140;4576749;109;1276686;23508;20793
39205;Éclans-Nenon;186;4372689;132542;107;3415877;79;956812;23509;20794
35060;La Chapelle-du-Lou;364;8557486;186308;219;6731226;145;1826260;23510;20795
60542;Rochy-Condé;506;11896393;381760;341;9999396;165;1896997;23511;20796
59507;Ronchin;9950;233932061;11267813;5933;193627178;4017;40304883;23511;20797
27107;Bourneville;515;12108043;448852;290;9638039;225;2470004;23511;20798
59489;Raimbeaucourt;2211;51984335;2412822;1194;40827871;1017;11156464;23512;20799
89374;Sambourg;43;1011016;24357;23;780697;20;230319;23512;20800
65138;Cauterets;716;16834842;927324;414;13700686;302;3134156;23512;20801
04027;Bevons;118;2774479;93780;69;2282130;49;492349;23513;20802
82152;Saint-Aignan;229;5384525;175206;115;4241254;114;1143271;23513;20803
37077;Cinq-Mars-la-Pile;1700;39972593;1288927;1055;32269630;645;7702963;23513;20804
36137;Néons-sur-Creuse;214;5031882;115315;110;3822147;104;1209735;23513;20805
89261;Molinons;153;3597840;165548;90;2881228;63;716612;23515;20806
62754;Saint-Léger;221;5196993;204481;123;4098646;98;1098347;23516;20807
21148;Charrey-sur-Saône;171;4021236;149167;101;3143210;70;878026;23516;20808
30163;Mauressargues;74;1740197;69118;42;1426220;32;313977;23516;20809
54317;Lironville;56;1317003;43309;30;1013720;26;303283;23518;20810
57009;Ajoncourt;57;1340590;60065;36;1151137;21;189453;23519;20811
21568;Saint-Rémy;433;10183915;361440;261;8195713;172;1988202;23519;20812
72267;Saint-Aubin-des-Coudrais;473;11125566;305299;301;9027439;172;2098127;23521;20813
64088;Balansun;141;3316560;106498;87;2741513;54;575047;23522;20814
49072;La Chapelle-du-Genêt;557;13101776;266443;327;10026757;230;3075019;23522;20815
60133;Catillon-Fumechon;306;7198019;325164;191;5882594;115;1315425;23523;20816
27319;La Haye-de-Routot;150;3528451;91164;96;2853410;54;675041;23523;20817
65048;Aurensan;406;9551014;352424;253;7864556;153;1686458;23525;20818
02710;Seraucourt-le-Grand;392;9221682;437427;217;7437073;175;1784609;23525;20819
62877;Warlincourt-lès-Pas;92;2164326;75330;50;1746200;42;418126;23525;20820
06097;Pierrefeu;157;3693744;154526;82;2913264;75;780480;23527;20821
23245;Saint-Sulpice-le-Guérétois;1158;27245213;1187082;731;22757012;427;4488201;23528;20822
49317;Saint-Rémy-la-Varenne;492;11575835;412387;259;8903839;233;2671996;23528;20823
82028;Canals;358;8423200;255220;207;6868911;151;1554289;23528;20824
14692;Tilly-sur-Seulles;792;18634794;628681;456;14649422;336;3985372;23529;20825
39170;Courlans;478;11246763;441043;277;8972628;201;2274135;23529;20826
37227;Saint-Michel-sur-Loire;361;8494034;349444;212;6829824;149;1664210;23529;20827
60514;Prévillers;100;2353071;71408;65;1966341;35;386730;23531;20828
62372;Givenchy-le-Noble;80;1882476;77499;50;1550190;30;332286;23531;20829
62019;Aix-Noulette;2053;48310692;2410101;1147;38027485;906;10283207;23532;20830
55154;Dieue-sur-Meuse;763;17955081;700891;424;13974956;339;3980125;23532;20831
73276;Saint-Pierre-de-Soucy;217;5106682;246923;118;4005292;99;1101390;23533;20832
26129;Eymeux;494;11625481;325486;285;9249605;209;2375876;23533;20833
86048;Chabournay;488;11484424;324305;303;9347584;185;2136840;23534;20834
51352;Marolles;437;10284427;433384;252;7962480;185;2321947;23534;20835
02373;Hary;126;2965327;101202;78;2510342;48;454985;23534;20836
67514;Waldhambach;364;8566518;426105;197;6668050;167;1898468;23534;20837
62903;Zoteux;255;6001332;337152;124;4442152;131;1559180;23535;20838
53180;Pommerieux;315;7413590;280926;172;5737054;143;1676536;23535;20839
62739;Sains-lès-Marquion;171;4024531;210756;92;3190883;79;833648;23535;20840
11258;Moussan;953;22429412;917921;516;17506528;437;4922884;23536;20841
49327;Saulgé-l'Hôpital;264;6213416;148627;153;4834068;111;1379348;23536;20842
34308;Taussac-la-Billière;238;5601557;221384;146;4644712;92;956845;23536;20843
31371;Montégut-Lauragais;228;5366307;195907;132;4362773;96;1003534;23536;20844
42155;Nervieux;511;12027127;490184;274;9181620;237;2845507;23536;20845
34254;Saint-Félix-de-Lodez;586;13792561;625056;326;11165280;260;2627281;23537;20846
57685;Vahl-lès-Bénestroff;61;1435801;60294;35;1147909;26;287892;23538;20847
16057;Bouteville;187;4401629;263370;101;3476224;86;925405;23538;20848
07279;Saint-Montan;943;22196585;833519;522;17489238;421;4707347;23538;20849
66225;Villelongue-dels-Monts;861;20266485;1032987;479;16322363;382;3944122;23538;20850
40234;Pouydesseaux;459;10804326;415706;263;8686107;196;2118219;23539;20851
89097;Chêne-Arnoult;62;1459448;65720;41;1284643;21;174805;23539;20852
59488;Raillencourt-Sainte-Olle;1258;29614624;1339345;672;24083684;586;5530940;23541;20853
49066;Champ-sur-Layon;478;11252674;286424;264;8646096;214;2606578;23541;20854
47281;Saint-Urcisse;118;2777868;72740;66;2133345;52;644523;23541;20855
51143;Le Chemin;34;800422;29885;15;566402;19;234020;23542;20856
56139;Montertelot;181;4261085;139772;102;3326297;79;934788;23542;20857
49001;Les Alleuds;404;9510960;226438;227;7505973;177;2004987;23542;20858
25274;Glay;200;4708580;223957;123;3806158;77;902422;23543;20859
69247;Thel;176;4143562;132145;109;3381443;67;762119;23543;20860
64344;Livron;209;4920505;211304;108;3838363;101;1082142;23543;20861
66114;Montescot;917;21589361;929101;503;17020813;414;4568548;23543;20862
55012;Apremont-la-Forêt;194;4567713;164130;115;3663970;79;903743;23545;20863
89366;Saint-Romain-le-Preux;110;2589991;140828;56;1965369;54;624622;23545;20864
29236;Riec-sur-Belon;2486;58534379;2767882;1353;45240622;1133;13293757;23546;20865
01118;Corbonod;662;15587835;606819;323;11936605;339;3651230;23547;20866
14213;Curcy-sur-Orne;235;5533493;195362;132;4301995;103;1231498;23547;20867
45234;Orléans;63787;1502019027;95252127;36853;1253126470;26934;248892557;23547;20868
25065;Blarians;31;729992;19210;19;600026;12;129966;23548;20869
89006;Ancy-le-Libre;112;2637403;130388;60;2030849;52;606554;23548;20870
42168;Pélussin;2040;48039208;1950510;1188;38643438;852;9395770;23549;20871
32258;Mirepoix;129;3037942;119988;75;2382735;54;655207;23550;20872
56146;Neulliac;802;18887057;914163;449;14988693;353;3898364;23550;20873
18145;Menetou-Salon;974;22937664;1256752;531;18343257;443;4594407;23550;20874
67020;Barembach;473;11139492;453033;279;8882386;194;2257106;23551;20875
73180;Motz;241;5675733;183901;150;4643698;91;1032035;23551;20876
27550;Saint-Grégoire-du-Vièvre;181;4262763;172120;99;3404955;82;857808;23551;20877
63407;Saulzet-le-Froid;159;3744689;124597;76;2860307;83;884382;23552;20878
17262;Nieul-lès-Saintes;619;14578603;535869;371;11828673;248;2749930;23552;20879
67028;Benfeld;3087;72704866;3471832;1810;58512252;1277;14192614;23552;20880
57516;Oberdorff;216;5087276;170954;125;3833378;91;1253898;23552;20881
60262;Le Frestoy-Vaux;124;2920478;117856;73;2248465;51;672013;23552;20882
02717;Séry-lès-Mézières;333;7843278;453663;182;6198408;151;1644870;23553;20883
26334;Salettes;69;1625217;54616;37;1287736;32;337481;23554;20884
24340;Prigonrieux;2225;52407696;2071364;1280;41471547;945;10936149;23554;20885
40022;Bahus-Soubiran;213;5017090;199850;113;3863798;100;1153292;23554;20886
72199;Moitron-sur-Sarthe;117;2755937;159043;63;2141958;54;613979;23555;20887
31520;Sajas;61;1436873;60079;32;1140274;29;296599;23555;20888
57481;Montois-la-Montagne;1317;31023979;1149078;767;23917580;550;7106399;23557;20889
76294;La Gaillarde;218;5135356;269322;106;3791109;112;1344247;23557;20890
63249;Néronde-sur-Dore;254;5983663;299900;144;4814555;110;1169108;23558;20891
42001;Aboën;215;5064944;297859;115;4005645;100;1059299;23558;20892
54401;Nonhigny;62;1460634;73319;25;1119826;37;340808;23559;20893
50540;Saint-Pierre-Langers;288;6784935;180386;162;5122634;126;1662301;23559;20894
35141;Landavran;304;7161883;108299;191;5723720;113;1438163;23559;20895
80192;Chipilly;92;2167466;78191;56;1782512;36;384954;23559;20896
49256;Rablay-sur-Layon;364;8575735;258512;190;6507180;174;2068555;23560;20897
74287;Vailly;450;10602266;250399;272;8113561;178;2488705;23561;20898
35338;Torcé;545;12841053;318868;344;10272406;201;2568647;23562;20899
82124;Montbeton;1866;43966497;1695385;1009;35708754;857;8257743;23562;20900
89407;Tanlay;646;15221039;650509;364;11683761;282;3537278;23562;20901
08357;Remilly-Aillicourt;411;9684057;462933;224;7608250;187;2075807;23562;20902
38004;L'Albenc;575;13548332;445247;324;10497294;251;3051038;23562;20903
67446;Schillersdorf;227;5348718;152484;148;4429896;79;918822;23563;20904
25578;Valdahon;2673;62983077;2634985;1576;50648614;1097;12334463;23563;20905
80619;Pernois;361;8506155;364685;217;6932163;144;1573992;23563;20906
57299;Hartzviller;487;11475614;409327;324;9557194;163;1918420;23564;20907
25438;Osselle;229;5396190;193001;143;4416142;86;980048;23564;20908
88402;Roville-aux-Chênes;129;3039792;154213;69;2377901;60;661891;23564;20909
14292;Friardel;124;2922031;162148;63;2231275;61;690756;23565;20910
60676;Ville;405;9543885;364070;261;7760056;144;1783829;23565;20911
41108;Lancôme;78;1838123;95160;46;1522555;32;315568;23566;20912
39362;Montmorot;1823;42960347;2033089;1116;35256896;707;7703451;23566;20913
39514;Serre-les-Moulières;92;2168081;71089;55;1758513;37;409568;23566;20914
56077;Le Guerno;462;10887731;360510;290;9018525;172;1869206;23567;20915
25137;Chaudefontaine;116;2733775;93176;75;2241221;41;492554;23567;20916
22369;Trémeur;382;9002923;453662;189;6800653;193;2202270;23568;20917
62561;Martinpuich;105;2474711;97619;53;1837444;52;637267;23569;20918
84126;Séguret;498;11737201;667244;264;9235603;234;2501598;23569;20919
06109;La Roquette-sur-Var;491;11572475;486302;301;9624390;190;1948085;23569;20920
33215;Ladaux;107;2521912;116934;59;2023881;48;498031;23569;20921
31096;Cabanac-Séguenville;81;1909138;77010;45;1502652;36;406486;23570;20922
21351;Longchamp;583;13741131;455654;357;10902447;226;2838684;23570;20923
50013;Anneville-en-Saire;205;4831862;239994;106;3767572;99;1064290;23570;20924
27095;Bosrobert;280;6599769;234134;165;5264237;115;1335532;23571;20925
40012;Artassenx;136;3205615;134827;88;2647358;48;558257;23571;20926
50467;Saint-Floxel;247;5822079;223473;147;4718353;100;1103726;23571;20927
80152;Bus-la-Mésière;77;1815121;70534;44;1481049;33;334072;23573;20928
46334;Le Vigan;846;19943061;896902;461;15862163;385;4080898;23573;20929
38097;Chavanoz;2211;52121568;1884815;1299;41630424;912;10491144;23574;20930
88399;Le Roulier;104;2451688;72690;65;2017068;39;434620;23574;20931
90051;Froidefontaine;260;6129431;250754;172;5103957;88;1025474;23575;20932
83136;Le Thoronet;1286;30318326;1323776;678;23763305;608;6555021;23576;20933
50332;Les Moitiers-d'Allonne;400;9430666;374850;230;7727295;170;1703371;23577;20934
63442;Valz-sous-Châteauneuf;25;589444;27154;13;464948;12;124496;23578;20935
35218;Le Petit-Fougeray;398;9383997;231483;249;7459398;149;1924599;23578;20936
35127;Guignen;1763;41568128;1162965;1074;33205830;689;8362298;23578;20937
88225;Hadol;1232;29048210;944053;748;23516946;484;5531264;23578;20938
38541;Veyrins-Thuellin;1054;24851500;749315;605;19515697;449;5335803;23578;20939
39489;Saint-Lothain;257;6059618;288304;139;4853776;118;1205842;23578;20940
72268;Saint-Biez-en-Belin;320;7545214;220426;193;5937701;127;1607513;23579;20941
80097;Béthencourt-sur-Somme;71;1674099;61471;34;1245737;37;428362;23579;20942
45127;Dordives;1687;39777550;1844304;980;31688285;707;8089265;23579;20943
27420;Mouflaines;93;2192867;106696;53;1729485;40;463382;23579;20944
04046;Le Chaffaut-Saint-Jurson;374;8818878;420310;233;7322662;141;1496216;23580;20945
85259;Saint-Paul-en-Pareds;606;14289443;345591;397;11699044;209;2590399;23580;20946
84032;Caseneuve;266;6272412;323400;156;5177091;110;1095321;23580;20947
80010;Ailly-sur-Noye;1532;36126989;1624560;897;29665777;635;6461212;23582;20948
56168;Plouharnel;1213;28604529;1386362;654;22819893;559;5784636;23582;20949
62594;Mory;165;3890994;189748;91;3053691;74;837303;23582;20950
08482;Villers-sur-le-Mont;54;1273464;63739;34;1094805;20;178659;23583;20951
17396;Saint-Sauveur-d'Aunis;826;19480602;576810;469;15253366;357;4227236;23584;20952
25626;Villers-Saint-Martin;107;2523578;50842;71;2029613;36;493965;23585;20953
14556;Saint-André-sur-Orne;914;21556706;811020;544;17405442;370;4151264;23585;20954
44020;Bouguenais;10018;236274834;9110987;6071;196243336;3947;40031498;23585;20955
16342;Saint-Palais-du-Né;150;3537799;182004;87;2942038;63;595761;23585;20956
38152;Eclose;391;9222038;335096;239;7323493;152;1898545;23586;20957
27271;Fresney;149;3514304;82227;87;2634377;62;879927;23586;20958
86285;Verrières;528;12453433;620969;276;9635053;252;2818380;23586;20959
32040;Bédéchan;70;1651048;107311;41;1357680;29;293368;23586;20960
57079;Bibiche;202;4764494;106566;102;3256640;100;1507854;23587;20961
80530;Méricourt-l'Abbé;312;7359174;348095;177;6022982;135;1336192;23587;20962
27542;Saint-Georges-du-Vièvre;465;10968114;393656;249;8877412;216;2090702;23587;20963
67415;Rothbach;254;5991285;208702;157;4749578;97;1241707;23588;20964
31186;Fonbeauzard;1710;40335811;1827457;1180;34570553;530;5765258;23588;20965
40164;Retjons;184;4340259;242050;93;3320924;91;1019335;23588;20966
71183;Dracy-lès-Couches;93;2193766;85676;61;1835770;32;357996;23589;20967
58260;Saint-Parize-le-Châtel;716;16890094;659204;444;13872583;272;3017511;23590;20968
95019;Arnouville;7293;172045052;8734861;4226;141672856;3067;30372196;23590;20969
32150;Goutz;100;2359086;91678;53;1860513;47;498573;23591;20970
02417;Lempire;63;1486242;91023;31;1177052;32;309190;23591;20971
39378;Nanc-lès-Saint-Amour;157;3703831;156343;92;3000755;65;703076;23591;20972
18281;Vignoux-sur-Barangeon;1184;27932314;1107296;746;23200062;438;4732252;23591;20973
09258;Saint-Félix-de-Rieutord;233;5496880;198693;150;4592605;83;904275;23592;20974
36217;Sembleçay;61;1439098;72282;35;1187960;26;251138;23592;20975
81046;Cadalen;834;19675666;894615;421;15273210;413;4402456;23592;20976
33421;Saint-Jean-de-Blaignac;225;5308209;233484;120;4161019;105;1147190;23592;20977
17311;Saint-Augustin;784;18496586;934924;431;14352244;353;4144342;23593;20978
44050;Crossac;1354;31945163;868502;842;25854970;512;6090193;23593;20979
27232;Farceaux;145;3421037;143639;82;2650954;63;770083;23593;20980
27496;Rosay-sur-Lieure;307;7243298;282053;195;6082132;112;1161166;23594;20981
03101;Domérat;5190;122451945;5548263;3129;100650986;2061;21800959;23594;20982
53260;Simplé;184;4341271;78064;90;3193193;94;1148078;23594;20983
50489;Saint-Jean-de-la-Haize;264;6228808;223722;167;5201109;97;1027699;23594;20984
33334;Portets;1389;32772137;1623202;801;26421357;588;6350780;23594;20985
86094;Dienné;259;6110948;216884;159;4899083;100;1211865;23594;20986
33414;Saint-Germain-de-la-Rivière;196;4624699;195401;103;3652896;93;971803;23595;20987
03030;Biozat;433;10216959;593238;248;8256004;185;1960955;23596;20988
34223;Puimisson;548;12930477;661342;265;10231725;283;2698752;23596;20989
38527;Vaujany;187;4412491;252189;114;3694069;73;718422;23596;20990
07140;Lemps;398;9391313;353627;229;7420979;169;1970334;23596;20991
01262;Montluel;3834;90470605;4156063;2272;72642497;1562;17828108;23597;20992
60381;Margny-aux-Cerises;125;2949630;147592;77;2506371;48;443259;23597;20993
55289;Levoncourt;26;613531;22830;15;527132;11;86399;23597;20994
14372;Livry;414;9769557;424376;220;7521964;194;2247593;23598;20995
89371;Sainte-Vertu;53;1250783;71184;26;935313;27;315470;23600;20996
39233;Foucherans;1104;26054374;992057;731;21899309;373;4155065;23600;20997
57538;Pettoncourt;147;3469244;138030;92;2792416;55;676828;23600;20998
65420;Sère-en-Lavedan;38;896817;61317;22;740450;16;156367;23600;20999
51258;La Forestière;122;2879334;123549;68;2225419;54;653915;23601;21000
50496;Saint-Jean-le-Thomas;268;6325138;275071;155;5196986;113;1128152;23601;21001
84105;Saignon;602;14208267;717163;363;11894421;239;2313846;23602;21002
50139;Condé-sur-Vire;1813;42790031;1468477;1134;35172600;679;7617431;23602;21003
64331;Lembeye;451;10644418;581737;219;8128921;232;2515497;23602;21004
18037;Brinon-sur-Sauldre;630;14869546;917834;323;11618219;307;3251327;23602;21005
16220;Les Métairies;348;8213985;325966;201;6639713;147;1574272;23603;21006
57190;Elvange;199;4697118;165410;110;3690950;89;1006168;23604;21007
71015;Auxy;524;12368395;413422;343;10316745;181;2051650;23604;21008
12295;Viala-du-Pas-de-Jaux;54;1274631;57448;28;942290;26;332341;23604;21009
46051;Cambes;181;4272495;206485;92;3318493;89;954002;23605;21010
49284;Saint-Germain-des-Prés;714;16854163;588539;410;13239436;304;3614727;23605;21011
34025;Bassan;941;22212666;845474;505;17197302;436;5015364;23605;21012
39318;Martigna;103;2431378;73317;60;1794376;43;637002;23606;21013
17184;La Gripperie-Saint-Symphorien;312;7365153;252336;152;5712951;160;1652202;23606;21014
49110;Corzé;807;19050699;670752;488;15337615;319;3713084;23607;21015
31247;Labarthe-Rivière;747;17634586;745817;442;14132604;305;3501982;23607;21016
76329;Gruchet-le-Valasse;1595;37653546;1461658;921;29873426;674;7780120;23607;21017
41167;Onzain;1952;46081762;1920909;1100;36194152;852;9887610;23607;21018
88357;Poussay;390;9207012;303408;259;7678033;131;1528979;23608;21019
32381;Saint-Jean-le-Comtal;210;4957659;176953;127;4019597;83;938062;23608;21020
57639;Schorbach;316;7460110;433430;170;5936961;146;1523149;23608;21021
02632;Quincy-Basse;29;684631;22612;17;577774;12;106857;23608;21022
10087;Chaserey;29;684636;31166;16;509612;13;175024;23608;21023
05183;Villar-Saint-Pancrace;835;19712876;807377;541;16369232;294;3343644;23608;21024
22040;Coadout;288;6799477;276563;165;5416181;123;1383296;23609;21025
33259;Lugon-et-l'Île-du-Carnay;574;13552009;595475;306;10473239;268;3078770;23610;21026
59057;Beaudignies;313;7389879;260587;192;5982276;121;1407603;23610;21027
27310;Hacqueville;237;5595642;237922;135;4584783;102;1010859;23610;21028
17306;Royan;12869;303844126;19098706;6965;242532347;5904;61311779;23611;21029
17322;Saint-Cyr-du-Doret;321;7579044;231675;136;5589290;185;1989754;23611;21030
70566;Villers-sur-Port;105;2479234;65861;65;2022071;40;457163;23612;21031
85039;La Bruffière;1959;46255684;972218;1116;36287753;843;9967931;23612;21032
40311;Taller;272;6422542;242025;144;4967474;128;1455068;23612;21033
03106;Durdat-Larequille;673;15891215;711690;391;13067159;282;2824056;23613;21034
67387;Reichsfeld;167;3943341;130839;99;3240750;68;702591;23613;21035
62728;Rumaucourt;352;8311806;310290;203;6842461;149;1469345;23613;21036
37106;La Ferrière;150;3541998;100492;97;2902701;53;639297;23613;21037
51550;Sompuis;156;3683695;132382;82;2950422;74;733273;23613;21038
62265;Delettes;556;13129412;382948;288;10036151;268;3093261;23614;21039
31379;Montgazin;103;2432272;112656;60;1906597;43;525675;23614;21040
72302;Saint-Martin-des-Monts;93;2196161;55758;66;1900869;27;295292;23615;21041
56009;Bangor;590;13933082;635763;363;11383973;227;2549109;23615;21042
58215;Pouilly-sur-Loire;1082;25551877;1677229;584;20291705;498;5260172;23615;21043
34208;Popian;174;4109159;206234;90;3101502;84;1007657;23616;21044
29188;Plougasnou;2060;48650412;2587174;1146;38975579;914;9674833;23617;21045
29103;Landerneau;8544;201781351;9252863;4866;162138115;3678;39643236;23617;21046
80364;Friaucourt;400;9446968;360884;259;7799069;141;1647899;23617;21047
62549;Marconne;652;15398741;1086833;297;11682810;355;3715931;23618;21048
52036;Balesmes-sur-Marne;142;3353724;118513;84;2605812;58;747912;23618;21049
47213;Prayssas;526;12423046;723160;265;9513322;261;2909724;23618;21050
89286;Parly;431;10179444;404735;266;8391265;165;1788179;23618;21051
42273;Saint-Pierre-la-Noaille;193;4558570;154824;117;3733188;76;825382;23620;21052
13026;Châteauneuf-les-Martigues;7299;172399540;8445676;4332;142910545;2967;29488995;23620;21053
40054;Brassempouy;154;3637520;155639;84;2888410;70;749110;23620;21054
50229;Hamelin;65;1535329;25373;28;1146786;37;388543;23620;21055
57480;Montigny-lès-Metz;13458;317885159;18888121;7490;254432325;5968;63452834;23621;21056
21699;Villers-les-Pots;546;12896990;427210;316;10105011;230;2791979;23621;21057
61481;Tellières-le-Plessis;38;897596;26112;21;702363;17;195233;23621;21058
38240;Moissieu-sur-Dolon;348;8220148;237383;218;6694939;130;1525209;23621;21059
08445;Thelonne;174;4110150;101795;98;3183473;76;926677;23622;21060
76379;Lamberville;85;2007847;46833;43;1552340;42;455507;23622;21061
50190;Fontenay-sur-Mer;105;2480299;78843;61;2031661;44;448638;23622;21062
25014;Amagney;427;10086585;386617;286;8484264;141;1602321;23622;21063
50386;Omonville-la-Rogue;272;6425220;238563;152;5157728;120;1267492;23622;21064
44004;Anetz;906;21402237;457896;570;17221893;336;4180344;23623;21065
80273;Éplessier;200;4724621;187083;107;3607887;93;1116734;23623;21066
59503;Robersart;97;2291476;113359;54;1817180;43;474296;23623;21067
56109;Lauzach;475;11221338;367571;294;8986219;181;2235119;23624;21068
27466;Le Plessis-Sainte-Opportune;160;3779822;148132;101;3143636;59;636186;23624;21069
80707;Saint-Léger-sur-Bresle;38;897725;32312;22;726277;16;171448;23624;21070
45268;Saint-Aignan-le-Jaillard;347;8197807;347454;227;6926149;120;1271658;23625;21071
57461;Métairies-Saint-Quirin;155;3661862;161569;96;2996994;59;664868;23625;21072
69113;Létra;434;10253370;423634;232;8177960;202;2075410;23625;21073
62232;La Comté;434;10253612;439319;242;8104280;192;2149332;23626;21074
56021;Brandérion;640;15120764;424281;396;12174866;244;2945898;23626;21075
80052;Baizieux;113;2669802;101664;67;2127719;46;542083;23627;21076
38116;Cognet;23;543416;24554;12;408963;11;134453;23627;21077
76222;Duclair;2303;54418381;2549859;1348;43973582;955;10444799;23629;21078
27627;Le Theil-Nolent;125;2953893;136803;69;2332511;56;621382;23631;21079
41279;Villedieu-le-Château;201;4749876;239973;111;3644849;90;1105027;23631;21080
55163;Doncourt-aux-Templiers;39;921630;35567;21;697720;18;223910;23632;21081
72316;Saint-Rémy-des-Monts;369;8720115;326535;219;6818230;150;1901885;23632;21082
70229;Faymont;131;3095780;98357;73;2315080;58;780700;23632;21083
35175;Mernel;537;12690988;549199;302;9903740;235;2787248;23633;21084
14468;Noron-la-Poterie;176;4159521;114136;109;3348403;67;811118;23634;21085
24521;Sarliac-sur-l'Isle;547;12927603;582880;311;10300366;236;2627237;23634;21086
02245;Cuffies;838;19805091;946059;471;15943883;367;3861208;23634;21087
45275;Saint-Firmin-des-Bois;284;6712030;301498;177;5477524;107;1234506;23634;21088
70564;Villers-lès-Luxeuil;175;4135965;107505;102;3195766;73;940199;23634;21089
57320;Hertzing;96;2268893;76525;58;1797656;38;471237;23634;21090
81281;Sémalens;1086;25667243;1065017;608;20288466;478;5378777;23635;21091
76577;Sainte-Foy;261;6168651;174729;154;4776226;107;1392425;23635;21092
32194;Larressingle;110;2599866;116763;67;2180229;43;419637;23635;21093
86083;Coulombiers;593;14015715;575918;362;11412112;231;2603603;23635;21094
07268;Saint-Martin-d'Ardèche;607;14346926;816404;334;11506583;273;2840343;23636;21095
76050;Avremesnil;562;13283413;468463;348;10662855;214;2620558;23636;21096
69128;Mardore;292;6901849;280947;172;5519156;120;1382693;23636;21097
32346;Roquebrune;118;2789119;181939;64;2309952;54;479167;23637;21098
89043;Blacy;53;1252742;69887;31;1070733;22;182009;23637;21099
40272;Saint-Martin-de-Hinx;710;16782380;898627;397;13168756;313;3613624;23637;21100
57213;Filstroff;422;9975440;357066;234;7451275;188;2524165;23638;21101
47138;Laroque-Timbaut;868;20518564;991850;466;16427604;402;4090960;23639;21102
08429;Sormonne;281;6642542;258120;168;5433126;113;1209416;23639;21103
76235;Envermeu;1114;26333872;1203288;607;20807277;507;5526595;23639;21104
04068;Dauphin;469;11086750;492131;274;8893367;195;2193383;23639;21105
30248;Saint-Dézéry;199;4704198;219304;106;3651374;93;1052824;23639;21106
14498;Pertheville-Ners;126;2978611;99490;75;2437665;51;540946;23640;21107
71261;Loisy;318;7517708;303343;185;6157296;133;1360412;23641;21108
60198;Dives;193;4562706;161779;122;3691014;71;871692;23641;21109
25298;Grosbois;105;2482361;57329;62;1932245;43;550116;23642;21110
38564;Voissant;125;2955235;97635;78;2368541;47;586694;23642;21111
85127;Longeville-sur-Mer;1466;34659013;1590754;811;27442731;655;7216282;23642;21112
61185;Gémages;67;1584081;56886;37;1225373;30;358708;23643;21113
25020;Arbouans;525;12413091;547335;323;10134108;202;2278983;23644;21114
42293;Saint-Victor-sur-Rhins;574;13571868;480369;363;11086952;211;2484916;23644;21115
50270;Lieusaint;193;4563382;114484;110;3610036;83;953346;23644;21116
61349;Ri;85;2009809;112161;46;1576295;39;433514;23645;21117
53023;La Bazouge-des-Alleux;211;4989084;38634;136;4039600;75;949484;23645;21118
17483;Yves;778;18395969;836172;452;14894570;326;3501399;23645;21119
33425;Saint-Laurent-d'Arce;702;16598949;541573;411;13249463;291;3349486;23645;21120
13039;Fos-sur-Mer;8452;199854332;8533608;5191;164957800;3261;34896532;23646;21121
44108;Mouzillon;1324;31307072;915857;830;25567273;494;5739799;23646;21122
80383;Goyencourt;54;1276882;44440;36;1022333;18;254549;23646;21123
67009;Altwiller;217;5131196;149310;112;3855524;105;1275672;23646;21124
02063;Bellenglise;194;4587348;180808;102;3548692;92;1038656;23646;21125
21635;Thoste;61;1442438;66713;34;1079243;27;363195;23647;21126
54099;Briey;3162;74772971;4081108;1656;58330393;1506;16442578;23647;21127
85189;Notre-Dame-de-Riez;990;23410994;830010;580;18676495;410;4734499;23647;21128
27530;Saint-Denis-d'Augerons;51;1206021;77399;27;982286;24;223735;23647;21129
08284;Les Mazures;477;11279889;512034;279;9093237;198;2186652;23648;21130
53168;Nuillé-sur-Vicoin;616;14567069;513273;364;11744808;252;2822261;23648;21131
30145;Lédenon;766;18114967;686960;431;14597456;335;3517511;23649;21132
71368;Reclesne;162;3831103;125157;95;2980305;67;850798;23649;21133
09321;Ussat;183;4327729;152203;122;3644796;61;682933;23649;21134
24468;Saint-Michel-de-Villadeix;177;4185997;139792;85;3155739;92;1030258;23650;21135
66144;Pollestres;2465;58297968;2557797;1395;46726626;1070;11571342;23650;21136
50298;Méautis;329;7781335;314621;186;6130266;143;1651069;23651;21137
10138;Épagne;66;1561003;39740;37;1234720;29;326283;23652;21138
22182;Plélo;1621;38340613;1322312;934;30412493;687;7928120;23652;21139
86067;Châtillon;113;2672769;89716;68;2150684;45;522085;23653;21140
63069;Le Cendre;2717;64264776;2415188;1745;53389496;972;10875280;23653;21141
41107;Lancé;242;5724121;186310;149;4584958;93;1139163;23653;21142
39325;Mesnay;301;7119763;276573;183;5758559;118;1361204;23654;21143
37246;Sennevières;117;2767534;120220;73;2238673;44;528861;23654;21144
87169;Saint-Maurice-les-Brousses;466;11022866;285797;295;8912648;171;2110218;23654;21145
38054;Bouvesse-Quirieu;761;18000864;780468;453;14619479;308;3381385;23654;21146
59415;Montrécourt;127;3004108;151561;70;2374753;57;629355;23654;21147
49050;Brissac-Quincé;1581;37397899;1352928;917;30307539;664;7090360;23655;21148
04054;Châteauredon;49;1159097;49705;32;1016523;17;142574;23655;21149
40310;Soustons;4507;106614492;5467065;2604;86802052;1903;19812440;23655;21150
59220;Faches-Thumesnil;9468;223969852;11489491;5491;185182228;3977;38787624;23655;21151
02140;Camelin;231;5464565;337339;131;4338012;100;1126553;23656;21152
21599;Selongey;1290;30516961;1188796;764;24271517;526;6245444;23657;21153
22093;Lamballe;6920;163704851;7568594;3875;130885891;3045;32818960;23657;21154
40170;Maillères;118;2791506;86498;69;2173295;49;618211;23657;21155
51042;Baye;240;5677683;382040;127;4554683;113;1123000;23657;21156
33465;Saint-Pierre-de-Mons;584;13815893;577520;340;11353617;244;2462276;23657;21157
14330;Heurtevent;96;2271119;85568;61;1874232;35;396887;23657;21158
87176;Saint-Priest-Ligoure;349;8256870;474603;192;6647086;157;1609784;23659;21159
80311;Fignières;77;1821718;60848;45;1332322;32;489396;23659;21160
65252;Lamarque-Pontacq;415;9818476;247340;248;7955652;167;1862824;23659;21161
65336;Organ;27;638802;63606;11;503965;16;134837;23659;21162
53178;Peuton;102;2413263;39807;58;1818533;44;594730;23659;21163
42193;Rozier-en-Donzy;738;17461790;756913;387;13447543;351;4014247;23661;21164
64274;Irouléguy;175;4140758;232106;87;3235225;88;905533;23661;21165
58208;Pazy;167;3951477;179283;101;3272070;66;679407;23662;21166
67307;Mulhausen;225;5324084;150361;139;4277561;86;1046523;23663;21167
33053;Birac;118;2792200;161795;60;2249918;58;542282;23663;21168
60223;Estrées-Saint-Denis;1908;45153422;1834663;1153;36378936;755;8774486;23665;21169
16119;Dignac;702;16613219;821344;401;13225332;301;3387887;23666;21170
62374;Gomiécourt;78;1845934;51978;36;1386108;42;459826;23666;21171
88246;Hymont;273;6461002;243646;172;5127159;101;1333843;23667;21172
25548;Solemont;76;1798735;65620;44;1386304;32;412431;23668;21173
60567;Saint-Aubin-en-Bray;518;12259970;438461;337;10263702;181;1996268;23668;21174
74032;Bellevaux;736;17419610;520289;429;13745694;307;3673916;23668;21175
05074;Lettret;95;2248473;111795;61;1885089;34;363384;23668;21176
79189;Nanteuil;853;20189418;635436;519;16305948;334;3883470;23669;21177
47061;Caumont-sur-Garonne;348;8236740;257618;164;6407411;184;1829329;23669;21178
22161;Pabu;1603;37941603;1839783;855;30151527;748;7790076;23669;21179
44096;Mésanger;2129;50391792;1268041;1329;40464484;800;9927308;23669;21180
29144;La Martyre;372;8804970;236128;217;6919809;155;1885161;23669;21181
14546;Rouvres;103;2438007;85328;61;1911815;42;526192;23670;21182
59341;Lesdain;232;5491510;245495;141;4590519;91;900991;23670;21183
14647;Saint-Pierre-de-Mailloc;251;5941268;237775;144;4704974;107;1236294;23670;21184
01162;Flaxieu;30;710115;20209;16;544676;14;165439;23671;21185
86186;Oyré;520;12308786;480610;310;9991383;210;2317403;23671;21186
46091;Escamps;95;2248726;79868;46;1575627;49;673099;23671;21187
02579;Oulchy-la-Ville;63;1491325;58626;37;1171369;26;319956;23672;21188
59064;Bellaing;651;15410407;751145;340;12225653;311;3184754;23672;21189
34016;Aumelas;273;6462538;225284;142;4983652;131;1478886;23672;21190
68294;Sainte-Croix-aux-Mines;1065;25211596;1200863;578;19822058;487;5389538;23673;21191
89253;Merry-sur-Yonne;122;2888100;123524;66;2206710;56;681390;23673;21192
13097;Saint-Martin-de-Crau;6649;157402362;7033582;3867;127130968;2782;30271394;23673;21193
89023;Augy;584;13825231;618749;364;11410813;220;2414418;23673;21194
17308;Saint-Agnant;1403;33214950;1211196;852;27152611;551;6062339;23674;21195
50353;Le Mont-Saint-Michel;33;781269;102610;16;736922;17;44347;23675;21196
50222;Grosville;396;9375380;265603;235;7582111;161;1793269;23675;21197
81252;Saint-Germier;80;1894043;84408;47;1595030;33;299013;23676;21198
81050;Cambon-lès-Lavaur;137;3243653;140533;76;2604431;61;639222;23676;21199
54292;Lamath;94;2225574;76560;53;1757137;41;468437;23676;21200
45220;Nancray-sur-Rimarde;305;7221450;259070;174;5613507;131;1607943;23677;21201
50567;Saussemesnil;485;11483483;413183;270;9057421;215;2426062;23677;21202
59254;Fressain;485;11483530;458016;286;9287050;199;2196480;23677;21203
18182;Poisieux;129;3054451;151141;77;2498449;52;556002;23678;21204
02359;Grugies;616;14586011;667857;377;12063726;239;2522285;23679;21205
46190;Mechmont;72;1704884;105591;37;1358558;35;346326;23679;21206
62195;Calonne-sur-la-Lys;776;18374945;577900;448;14392962;328;3981983;23679;21207
44182;Saint-Michel-Chef-Chef;2775;65709416;2710477;1712;53641907;1063;12067509;23679;21208
54045;Barbonville;232;5493553;193520;150;4582224;82;911329;23679;21209
82025;Bressols;1889;44730379;1882397;1093;35799644;796;8930735;23679;21210
57365;Kirschnaumen;267;6322470;130676;123;4028564;144;2293906;23680;21211
28385;Le Thieulin;203;4806972;184401;115;3781699;88;1025273;23680;21212
61323;Le Pas-Saint-l'Homer;81;1918055;120983;49;1551946;32;366109;23680;21213
39319;Mathenay;65;1539189;51443;34;1158231;31;380958;23680;21214
57680;Troisfontaines;734;17381067;862808;453;13895963;281;3485104;23680;21215
88359;Prey;53;1255039;19806;35;1057156;18;197883;23680;21216
14235;Écrammeville;103;2439100;151784;61;1987952;42;451148;23681;21217
57721;Vilsberg;193;4570465;118717;119;3697448;74;873017;23681;21218
72228;Parcé-sur-Sarthe;1078;25528829;875920;659;20600360;419;4928469;23682;21219
24114;Chassaignes;41;970951;71119;19;766685;22;204266;23682;21220
38324;Primarette;387;9165002;325726;209;7088496;178;2076506;23682;21221
50517;Saint-Martin-de-Varreville;101;2391940;85833;54;1843858;47;548082;23683;21222
27374;Louversey;294;6962787;288878;170;5563863;124;1398924;23683;21223
18134;Lury-sur-Arnon;391;9260376;430029;215;7317786;176;1942590;23684;21224
54210;Fréménil;94;2226286;48764;52;1690410;42;535876;23684;21225
17108;Clam;208;4926261;164319;126;4030116;82;896145;23684;21226
47308;Thouars-sur-Garonne;105;2486818;126817;53;1822745;52;664073;23684;21227
58112;La Fermeté;343;8123678;286720;207;6346913;136;1776765;23684;21228
89139;Diges;618;14636888;592237;360;11801291;258;2835597;23684;21229
12178;Paulhe;193;4571203;83526;104;3464856;89;1106347;23685;21230
76128;Bosville;284;6726738;230340;156;5232805;128;1493933;23686;21231
14021;Arromanches-les-Bains;332;7864220;396210;186;6271327;146;1592893;23687;21232
38361;Saint-Arey;45;1065971;49898;29;922392;16;143579;23688;21233
21350;Lignerolles;30;710649;66461;14;567492;16;143157;23688;21234
27381;Malouy;76;1800429;94666;50;1536885;26;263544;23690;21235
51239;Étréchy;60;1421395;57982;35;1135437;25;285958;23690;21236
37240;Saunay;341;8078277;271767;202;6308533;139;1769744;23690;21237
45148;Fontenay-sur-Loing;959;22718767;987517;612;18975852;347;3742915;23690;21238
83111;Sainte-Anastasie-sur-Issole;1025;24282475;1058411;573;19630964;452;4651511;23690;21239
89313;Précy-sur-Vrin;265;6278048;264196;162;5163800;103;1114248;23691;21240
62135;Blairville;169;4003788;230660;101;3351943;68;651845;23691;21241
31152;Coueilles;50;1184602;97329;18;840897;32;343705;23692;21242
01154;Étrez;374;8860956;211529;226;6852335;148;2008621;23692;21243
66002;Alénya;1742;41272571;1676302;961;32910537;781;8362034;23693;21244
08312;Murtin-et-Bogny;81;1919183;44322;50;1499133;31;420050;23694;21245
39584;Vriange;75;1777055;54568;43;1399546;32;377509;23694;21246
12286;Vabres-l'Abbaye;643;15235321;585617;374;11944689;269;3290632;23694;21247
02740;Thenailles;146;3459471;268362;76;2829501;70;629970;23695;21248
61504;Villebadin;62;1469127;62333;28;1062672;34;406455;23696;21249
02190;Chivres-Val;295;6990208;280823;174;5504352;121;1485856;23696;21250
47090;Espiens;194;4597176;212481;104;3665868;90;931308;23697;21251
54434;Praye;145;3436210;114551;91;2745010;54;691200;23698;21252
28276;Neuvy-en-Beauce;108;2559431;91711;58;1977494;50;581937;23698;21253
21677;Vic-des-Prés;51;1208626;51804;25;853931;26;354695;23699;21254
10251;Montigny-les-Monts;122;2891409;82819;70;2256659;52;634750;23700;21255
22113;Lannion;11033;261486902;13329713;6235;216197226;4798;45289676;23700;21256
73176;Montvalezan;448;10618188;619771;260;8480885;188;2137303;23701;21257
21323;Jancigny;65;1540625;49579;34;1148677;31;391948;23702;21258
46292;Saint-Simon;77;1825054;68654;46;1503010;31;322044;23702;21259
16089;Châteaubernard;2187;51837874;2585116;1338;42547793;849;9290081;23703;21260
65216;Hauban;62;1469572;75500;37;1241234;25;228338;23703;21261
22237;Pluduno;1097;26002092;928292;623;20634927;474;5367165;23703;21262
27330;Herqueville;87;2062299;128090;52;1696643;35;365656;23705;21263
85250;Saint-Mathurin;1080;25601169;834526;673;20835982;407;4765187;23705;21264
21416;Mirebeau-sur-Bèze;1066;25269558;1076277;603;20106117;463;5163441;23705;21265
55453;Saint-André-en-Barrois;28;663742;7233;12;411568;16;252174;23705;21266
17385;Saint-Pierre-d'Oléron;4328;102599819;5683242;2455;83054883;1873;19544936;23706;21267
53169;Olivet;204;4836048;129630;122;3789757;82;1046291;23706;21268
52158;Cusey;154;3650797;134683;92;2917849;62;732948;23706;21269
41211;Saint-Georges-sur-Cher;1456;34516659;1502908;834;26639084;622;7877575;23706;21270
80170;Cantigny;57;1351298;43473;35;1064431;22;286867;23707;21271
57585;Ritzing;76;1801775;26276;35;1160501;41;641274;23708;21272
79191;Niort;34126;809044863;50523717;19368;673262651;14758;135782212;23708;21273
60495;Plainval;191;4528255;171896;115;3631534;76;896721;23708;21274
12018;Balaguier-d'Olt;79;1872952;63212;40;1398091;39;474861;23708;21275
50573;Servigny;97;2299714;58798;61;1925814;36;373900;23708;21276
25350;Lougres;414;9815382;346572;264;8057534;150;1757848;23709;21277
55497;Les Souhesmes-Rampont;176;4172731;120771;98;3295756;78;876975;23709;21278
19194;Saint-Clément;695;16478443;576153;430;13408758;265;3069685;23710;21279
71035;Bissy-la-Mâconnaise;116;2750412;151376;68;2183132;48;567280;23710;21280
02288;Essigny-le-Petit;205;4860686;171584;105;3609922;100;1250764;23711;21281
38376;Saint-Christophe-sur-Guiers;447;10598677;343520;266;8347790;181;2250887;23711;21282
89212;Jussy;248;5880330;282111;162;5026921;86;853409;23711;21283
80560;Montauban-de-Picardie;99;2347405;39760;52;1694916;47;652489;23711;21284
81044;Cabanès;125;2963958;64635;71;2295957;54;668001;23712;21285
72385;Yvré-le-Pôlin;915;21696211;691976;526;16956148;389;4740063;23712;21286
42262;Saint-Maurice-en-Gourgois;882;20914113;716883;509;16607032;373;4307081;23712;21287
63362;Saint-Ignat;445;10551910;439962;273;8755091;172;1796819;23712;21288
60127;Canny-sur-Matz;189;4481678;171925;114;3542700;75;938978;23713;21289
62863;Violaines;1900;45054197;1798939;1073;36162559;827;8891638;23713;21290
01428;Valeins;56;1327929;33684;32;964723;24;363206;23713;21291
62675;Quercamps;130;3082772;137123;73;2465730;57;617042;23714;21292
17027;Avy;286;6782108;448047;163;5573934;123;1208174;23714;21293
36209;Saint-Valentin;156;3699402;122994;97;3021158;59;678244;23714;21294
67306;Muhlbach-sur-Bruche;361;8561063;345432;231;7364701;130;1196362;23715;21295
02037;Aulnois-sous-Laon;692;16410909;574653;439;13495901;253;2915008;23715;21296
38150;Domène;3709;87961308;3814474;2308;72345678;1401;15615630;23716;21297
13028;La Ciotat;23549;558490098;34845026;13001;454872544;10548;103617554;23716;21298
06083;Menton;19447;461208310;27159534;11630;383363162;7817;77845148;23716;21299
54029;Audun-le-Roman;1262;29930765;864816;480;17575425;782;12355340;23717;21300
21122;Bussy-le-Grand;172;4079490;213136;89;3142898;83;936592;23718;21301
80191;Chilly;100;2371855;116270;61;1969209;39;402646;23719;21302
85003;Aizenay;4405;104481818;3303597;2502;82303950;1903;22177868;23719;21303
11359;Saint-Michel-de-Lanès;216;5123328;258484;133;4330308;83;793020;23719;21304
07167;Les Ollières-sur-Eyrieux;522;12381555;568468;265;9536611;257;2844944;23719;21305
64219;Estialescq;137;3249591;95052;77;2548555;60;701036;23720;21306
30001;Aigaliers;248;5882526;358262;126;4806061;122;1076465;23720;21307
71061;Brienne;244;5787654;227125;145;4661790;99;1125864;23720;21308
27169;Conteville;491;11646850;507929;261;9333850;230;2313000;23721;21309
09339;Villeneuve-du-Paréage;387;9180036;373108;232;7350409;155;1829627;23721;21310
83039;Châteauvert;77;1826550;90677;44;1523312;33;303238;23721;21311
28378;Souancé-au-Perche;297;7045369;316624;186;5736964;111;1308405;23722;21312
61007;Athis-de-l'Orne;1434;34017718;1416985;818;27096898;616;6920820;23722;21313
85017;Beaurepaire;1088;25809878;740525;620;19980689;468;5829189;23722;21314
47128;Lafox;608;14423767;635785;365;11690883;243;2732884;23723;21315
63296;Ravel;395;9370766;384755;229;7467337;166;1903429;23723;21316
80659;Raincheval;144;3416228;127072;80;2617672;64;798556;23724;21317
24459;Saint-Maime-de-Péreyrol;157;3724675;178867;84;2892101;73;832574;23724;21318
35050;Cardroc;269;6381892;169379;164;5140041;105;1241851;23725;21319
59114;Bruille-Saint-Amand;908;21542076;1065593;488;17363042;420;4179034;23725;21320
37097;Dolus-le-Sec;338;8019028;334478;181;6229803;157;1789225;23725;21321
21208;Courtivron;94;2230149;88671;60;1838800;34;391349;23725;21322
28222;Luplanté;205;4863685;180671;130;3953647;75;910038;23725;21323
50148;Couvains;239;5670391;303449;135;4559791;104;1110600;23725;21324
16060;Bréville;277;6571967;416017;145;5196790;132;1375177;23726;21325
61511;Vrigny;180;4270637;114441;105;3440028;75;830609;23726;21326
32069;Cadeillan;32;759271;30850;18;619736;14;139535;23727;21327
41269;Vendôme;9976;236725374;13550359;5097;189709713;4879;47015661;23729;21328
80808;Vironchaux;251;5956112;217559;122;4637425;129;1318687;23730;21329
65077;Beaucens;229;5434122;213043;133;4227527;96;1206595;23730;21330
88341;Pair-et-Grandrupt;278;6596882;236878;166;5500322;112;1096560;23730;21331
39029;Aumur;186;4413962;133860;124;3673978;62;739984;23731;21332
02698;Sancy-les-Cheminots;48;1139123;28672;32;903400;16;235723;23732;21333
45061;Cepoy;1324;31421120;1533398;832;26330640;492;5090480;23732;21334
19104;Lamongerie;61;1447655;67983;31;1059060;30;388595;23732;21335
02066;Benay;116;2752976;114105;76;2345094;40;407882;23733;21336
51506;Saint-Memmie;3115;73930833;3807805;1816;59676785;1299;14254048;23734;21337
08232;Illy;225;5340167;251172;122;4184442;103;1155725;23734;21338
02536;Nampteuil-sous-Muret;50;1186709;62134;28;997544;22;189165;23734;21339
24162;Escoire;250;5933698;232682;164;5028491;86;905207;23735;21340
31399;Noé;1436;34083614;1282028;844;27600607;592;6483007;23735;21341
02560;Nouvion-le-Comte;143;3394177;141778;79;2632614;64;761563;23736;21342
42132;Malleval;301;7144423;228440;174;5646884;127;1497539;23736;21343
10275;Ossey-les-Trois-Maisons;315;7477060;382334;180;5984968;135;1492092;23737;21344
79160;Lusseray;97;2302501;92721;55;1853455;42;449046;23737;21345
05068;Jarjayes;243;5768338;248013;143;4793711;100;974627;23738;21346
52181;Échenay;56;1329332;117480;27;1024908;29;304424;23738;21347
55406;Pintheville;52;1234396;56646;32;1021901;20;212495;23738;21348
77511;Villeneuve-sous-Dammartin;368;8736019;490131;256;7661233;112;1074786;23739;21349
72082;Le Chevain;322;7644017;250469;204;6300299;118;1343718;23739;21350
33022;Avensan;1282;30434535;1058278;805;24759753;477;5674782;23740;21351
64465;Riupeyrous;81;1922947;70085;43;1477332;38;445615;23740;21352
26250;Pont-de-l'Isère;1569;37248302;1307231;956;29977213;613;7271089;23740;21353
71110;Chassigny-sous-Dun;303;7193398;185673;172;5462927;131;1730471;23741;21354
69276;Feyzin;4812;114244068;4500767;2935;93359840;1877;20884228;23741;21355
31582;Villefranche-de-Lauragais;2417;57384332;3061328;1372;46001801;1045;11382531;23742;21356
54463;Rosières-en-Haye;121;2872804;118939;67;2279382;54;593422;23742;21357
91182;Courcouronnes;7011;166458766;8978762;4060;138593373;2951;27865393;23743;21358
26014;Arthémonay;277;6576923;176581;182;5569171;95;1007752;23743;21359
76416;Mathonville;130;3086650;61806;76;2358329;54;728321;23743;21360
10073;Chalette-sur-Voire;75;1780798;90757;41;1386540;34;394258;23744;21361
10326;Rosnay-l'Hôpital;111;2635602;144501;56;2060985;55;574617;23744;21362
67547;Wittisheim;1042;24741417;926713;631;19933846;411;4807571;23744;21363
45238;Ousson-sur-Loire;408;9687733;409763;243;7698829;165;1988904;23744;21364
62185;Bullecourt;129;3063063;180383;69;2435368;60;627695;23745;21365
02451;Magny-la-Fosse;74;1757109;95293;39;1332288;35;424821;23745;21366
80161;Cahon;116;2754425;167894;55;2101094;61;653331;23745;21367
70334;Marnay;818;19423537;928538;482;15666402;336;3757135;23745;21368
18082;Cuffy;599;14223358;528539;376;11860955;223;2362403;23745;21369
16104;Condac;254;6031350;365322;126;4639199;128;1392151;23745;21370
33205;Illats;752;17856635;617638;414;14291053;338;3565582;23746;21371
02273;Dury;97;2303330;96792;53;1749242;44;554088;23746;21372
61409;Saint-Jean-de-la-Forêt;96;2279631;61425;59;1762965;37;516666;23746;21373
02147;La Celle-sous-Montmirail;57;1353568;49781;36;1162836;21;190732;23747;21374
62634;Offekerque;517;12277326;381565;284;9556505;233;2720821;23747;21375
31346;Mirepoix-sur-Tarn;388;9213939;337830;226;7304767;162;1909172;23747;21376
68268;Retzwiller;334;7931716;321290;210;6738143;124;1193573;23748;21377
71334;Oudry;189;4488363;118469;103;3420666;86;1067697;23748;21378
89124;Courlon-sur-Yonne;658;15626206;623886;412;12828057;246;2798149;23748;21379
14261;Le Faulq;166;3942178;146850;91;3090559;75;851619;23748;21380
25393;Montécheroux;308;7314455;299082;183;5900870;125;1413585;23748;21381
38354;Saint-Albin-de-Vaulserre;198;4702214;172115;115;3796800;83;905414;23749;21382
14582;Saint-Germain-de-Livet;401;9523556;317762;231;7563073;170;1960483;23750;21383
01236;Marsonnas;501;11898517;403063;305;9428887;196;2469630;23750;21384
61476;Suré;142;3372549;137811;79;2613684;63;758865;23750;21385
41082;Feings;380;9025201;354665;227;7322881;153;1702320;23751;21386
52128;Cirey-lès-Mareilles;63;1496323;46184;39;1225348;24;270975;23751;21387
77291;Le Mesnil-Amelot;410;9738458;460974;290;8364836;120;1373622;23752;21388
83018;Besse-sur-Issole;1577;37459273;1617332;867;29739028;710;7720245;23754;21389
57037;Aube;132;3135494;124268;76;2474877;56;660617;23754;21390
64544;Urost;38;902655;42969;26;766328;12;136327;23754;21391
63454;Vertolaye;330;7838881;408060;192;6441059;138;1397822;23754;21392
59011;Annoeullin;5095;121029362;5357864;2885;97937983;2210;23091379;23755;21393
41173;Ouzouer-le-Marché;1060;25179842;1000301;569;19223674;491;5956168;23755;21394
21080;Blaisy-Bas;342;8124491;275183;209;6557390;133;1567101;23756;21395
23175;Sous-Parsat;67;1591716;66161;39;1302656;28;289060;23757;21396
63172;Grandeyrolles;32;760227;33494;16;620304;16;139923;23757;21397
57739;Waldweistroff;230;5464223;158407;118;3900988;112;1563235;23757;21398
31031;Ausson;338;8030071;447865;198;6452872;140;1577199;23758;21399
21012;Ampilly-le-Sec;204;4846641;225793;121;3932491;83;914150;23758;21400
10098;Chesley;175;4157684;173743;100;3297220;75;860464;23758;21401
19096;Ladignac-sur-Rondelles;240;5702112;204571;151;4783436;89;918676;23759;21402
01056;Boyeux-Saint-Jérôme;191;4538004;209427;120;3760144;71;777860;23759;21403
76076;Bénarville;109;2589860;131401;59;1977356;50;612504;23760;21404
21639;Tillenay;376;8933950;281336;213;6838263;163;2095687;23761;21405
80207;Contay;199;4728345;248453;120;3927056;79;801289;23761;21406
86141;Magné;340;8078645;284350;199;6630520;141;1448125;23761;21407
18086;Drevant;318;7556216;305690;200;6256353;118;1299863;23762;21408
42046;Champdieu;962;22858921;951584;557;18739707;405;4119214;23762;21409
43074;Cohade;429;10193895;396931;241;7952824;188;2241071;23762;21410
80342;Framerville-Rainecourt;234;5560332;247694;133;4370499;101;1189833;23762;21411
90053;Grandvillars;1622;38546692;1921017;889;30631669;733;7915023;23765;21412
80384;Grandcourt;95;2257668;87887;54;1791135;41;466533;23765;21413
05026;Ceillac;168;3992747;135887;92;3104239;76;888508;23766;21414
76721;Varneville-Bretteville;164;3897744;157339;99;3117714;65;780030;23767;21415
22091;Kermoroc'h;214;5086083;263459;113;3944289;101;1141794;23767;21416
01035;Belleydoux;185;4396849;153186;117;3693622;68;703227;23767;21417
54542;Valleroy;1291;30682954;1329644;741;24234508;550;6448446;23767;21418
14193;Courtonne-la-Meurdrac;372;8841440;453840;223;7242400;149;1599040;23767;21419
80788;Vergies;104;2471807;136117;53;1909790;51;562017;23767;21420
89037;Béon;298;7082699;321258;195;5945990;103;1136709;23767;21421
45028;Beaugency;4423;105123581;5091998;2472;83011497;1951;22112084;23767;21422
70528;Velesmes-Échevanne;253;6013223;208513;153;4804143;100;1209080;23768;21423
52102;Champigny-lès-Langres;241;5728164;171519;155;4782929;86;945235;23768;21424
82142;Pompignan;704;16732990;655390;421;13775669;283;2957321;23768;21425
38159;Eydoche;243;5775745;226484;128;4343289;115;1432456;23768;21426
71305;Montbellet;416;9887867;319825;256;7965217;160;1922650;23769;21427
80099;Bettencourt-Rivière;118;2805000;113217;68;2294864;50;510136;23771;21428
14081;Boissey;126;2995183;135525;77;2462083;49;533100;23771;21429
41264;Tripleville;81;1925535;81894;43;1428764;38;496771;23772;21430
42102;Grammond;395;9390219;156167;229;7169213;166;2221006;23773;21431
59375;Marchiennes;2465;58599844;2666496;1341;46454828;1124;12145016;23773;21432
61023;Bailleul;328;7797497;235160;191;6132835;137;1664662;23773;21433
45171;Isdes;305;7250730;305085;166;5533924;139;1716806;23773;21434
16386;Touzac;241;5729296;395296;132;4552779;109;1176517;23773;21435
95427;Montmagny;7229;171859386;8919804;4069;140715181;3160;31144205;23774;21436
70474;Saint-Sulpice;72;1711716;87537;43;1388428;29;323288;23774;21437
66012;Baho;1721;40914857;2034355;979;33020008;742;7894849;23774;21438
61164;La Ferrière-Béchet;110;2615155;134066;61;2082027;49;533128;23774;21439
40262;Saint-Gor;173;4113064;117681;89;2924145;84;1188919;23775;21440
50412;Portbail;1003;23847020;1204619;514;18585975;489;5261045;23776;21441
17462;Vénérand;377;8963881;359724;223;7282783;154;1681098;23777;21442
38345;Rovon;324;7703800;258543;186;6024755;138;1679045;23777;21443
59662;Winnezeele;594;14123705;471766;321;10941941;273;3181764;23777;21444
89048;Boeurs-en-Othe;157;3733176;236616;88;3001488;69;731688;23778;21445
29196;Plouguin;1054;25062883;688531;627;19653921;427;5408962;23779;21446
24053;Boulazac;3649;86770736;3803430;2193;70908075;1456;15862661;23779;21447
39552;Vernantois;197;4684545;199319;127;3833331;70;851214;23779;21448
51590;Vanault-les-Dames;202;4803865;205792;109;3707811;93;1096054;23782;21449
27109;Bray;172;4090578;110312;103;3228839;69;861739;23782;21450
71591;Fleurville;264;6278625;229540;156;5009159;108;1269466;23783;21451
35187;Monterfil;605;14388821;314900;367;11301978;238;3086843;23783;21452
71171;Dennevy;167;3971856;160409;90;3091195;77;880661;23784;21453
22273;Saint-Alban;1079;25663391;934473;623;20531139;456;5132252;23784;21454
77296;Moissy-Cramayel;8505;202287104;8777698;5242;168963204;3263;33323900;23784;21455
57284;Hallering;69;1641151;91286;40;1314749;29;326402;23785;21456
60566;Saint-Arnoult;106;2521233;167847;61;2043593;45;477640;23785;21457
27054;Bémécourt;280;6660000;432028;147;4992871;133;1667129;23786;21458
55229;Han-sur-Meuse;156;3710784;134693;97;3007466;59;703318;23787;21459
41100;Les Hayes;104;2473913;106058;64;2034369;40;439544;23788;21460
30277;Saint-Laurent-de-Carnols;258;6137223;284310;148;4992362;110;1144861;23788;21461
31430;Ponlat-Taillebourg;320;7612082;180808;194;6126413;126;1485669;23788;21462
08234;Inaumont;44;1046685;65446;24;844558;20;202127;23788;21463
80714;Saint-Quentin-la-Motte-Croix-au-Bailly;729;17343023;714066;458;14503382;271;2839641;23790;21464
63121;Coudes;634;15083200;701063;378;12210653;256;2872547;23791;21465
45307;La Selle-sur-le-Bied;537;12775613;589409;306;10028331;231;2747282;23791;21466
66213;Toulouges;3761;89479318;4586081;2116;72859150;1645;16620168;23791;21467
39507;Séligney;44;1046828;52187;23;797346;21;249482;23792;21468
80609;Oneux;180;4282488;157873;103;3414203;77;868285;23792;21469
24192;Gabillou;62;1475080;89000;38;1265992;24;209088;23792;21470
30049;Bourdic;203;4829723;217156;108;3904772;95;924951;23792;21471
77090;La Chapelle-Saint-Sulpice;111;2640920;49231;72;2184142;39;456778;23792;21472
62718;Roeux;745;17725212;625145;448;14149041;297;3576171;23792;21473
81283;Senouillac;558;13276271;501729;291;10436110;267;2840161;23793;21474
60129;Carlepont;773;18391685;850775;487;15414043;286;2977642;23793;21475
38222;Massieu;394;9374446;344359;246;7688420;148;1686026;23793;21476
47205;Pindères;134;3188266;269749;67;2626878;67;561388;23793;21477
31164;Drudas;109;2593448;115095;65;2066412;44;527036;23793;21478
71286;Mary;141;3354887;154029;85;2721455;56;633432;23794;21479
29201;Ploumoguer;988;23508639;802723;562;18435048;426;5073591;23794;21480
87062;Eybouleuf;205;4877842;169803;124;4086029;81;791813;23794;21481
27368;Lignerolles;159;3783308;127011;100;3051031;59;732277;23794;21482
89278;Noé;251;5972437;241579;165;5166089;86;806348;23795;21483
57198;Erstroff;101;2403267;66562;61;1870697;40;532570;23795;21484
57290;Hampont;105;2498447;111120;64;1993080;41;505367;23795;21485
01294;Peyrieu;433;10303240;396094;269;8463492;164;1839748;23795;21486
27656;Toutainville;679;16157014;599680;425;13471938;254;2685076;23795;21487
21600;Semarey;60;1427731;48863;38;1194213;22;233518;23796;21488
14377;Longues-sur-Mer;339;8066777;362000;195;6489930;144;1576847;23796;21489
25229;Évillers;159;3783571;120342;90;3007011;69;776560;23796;21490
56148;Nostang;749;17823531;484064;458;14551262;291;3272269;23796;21491
59204;Escarmain;237;5639862;296733;126;4403034;111;1236828;23797;21492
42025;Boyer;93;2213134;48866;52;1714513;41;498621;23797;21493
18020;Bannay;488;11613034;531409;296;9198234;192;2414800;23797;21494
54244;Hagéville;66;1570676;67675;38;1239846;28;330830;23798;21495
07091;Fons;186;4426458;217451;113;3702208;73;724250;23798;21496
05061;Gap;23519;559713768;30821538;13408;453940814;10111;105772954;23798;21497
03012;Autry-Issards;186;4426599;220281;109;3533278;77;893321;23799;21498
46266;Saint-Félix;230;5473766;84841;135;4319223;95;1154543;23799;21499
02478;Merlieux-et-Fouquerolles;133;3165339;124873;81;2531189;52;634150;23800;21500
11225;Mas-Saintes-Puelles;476;11329175;493065;255;8924088;221;2405087;23801;21501
38468;Salaise-sur-Sanne;2275;54147896;2248702;1359;43984823;916;10163073;23801;21502
46088;Douelle;480;11424765;512053;288;9352105;192;2072660;23802;21503
01102;Chevroux;469;11163300;424246;286;9139117;183;2024183;23802;21504
91511;Pussay;1134;26991954;1099376;710;21943555;424;5048399;23802;21505
38135;Courtenay;650;15471988;456716;391;12514096;259;2957892;23803;21506
79321;Taizé;395;9402311;253386;226;7302886;169;2099425;23803;21507
80129;Bouzincourt;304;7236618;371404;168;5741714;136;1494904;23805;21508
77117;Citry;446;10617503;544788;272;8897697;174;1719806;23806;21509
72300;Saint-Mars-la-Brière;1331;31686673;1157826;855;26219999;476;5466674;23807;21510
80547;Millencourt;114;2713961;96220;66;2233803;48;480158;23807;21511
70216;Esboz-Brest;248;5904315;223915;143;4763123;105;1141192;23808;21512
65301;Marseillan;137;3261687;105963;84;2615402;53;646285;23808;21513
10095;Le Chêne;151;3595113;156850;85;2924940;66;670173;23809;21514
89427;Vallan;391;9309322;382136;256;7768470;135;1540852;23809;21515
60275;Glatigny;118;2809494;91422;78;2344046;40;465448;23809;21516
46153;Lanzac;352;8381312;462989;203;6816408;149;1564904;23811;21517
01303;Poncin;914;21763306;935295;502;17137945;412;4625361;23811;21518
80341;Fourdrinoy;198;4714638;177721;130;3944251;68;770387;23811;21519
49371;Vezins;801;19073294;617814;472;15029970;329;4043324;23812;21520
74286;Vacheresse;438;10429855;385061;260;8356676;178;2073179;23812;21521
86065;Château-Larcher;494;11763469;388972;309;9673767;185;2089702;23813;21522
95355;Magny-en-Vexin;3210;76439831;3837589;1882;63227222;1328;13212609;23813;21523
09236;Prayols;216;5143674;240953;135;4259571;81;884103;23813;21524
73194;Orelle;191;4548399;172344;133;3881388;58;667011;23814;21525
27669;Valletot;176;4191218;189166;97;3309771;79;881447;23814;21526
84009;La Bastide-des-Jourdans;738;17574673;735573;406;14270766;332;3303907;23814;21527
80829;Y;46;1095448;84325;24;837137;22;258311;23814;21528
79050;Bretignolles;310;7382433;266958;161;5590117;149;1792316;23814;21529
02270;Douchy;81;1928971;175238;33;1455122;48;473849;23814;21530
73006;Aime;2171;51701338;2338690;1324;41784536;847;9916802;23815;21531
68051;Breitenbach-Haut-Rhin;463;11026313;411142;277;8819674;186;2206639;23815;21532
43205;Saint-Just-Malmont;2169;51656237;1696728;1278;40332482;891;11323755;23816;21533
57174;Destry;52;1238463;35290;32;992617;20;245846;23817;21534
21238;Échannay;69;1643349;73005;42;1334597;27;308752;23817;21535
52105;Changey;165;3929760;152617;111;3396079;54;533681;23817;21536
59669;Zuytpeene;254;6049570;149885;151;4728727;103;1320843;23817;21537
47180;Montagnac-sur-Auvignon;330;7859935;396188;186;6262206;144;1597729;23818;21538
16209;Marillac-le-Franc;415;9884651;420375;216;7554801;199;2329850;23818;21539
88006;Ambacourt;172;4096816;237983;102;3439091;70;657725;23819;21540
22322;Saint-Péver;219;5216354;206579;106;3927386;113;1288968;23819;21541
45221;Nangeville;68;1619725;67310;38;1294879;30;324846;23819;21542
21045;Barbirey-sur-Ouche;147;3501474;149912;94;2872463;53;629011;23820;21543
30115;Fontarèches;131;3120521;139746;76;2504276;55;616245;23821;21544
61332;Pointel;153;3644614;114563;103;3075567;50;569047;23821;21545
55488;Silmont;106;2525043;108674;66;2063231;40;461812;23821;21546
30012;Aramon;2302;54836832;3009645;1329;45348766;973;9488066;23821;21547
65198;Gerde;693;16508956;749391;391;13068614;302;3440342;23822;21548
49227;Notre-Dame-d'Allençon;307;7313664;253540;172;5638913;135;1674751;23823;21549
02077;Berzy-le-Sec;218;5193430;204433;131;4204155;87;989275;23823;21550
18092;Farges-en-Septaine;459;10935097;347516;299;9032071;160;1903026;23824;21551
44173;Saint-Lumine-de-Clisson;1000;23823796;688879;620;19409002;380;4414794;23824;21552
39103;La Chapelle-sur-Furieuse;168;4002535;173343;96;3310695;72;691840;23825;21553
42308;La Terrasse-sur-Dorlay;408;9720597;324287;240;7822601;168;1897996;23825;21554
2A048;Calcatoggio;364;8672399;517000;196;7086533;168;1585866;23825;21555
59126;Cantin;775;18464929;929990;446;15324264;329;3140665;23826;21556
30234;Saint-Bénézet;143;3407183;194084;71;2707720;72;699463;23826;21557
39426;Plasne;120;2859176;66586;65;2184615;55;674561;23826;21558
32298;Nougaroulet;192;4574683;151258;115;3740193;77;834490;23826;21559
38029;La Bâtie-Montgascon;998;23779089;1083228;583;19267111;415;4511978;23827;21560
25222;Étalans;580;13819901;489839;317;11168897;263;2651004;23827;21561
57029;Arriance;111;2644854;79267;70;2153617;41;491237;23828;21562
57169;Dannelbourg;266;6338121;213067;161;5050827;105;1287294;23828;21563
77271;Maisoncelles-en-Gâtinais;71;1691811;70249;46;1478794;25;213017;23828;21564
46095;Espère;505;12033329;565304;284;9570594;221;2462735;23828;21565
46295;Saint-Vincent-du-Pendit;102;2430516;113643;55;1897558;47;532958;23829;21566
40014;Arue;190;4527492;222601;116;3698258;74;829234;23829;21567
30180;Montignargues;299;7125113;270544;168;5609207;131;1515906;23830;21568
57745;Wiesviller;553;13177947;497986;318;10390190;235;2787757;23830;21569
19072;Donzenac;1486;35412095;1568639;895;29295414;591;6116681;23830;21570
26095;Cléon-d'Andran;512;12201400;772850;257;9379138;255;2822262;23831;21571
67520;Wasselonne;3066;73066250;3344063;1799;58895405;1267;14170845;23831;21572
55460;Saint-Julien-sous-les-Côtes;79;1882686;67977;41;1449837;38;432849;23831;21573
60627;Tartigny;130;3098129;125058;76;2471717;54;626412;23832;21574
55155;Dombasle-en-Argonne;210;5004716;184118;115;3952242;95;1052474;23832;21575
30123;Gallargues-le-Montueux;1871;44589724;2042556;1086;36422261;785;8167463;23832;21576
91521;Ris-Orangis;14366;342388459;17424436;8788;284030393;5578;58358066;23833;21577
29179;Ploudaniel;1853;44163363;1400777;1106;35169902;747;8993461;23833;21578
80120;Bouillancourt-en-Séry;284;6768803;286239;161;5259648;123;1509155;23834;21579
45016;Autry-le-Châtel;577;13752160;635475;340;11196899;237;2555261;23834;21580
76168;Les Cent-Acres;28;667359;22950;17;553681;11;113678;23834;21581
60323;Janville;392;9343078;341911;260;7918341;132;1424737;23834;21582
63198;Loubeyrat;654;15587847;599938;394;12821544;260;2766303;23835;21583
54482;Saint-Max;5999;142984901;8330326;3511;116873750;2488;26111151;23835;21584
02482;Meurival;29;691223;46492;14;564976;15;126247;23835;21585
55556;Ville-devant-Chaumont;32;762749;44183;16;599829;16;162920;23836;21586
67183;Harskirchen;450;10726336;402954;247;8223493;203;2502843;23836;21587
27110;Brestot;270;6436134;250026;161;5128772;109;1307362;23838;21588
69229;Saint-Nizier-d'Azergues;383;9129824;321358;226;7430887;157;1698937;23838;21589
67482;Strasbourg;144457;3443762105;250083766;76155;2839342448;68302;604419657;23839;21590
51017;Arzillières-Neuville;187;4457991;171319;106;3461505;81;996486;23840;21591
35317;Saint-Symphorien;272;6484503;153788;158;5228786;114;1255717;23840;21592
76121;Bosc-Édeline;161;3838291;72465;95;3073389;66;764902;23840;21593
61468;Sentilly;76;1811893;111942;40;1455723;36;356170;23841;21594
84004;Aubignan;2820;67232222;3118228;1510;53195412;1310;14036810;23841;21595
37073;Chisseaux;353;8416242;360184;207;6549133;146;1867109;23842;21596
11084;Caux-et-Sauzens;441;10514509;465708;259;8560500;182;1954009;23842;21597
41133;Membrolles;144;3433337;146526;85;2777840;59;655497;23843;21598
10377;Thil;77;1835885;81074;38;1350755;39;485130;23843;21599
51553;Souain-Perthes-lès-Hurlus;103;2455813;65432;61;1952856;42;502957;23843;21600
08487;Vireux-Wallerand;1049;25011673;1207075;567;19714585;482;5297088;23843;21601
42335;Viricelles;207;4935726;113585;132;3962760;75;972966;23844;21602
55077;Breux;134;3195226;158465;66;2294277;68;900949;23845;21603
88164;Estrennes;54;1287629;49181;31;1022910;23;264719;23845;21604
42141;Mars;292;6962769;251874;176;5462680;116;1500089;23845;21605
28260;Montharville;55;1311494;62305;29;1021090;26;290404;23845;21606
61278;Messei;1035;24680419;904944;636;19795997;399;4884422;23846;21607
57526;Ormersviller;189;4506899;130941;120;3717009;69;789890;23846;21608
22280;Saint-Carné;495;11803851;459149;295;9548803;200;2255048;23846;21609
03193;Nassigny;105;2503908;176721;56;2052418;49;451490;23847;21610
61096;La Chapelle-d'Andaine;910;21701335;861906;460;16986064;450;4715271;23848;21611
40129;Josse;420;10016117;332084;246;7818626;174;2197491;23848;21612
32051;Bézéril;62;1478580;68435;31;1115898;31;362682;23848;21613
53153;Mézangers;326;7774546;246975;185;6012513;141;1762033;23848;21614
31231;Grazac;265;6319917;241565;159;5056465;106;1263452;23849;21615
05017;La Bâtie-Neuve;1243;29644697;1263297;740;24016677;503;5628020;23849;21616
79258;Saint-Jacques-de-Thouars;247;5890937;321254;146;4938776;101;952161;23850;21617
60575;Sainte-Geneviève;1533;36562574;1551562;915;29609750;618;6952824;23850;21618
16030;Barret;548;13070229;638964;307;10558015;241;2512214;23851;21619
40150;Léon;1214;28954936;1496621;676;23374936;538;5580000;23851;21620
14291;Fresney-le-Vieux;132;3148335;78968;85;2532876;47;615459;23851;21621
62641;Ostreville;133;3172269;106845;74;2453295;59;718974;23852;21622
24148;Cunèges;156;3720909;183623;88;3080825;68;640084;23852;21623
70075;Bonboillon;91;2170531;69053;55;1762958;36;407573;23852;21624
61243;Magny-le-Désert;760;18127901;686205;451;14738279;309;3389622;23853;21625
29226;Poullan-sur-Mer;865;20632487;850998;498;16535608;367;4096879;23853;21626
03301;Vaux;544;12975966;389572;341;10363619;203;2612347;23853;21627
31286;Lavelanet-de-Comminges;316;7537617;315573;181;6005437;135;1532180;23853;21628
57691;Valmunster;46;1097278;43844;29;944612;17;152666;23854;21629
01080;Champdor;250;5963658;206272;164;4936536;86;1027122;23855;21630
55035;Bazincourt-sur-Saulx;79;1884516;54885;48;1477551;31;406965;23855;21631
80595;La Neuville-Sire-Bernard;136;3244262;141233;84;2557771;52;686491;23855;21632
71269;Lux;1133;27029068;1237723;718;22588630;415;4440438;23856;21633
29078;Hanvec;1067;25455009;976264;612;20274396;455;5180613;23857;21634
57096;Boulange;1096;26147195;359984;406;13369829;690;12777366;23857;21635
42272;Saint-Pierre-de-Boeuf;905;21591134;880490;525;17362424;380;4228710;23858;21636
86046;Cenon-sur-Vienne;1048;25003040;1126796;666;20754764;382;4248276;23858;21637
38078;La Chapelle-du-Bard;285;6799774;259644;174;5452506;111;1347268;23859;21638
08456;Tournavaux;99;2362039;53466;64;1950473;35;411566;23859;21639
54188;Faulx;693;16534314;716863;373;13159027;320;3375287;23859;21640
72225;Oisseau-le-Petit;353;8422395;319055;215;6699094;138;1723301;23859;21641
11292;La Pomarède;94;2242858;72974;55;1829023;39;413835;23860;21642
33262;Macau;2032;48484220;2381637;1256;40062811;776;8421409;23860;21643
51360;Le Meix-Saint-Epoing;157;3746189;183488;94;3158849;63;587340;23861;21644
34174;Moulès-et-Baucels;460;10976206;552909;241;8618526;219;2357680;23861;21645
84074;Mérindol;1165;27799374;1266348;637;22141715;528;5657659;23862;21646
14130;Campigny;97;2314743;74697;66;1993088;31;321655;23863;21647
01227;Magnieu;241;5751206;211556;162;4894222;79;856984;23864;21648
74182;Meythet;4971;118629767;4526057;3295;97947711;1676;20682056;23864;21649
61218;La Lande-Patry;930;22193918;794586;583;18055788;347;4138130;23864;21650
83143;Le Val;2380;56799784;2848579;1285;44818158;1095;11981626;23865;21651
22223;Plouisy;1029;24557764;1057612;545;19477338;484;5080426;23866;21652
36100;Lourouer-Saint-Laurent;149;3556022;173068;91;2960936;58;595086;23866;21653
39440;Pratz;284;6777935;230054;183;5486772;101;1291163;23866;21654
62564;Mazinghem;226;5393738;138247;140;4334276;86;1059462;23866;21655
88173;Florémont;225;5370140;188633;128;4224034;97;1146106;23867;21656
38083;Charette;230;5489549;292571;135;4329969;95;1159580;23868;21657
59629;Vred;709;16922331;692567;414;13557348;295;3364983;23868;21658
47214;Puch-d'Agenais;408;9738143;560218;216;7718125;192;2020018;23868;21659
54050;Bathelémont;33;787675;27735;20;669755;13;117920;23869;21660
38478;Séchilienne;515;12292607;413403;328;10093949;187;2198658;23869;21661
04073;Enchastrayes;270;6444723;341906;161;5382898;109;1061825;23869;21662
64501;Sallespisse;305;7280284;277519;175;5764443;130;1515841;23870;21663
61026;Barville;99;2363111;61659;57;1787112;42;575999;23870;21664
57025;Anzeling;264;6301724;254460;151;4955960;113;1345764;23870;21665
60073;Blacourt;290;6922556;233215;181;5685051;109;1237505;23871;21666
59069;Bermerain;369;8808369;429483;200;6937014;169;1871355;23871;21667
21237;Échalot;56;1336779;64662;32;1080120;24;256659;23871;21668
71481;Saint-Symphorien-d'Ancelles;591;14108042;537712;379;11565972;212;2542070;23871;21669
50186;Flottemanville;97;2315547;44847;53;1800950;44;514597;23872;21670
24005;Alles-sur-Dordogne;198;4726697;289348;96;3468504;102;1258193;23872;21671
01425;La Tranclière;171;4082350;174543;109;3453102;62;629248;23873;21672
73248;Saint-Jean-de-Maurienne;4906;117123662;6871020;2794;95127665;2112;21995997;23874;21673
50480;Saint-Germain-le-Gaillard;406;9692750;356987;246;7892774;160;1799976;23874;21674
88332;Norroy;143;3413988;167949;88;2867125;55;546863;23874;21675
54117;Chaouilley;52;1241486;31935;34;1044745;18;196741;23875;21676
17480;Virson;363;8666576;344559;196;6584562;167;2082014;23875;21677
73307;Valmeinier;175;4178238;207450;120;3583149;55;595089;23876;21678
42055;Châtelus;57;1360942;35593;29;1032897;28;328045;23876;21679
50213;Gourfaleur;244;5825884;168312;144;4559479;100;1266405;23877;21680
01202;Lagnieu;3789;90468548;3996628;2247;72922757;1542;17545791;23877;21681
33503;Saumos;284;6781071;329482;160;5275919;124;1505152;23877;21682
50435;Rocheville;306;7306426;209455;182;5826021;124;1480405;23877;21683
67283;Marmoutier;1437;34313660;1415085;814;26802357;623;7511303;23879;21684
64495;Saint-Pée-sur-Nivelle;3245;77486884;3661827;1817;61659624;1428;15827260;23879;21685
65306;Mauvezin;148;3534184;153717;83;2770054;65;764130;23880;21686
50085;Bricqueville-sur-Mer;658;15712864;737982;366;12692793;292;3020071;23880;21687
59625;Villers-Plouich;219;5229691;150567;125;4166089;94;1063602;23880;21688
50202;Giéville;350;8358124;288506;202;6448480;148;1909644;23880;21689
58035;Bona;179;4274721;298757;96;3450789;83;823932;23881;21690
54018;Anoux;142;3391132;106628;84;2541441;58;849691;23881;21691
03176;Monétay-sur-Allier;312;7451001;464300;158;5901481;154;1549520;23881;21692
77055;Brou-sur-Chantereine;2439;58247769;2872818;1640;50609529;799;7638240;23882;21693
32420;Sauvimont;36;859755;34747;25;712649;11;147106;23882;21694
80604;Offignies;39;931414;44601;22;776532;17;154882;23882;21695
02096;Bois-lès-Pargny;100;2388469;103000;60;1975932;40;412537;23885;21696
73317;Villard-sur-Doron;373;8909271;325941;228;7273100;145;1636171;23885;21697
89402;Soumaintrain;122;2914105;104639;85;2471434;37;442671;23886;21698
80776;Varennes;111;2651590;96268;60;2052841;51;598749;23888;21699
59038;Avesnes-le-Sec;732;17486408;984742;397;13857841;335;3628567;23889;21700
80578;Moyenneville;361;8623838;382694;215;7031481;146;1592357;23889;21701
61328;Le Pin-au-Haras;163;3893945;180432;108;3339294;55;554651;23889;21702
35184;Montauban-de-Bretagne;2595;61994078;2444274;1468;48991992;1127;13002086;23890;21703
59377;Marcoing;989;23627849;1089576;570;18572886;419;5054963;23891;21704
57312;Helstroff;236;5638224;180896;127;4337831;109;1300393;23891;21705
76244;Esclavelles;188;4491490;143870;102;3502652;86;988838;23891;21706
28237;Marolles-les-Buis;123;2938618;120795;70;2375310;53;563308;23891;21707
03015;Bagneux;150;3583694;136802;91;2873313;59;710381;23891;21708
47324;Villeréal;865;20666097;1092558;313;15714590;552;4951507;23891;21709
38103;Chichilianne;155;3703242;155912;91;3004303;64;698939;23892;21710
79071;La Chapelle-Bertrand;236;5638506;185210;135;4506147;101;1132359;23892;21711
49188;Marcé;385;9198764;229215;222;7213184;163;1985580;23893;21712
15016;Ayrens;315;7526339;371542;145;5550939;170;1975400;23893;21713
69160;Poule-les-Écharmeaux;548;13093584;513260;300;10165752;248;2927832;23893;21714
73127;Gresin;185;4420376;181572;109;3603696;76;816680;23894;21715
57722;Vionville;105;2508873;117655;58;1944208;47;564665;23894;21716
26085;Châteauneuf-du-Rhône;1452;34695458;1514399;849;28074417;603;6621041;23895;21717
27279;Gasny;1729;41314685;1845329;1089;34577808;640;6736877;23895;21718
35136;Janzé;4145;99046810;3789498;2421;79443318;1724;19603492;23895;21719
30282;Saint-Marcel-de-Careiret;411;9821104;362609;248;8230263;163;1590841;23896;21720
54047;Barisey-la-Côte;108;2580738;93336;72;2126499;36;454239;23896;21721
67398;Richtolsheim;181;4325155;164505;121;3636234;60;688921;23896;21722
57453;Maxstadt;163;3895099;165245;93;2959382;70;935717;23896;21723
49259;Rochefort-sur-Loire;1187;28365245;1128175;638;22028749;549;6336496;23897;21724
54573;Villers-en-Haye;103;2461359;118203;63;1938918;40;522441;23897;21725
60608;Le Saulchoy;52;1242677;54275;25;915372;27;327305;23898;21726
89196;Guerchy;342;8173020;312015;215;6797167;127;1375853;23898;21727
57038;Audun-le-Tiche;3174;75852465;985519;825;28932057;2349;46920408;23898;21728
92050;Nanterre;48651;1162710875;78418985;27566;976843868;21085;185867007;23899;21729
55060;Bonzée;185;4421359;150873;108;3501642;77;919717;23899;21730
11215;Malves-en-Minervois;438;10468101;499030;243;8557777;195;1910324;23900;21731
79231;Romans;353;8436974;225631;219;6899056;134;1537918;23901;21732
80361;Frettecuisse;38;908240;21188;21;649772;17;258468;23901;21733
31225;Goutevernisse;88;2103297;73027;57;1744870;31;358427;23901;21734
31065;Bérat;1346;32171247;1204992;763;25462231;583;6709016;23901;21735
22176;Plédran;3302;78930041;2923170;2067;65544998;1235;13385043;23904;21736
71517;Sermesse;127;3035851;114341;80;2474842;47;561009;23904;21737
25066;Blussangeaux;40;956185;30647;24;772960;16;183225;23905;21738
18061;Chaumoux-Marcilly;63;1505994;117103;36;1257824;27;248170;23905;21739
02375;Hautevesnes;79;1888523;87218;42;1523480;37;365043;23905;21740
07022;Baix;553;13219665;601647;308;10520232;245;2699433;23905;21741
02153;Cessières;251;6000315;250016;150;5007591;101;992724;23906;21742
19278;Varetz;1274;30455844;1336902;762;25175030;512;5280814;23906;21743
21464;Nuits-Saint-Georges;3348;80036239;4390734;1850;63408243;1498;16627996;23906;21744
32042;Belloc-Saint-Clamens;75;1792935;104246;41;1460377;34;332558;23906;21745
30143;Laval-Saint-Roman;132;3155751;107085;57;2490492;75;665259;23907;21746
08102;Chappes;49;1171493;13494;23;844330;26;327163;23908;21747
80736;Sorel-en-Vimeu;119;2845156;168664;57;2232650;62;612506;23909;21748
60139;Chambly;5289;126455765;5879484;3364;105735335;1925;20720430;23909;21749
67397;Rhinau;1447;34596618;1378750;841;27291948;606;7304670;23909;21750
34294;Saturargues;444;10615790;425319;244;8411987;200;2203803;23909;21751
22311;Saint-Lormel;468;11189628;436138;273;9227417;195;1962211;23909;21752
56067;Grand-Champ;2608;62355960;2474462;1457;49782636;1151;12573324;23909;21753
80550;Mirvaux;77;1841115;39264;49;1422921;28;418194;23911;21754
76394;Longroy;362;8655789;408091;219;7064129;143;1591660;23911;21755
07261;Saint-Laurent-du-Pape;844;20181153;716098;489;16034148;355;4147005;23911;21756
68089;Fellering;883;21114352;854764;545;17323768;338;3790584;23912;21757
31037;Avignonet-Lauragais;744;17791060;651653;450;14691674;294;3099386;23913;21758
33219;La Lande-de-Fronsac;1226;29317294;1173210;754;24076907;472;5240387;23913;21759
62852;Vieille-Église;660;15783411;559022;375;12705901;285;3077510;23914;21760
33369;Saint-André-et-Appelles;393;9398351;463025;198;7318657;195;2079694;23914;21761
01116;Contrevoz;277;6624496;231914;170;5349206;107;1275290;23915;21762
72040;La Bosse;72;1721895;69556;47;1446170;25;275725;23915;21763
62405;Hamblain-les-Prés;254;6074660;222354;149;4954879;105;1119781;23916;21764
59529;Saint-Aubin;196;4687645;211887;113;3733556;83;954089;23917;21765
59618;Vieux-Reng;427;10212389;431191;255;8199563;172;2012826;23917;21766
32063;Bouzon-Gellenave;104;2487328;107008;54;1885514;50;601814;23917;21767
54541;Valhey;85;2032922;87795;42;1528530;43;504392;23917;21768
63368;Saint-Julien-de-Coppel;658;15737242;759817;388;12770965;270;2966277;23917;21769
89167;Fleury-la-Vallée;621;14852549;609841;385;12263488;236;2589061;23917;21770
60664;Vendeuil-Caply;251;6003227;249626;149;4937321;102;1065906;23917;21771
55522;Ugny-sur-Meuse;61;1458953;78263;35;1211749;26;247204;23917;21772
17069;Brives-sur-Charente;121;2894063;93502;60;2221146;61;672917;23918;21773
60554;Rouvres-en-Multien;238;5692556;243276;139;4556625;99;1135931;23918;21774
84059;Lafare;60;1435130;47552;32;1092808;28;342322;23919;21775
33152;Donzac;81;1937437;93422;45;1542502;36;394935;23919;21776
71460;Saint-Maurice-de-Satonnay;227;5429610;264954;135;4643058;92;786552;23919;21777
60647;Trosly-Breuil;1165;27865691;1312495;712;23252450;453;4613241;23919;21778
74295;La Vernaz;139;3324855;83987;77;2493350;62;831505;23920;21779
26259;Ratières;150;3588135;183196;83;2849005;67;739130;23921;21780
02120;Brenelle;102;2439950;125774;52;1816743;50;623207;23921;21781
85194;Les Sables-d'Olonne;10882;260320904;15617413;5883;207475412;4999;52845492;23922;21782
41249;Souesmes;714;17080594;921377;439;13888544;275;3192050;23922;21783
08335;Omont;47;1124358;57803;25;874140;22;250218;23923;21784
13017;Boulbon;846;20239340;906822;473;16183913;373;4055427;23924;21785
40115;Gousse;143;3421115;85667;85;2759391;58;661724;23924;21786
71087;Chapaize;81;1937879;92301;52;1592804;29;345075;23924;21787
01421;Torcieu;402;9617639;352324;262;8019284;140;1598355;23924;21788
53104;Gennes-sur-Glaize;494;11818888;339865;298;9590506;196;2228382;23925;21789
42175;Pouilly-lès-Feurs;608;14546420;465809;341;11387598;267;3158822;23925;21790
41267;Vallières-les-Grandes;438;10479357;398429;262;8440471;176;2038886;23925;21791
49360;La Varenne;937;22418339;717364;560;17965099;377;4453240;23926;21792
19147;Nespouls;344;8230571;412022;196;6756372;148;1474199;23926;21793
55082;Brocourt-en-Argonne;37;885269;73824;19;733481;18;151788;23926;21794
08338;Pauvres;91;2177294;39338;48;1660112;43;517182;23926;21795
61422;Les Aspres;387;9259484;444863;206;7329776;181;1929708;23926;21796
71336;Ouroux-sur-Saône;1576;37709289;1499796;959;30790140;617;6919149;23927;21797
10075;Champfleury;59;1411731;70422;34;1107979;25;303752;23928;21798
56040;Cléguer;1725;41276037;1479317;1039;33622082;686;7653955;23928;21799
41239;Seigy;644;15409723;693283;363;11772483;281;3637240;23928;21800
37176;Noyant-de-Touraine;490;11724887;320613;289;9223083;201;2501804;23928;21801
57476;Monneren;173;4139713;87704;83;2829151;90;1310562;23929;21802
12202;Rodez;14542;347977794;22334359;8430;291008611;6112;56969183;23929;21803
55089;Burey-la-Côte;48;1148624;48503;28;957356;20;191268;23930;21804
87178;Saint-Priest-Taurion;1573;37641904;1479042;969;30646152;604;6995752;23930;21805
65320;Montgaillard;475;11366785;542734;280;9154887;195;2211898;23930;21806
15184;Saint-Étienne-de-Maurs;412;9859202;363877;227;7648485;185;2210717;23930;21807
25063;Blamont;648;15507089;664504;370;12503932;278;3003157;23931;21808
64134;Bonloc;161;3852855;168326;81;2966493;80;886362;23931;21809
51328;Loisy-sur-Marne;567;13568838;519234;323;10487405;244;3081433;23931;21810
38550;Villard-Reculas;31;741927;67293;13;567616;18;174311;23933;21811
02650;Rocquigny;207;4954181;235504;104;3960301;103;993880;23933;21812
02362;Guivry;141;3374615;177112;78;2782694;63;591921;23933;21813
50031;Barneville-Carteret;1539;36833621;2214416;779;28359990;760;8473631;23933;21814
80520;Maucourt;79;1890766;140859;36;1407061;43;483705;23934;21815
50568;Saussey;266;6366553;300802;157;5232425;109;1134128;23934;21816
02296;Étreillers;629;15055206;585822;343;11686662;286;3368544;23935;21817
31304;Loubens-Lauragais;224;5361576;238259;131;4416644;93;944932;23936;21818
14716;Trungy;121;2896284;100537;71;2263470;50;632814;23936;21819
54235;Goviller;206;4930949;150868;106;3727745;100;1203204;23937;21820
51537;Sivry-Ante;101;2417619;77527;63;1992136;38;425483;23937;21821
81176;Montels;53;1268652;44902;25;965759;28;302893;23937;21822
72041;Bouër;147;3518859;90307;103;3009292;44;509567;23938;21823
67089;Dettwiller;1479;35404691;1526328;866;28107378;613;7297313;23938;21824
27001;Aclou;157;3758382;187002;99;3118222;58;640160;23939;21825
88251;Jeanménil;564;13501798;581384;290;10345080;274;3156718;23939;21826
45310;Sermaises;889;21282177;974256;539;17313857;350;3968320;23939;21827
26223;Oriol-en-Royans;300;7181886;291098;184;5818994;116;1362892;23940;21828
25185;Cussey-sur-Lison;31;742149;24762;18;568615;13;173534;23940;21829
29117;Lannilis;2810;67272594;2396365;1518;52081807;1292;15190787;23940;21830
56002;Ambon;1008;24132515;981003;576;19001458;432;5131057;23941;21831
82146;Puygaillard-de-Lomagne;31;742192;16033;17;567881;14;174311;23942;21832
14169;Colombiers-sur-Seulles;82;1963313;67249;54;1628243;28;335070;23943;21833
64225;Féas;224;5363252;218614;127;4368822;97;994430;23943;21834
89088;Chassy;265;6345063;311156;157;5214456;108;1130607;23944;21835
05128;Saint-André-d'Embrun;369;8835300;515727;199;7055149;170;1780151;23944;21836
57443;Marange-Silvange;2968;71067421;2558115;1670;54617505;1298;16449916;23945;21837
62688;Rang-du-Fliers;2267;54283655;2508031;1353;44433581;914;9850074;23945;21838
76695;Tocqueville-les-Murs;147;3520010;98560;89;2800828;58;719182;23946;21839
45265;Rozoy-le-Vieil;234;5603834;246328;141;4491174;93;1112660;23948;21840
27444;Le Noyer-en-Ouche;130;3113327;176713;72;2529864;58;583463;23949;21841
02385;Housset;91;2179365;130468;41;1612214;50;567151;23949;21842
14520;Le Pré-d'Auge;412;9867031;341741;266;8228954;146;1638077;23949;21843
09050;Benagues;230;5508475;279157;134;4431993;96;1076482;23950;21844
17416;Saleignes;40;958001;21110;16;714701;24;243300;23950;21845
71338;Ozenay;136;3257221;172264;76;2544274;60;712947;23950;21846
73062;Cessens;199;4766113;183035;119;3836352;80;929761;23950;21847
49182;Louresse-Rochemenier;408;9771926;309998;235;7538700;173;2233226;23951;21848
76691;Le Thil-Riberpré;113;2706444;114274;69;2186699;44;519745;23951;21849
02072;Berrieux;98;2347187;103018;58;1958442;40;388745;23951;21850
38138;Crémieu;1946;46609591;2569479;1165;38056221;781;8553370;23951;21851
85165;L'Oie;572;13700386;328305;345;10908774;227;2791612;23952;21852
60557;Roy-Boissy;181;4335266;166764;117;3552174;64;783092;23952;21853
79351;Villiers-en-Plaine;858;20550798;719936;537;17043306;321;3507492;23952;21854
36127;Montgivray;992;23760618;1069572;552;18741231;440;5019387;23952;21855
28140;Épernon;3250;77846208;4058363;2178;66654465;1072;11191743;23953;21856
45056;Bromeilles;173;4143823;204389;106;3380748;67;763075;23953;21857
64463;Rébénacq;382;9150292;414468;212;7341940;170;1808352;23954;21858
35007;Aubigné;208;4982407;74719;133;4093614;75;888793;23954;21859
70446;Rigny;357;8551905;402775;217;7082240;140;1469665;23955;21860
16031;Barro;216;5174336;237458;135;4332050;81;842286;23955;21861
72167;Louailles;328;7857355;234996;218;6424331;110;1433024;23955;21862
89145;Domecy-sur-Cure;220;5270233;224171;136;4337473;84;932760;23956;21863
59075;Béthencourt;382;9151308;443366;216;7341184;166;1810124;23956;21864
45297;Saint-Père-sur-Loire;578;13846948;525218;382;11693646;196;2153302;23957;21865
50173;Équeurdreville-Hainneville;9089;217748112;9072494;5495;179182785;3594;38565327;23957;21866
28261;Montigny-le-Chartif;309;7403450;241740;187;5855543;122;1547907;23959;21867
67184;Hatten;1096;26259736;1317160;657;21620921;439;4638815;23960;21868
33181;Gardegan-et-Tourtirac;161;3857530;245012;74;2913071;87;944459;23960;21869
57366;Kirviller;70;1677191;49101;43;1365764;27;311427;23960;21870
33077;Cabanac-et-Villagrains;1082;25924751;947987;659;21428737;423;4496014;23960;21871
50485;Saint-Hilaire-Petitville;761;18233587;959880;422;14606026;339;3627561;23960;21872
31281;Launac;672;16101567;617371;403;13272004;269;2829563;23961;21873
89479;Vincelottes;200;4792168;221139;125;4164971;75;627197;23961;21874
65422;Séron;166;3977580;111308;85;3079131;81;898449;23961;21875
90069;Méziré;749;17947271;879992;472;15035379;277;2911892;23962;21876
01345;Saint-Denis-en-Bugey;1194;28610798;1082119;771;23802624;423;4808174;23962;21877
10023;Avon-la-Pèze;102;2444277;86158;65;2009811;37;434466;23964;21878
47031;Boé;2867;68705814;3301377;1724;56417175;1143;12288639;23964;21879
25114;Chamesol;211;5056548;206933;125;4160009;86;896539;23965;21880
06033;Carros;6084;145804651;7212646;3587;119819544;2497;25985107;23965;21881
14646;Saint-Pierre-Canivet;211;5056694;204856;125;4113493;86;943201;23965;21882
67478;Steinbourg;1077;25811832;890953;660;20723216;417;5088616;23966;21883
33014;Les Artigues-de-Lussac;554;13277800;563919;285;10308949;269;2968851;23967;21884
76088;Berville-sur-Seine;286;6854791;241953;176;5646717;110;1208074;23968;21885
25082;Bourguignon;494;11840434;397484;335;9849866;159;1990568;23968;21886
84085;Murs;232;5560882;307428;113;4279933;119;1280949;23969;21887
24224;Lamonzie-Montastruc;379;9084597;401793;200;7184608;179;1899989;23970;21888
59423;Neuf-Berquin;631;15125160;620496;361;12210167;270;2914993;23970;21889
54342;Mancieulles;989;23707159;692433;469;16327204;520;7379955;23971;21890
55445;Rouvrois-sur-Othain;108;2588882;99697;50;1709863;58;879019;23971;21891
42113;Jas;127;3044505;131137;71;2498390;56;546115;23972;21892
28091;Les Châtelliers-Notre-Dame;70;1678112;94024;39;1345288;31;332824;23973;21893
38095;Chatte;1367;32771554;1431244;754;25555616;613;7215938;23973;21894
09238;Les Pujols;397;9517579;631772;219;7713736;178;1803843;23974;21895
80083;Bergicourt;81;1941917;75852;46;1558353;35;383564;23974;21896
59363;Louvignies-Quesnoy;528;12658447;595603;300;10283111;228;2375336;23974;21897
74270;Seythenex;343;8223237;329245;201;6531521;142;1691716;23974;21898
76663;Sassetot-le-Mauconduit;627;15032070;780941;327;11639271;300;3392799;23975;21899
52134;Cohons;140;3356503;191041;79;2707067;61;649436;23975;21900
41293;Villiersfaux;131;3140753;100780;78;2457770;53;682983;23975;21901
44102;Montbert;1434;34380762;904397;848;27005741;586;7375021;23975;21902
47287;Saumont;126;3020976;103794;73;2401673;53;619303;23976;21903
24587;Vitrac;530;12707858;733276;315;10385975;215;2321883;23977;21904
46280;Saint-Médard;96;2301804;108393;54;1901254;42;400550;23977;21905
2A349;Viggianello;369;8847657;422821;200;7169794;169;1677863;23977;21906
27625;Suzay;140;3356872;102209;87;2726140;53;630732;23978;21907
64120;Beyrie-sur-Joyeuse;260;6234192;294578;128;4825230;132;1408962;23978;21908
60382;Margny-lès-Compiègne;4495;107781073;5657263;2842;91150993;1653;16630080;23978;21909
80206;Contalmaison;64;1534593;94023;36;1297021;28;237572;23978;21910
73159;Les Mollettes;386;9255861;361795;229;7316786;157;1939075;23979;21911
39464;Romain;105;2517791;83745;57;2027053;48;490738;23979;21912
31442;Puydaniel;239;5730975;214559;138;4527410;101;1203565;23979;21913
08395;Saint-Pierre-sur-Vence;88;2110158;98481;49;1712750;39;397408;23979;21914
81149;Loupiac;193;4628219;129791;115;3710331;78;917888;23980;21915
25121;Chapelle-des-Bois;134;3213408;105056;67;2399365;67;814043;23981;21916
32030;Bars;80;1918481;141435;30;1506141;50;412340;23981;21917
42333;Villers;288;6906653;288254;159;5431686;129;1474967;23981;21918
39250;Geruge;94;2254276;104794;56;1878724;38;375552;23982;21919
06088;Nice;223611;5362583715;391527074;122916;4463039772;100695;899543943;23982;21920
10417;Villemoiron-en-Othe;127;3045713;123480;82;2607700;45;438013;23982;21921
81087;Fayssac;177;4244924;158091;90;3180183;87;1064741;23983;21922
14455;Moulines;130;3117755;111946;72;2526279;58;591476;23983;21923
21153;Châtellenot;91;2182429;104058;59;1839422;32;343007;23983;21924
72165;Lombron;954;22879677;759131;596;18368273;358;4511404;23983;21925
43127;Malvalette;395;9473421;361971;235;7591646;160;1881775;23983;21926
54242;Gye;110;2638191;89505;70;2156707;40;481484;23984;21927
33417;Sainte-Hélène;1331;31922615;1089729;798;26021909;533;5900706;23984;21928
14719;Urville;271;6499758;225098;153;5098163;118;1401595;23984;21929
61286;Montgaudry;52;1247211;76218;19;825015;33;422196;23985;21930
31024;Auragne;204;4893016;167963;116;4020358;88;872658;23985;21931
33441;Saint-Martin-Lacaussade;644;15447126;916841;360;12743455;284;2703671;23986;21932
87183;Saint-Sylvestre;468;11225984;505566;286;9140256;182;2085728;23987;21933
45347;Vrigny;422;10123017;425675;258;8184318;164;1938699;23988;21934
30346;Vers-Pont-du-Gard;999;23964257;988636;568;19050522;431;4913735;23988;21935
59306;Hestrud;150;3598312;158237;89;2982516;61;615796;23989;21936
04195;Saint-Pons;408;9787503;391837;255;8070086;153;1717417;23989;21937
62734;Sailly-en-Ostrevent;353;8468300;298369;201;6663809;152;1804491;23990;21938
72083;Chevillé;185;4438150;156443;108;3539413;77;898737;23990;21939
84103;Rustrel;431;10339698;517888;230;8183693;201;2156005;23990;21940
69029;Bron;21131;506934439;29553240;12196;419535066;8935;87399373;23990;21941
42322;La Valla-en-Gier;505;12115499;372198;320;9913724;185;2201775;23991;21942
71054;Bragny-sur-Saône;337;8085021;388910;191;6423793;146;1661228;23991;21943
88174;Fomerey;77;1847365;61584;47;1509126;30;338239;23992;21944
60136;Cempuis;238;5710224;218616;148;4569284;90;1140940;23993;21945
76062;Beaumont-le-Hareng;121;2903208;97370;69;2290427;52;612781;23993;21946
77356;Passy-sur-Seine;25;599856;17272;13;401791;12;198065;23994;21947
80295;Étinehem;196;4702959;255927;105;3675124;91;1027835;23995;21948
60357;Léglantiers;272;6526971;303172;150;5084330;122;1442641;23996;21949
77032;Beton-Bazoches;470;11278295;554092;251;8780939;219;2497356;23996;21950
38267;Mottier;342;8206816;275537;197;6293615;145;1913201;23997;21951
02505;Montfaucon;117;2807655;101163;71;2274663;46;532992;23997;21952
39088;Cesancey;229;5495331;231310;144;4510394;85;984937;23997;21953
71312;Montcoy;136;3263716;118964;93;2754221;43;509495;23998;21954
71437;Saint-Laurent-en-Brionnais;196;4703629;199678;111;3745566;85;958063;23998;21955
40195;Montgaillard;307;7367610;334904;168;5717934;139;1649676;23999;21956
25208;Durnes;86;2063966;74362;52;1659088;34;404878;24000;21957
67083;Dambach;416;9983872;368685;263;7965540;153;2018332;24000;21958
80408;Halloy-lès-Pernois;184;4415974;182929;117;3694653;67;721321;24000;21959
66132;Palau-de-Cerdagne;189;4535993;202554;113;3690130;76;845863;24000;21960
65445;Tilhouse;128;3072014;138756;78;2515862;50;556152;24000;21961
80347;Fransart;71;1704069;62425;41;1391884;30;312185;24001;21962
80597;Nibas;427;10248593;439458;269;8442648;158;1805945;24001;21963
37234;Saint-Quentin-sur-Indrois;253;6072370;267818;141;4798545;112;1273825;24001;21964
71159;Culles-les-Roches;111;2664191;108733;65;2046307;46;617884;24002;21965
15055;Coren;232;5568650;196876;127;4325653;105;1242997;24003;21966
21524;Riel-les-Eaux;48;1152170;72882;28;929652;20;222518;24004;21967
51229;Épense;63;1512237;62075;39;1242628;24;269609;24004;21968
70197;Dampierre-sur-Linotte;403;9673519;519476;215;7426871;188;2246648;24004;21969
86115;Jaunay-Clan;3198;76765115;3405520;1982;63940955;1216;12824160;24004;21970
60594;Saint-Quentin-des-Prés;153;3672724;141051;76;2776008;77;896716;24005;21971
27342;Houetteville;117;2808567;90214;78;2347483;39;461084;24005;21972
62656;Pihem;469;11258668;374874;278;9172769;191;2085899;24006;21973
21547;Saint-Euphrône;115;2760678;99389;75;2291491;40;469187;24006;21974
57765;Diesen;581;13947464;561710;354;11205868;227;2741596;24006;21975
40098;Eyres-Moncube;188;4513161;190537;100;3485353;88;1027808;24006;21976
59138;Cattenières;362;8690271;442835;216;7092942;146;1597329;24006;21977
46148;Lalbenque;898;21558339;1067007;484;17221626;414;4336713;24007;21978
52534;Villiers-en-Lieu;803;19278325;702436;504;15536039;299;3742286;24008;21979
15255;Vézac;593;14237268;475534;336;11299444;257;2937824;24009;21980
17102;Chermignac;675;16206124;613800;431;13540176;244;2665948;24009;21981
42013;Bellegarde-en-Forez;966;23193918;630513;532;17703322;434;5490596;24010;21982
09303;Surba;201;4826121;213995;111;3728631;90;1097490;24011;21983
59280;Hamel;430;10324847;508786;247;8365226;183;1959621;24011;21984
57674;Tincry;86;2064989;57969;48;1571611;38;493378;24012;21985
70426;Provenchère;149;3577725;121160;103;2974306;46;603419;24012;21986
88375;Raves;230;5522663;190529;142;4506042;88;1016621;24012;21987
22026;Calorguen;355;8524413;239642;218;6852167;137;1672246;24012;21988
24466;Saint-Michel-de-Montaigne;196;4706601;330673;91;3622869;105;1083732;24013;21989
27256;La Forêt-du-Parc;290;6963973;248443;187;5872702;103;1091271;24014;21990
68156;Issenheim;1902;45674375;1998810;1153;37289962;749;8384413;24014;21991
01097;Chavornay;129;3097810;137663;84;2512763;45;585047;24014;21992
68175;Lapoutroie;1096;26319476;1211507;637;21230621;459;5088855;24014;21993
67384;Ranrupt;205;4923009;288023;121;3981743;84;941266;24015;21994
44162;Saint-Herblain;23606;566894255;26202368;14367;469291000;9239;97603255;24015;21995
44155;Saint-Colomban;1515;36383064;1138172;897;28893416;618;7489648;24015;21996
73067;La Chambre;672;16138459;897646;412;13349055;260;2789404;24016;21997
87152;Saint-Jouvent;856;20557535;729602;559;17500157;297;3057378;24016;21998
2B366;Chisa;51;1224812;88736;27;1014312;24;210500;24016;21999
76705;Tourville-la-Rivière;1292;31028928;1352426;793;25585362;499;5443566;24016;22000
41182;Pray;157;3770802;152839;92;3111325;65;659477;24018;22001
04106;Lurs;215;5163920;327471;102;3946064;113;1217856;24018;22002
95488;Pierrelaye;4325;103879496;5460480;2672;88628948;1653;15250548;24018;22003
89251;Merry-la-Vallée;226;5428164;254110;124;4281258;102;1146906;24018;22004
60077;Blicourt;177;4251287;154764;121;3613380;56;637907;24019;22005
72045;Brains-sur-Gée;325;7806246;172396;202;6395794;123;1410452;24019;22006
27424;Nagel-Séez-Mesnil;169;4059252;142391;104;3271882;65;787370;24019;22007
65222;Hitte;87;2089677;83958;52;1676520;35;413157;24019;22008
39197;Digna;198;4755822;180054;121;3765967;77;989855;24019;22009
46336;Vire-sur-Lot;219;5260244;288116;121;4281387;98;978857;24019;22010
32257;Mirannes;40;960777;46605;18;687937;22;272840;24019;22011
2A209;Peri;1003;24092485;1355410;581;20054405;422;4038080;24020;22012
88159;Entre-deux-Eaux;274;6581614;274622;163;5299183;111;1282431;24020;22013
59164;Croix-Caluyau;129;3098907;103120;70;2226071;59;872836;24023;22014
71354;Poisson;293;7039014;249520;174;5480097;119;1558917;24024;22015
83072;Lorgues;5303;127401515;7733596;2816;102569692;2487;24831823;24024;22016
89202;Irancy;198;4756863;287612;126;4039722;72;717141;24025;22017
08485;Villy;95;2282378;80077;51;1764968;44;517410;24025;22018
02262;Deuillet;107;2570687;93896;71;2126594;36;444093;24025;22019
39038;Barésia-sur-l'Ain;74;1777886;50079;43;1333787;31;444099;24025;22020
39070;Bourg-de-Sirod;57;1369460;39710;34;1048230;23;321230;24026;22021
62407;Ham-en-Artois;523;12565407;509574;286;10005856;237;2559551;24026;22022
72075;Chemiré-le-Gaudin;466;11196023;356174;304;9397886;162;1798137;24026;22023
43251;Vals-près-le-Puy;2132;51223147;2757407;1254;41762277;878;9460870;24026;22024
55034;Bazeilles-sur-Othain;59;1417544;71492;24;927752;35;489792;24026;22025
73111;Étable;199;4781240;158832;134;3987036;65;794204;24026;22026
60297;Le Hamel;84;2018235;66907;53;1598255;31;419980;24027;22027
14090;Boulon;315;7568454;320202;185;6242904;130;1325550;24027;22028
31209;Garac;82;1970262;48218;43;1592843;39;377419;24028;22029
89273;Moutiers-en-Puisaye;182;4373047;170457;98;3401714;84;971333;24028;22030
71078;Chamilly;75;1802083;68037;49;1518302;26;283781;24028;22031
72363;Tuffé;921;22129682;1351291;479;17119606;442;5010076;24028;22032
54543;Vallois;73;1754041;73364;40;1371202;33;382839;24028;22033
40289;Sarraziet;100;2402819;71471;62;2017251;38;385568;24028;22034
50288;Marcey-les-Grèves;697;16748055;707119;400;13332113;297;3415942;24029;22035
52205;Foulain;409;9828251;381400;247;8020905;162;1807346;24030;22036
77293;Misy-sur-Yonne;496;11919223;458509;305;9643186;191;2276037;24031;22037
02640;Renansart;99;2379063;184115;33;1695812;66;683251;24031;22038
47145;Layrac;2070;49745506;2539734;1224;40977635;846;8767871;24032;22039
62226;Clarques;144;3460586;106791;83;2797061;61;663525;24032;22040
27266;Franqueville;158;3797193;106202;107;3226642;51;570551;24033;22041
76574;Saint-Denis-sur-Scie;268;6440910;200941;150;5102682;118;1338228;24033;22042
25191;Dampierre-sur-le-Doubs;288;6921621;296156;191;5885890;97;1035731;24033;22043
51306;Joiselle;55;1321855;77675;33;1097114;22;224741;24034;22044
33190;Goualade;53;1273799;62389;30;975089;23;298710;24034;22045
41268;Veilleins;108;2595693;179350;60;2089376;48;506317;24034;22046
63215;Martres-sur-Morge;313;7522726;269049;202;6301299;111;1221427;24034;22047
70394;Onay;36;865260;49556;15;571059;21;294201;24035;22048
61138;Croisilles;101;2427568;86190;53;1826494;48;601074;24035;22049
01454;Virignin;508;12210057;528896;287;10050105;221;2159952;24036;22050
42169;Périgneux;725;17426160;561872;448;14084570;277;3341590;24036;22051
80568;Morchain;163;3917927;216727;94;3224378;69;693549;24036;22052
74265;Serraval;346;8316665;267611;210;6779295;136;1537370;24037;22053
88051;Belmont-sur-Vair;67;1610459;63980;43;1306650;24;303809;24037;22054
35178;Mézières-sur-Couesnon;729;17523314;434235;444;14191529;285;3331785;24037;22055
51300;Isle-sur-Marne;50;1201908;60258;31;995907;19;206001;24038;22056
62824;Tortefontaine;130;3125061;149753;65;2311421;65;813640;24039;22057
16351;Saint-Simeux;312;7500296;331614;180;6188127;132;1312169;24039;22058
82150;Reyniès;471;11322858;395547;245;8617299;226;2705559;24040;22059
65281;Loucrup;119;2860775;167575;62;2219866;57;640909;24040;22060
65211;Guchan;73;1755053;53799;42;1310852;31;444201;24042;22061
73036;Bellecombe-en-Bauges;355;8535032;363893;216;7060962;139;1474070;24042;22062
64106;Béhasque-Lapiste;251;6034665;224674;138;4701685;113;1332980;24042;22063
10131;Droupt-Saint-Basle;183;4399969;228527;104;3528410;79;871559;24044;22064
80415;Hangest-en-Santerre;548;13175908;609291;315;10528974;233;2646934;24044;22065
49026;Bécon-les-Granits;1351;32483279;1203300;784;25298286;567;7184993;24044;22066
32371;Saint-Créac;59;1418603;90275;29;1120831;30;297772;24044;22067
78401;Meulan-en-Yvelines;5146;123731185;7167808;3286;105452655;1860;18278530;24044;22068
35319;Saint-Thurial;960;23082482;695919;602;18977947;358;4104535;24044;22069
72362;Le Tronchet;74;1779336;45361;32;1247239;42;532097;24045;22070
72312;Saint-Pierre-des-Bois;92;2212165;66702;43;1531971;49;680194;24045;22071
33539;Vayres;1882;45255441;1867059;1108;37054688;774;8200753;24046;22072
07254;Saint-Julien-du-Serre;437;10508665;409312;273;8667816;164;1840849;24047;22073
97124;Saint-Claude;6099;146670718;7231885;2727;116425871;3372;30244847;24048;22074
72319;Sainte-Sabine-sur-Longève;354;8513114;239898;196;6501052;158;2012062;24048;22075
77303;Montdauphin;119;2861876;140193;69;2167184;50;694692;24049;22076
21511;Puits;80;1923956;114888;44;1558568;36;365388;24049;22077
22012;La Bouillie;451;10846314;498764;239;8227118;212;2619196;24049;22078
27405;Mesnil-sous-Vienne;71;1707543;80746;42;1371410;29;336133;24050;22079
54387;Morville-sur-Seille;69;1659525;57254;43;1307355;26;352170;24051;22080
10165;Géraudot;181;4353271;185879;110;3590380;71;762891;24051;22081
54213;Friauville;185;4449653;166811;99;3374225;86;1075428;24052;22082
76115;Bolleville;300;7215776;232915;197;6012552;103;1203224;24053;22083
15262;Villedieu;289;6951467;293578;168;5784173;121;1167294;24054;22084
08199;La Grandville;421;10126652;393306;256;8379859;165;1746793;24054;22085
80038;Auchonvillers;67;1611643;90810;28;1182828;39;428815;24054;22086
59127;Capelle;79;1900353;87743;50;1668847;29;231506;24055;22087
84028;Cairanne;560;13470889;663814;302;10837941;258;2632948;24055;22088
16277;Réparsac;321;7722082;288063;213;6454367;108;1267715;24056;22089
32160;L'Isle-Jourdain;4493;108085856;5442564;2593;88851400;1900;19234456;24057;22090
67324;Niederbronn-les-Bains;2500;60146145;2624996;1475;48883603;1025;11262542;24058;22091
10436;Vinets;106;2550238;154393;61;2141645;45;408593;24059;22092
60065;Berthecourt;866;20835069;1037062;530;16867885;336;3967184;24059;22093
79273;Saint-Martin-de-Bernegoue;418;10056958;393772;273;8502235;145;1554723;24060;22094
71040;Blanzy;3551;85436037;3250560;2015;69003312;1536;16432725;24060;22095
86164;Monthoiron;360;8662229;323586;211;6998158;149;1664071;24062;22096
14105;La Brévière;57;1371562;41645;33;1110761;24;260801;24062;22097
83153;Saint-Mandrier-sur-Mer;3375;81216715;4728232;2057;67831241;1318;13385474;24064;22098
08297;Montcornet;139;3345062;172279;73;2594812;66;750250;24065;22099
28362;Saint-Victor-de-Buthon;266;6401426;253824;160;5230045;106;1171381;24066;22100
14639;Saint-Ouen-le-Pin;144;3465436;151093;88;2815724;56;649712;24066;22101
51654;Vouillers;105;2526939;88804;53;1873667;52;653272;24066;22102
49133;Faveraye-Mâchelles;326;7845564;221505;184;6389540;142;1456024;24066;22103
35200;Moutiers;409;9843225;155436;234;7250557;175;2592668;24067;22104
52115;Chatenay-Mâcheron;61;1468073;49631;41;1284036;20;184037;24067;22105
33390;Sainte-Colombe;224;5390976;225630;103;4114222;121;1276754;24067;22106
27024;Le Roncenay-Authenay;191;4596792;254544;98;3563809;93;1032983;24067;22107
81284;Le Sequestre;850;20456977;931741;532;17085182;318;3371795;24067;22108
71486;Saint-Vallier;5210;125391299;5753585;2855;99645187;2355;25746112;24067;22109
33093;Capian;364;8760548;422376;200;6955024;164;1805524;24067;22110
63297;Reignat;183;4404399;242036;115;3699237;68;705162;24068;22111
04110;Mallemoisson;567;13646419;548621;367;11510463;200;2135956;24068;22112
02097;Boncourt;127;3056661;160668;65;2393542;62;663119;24068;22113
12159;Morlhon-le-Haut;308;7413277;513524;145;5639658;163;1773619;24069;22114
57389;Lelling;250;6017326;170036;145;4707999;105;1309327;24069;22115
07264;Saint-Marcel-d'Ardèche;1367;32902852;1472795;797;26647009;570;6255843;24069;22116
49043;Brain-sur-Longuenée;450;10831357;274396;261;8504733;189;2326624;24070;22117
82015;Belbèse;63;1516424;38223;40;1237907;23;278517;24070;22118
10178;Jessains;146;3514307;167520;89;2938069;57;576238;24071;22119
79046;Le Bourdet;283;6811996;207732;167;5490700;116;1321296;24071;22120
71332;Ormes;279;6716181;282438;179;5571283;100;1144898;24072;22121
84115;Saint-Pierre-de-Vassols;293;7053243;314808;153;5515332;140;1537911;24073;22122
42134;Marcilly-le-Châtel;616;14828818;449253;335;11385111;281;3443707;24073;22123
01340;Saint-Bois;69;1661024;69730;46;1399945;23;261079;24073;22124
72292;Saint-Jean-des-Échelles;128;3081382;102418;79;2626961;49;454421;24073;22125
77159;Donnemarie-Dontilly;1522;36639828;1783391;882;29585229;640;7054599;24073;22126
13045;Graveson;2383;57367237;2653382;1300;45943280;1083;11423957;24074;22127
24010;Annesse-et-Beaulieu;749;18031948;807508;470;14696609;279;3335339;24075;22128
39009;Andelot-en-Montagne;257;6187446;239186;134;4655369;123;1532077;24076;22129
67470;Solbach;67;1613080;95402;39;1358659;28;254421;24076;22130
25203;Domprel;80;1926077;70556;46;1582007;34;344070;24076;22131
38439;Saint-Pierre-d'Allevard;1421;34212610;1176833;869;27871632;552;6340978;24076;22132
70470;Sainte-Marie-en-Chaux;89;2142808;92329;50;1731626;39;411182;24076;22133
14753;Villers-Canivet;341;8210116;261466;215;6719946;126;1490170;24077;22134
50490;Saint-Jean-de-la-Rivière;203;4887632;185399;126;3997181;77;890451;24077;22135
24011;Antonne-et-Trigonant;616;14831455;722981;360;12241843;256;2589612;24077;22136
06030;Le Cannet;27646;665685895;44063426;15754;548984699;11892;116701196;24079;22137
67255;Lalaye;270;6501322;338151;167;5311355;103;1189967;24079;22138
21099;Bouze-lès-Beaune;177;4262006;186473;110;3531875;67;730131;24079;22139
57349;Jallaucourt;77;1854135;62962;48;1507668;29;346467;24080;22140
65055;Ayros-Arbouix;175;4214033;194331;106;3409980;69;804053;24080;22141
62147;Boiry-Sainte-Rictrude;213;5129102;173757;132;4173765;81;955337;24080;22142
55171;Eix;119;2865602;91792;70;2283339;49;582263;24081;22143
02834;Wissignicourt;84;2022805;90324;47;1565996;37;456809;24081;22144
71127;Chevagny-sur-Guye;47;1131828;45729;19;812419;28;319409;24081;22145
14504;Le Pin;383;9223223;353206;217;7294271;166;1928952;24082;22146
25518;Saint-Hilaire;65;1565408;12450;39;1249928;26;315480;24083;22147
63214;Les Martres-de-Veyre;2221;53489934;2220008;1386;44641300;835;8848634;24084;22148
80740;Sourdon;150;3612627;116151;95;3057461;55;555166;24084;22149
16133;Étriac;108;2601111;132074;59;2057681;49;543430;24084;22150
56169;Plouhinec;2923;70398876;2943266;1733;56568120;1190;13830756;24084;22151
36109;Le Magny;578;13921095;641105;347;11128449;231;2792646;24085;22152
86045;Celle-Lévescault;691;16642716;699234;418;13687287;273;2955429;24085;22153
33522;Talence;22044;530942173;33039554;12933;452845163;9111;78097010;24086;22154
65417;Séméac;2860;68886898;3530451;1663;56150693;1197;12736205;24086;22155
60143;Chaumont-en-Vexin;1694;40803008;2484474;947;33244741;747;7558267;24087;22156
70509;Tromarey;53;1276600;56238;26;969992;27;306608;24087;22157
41283;Villemardy;151;3637158;144047;99;3024578;52;612580;24087;22158
27457;Piseux;359;8647518;380212;221;7222307;138;1425211;24088;22159
14483;Ouffières;95;2288494;71736;61;1906091;34;382403;24089;22160
57161;Cutting;60;1445375;55394;36;1133642;24;311733;24090;22161
01389;Saint-Trivier-sur-Moignans;954;22984103;1039188;545;18254917;409;4729186;24092;22162
05111;Puy-Sanières;142;3421161;174054;86;2766452;56;654709;24093;22163
65321;Montignac;67;1614217;58218;40;1325678;27;288539;24093;22164
52056;Blessonville;109;2626126;72985;60;1995160;49;630966;24093;22165
25120;Chantrans;202;4866944;187860;119;3789806;83;1077138;24094;22166
10047;Blignicourt;30;722814;35557;14;592348;16;130466;24094;22167
51607;Verdon;101;2433477;136414;59;2002500;42;430977;24094;22168
64211;Eslourenties-Daban;139;3349060;94366;78;2587130;61;761930;24094;22169
62233;Conchil-le-Temple;548;13204206;501486;322;10567184;226;2637022;24095;22170
68317;Soultzeren;655;15782575;684573;389;12550958;266;3231617;24096;22171
14317;La Graverie;595;14337446;481433;351;11389097;244;2948349;24097;22172
26045;La Bégude-de-Mazenc;895;21566641;1033706;489;17090394;406;4476247;24097;22173
50418;Quettetot;331;7976084;222601;186;6168114;145;1807970;24097;22174
01074;Chalamont;1233;29713442;1303598;719;23771554;514;5941888;24098;22175
73260;Saint-Maurice-de-Rotherens;121;2915930;136906;72;2383412;49;532518;24099;22176
80657;Quiry-le-Sec;154;3711204;113765;89;2876045;65;835159;24099;22177
73242;Saint-Jean-d'Arves;172;4144983;212022;98;3416536;74;728447;24099;22178
63382;Saint-Pardoux;248;5976518;292574;115;4528422;133;1448096;24099;22179
41274;Villavard;78;1879720;71358;49;1548259;29;331461;24099;22180
54360;Ménil-la-Tour;172;4145129;131486;120;3638127;52;507002;24100;22181
76486;Orival;494;11905428;516616;314;10258358;180;1647070;24100;22182
27549;Saint-Germain-Village;884;21304951;976288;509;16992681;375;4312270;24101;22183
19135;Mestes;191;4603417;159177;125;3829937;66;773480;24102;22184
88066;Boulaincourt;33;795360;16626;22;675986;11;119374;24102;22185
10144;Étrelles-sur-Aube;84;2024566;105362;47;1592181;37;432385;24102;22186
02664;Rozoy-Bellevalle;62;1494329;54576;32;1197370;30;296959;24102;22187
53206;Saint-Charles-la-Forêt;104;2506684;65830;65;2102616;39;404068;24103;22188
61404;Saint-Hilaire-le-Châtel;345;8315497;319375;214;6951822;131;1363675;24103;22189
65153;Coussan;68;1639003;73306;38;1283621;30;355382;24103;22190
43223;Saint-Romain-Lachalm;513;12364907;452201;274;9521677;239;2843230;24103;22191
24130;Condat-sur-Vézère;464;11183970;489630;265;8978560;199;2205410;24103;22192
31260;Laffite-Toupière;60;1446213;57126;27;1155453;33;290760;24104;22193
68082;Ensisheim;3987;96105986;4799002;2440;79529741;1547;16576245;24105;22194
46326;Valprionde;83;2000713;53334;29;1505725;54;494988;24105;22195
64498;Saint-Vincent;175;4218417;189731;80;3113910;95;1104507;24105;22196
57016;Alzing;222;5351455;211190;134;4406405;88;945050;24106;22197
54315;Leyr;458;11040418;364326;289;9074054;169;1966364;24106;22198
27046;Bazoques;88;2121306;99195;56;1767582;32;353724;24106;22199
59262;Godewaersvelde;1063;25625435;1091504;570;20468754;493;5156681;24107;22200
80402;Guizancourt;68;1639302;54061;43;1371127;25;268175;24107;22201
05084;Montgardin;244;5882400;225053;147;4614647;97;1267753;24108;22202
01331;Saint-Alban;82;1976875;74492;45;1517828;37;459047;24108;22203
35282;Saint-Jean-sur-Couesnon;527;12705117;343597;321;10172126;206;2532991;24108;22204
80463;Lamotte-Warfusée;336;8100422;284732;218;6843894;118;1256528;24108;22205
51059;Bignicourt-sur-Marne;208;5014571;250182;124;4060553;84;954018;24109;22206
27288;Glos-sur-Risle;267;6436987;330740;164;5349650;103;1087337;24109;22207
53004;Ampoigné;246;5930803;237320;133;4530472;113;1400331;24109;22208
81126;Lacougotte-Cadoul;90;2169848;137833;55;1838626;35;331222;24109;22209
61501;Verrières;227;5472882;289917;136;4462785;91;1010097;24110;22210
70304;Linexert;73;1760125;101105;39;1423406;34;336719;24111;22211
17275;Pessines;436;10512864;483441;270;8893333;166;1619531;24112;22212
31555;Toulouse;254507;6136716504;451221376;146870;5233486147;107637;903230357;24112;22213
51625;Villeneuve-la-Lionne;154;3713326;168061;93;3091663;61;621663;24113;22214
22069;Guenroc;115;2772952;113787;61;2217495;54;555457;24113;22215
61165;La Ferrière-Bochard;354;8535880;338875;210;6671321;144;1864559;24113;22216
47307;Thézac;98;2363058;95911;48;1805116;50;557942;24113;22217
21437;Montmançon;108;2604220;82669;70;2221861;38;382359;24113;22218
27558;Saint-Léger-du-Gennetey;82;1977315;71182;43;1527900;39;449415;24114;22219
38458;Saint-Sorlin-de-Morestel;289;6968897;248397;176;5505377;113;1463520;24114;22220
40126;Hinx;978;23583335;938814;579;19117624;399;4465711;24114;22221
67027;Belmont;84;2025567;98562;49;1674597;35;350970;24114;22222
45206;Mignères;176;4244090;192717;115;3572975;61;671115;24114;22223
80127;Bouvaincourt-sur-Bresle;440;10610303;292689;264;8556179;176;2054124;24114;22224
89287;Paron;2535;61130343;2725227;1485;49873410;1050;11256933;24115;22225
28390;Tillay-le-Péneux;192;4630021;250350;113;3803078;79;826943;24115;22226
67388;Reichshoffen;2897;69860712;2881798;1695;56285666;1202;13575046;24115;22227
35238;Rennes;111000;2676767290;182186751;62869;2265859183;48131;410908107;24115;22228
64213;Espelette;1112;26815946;1122113;631;21645390;481;5170556;24115;22229
80540;Mesnil-Martinsart;129;3110878;155017;79;2575159;50;535719;24115;22230
25129;Chassagne-Saint-Denis;65;1567528;53858;38;1326065;27;241463;24116;22231
80339;Fouquescourt;77;1856921;92643;43;1433942;34;422979;24116;22232
52399;Pont-la-Ville;76;1832869;53841;44;1416163;32;416706;24117;22233
27492;Romilly-la-Puthenaye;170;4099990;203385;98;3299699;72;800291;24118;22234
45095;Chilleurs-aux-Bois;1058;25516633;1166916;635;20865082;423;4651551;24118;22235
54520;Thiébauménil;200;4823608;133238;131;3979839;69;843769;24118;22236
25417;Naisey-les-Granges;372;8971922;242750;229;7114632;143;1857290;24118;22237
17146;Échillais;1877;45269984;1918109;1142;36933197;735;8336787;24118;22238
14505;Placy;84;2026040;68318;52;1670393;32;355647;24120;22239
46339;Saint-Jean-Lagineste;183;4413934;175953;110;3692352;73;721582;24120;22240
05075;Manteyer;231;5571705;174142;142;4471842;89;1099863;24120;22241
24537;Siorac-de-Ribérac;156;3762836;401715;72;2942212;84;820624;24121;22242
19145;Moustier-Ventadour;261;6295522;316578;169;5447335;92;848187;24121;22243
47254;Saint-Martin-Curton;179;4317634;242304;86;3390644;93;926990;24121;22244
71195;Farges-lès-Mâcon;115;2773934;93156;72;2277434;43;496500;24121;22245
72122;Duneau;529;12760353;405527;344;10368242;185;2392111;24122;22246
02016;Andelain;99;2388085;59188;62;1938659;37;449426;24122;22247
76356;Hermanville;59;1423204;40119;31;1067461;28;355743;24122;22248
39051;Biarne;221;5331069;154531;135;4298111;86;1032958;24122;22249
56075;Guer;3105;74900595;3142670;1853;60249707;1252;14650888;24123;22250
02474;Mennessis;200;4824520;195309;116;3778862;84;1045658;24123;22251
71492;Saint-Ythaire;77;1857456;91655;52;1544491;25;312965;24123;22252
35251;Saint-Aubin-d'Aubigné;1701;41035404;1387824;1061;33561875;640;7473529;24124;22253
88260;Langley;86;2074692;51592;52;1577394;34;497298;24124;22254
89414;Thorigny-sur-Oreuse;833;20095566;980637;506;16383543;327;3712023;24124;22255
40269;Saint-Lon-les-Mines;598;14426503;601378;322;11432307;276;2994196;24125;22256
45023;Batilly-en-Puisaye;49;1182120;36272;24;856607;25;325513;24125;22257
53248;Saint-Pierre-sur-Erve;65;1568195;78916;31;1123298;34;444897;24126;22258
17228;Médis;1608;38795781;1686444;912;30983501;696;7812280;24127;22259
03321;Yzeure;7386;178212209;9036567;4637;151353403;2749;26858806;24128;22260
17345;Saint-Hilaire-du-Bois;192;4633020;249293;97;3701108;95;931912;24130;22261
32045;Berdoues;267;6442904;409848;143;5075909;124;1366995;24131;22262
82178;Savenès;365;8807828;301989;203;6808336;162;1999492;24131;22263
30242;Saint-Christol-de-Rodières;97;2340732;121501;55;1924626;42;416106;24131;22264
28316;Rohaire;83;2002896;79172;46;1601976;37;400920;24131;22265
84020;Bonnieux;894;21574374;1319784;476;17430850;418;4143524;24132;22266
09095;Cescau;79;1906483;125745;36;1478111;43;428372;24133;22267
62258;Croisette;154;3716463;166636;81;2892257;73;824206;24133;22268
30326;Tavel;1039;25074085;1232922;600;20551616;439;4522469;24133;22269
76127;Bosc-Roger-sur-Buchy;382;9219036;345080;241;7741907;141;1477129;24134;22270
45224;Neuville-aux-Bois;2332;56279897;2639072;1357;45279063;975;11000834;24134;22271
76402;Malaunay;3177;76674592;3024652;1909;63521401;1268;13153191;24134;22272
38314;Pontcharra;3713;89611761;3850180;2244;72952953;1469;16658808;24135;22273
80287;Estréboeuf;123;2968595;167982;64;2233501;59;735094;24135;22274
54298;Laneuveville-derrière-Foug;75;1810138;77122;39;1298761;36;511377;24135;22275
22160;Noyal;443;10692034;345682;288;8977323;155;1714711;24136;22276
17208;Longèves;444;10716378;318880;284;8830983;160;1885395;24136;22277
14231;Beaufour-Druval;230;5551803;369560;128;4568251;102;983552;24138;22278
57050;Barchain;51;1231062;29895;33;985065;18;245997;24138;22279
25216;Écurcey;155;3741529;133329;97;2991933;58;749596;24139;22280
54142;Crantenoy;69;1665586;49071;43;1329926;26;335660;24139;22281
60168;Courcelles-Epayelles;90;2172511;123302;50;1636314;40;536197;24139;22282
54517;Thézey-Saint-Martin;106;2558738;100506;61;2028391;45;530347;24139;22283
69084;Fleurie;681;16438776;966515;374;12893909;307;3544867;24139;22284
01031;Bellignat;1913;46178662;2574853;1067;37117340;846;9061322;24139;22285
68321;Staffelfelden;1960;47313270;1736465;1245;38677326;715;8635944;24139;22286
60380;Mareuil-sur-Ourcq;768;18539153;610332;505;15399752;263;3139401;24140;22287
67422;Saasenheim;300;7241959;207372;177;5764096;123;1477863;24140;22288
08082;Brécy-Brières;42;1013876;27368;29;862991;13;150885;24140;22289
57238;Fresnes-en-Saulnois;85;2051912;61491;48;1620356;37;431556;24140;22290
37253;Sublaines;99;2389889;88769;62;2001519;37;388370;24140;22291
71546;Trambly;200;4828515;133418;108;3850291;92;978224;24143;22292
62280;Dury;187;4514784;182187;106;3665024;81;849760;24143;22293
43089;Espaly-Saint-Marcel;2077;50146543;2892030;1105;40393115;972;9753428;24144;22294
89429;Vareilles;132;3187052;131409;82;2608609;50;578443;24144;22295
25149;Chenecey-Buillon;311;7508899;383789;180;6283636;131;1225263;24144;22296
54093;Brainville;85;2052304;70511;53;1719669;32;332635;24145;22297
73235;Saint-François-Longchamp;112;2704216;156667;71;2337227;41;366989;24145;22298
50209;Gonneville;444;10720392;323000;274;8776316;170;1944076;24145;22299
58096;Devay;255;6157020;282545;153;5091605;102;1065415;24145;22300
05087;Montmaur;291;7026266;337620;181;5857859;110;1168407;24145;22301
02301;Faucoucourt;151;3645962;155850;94;3036481;57;609481;24145;22302
51264;Le Gault-Soigny;297;7171218;409531;171;5793212;126;1378006;24146;22303
62349;Fouquereuil;618;14922107;644025;356;11803692;262;3118415;24146;22304
49266;Saint-Augustin-des-Bois;490;11831533;273268;281;9237210;209;2594323;24146;22305
62434;La Herlière;78;1883389;91529;41;1535876;37;347513;24146;22306
17482;Vouhé;297;7171585;237236;167;5497813;130;1673772;24147;22307
36198;Saint-Lactencin;229;5529676;231136;137;4369102;92;1160574;24147;22308
47198;Pailloles;166;4008510;222343;89;3003563;77;1004947;24148;22309
76639;Saint-Pierre-Lavis;122;2946191;158912;68;2286404;54;659787;24149;22310
97103;Baie-Mahault;15090;364410184;16262474;6833;283281038;8257;81129146;24149;22311
54335;Maixe;231;5578629;186312;153;4633835;78;944794;24150;22312
02115;Braye-en-Laonnois;104;2511667;167511;52;1868449;52;643218;24151;22313
25437;Osse;160;3864139;130180;102;3111588;58;752551;24151;22314
25480;Rantechaux;89;2149429;69798;50;1673690;39;475739;24151;22315
21515;Quetigny;5046;121865389;5377844;3147;101261493;1899;20603896;24151;22316
08053;Bazeilles;943;22774421;931480;506;17664355;437;5110066;24151;22317
52206;Frampas;88;2125357;86123;55;1801718;33;323639;24152;22318
42036;Chagnon;235;5675773;128800;140;4483378;95;1192395;24152;22319
67010;Andlau;1021;24659425;1115549;603;20124563;418;4534862;24152;22320
34337;Villeneuve-lès-Maguelone;4774;115304665;5602746;2745;94666278;2029;20638387;24153;22321
60186;Cuignières;108;2608524;91379;67;2114602;41;493922;24153;22322
73161;Montagny;373;9009204;442473;238;7450321;135;1558883;24153;22323
60296;Hannaches;77;1859845;88015;40;1347070;37;512775;24154;22324
70306;Lomont;238;5748686;245720;141;4610791;97;1137895;24154;22325
84134;Travaillan;344;8309336;332111;201;6780797;143;1528539;24155;22326
54544;Vandelainville;83;2004917;98106;49;1611641;34;393276;24156;22327
28335;Saint-Éliph;484;11691948;532618;287;9446046;197;2245902;24157;22328
32339;Razengues;95;2294939;89510;56;1914306;39;380633;24157;22329
45309;Sennely;363;8769339;360320;219;7030276;144;1739063;24158;22330
79171;Mauzé-Thouarsais;1165;28144215;1321572;659;22390850;506;5753365;24158;22331
72339;Souligné-Flacé;360;8697009;288893;224;7092170;136;1604839;24158;22332
38437;Saint-Paul-d'Izeaux;163;3937845;165172;99;3225892;64;711953;24159;22333
21414;Mimeure;154;3720548;123250;94;3061449;60;659099;24159;22334
42319;Valeille;315;7610261;243943;191;6111751;124;1498510;24160;22335
29150;Moëlan-sur-Mer;4198;101423407;4502608;2415;81456801;1783;19966606;24160;22336
37069;Chemillé-sur-Indrois;131;3164980;155498;73;2454997;58;709983;24160;22337
53094;Entrammes;1103;26648723;918594;707;22171540;396;4477183;24160;22338
01351;Saint-Étienne-sur-Chalaronne;759;18337775;629003;443;14746356;316;3591419;24160;22339
18235;Sainte-Solange;617;14907219;610964;388;12474354;229;2432865;24161;22340
30126;Garrigues-Sainte-Eulalie;403;9736931;415092;245;8092489;158;1644442;24161;22341
27590;Saint-Pierre-de-Cernières;120;2899529;188731;67;2445953;53;453576;24163;22342
89209;Jouy;267;6451727;286557;162;5319715;105;1132012;24164;22343
28142;Ermenonville-la-Petite;94;2271424;86626;55;1889124;39;382300;24164;22344
59369;Maing;2199;53139022;2367072;1145;42460928;1054;10678094;24165;22345
31189;Forgues;100;2416526;105146;59;1984757;41;431769;24165;22346
21613;Soussey-sur-Brionne;76;1836562;93402;46;1474599;30;361963;24165;22347
29208;Plourin;586;14161221;403517;333;10822613;253;3338608;24166;22348
63321;Saint-Babel;481;11623902;497855;291;9449121;190;2174781;24166;22349
59573;Solrinnes;65;1570800;58271;34;1209476;31;361324;24166;22350
62174;Brêmes;691;16699223;793798;376;13256340;315;3442883;24167;22351
32306;Pauilhac;307;7419215;279840;165;5873158;142;1546057;24167;22352
81325;Viviers-lès-Montagnes;1000;24167403;922068;586;19738874;414;4428529;24167;22353
16368;Sers;452;10923728;525268;275;9239717;177;1684011;24168;22354
39582;Voiteur;450;10875431;499697;271;8776753;179;2098678;24168;22355
42062;Chevrières;484;11697354;275370;289;9248942;195;2448412;24168;22356
79157;Louzy;657;15878463;579708;403;13035998;254;2842465;24168;22357
77522;Villiers-sur-Seine;177;4277773;208951;107;3574695;70;703078;24168;22358
21042;Bagnot;78;1885142;73155;45;1465051;33;420091;24168;22359
10175;Jasseines;98;2368551;109755;60;1877350;38;491201;24169;22360
27318;La Haye-de-Calleville;141;3407855;133035;82;2673647;59;734208;24169;22361
02665;Grand-Rozoy;169;4084712;270219;87;3231813;82;852899;24170;22362
57549;Pontpierre;387;9353773;327537;239;7505467;148;1848306;24170;22363
01224;Loyettes;1507;36425053;1330297;928;29606733;579;6818320;24171;22364
68233;Niederbruck;241;5825128;208823;153;4769557;88;1055571;24171;22365
61090;Champs;57;1377753;34080;33;1084602;24;293151;24171;22366
32128;Estipouy;124;2997305;207607;64;2358678;60;638627;24172;22367
61372;Saint-Céneri-le-Gérei;77;1861247;75169;43;1410054;34;451193;24172;22368
62741;Saint-Amand;79;1909600;114148;39;1435282;40;474318;24172;22369
07293;Saint-Romain-de-Lerps;384;9282397;285868;209;7016925;175;2265472;24173;22370
68361;Wegscheid;187;4520400;176846;113;3681199;74;839201;24173;22371
89369;Saint-Sérotin;278;6720207;229602;188;5519945;90;1200262;24173;22372
57436;Malaucourt-sur-Seille;64;1547125;43022;40;1249077;24;298048;24174;22373
62164;Bourlon;648;15664999;810591;354;12741555;294;2923444;24174;22374
59342;Lez-Fontaine;132;3191019;160986;81;2732138;51;458881;24174;22375
16210;Marsac;434;10491732;443695;234;8126735;200;2364997;24174;22376
26052;Bonlieu-sur-Roubion;190;4593304;174417;105;3626186;85;967118;24175;22377
06068;Gourdon;245;5923189;302577;150;5136364;95;786825;24176;22378
29093;Kernilis;673;16270665;520326;367;12316001;306;3954664;24176;22379
65299;Marsac;114;2756190;65461;74;2201509;40;554681;24177;22380
31147;Clarac;315;7615811;344408;207;6392168;108;1223643;24177;22381
02325;Fontenelle-en-Brie;110;2659509;163886;58;2131511;52;527998;24177;22382
13070;La Penne-sur-Huveaune;3599;87015503;4248478;2179;72056061;1420;14959442;24178;22383
76214;Dénestanville;132;3191492;102885;87;2691329;45;500163;24178;22384
64061;Artix;1886;45600010;1661126;1071;35868117;815;9731893;24178;22385
31507;Saint-Paul-sur-Save;746;18038120;768755;455;14857410;291;3180710;24180;22386
25330;Lavans-Quingey;87;2103695;45295;53;1711322;34;392373;24180;22387
50006;Amigny;79;1910272;70150;42;1422375;37;487897;24181;22388
60339;Lafraye;176;4255849;147419;115;3594066;61;661783;24181;22389
57704;Veckring;352;8511948;229798;179;5926591;173;2585357;24182;22390
28085;Chartres;23770;574802971;38871802;13956;479778323;9814;95024648;24182;22391
45240;Outarville;792;19152205;776424;456;15205221;336;3946984;24182;22392
39203;Doye;47;1136562;18981;29;939473;18;197089;24182;22393
21572;Saint-Seine-en-Bâche;172;4159351;117872;117;3554226;55;605125;24182;22394
29147;Mellac;1472;35596977;1363029;901;29150366;571;6446611;24183;22395
24140;Cours-de-Pile;798;19298534;710782;485;15770870;313;3527664;24184;22396
22090;Kermaria-Sulard;491;11874167;463856;283;9485562;208;2388605;24184;22397
22003;Aucaleuc;413;9987992;288584;265;8359975;148;1628017;24184;22398
24513;Saint-Vincent-sur-l'Isle;162;3917810;164443;103;3272923;59;644887;24184;22399
35220;Piré-sur-Seiche;1093;26434436;786101;657;20795624;436;5638812;24185;22400
31504;Saint-Médard;123;2974813;91445;70;2306853;53;667960;24185;22401
37185;Pocé-sur-Cisse;910;22008855;1024012;567;18196461;343;3812394;24186;22402
65352;Ouzous;107;2587962;92714;63;2027661;44;560301;24187;22403
67259;Langensoultzbach;483;11682207;468340;299;9495436;184;2186771;24187;22404
54283;Jouaville;166;4015003;128204;109;3342999;57;672004;24187;22405
32224;Maignaut-Tauzia;118;2854039;92831;72;2271381;46;582658;24187;22406
21373;Mâlain;392;9481357;310132;253;7958778;139;1522579;24187;22407
66220;Valcebollère;32;774004;51740;20;634970;12;139034;24188;22408
63143;Effiat;590;14270710;499042;329;11407446;261;2863264;24188;22409
77263;Luisetaines;121;2926730;116389;74;2291923;47;634807;24188;22410
58072;Chevenon;330;7982263;428765;211;6679141;119;1303122;24189;22411
27455;Piencourt;80;1935109;78658;49;1655244;31;279865;24189;22412
29180;Ploudiry;461;11151413;339857;253;8697789;208;2453624;24190;22413
22188;Plerneuf;501;12119010;454732;308;9871697;193;2247313;24190;22414
67246;Kogenheim;603;14586474;616876;335;11353797;268;3232677;24190;22415
02200;Clermont-les-Fermes;62;1499802;106386;25;1094054;37;405748;24190;22416
63379;Saint-Myon;261;6313859;281954;155;5124913;106;1188946;24191;22417
41136;Mer;3396;82154331;4597352;1954;66040260;1442;16114071;24191;22418
51129;Charleville;139;3362678;119393;84;2615343;55;747335;24192;22419
58198;Oisy;198;4790345;249777;93;3470677;105;1319668;24194;22420
71551;Uchon;52;1258107;45302;28;1020840;24;237267;24194;22421
73033;La Bauche;210;5080820;155382;114;3759768;96;1321052;24194;22422
83062;La Garde;14487;350508378;18548643;8225;286936669;6262;63571709;24195;22423
55385;Nixéville-Blercourt;251;6072910;201585;158;4925350;93;1147560;24195;22424
02241;La Croix-sur-Ourcq;63;1524277;96345;34;1265408;29;258869;24195;22425
15188;Saint-Georges;601;14541359;595129;348;11673825;253;2867534;24195;22426
63013;Aubiat;489;11832647;488510;296;9636959;193;2195688;24198;22427
63347;Saint-Genès-du-Retz;260;6291482;247445;151;5132074;109;1159408;24198;22428
57315;Henridorff;322;7791911;283197;181;5987721;141;1804190;24198;22429
62424;Hendecourt-lès-Cagnicourt;155;3750786;220876;81;2952574;74;798212;24199;22430
55452;Saint-Amand-sur-Ornain;36;871192;61137;18;683954;18;187238;24200;22431
56232;Saint-Perreux;597;14447454;489015;383;11940362;214;2507092;24200;22432
89314;Prégilbert;104;2516852;95465;67;2089197;37;427655;24201;22433
55514;Trémont-sur-Saulx;325;7865233;296212;204;6463546;121;1401687;24201;22434
16061;Brie;2065;49975185;1742492;1371;41853720;694;8121465;24201;22435
17479;Virollet;155;3751500;280145;79;3027234;76;724266;24203;22436
35130;Hédé-Bazouges;1107;26793309;977265;636;21741835;471;5051474;24204;22437
55070;Brabant-sur-Meuse;55;1331224;38835;30;1015867;25;315357;24204;22438
28038;Béthonvilliers;72;1742709;77016;46;1525942;26;216767;24204;22439
55169;Écouviez;262;6341572;240545;166;5162444;96;1179128;24204;22440
89452;Villecien;219;5300931;257779;130;4276877;89;1024054;24205;22441
87070;La Geneytouse;458;11086552;429914;307;9354972;151;1731580;24206;22442
79055;Brieuil-sur-Chizé;31;750401;20134;17;574880;14;175521;24206;22443
38563;Voiron;12425;300771214;16267796;7052;245188147;5373;55583067;24207;22444
14607;Saint-Louet-sur-Seulles;78;1888165;78091;46;1468399;32;419766;24207;22445
44195;Savenay;4081;98792560;3795001;2311;80961084;1770;17831476;24208;22446
80469;Lawarde-Mauger-l'Hortoy;89;2154538;88878;55;1825398;34;329140;24208;22447
54200;Flirey;91;2202976;100687;51;1810881;40;392095;24209;22448
29039;Concarneau;12373;299538854;15492064;6770;239377176;5603;60161678;24209;22449
62248;Courcelles-le-Comte;224;5422857;168258;123;4269288;101;1153569;24209;22450
33082;Cadillac-en-Fronsadais;622;15058141;586749;397;12555325;225;2502816;24209;22451
76033;Auberville-la-Renault;219;5301853;156623;137;4337533;82;964320;24209;22452
65067;Barry;74;1791519;54325;47;1484355;27;307164;24210;22453
72116;Dissé-sous-Ballon;59;1428401;78975;34;1179151;25;249250;24210;22454
33237;Léogeats;420;10168392;445552;256;8333260;164;1835132;24210;22455
47291;La Sauvetat-sur-Lède;316;7650839;351202;153;5831376;163;1819463;24212;22456
41056;La Colombe;96;2324423;72609;54;1720186;42;604237;24213;22457
95116;Bruyères-sur-Oise;1941;46997997;1615891;1245;39258680;696;7739317;24213;22458
52480;Soncourt-sur-Marne;200;4842660;164435;111;3716995;89;1125665;24213;22459
81061;Castanet;106;2566660;100323;59;1977845;47;588815;24214;22460
65185;Gardères;237;5738678;148097;130;4437297;107;1301381;24214;22461
02089;Billy-sur-Aisne;633;15327373;633524;399;12590018;234;2737355;24214;22462
30344;Vergèze;2568;62181237;2647063;1493;50028653;1075;12152584;24214;22463
85112;L'Île-d'Olonne;1409;34118007;1310067;860;27553392;549;6564615;24214;22464
89051;Les Bordes;301;7288604;325169;188;5958632;113;1329972;24215;22465
36005;Ardentes;2066;50028154;2249130;1268;40825173;798;9202981;24215;22466
24472;Saint-Nexans;467;11308431;403123;273;8912887;194;2395544;24215;22467
37162;Mouzay;247;5981415;228704;148;4921360;99;1060055;24216;22468
30117;Fourques;1594;38601885;1810202;974;31794510;620;6807375;24217;22469
17353;Saint-Laurent-de-la-Prée;1067;25839851;1049572;632;21100048;435;4739803;24217;22470
54087;Bouillonville;64;1549931;37600;37;1234962;27;314969;24218;22471
34216;Le Pradal;154;3729561;177684;90;3057633;64;671928;24218;22472
46053;Camburat;223;5400626;190818;119;4026775;104;1373851;24218;22473
70326;La Malachère;132;3196786;110739;85;2573643;47;623143;24218;22474
62811;Thérouanne;577;13974116;658076;317;11068611;260;2905505;24219;22475
52035;Baissey;108;2615616;92386;57;2031275;51;584341;24219;22476
49344;Thorigné-d'Anjou;514;12448620;254196;311;9977766;203;2470854;24219;22477
05120;Ristolas;47;1138314;56627;29;894462;18;243852;24219;22478
63444;Varennes-sur-Usson;132;3197157;89376;82;2482517;50;714640;24221;22479
80616;Pargny;86;2083037;113942;42;1540471;44;542566;24221;22480
19255;Seilhac;1039;25166017;1204079;616;20877685;423;4288332;24221;22481
25048;Bavans;2030;49170288;2156869;1217;39891609;813;9278679;24222;22482
25414;Le Moutherot;61;1477541;47086;37;1223901;24;253640;24222;22483
73052;Bourget-en-Huile;72;1744033;51818;46;1412251;26;331782;24223;22484
45259;Quiers-sur-Bézonde;624;15115055;569865;372;12056628;252;3058427;24223;22485
55540;Vaux-lès-Palameix;28;678242;12287;16;567216;12;111026;24223;22486
30121;Gailhan;123;2979436;165943;75;2577294;48;402142;24223;22487
58279;Sichamps;93;2252824;87827;54;1818950;39;433874;24224;22488
14474;Notre-Dame-d'Estrées;86;2083267;106913;48;1726090;38;357177;24224;22489
45015;Autruy-sur-Juine;429;10392135;508157;267;8705134;162;1687001;24224;22490
69015;Avenas;51;1235447;29018;30;946419;21;289028;24224;22491
81100;Garrevaques;182;4408858;173009;100;3558111;82;850747;24224;22492
69292;Sathonay-Camp;2445;59229888;2796775;1580;49161353;865;10068535;24225;22493
90058;Lachapelle-sous-Rougemont;275;6661850;280964;178;5559005;97;1102845;24225;22494
41048;Chauvigny-du-Perche;131;3173516;180171;67;2455118;64;718398;24225;22495
40017;Audignon;194;4699826;138305;118;3790328;76;909498;24226;22496
60025;Attichy;1076;26068418;1394238;612;21234942;464;4833476;24227;22497
81029;Bernac;90;2180447;91637;48;1740191;42;440256;24227;22498
63240;Montpensier;224;5426932;209647;147;4575760;77;851172;24227;22499
73211;Queige;466;11290585;477136;295;9314728;171;1975857;24229;22500
08466;Vaux-lès-Mouzon;51;1235679;57789;30;994341;21;241338;24229;22501
25257;Franey;133;3222539;109270;73;2522891;60;699648;24230;22502
46246;Saignes;37;896498;34378;22;731603;15;164895;24230;22503
73027;Ayn;176;4264460;162917;110;3535380;66;729080;24230;22504
63193;Lempdes;4516;109425454;4825335;2863;90353338;1653;19072116;24231;22505
59557;Saultain;1158;28059213;1317678;693;23254590;465;4804623;24231;22506
50469;Sainte-Geneviève;167;4046548;185622;89;3172755;78;873793;24231;22507
30112;Fons;613;14853565;511473;378;12181980;235;2671585;24231;22508
76073;Belleville-sur-Mer;366;8868599;309072;199;6976134;167;1892465;24231;22509
83077;Méounes-lès-Montrieux;1129;27357369;1356552;636;22495036;493;4862333;24232;22510
51262;Frignicourt;1066;25831001;1211566;651;20924600;415;4906401;24232;22511
14473;Notre-Dame-de-Livaye;70;1696245;78739;42;1389877;28;306368;24232;22512
31403;Ondes;354;8578350;373779;219;7216770;135;1361580;24233;22513
30228;Sainte-Anastasie;881;21349170;901572;507;17256937;374;4092233;24233;22514
28279;Nogent-le-Roi;2203;53385680;2394506;1326;44039943;877;9345737;24233;22515
73268;Saint-Paul-sur-Isère;309;7488144;337291;209;6468341;100;1019803;24233;22516
88345;La Petite-Fosse;45;1090552;44782;24;806232;21;284320;24234;22517
07227;Saint-Cyr;647;15679952;518650;415;12724800;232;2955152;24235;22518
17029;Bagnizeau;97;2350800;125370;50;1890138;47;460662;24235;22519
14303;Glos;497;12044861;452887;305;9773365;192;2271496;24235;22520
49186;Luigné;117;2835565;49870;71;2350788;46;484777;24236;22521
27631;Thierville;171;4144315;224253;99;3339287;72;805028;24236;22522
44046;Corsept;1310;31749112;904852;816;25538157;494;6210955;24236;22523
30165;Méjannes-lès-Alès;629;15244630;756991;355;12322860;274;2921770;24236;22524
57419;Loupershouse;497;12045445;435631;273;9246060;224;2799385;24236;22525
49099;Cholet;29784;721856358;37241225;16547;581362313;13237;140494045;24236;22526
03026;Besson;427;10349094;430808;260;8680175;167;1668919;24237;22527
28068;Challet;214;5186745;173077;147;4331392;67;855353;24237;22528
65429;Sombrun;123;2981186;170168;62;2417314;61;563872;24237;22529
22201;Plévenon;464;11246223;544508;277;9206637;187;2039586;24238;22530
21231;Dijon;84953;2059119595;132714952;52367;1751521514;32586;307598081;24238;22531
60573;Sainte-Eusoye;157;3805444;152118;104;3265266;53;540178;24238;22532
51600;Vaudesincourt;50;1211935;32422;30;968768;20;243167;24239;22533
63268;Pardines;133;3223753;189043;77;2629054;56;594699;24239;22534
73113;Feissons-sur-Salins;99;2399730;104904;61;1927524;38;472206;24240;22535
22246;Pommeret;1009;24458175;760302;616;19784384;393;4673791;24240;22536
08494;Wadelincourt;266;6447876;274768;154;5133938;112;1313938;24240;22537
14679;Subles;339;8217495;258129;228;7038113;111;1179382;24240;22538
89105;Chichery;259;6278273;298641;166;5187733;93;1090540;24240;22539
10285;Perthes-lès-Brienne;42;1018120;34405;26;839987;16;178133;24241;22540
71193;Étrigny;273;6618213;233186;161;5139392;112;1478821;24243;22541
67281;Marckolsheim;2220;53819311;2887889;1304;44108620;916;9710691;24243;22542
03007;Arpheuilles-Saint-Priest;186;4509199;169282;117;3728544;69;780655;24243;22543
51139;Chaudefontaine;168;4072853;142641;91;3059720;77;1013133;24243;22544
80698;Saint-Aubin-Montenoy;131;3175877;162064;77;2565673;54;610204;24243;22545
40120;Hastingues;315;7636708;255013;181;6049542;134;1587166;24244;22546
38021;Autrans;898;21772483;921809;552;17799972;346;3972511;24246;22547
03140;Lavault-Sainte-Anne;637;15444553;648693;398;12640228;239;2804325;24246;22548
25249;Fontenotte;27;654656;17414;14;501530;13;153126;24247;22549
52541;Vitry-lès-Nogent;90;2182213;75569;54;1777495;36;404718;24247;22550
54155;Deuxville;195;4728235;150954;116;3842305;79;885930;24247;22551
56119;Locoal-Mendon;1706;41366618;1567286;972;32689062;734;8677556;24248;22552
07219;Saint-Bauzile;136;3297695;141966;80;2688224;56;609471;24248;22553
81144;Lescure-d'Albigeois;2410;58437265;2784645;1364;46632020;1046;11805245;24248;22554
80726;Sancourt;164;3976694;276785;91;3243617;73;733077;24248;22555
49330;Sceaux-d'Anjou;519;12585174;182204;334;10371644;185;2213530;24249;22556
51054;Bétheniville;565;13700798;413645;342;10906843;223;2793955;24249;22557
14200;Creully;866;20999889;900722;524;17134352;342;3865537;24249;22558
39471;Ruffey-sur-Seille;403;9772593;468169;236;7789247;167;1983346;24250;22559
64070;Astis;138;3346460;115695;95;2985135;43;361325;24250;22560
37244;Sazilly;160;3880061;361190;83;3098951;77;781110;24250;22561
71050;Bourgvilain;180;4365156;126139;97;3190126;83;1175030;24251;22562
38239;Moirans;4288;103989197;4598053;2531;85086334;1757;18902863;24251;22563
32351;Roques;66;1600643;107386;33;1282100;33;318543;24252;22564
27251;Fontaine-l'Abbé;319;7736672;357075;186;6291095;133;1445577;24253;22565
43010;Arsac-en-Velay;610;14794314;490610;379;12042908;231;2751406;24253;22566
28151;Fessanvilliers-Mattanvilliers;88;2134323;142587;47;1764136;41;370187;24254;22567
38209;Lentiol;110;2667940;96788;70;2218337;40;449603;24254;22568
41045;Chaumont-sur-Loire;553;13412786;553888;330;10780951;223;2631835;24255;22569
59169;Damousies;133;3225864;165087;83;2746604;50;479260;24255;22570
54458;Repaix;47;1139975;47236;30;963292;17;176683;24255;22571
44010;Batz-sur-Mer;1936;46957920;2409236;1138;37782189;798;9175731;24255;22572
04242;Villeneuve;2039;49456226;1972611;1209;39969326;830;9486900;24255;22573
26039;Beauregard-Baret;409;9920373;378143;248;8005153;161;1915220;24255;22574
67245;Knoersheim;114;2765095;102243;68;2237997;46;527098;24255;22575
34272;Saint-Just;1488;36091980;1597011;856;28941816;632;7150164;24255;22576
43030;Blanzac;173;4196185;144636;101;3324950;72;871235;24255;22577
02802;La Ville-aux-Bois-lès-Dizy;96;2328525;192076;40;1792265;56;536260;24255;22578
49359;Les Ulmes;306;7422285;321378;189;6128964;117;1293321;24256;22579
22059;Le Foeil;695;16857861;490202;434;13757364;261;3100497;24256;22580
38357;Saint-André-le-Gaz;1313;31849724;1118027;777;25643089;536;6206635;24257;22581
70045;Avrigney-Virey;226;5482131;246155;137;4401278;89;1080853;24257;22582
89116;Cornant;195;4730486;177604;123;3908226;72;822260;24259;22583
16395;Vaux-Rouillac;175;4245332;287365;93;3340972;82;904360;24259;22584
86031;Bonnes;944;22900606;903993;589;18992631;355;3907975;24259;22585
89027;Bagneaux;120;2911116;141568;67;2412965;53;498151;24259;22586
18081;Crosses;184;4463768;166312;112;3658994;72;804774;24260;22587
39339;Molinges;354;8587924;442057;214;6994467;140;1593457;24260;22588
81108;Itzac;71;1722437;76981;38;1391431;33;331006;24260;22589
02493;Monceau-le-Waast;121;2935456;181260;56;2241287;65;694169;24260;22590
32059;Bonas;70;1698210;153474;32;1302991;38;395219;24260;22591
83049;Cuers;5881;142675825;6988665;3338;116192621;2543;26483204;24260;22592
89443;Véron;1081;26225571;1184050;700;22085090;381;4140481;24260;22593
64042;Argagnon;373;9049189;349461;218;7392143;155;1657046;24261;22594
44019;Bouée;441;10699339;357023;259;8367818;182;2331521;24262;22595
52373;Ozières;29;703588;30583;14;552164;15;151424;24262;22596
67145;Friedolsheim;132;3202553;128489;81;2698125;51;504428;24262;22597
31077;Le Born;222;5386151;211219;126;4323026;96;1063125;24262;22598
50379;Notre-Dame-de-Livoye;59;1431483;42622;32;1087125;27;344358;24262;22599
45198;Marsainvilliers;159;3857819;131663;111;3214068;48;643751;24263;22600
89137;Dannemoine;255;6187103;316518;154;5048540;101;1138563;24263;22601
70422;Poyans;68;1649911;47705;41;1363206;27;286705;24263;22602
45081;Charsonville;328;7958486;414545;192;6252876;136;1705610;24264;22603
70166;Comberjon;97;2353624;77847;66;1921686;31;431938;24264;22604
27334;Heudreville-en-Lieuvin;60;1455868;81700;37;1239301;23;216567;24264;22605
55108;Chaumont-sur-Aire;75;1819836;52386;43;1456706;32;363130;24264;22606
10429;Villette-sur-Aube;130;3154618;128210;81;2590046;49;564572;24266;22607
39031;Auxange;99;2402425;93551;62;1970160;37;432265;24267;22608
22016;Île-de-Bréhat;240;5824201;394206;127;4695400;113;1128801;24268;22609
25345;Longevelle-sur-Doubs;358;8688038;324143;232;7145710;126;1542328;24268;22610
84029;Camaret-sur-Aigues;2380;57759309;2377361;1397;46910251;983;10849058;24269;22611
63058;Bulhon;265;6431263;276325;168;5337422;97;1093841;24269;22612
38274;Nantoin;216;5242248;137050;126;4068224;90;1174024;24270;22613
31258;Lacaugne;100;2427001;122033;49;1854505;51;572496;24270;22614
97231;Les Trois-Îlets;4594;111497474;5781790;2004;84800538;2590;26696936;24270;22615
27036;Bâlines;270;6553097;224700;170;5363918;100;1189179;24271;22616
64358;Lucgarier;152;3689190;139092;91;3009578;61;679612;24271;22617
60253;Francastel;242;5873742;280311;141;4846821;101;1026921;24272;22618
27260;Foulbec;288;6990325;257828;167;5414032;121;1576293;24272;22619
30023;Aujargues;460;11165143;494243;262;8871859;198;2293284;24272;22620
77331;Nanteuil-sur-Marne;220;5339927;304701;131;4408814;89;931113;24272;22621
28066;Bullou;130;3155650;133195;76;2474220;54;681430;24274;22622
70132;Chargey-lès-Gray;368;8932927;300452;227;7203265;141;1729662;24274;22623
31332;Mauvaisin;129;3131401;131183;67;2524011;62;607390;24274;22624
16398;Verneuil;45;1092368;47315;22;891590;23;200778;24275;22625
50492;Saint-Jean-des-Baisants;636;15438932;654250;375;12637531;261;2801401;24275;22626
85035;Bretignolles-sur-Mer;2682;65106453;3107564;1657;53344951;1025;11761502;24275;22627
82017;Bessens;659;15997505;489396;389;12949069;270;3048436;24275;22628
35228;Pleurtuit;3583;86980392;3595206;2004;68545669;1579;18434723;24276;22629
32062;Bourrouillan;82;1990622;99522;37;1416881;45;573741;24276;22630
22319;Saint-Michel-en-Grève;282;6845943;460325;153;5703806;129;1142137;24276;22631
21301;Glanon;121;2937456;139930;76;2436459;45;500997;24276;22632
50434;La Rochelle-Normande;162;3932819;153879;85;2825058;77;1107761;24277;22633
31536;Saux-et-Pomarède;151;3665793;144038;94;3080212;57;585581;24277;22634
65236;Julos;191;4636917;218724;112;3828362;79;808555;24277;22635
58164;Mesves-sur-Loire;383;9298307;495884;212;7502672;171;1795635;24278;22636
25360;Malbrans;79;1917929;93592;50;1632164;29;285765;24278;22637
21054;Beaune;12966;314797232;19055790;7287;258105986;5679;56691246;24279;22638
88167;Faucompierre;113;2743496;90375;72;2198831;41;544665;24279;22639
73246;Saint-Jean-de-Couz;123;2986301;117434;77;2498622;46;487679;24279;22640
70213;Éhuns;132;3204847;106892;83;2642195;49;562652;24279;22641
33189;Gornac;221;5365737;235727;106;4219691;115;1146046;24279;22642
89254;Mézilles;347;8424985;474890;174;6697870;173;1727115;24279;22643
57411;Lommerange;152;3690518;86170;77;2429240;75;1261278;24280;22644
50421;Quinéville;159;3860497;201250;87;3077418;72;783079;24280;22645
57057;Béchy;250;6070105;233822;144;4872652;106;1197453;24280;22646
53148;Mée;98;2379540;61770;56;1856789;42;522751;24281;22647
39573;Villette-lès-Dole;429;10416606;395780;291;8803437;138;1613169;24281;22648
80240;Doingt;760;18453691;884097;432;15193847;328;3259844;24281;22649
62633;OEuf-en-Ternois;129;3132281;167914;63;2351715;66;780566;24281;22650
44165;Saint-Hilaire-de-Clisson;1025;24889054;701990;650;20276947;375;4612107;24282;22651
16168;Jauldes;412;10004359;399024;252;8242557;160;1761802;24282;22652
02813;Villers-le-Sec;122;2962460;113438;60;2132803;62;829657;24282;22653
73270;Saint-Pierre-d'Albigny;2180;52936009;2494967;1317;43052251;863;9883758;24283;22654
76618;Saint-Martin-en-Campagne;631;15322397;633884;380;12672648;251;2649749;24283;22655
38543;Vézeronce-Curtin;984;23894870;1011551;557;18567358;427;5327512;24283;22656
54098;Brémoncourt;76;1845568;43669;50;1585958;26;259610;24284;22657
71146;Cortambert;112;2719890;105140;68;2232757;44;487133;24285;22658
80233;Dancourt-Popincourt;86;2088535;112732;51;1685198;35;403337;24285;22659
08077;Bourcq;37;898576;53910;18;666344;19;232232;24286;22660
31101;Cambernard;241;5852990;262594;149;4860371;92;992619;24286;22661
60117;Bussy;155;3764395;156693;92;2957561;63;806834;24286;22662
64146;Bournos;163;3958764;140426;95;3147574;68;811190;24287;22663
80175;Carnoy;50;1214349;48243;28;936078;22;278271;24287;22664
63219;Mazaye;348;8451944;401222;218;7190901;130;1261043;24287;22665
54288;Lagney;240;5828965;177089;152;4629387;88;1199578;24287;22666
88386;Remomeix;263;6387694;277284;162;5311804;101;1075890;24288;22667
76659;Saint-Wandrille-Rançon;657;15957336;676819;397;13384579;260;2572757;24288;22668
72036;Béthon;146;3546115;86519;95;2965590;51;580525;24288;22669
27193;Croth;650;15787911;557421;396;12922755;254;2865156;24289;22670
33462;Saint-Philippe-du-Seignal;252;6121103;319810;149;5038730;103;1082373;24290;22671
45074;La Chapelle-Onzerain;65;1578857;43638;44;1286846;21;292011;24290;22672
67277;Mackenheim;390;9473194;384948;245;7787742;145;1685452;24290;22673
02197;Clairfontaine;257;6242619;192498;136;4929656;121;1312963;24290;22674
25187;Dambelin;251;6096982;225165;147;4864406;104;1232576;24291;22675
34159;Mireval;1776;43140438;1881381;1068;35537340;708;7603098;24291;22676
89433;Vault-de-Lugny;195;4736822;237715;115;3794717;80;942105;24291;22677
67404;Rittershoffen;506;12291590;543602;316;10183707;190;2107883;24292;22678
38077;La Chapelle-de-Surieu;334;8113523;207636;197;6445958;137;1667565;24292;22679
03252;Saint-Pont;311;7554901;311322;186;6070026;125;1484875;24292;22680
57176;Diebling;912;22154794;869244;547;17933568;365;4221226;24293;22681
32239;Marsolan;258;6267557;461651;115;4794426;143;1473131;24293;22682
39574;Villevieux;397;9644290;363302;245;7839789;152;1804501;24293;22683
14353;Landes-sur-Ajon;187;4542938;115379;113;3628986;74;913952;24294;22684
62511;Lignereuil;71;1724869;71204;43;1437932;28;286937;24294;22685
51228;Élise-Daucourt;58;1409076;120891;25;1059283;33;349793;24294;22686
30292;Saint-Pons-la-Calm;239;5806396;268928;151;4860626;88;945770;24295;22687
45116;Cravant;500;12147314;449101;318;9991519;182;2155795;24295;22688
03073;Chemilly;339;8236053;344882;206;6716836;133;1519217;24295;22689
03170;Meillers;75;1822140;63872;44;1443313;31;378827;24295;22690
29199;Plouigneau;2528;61418694;2429729;1502;50002751;1026;11415943;24295;22691
37170;Neuvy-le-Roi;580;14091871;609662;324;11176068;256;2915803;24296;22692
64460;Précilhon;198;4810730;179822;129;4084714;69;726016;24297;22693
38266;La Motte-Saint-Martin;233;5661176;181898;144;4572129;89;1089047;24297;22694
51659;Wargemoulin-Hurlus;26;631724;32214;14;463625;12;168099;24297;22695
21001;Agencourt;219;5321062;235053;141;4600770;78;720292;24297;22696
17230;Meschers-sur-Gironde;1970;47865703;2543678;1137;38780800;833;9084903;24297;22697
62310;Essars;858;20847138;923637;498;16581937;360;4265201;24297;22698
57598;Rouhling;1126;27359534;974909;597;20979715;529;6379819;24298;22699
11120;La Digne-d'Aval;264;6414722;283799;155;5275717;109;1139005;24298;22700
41291;Villetrun;164;3985009;108226;100;3137725;64;847284;24299;22701
55080;Brixey-aux-Chanoines;54;1312154;79116;23;944222;31;367932;24299;22702
51349;Margerie-Hancourt;114;2770110;75070;64;2185975;50;584135;24299;22703
70449;Roche-sur-Linotte-et-Sorans-les-Cordiers;41;996340;76168;20;794695;21;201645;24301;22704
28047;Boisville-la-Saint-Père;375;9113215;345398;235;7401410;140;1711805;24302;22705
57384;Laning;291;7071879;291475;180;5759094;111;1312785;24302;22706
44178;Saint-Mars-de-Coutais;1277;31033909;1218991;707;24364496;570;6669413;24302;22707
54464;Rouves;49;1190875;35657;31;959632;18;231243;24304;22708
09140;Ignaux;44;1069380;37561;25;886306;19;183074;24304;22709
85025;La Boissière-de-Montaigu;1111;27003227;1218069;651;21405587;460;5597640;24305;22710
61266;Le Ménil-Guyon;54;1312528;75229;28;1020365;26;292163;24306;22711
39010;Andelot-Morval;43;1045171;32439;20;731731;23;313440;24306;22712
21467;Oisilly;62;1507000;71040;40;1258468;22;248532;24306;22713
69138;Montromant;206;5007188;165644;129;4092913;77;914275;24307;22714
25541;Septfontaines;155;3767630;106560;85;2805027;70;962603;24307;22715
52426;Rizaucourt-Buchey;73;1774487;123101;41;1466409;32;308078;24308;22716
02589;Pargny-Filain;138;3354774;139226;79;2685307;59;669467;24310;22717
16287;Roullet-Saint-Estèphe;2147;52194785;2148848;1325;42802077;822;9392708;24311;22718
67160;Goersdorf;568;13808417;586983;331;10835927;237;2972490;24311;22719
30324;Souvignargues;421;10235065;427765;225;7813584;196;2421481;24311;22720
55302;Longeville-en-Barrois;651;15826692;674204;433;13325472;218;2501220;24311;22721
67507;Villé;1056;25672968;1518347;583;20444427;473;5228541;24312;22722
88308;Mont-lès-Neufchâteau;165;4011456;187545;110;3461290;55;550166;24312;22723
27454;Perruel;237;5762010;196133;154;4866623;83;895387;24312;22724
54043;Bainville-sur-Madon;684;16630330;736047;399;13630675;285;2999655;24313;22725
16019;Asnières-sur-Nouère;660;16046887;702225;410;13323050;250;2723837;24313;22726
27115;Breux-sur-Avre;187;4546648;222414;106;3743889;81;802759;24314;22727
31073;Bondigoux;253;6151434;232178;156;5155274;97;996160;24314;22728
64393;Monein;2451;59595232;2519266;1440;48494430;1011;11100802;24315;22729
59062;Beaurieux;93;2261280;137167;56;1900660;37;360620;24315;22730
87078;Javerdat;364;8850789;528061;186;6942533;178;1908256;24315;22731
52246;Humes-Jorquenay;312;7586637;342151;189;6080355;123;1506282;24316;22732
59165;Cuincy;3525;85714678;3947253;2078;69860804;1447;15853874;24316;22733
60084;Bonnières;102;2480378;104854;63;2103088;39;377290;24317;22734
24126;Colombier;139;3380130;185944;79;2755510;60;624620;24317;22735
33431;Saint-Léon;174;4231247;170535;98;3395242;76;836005;24318;22736
31435;Poucharramet;453;11016171;526133;255;9039895;198;1976276;24318;22737
53194;Ruillé-le-Gravelais;416;10116793;210885;269;8244401;147;1872392;24319;22738
27587;Saint-Philbert-sur-Risle;409;9947011;432808;229;7881376;180;2065635;24320;22739
27206;Droisy;219;5326327;260048;131;4424849;88;901478;24321;22740
27377;Lyons-la-Forêt;479;11649870;876323;247;9314805;232;2335065;24321;22741
25305;L'Hôpital-du-Grosbois;271;6591119;200996;160;5186199;111;1404920;24321;22742
89411;Theil-sur-Vanne;260;6323613;243199;177;5392045;83;931568;24322;22743
54441;Puxieux;117;2845661;57829;74;2272054;43;573607;24322;22744
97408;La Possession;15565;378572682;15518756;6249;278051246;9316;100521436;24322;22745
84136;Vacqueyras;638;15518007;824126;368;12783344;270;2734663;24323;22746
37076;Cinais;245;5959321;259918;153;5016655;92;942666;24324;22747
76348;Hautot-Saint-Sulpice;331;8051391;324475;192;6603699;139;1447692;24324;22748
39504;Sarrogna;128;3113545;128226;71;2439314;57;674231;24325;22749
01016;Arbigny;206;5010879;167894;124;4013871;82;997008;24325;22750
25236;Fertans;119;2894722;80326;70;2263969;49;630753;24325;22751
73083;Les Chavannes-en-Maurienne;136;3308317;157797;97;2853146;39;455171;24326;22752
76173;La Chaussée;234;5692316;130284;147;4644763;87;1047553;24326;22753
28182;Gohory;172;4184139;203768;106;3500038;66;684101;24326;22754
84132;Le Thor;4581;111439941;5379649;2564;90491772;2017;20948169;24327;22755
35166;Marpiré;474;11530854;233302;305;9429640;169;2101214;24327;22756
41260;Thoury;226;5497945;267098;132;4276273;94;1221672;24327;22757
61306;Neuville-près-Sées;56;1362323;44818;28;1040338;28;321985;24327;22758
17086;Chaniers;1987;48338390;2276535;1166;39193651;821;9144739;24327;22759
33527;Le Teich;3862;93952919;3996952;2331;76747338;1531;17205581;24328;22760
16013;Angeac-Charente;209;5084471;278469;123;4023651;86;1060820;24328;22761
01355;Saint-Genis-sur-Menthon;247;6008944;237333;154;4943681;93;1065263;24328;22762
57322;Hestroff;228;5546732;180160;123;4360129;105;1186603;24328;22763
85151;Mortagne-sur-Sèvre;3140;76389401;2810969;1849;61442976;1291;14946425;24328;22764
89075;Champlay;421;10242153;527157;259;8345352;162;1896801;24328;22765
89235;Magny;498;12116075;537784;308;10032948;190;2083127;24329;22766
25230;Exincourt;1837;44693909;2053935;1123;36166582;714;8527327;24330;22767
57293;Han-sur-Nied;123;2992602;99863;75;2377714;48;614888;24330;22768
02651;Rogécourt;54;1313852;58972;30;1026447;24;287405;24331;22769
52484;Suzannecourt;198;4817617;156797;110;3897872;88;919745;24331;22770
47223;Rives;131;3187430;171638;60;2448222;71;739208;24332;22771
43084;Cussac-sur-Loire;881;21437316;790508;567;18039757;314;3397559;24333;22772
59497;Renescure;1084;26377307;1095868;661;21626713;423;4750594;24333;22773
82067;Gensac;61;1484342;77429;37;1220356;24;263986;24333;22774
35052;Champeaux;244;5937419;150516;163;4963257;81;974162;24334;22775
28190;Guillonville;244;5937502;294758;154;4757944;90;1179558;24334;22776
80480;Lignières-en-Vimeu;45;1095038;31190;29;921068;16;173970;24334;22777
31022;Aucamville;4657;113324339;5599662;3024;96144373;1633;17179966;24334;22778
88343;Parey-sous-Montfort;87;2117076;88790;51;1691862;36;425214;24334;22779
86294;Vouillé;1846;44921117;1819372;1100;36516788;746;8404329;24334;22780
89203;Island;104;2530803;76792;63;2037965;41;492838;24335;22781
84143;Venasque;699;17010002;1048169;357;13599233;342;3410769;24335;22782
08039;Avaux;242;5889569;268451;138;4661612;104;1227957;24337;22783
49277;Sainte-Gemmes-d'Andigné;754;18350341;755228;411;14132069;343;4218272;24337;22784
63209;Mareugheol;104;2531094;106935;72;2156733;32;374361;24337;22785
35096;Domagné;1140;27744690;958689;706;22257943;434;5486747;24337;22786
54351;Marbache;893;21733510;948652;567;18124220;326;3609290;24338;22787
14476;Olendon;90;2190413;78423;49;1731235;41;459178;24338;22788
51315;Landricourt;79;1922712;58562;51;1641656;28;281056;24338;22789
13092;Saint-Chamas;4521;110034626;5591520;2736;91897166;1785;18137460;24339;22790
27152;Château-sur-Epte;311;7569706;342220;188;6231106;123;1338600;24340;22791
59457;Pérenchies;4237;103129369;4272693;2557;83719920;1680;19409449;24340;22792
40155;Linxe;725;17646636;796359;405;13741664;320;3904972;24340;22793
50391;Parigny;1031;25095020;1008376;589;20156973;442;4938047;24340;22794
73294;La Thuile;160;3894667;139956;92;3092522;68;802145;24342;22795
72173;Luceau;637;15505643;672614;385;12597666;252;2907977;24342;22796
63445;Vassel;133;3237464;119787;79;2625834;54;611630;24342;22797
13053;Mallemort;3401;82786670;4215787;1856;66067753;1545;16718917;24342;22798
57128;Charleville-sous-Bois;134;3261825;108244;84;2683240;50;578585;24342;22799
21485;Plombières-lès-Dijon;1496;36416456;1595422;953;30271696;543;6144760;24343;22800
45082;Châteauneuf-sur-Loire;4546;110662779;5315985;2672;90881464;1874;19781315;24343;22801
02685;Saint-Nicolas-aux-Bois;57;1387592;46637;32;1046043;25;341549;24344;22802
57252;Gomelange;251;6110309;228525;140;4650152;111;1460157;24344;22803
47248;Saint-Jean-de-Thurac;274;6670295;295892;156;5388687;118;1281608;24344;22804
07002;Ailhon;276;6719028;400266;155;5508852;121;1210176;24344;22805
77423;Saint-Martin-des-Champs;371;9032008;366770;233;7454912;138;1577096;24345;22806
54453;Rembercourt-sur-Mad;99;2410248;94265;53;1833363;46;576885;24346;22807
31380;Montgeard;232;5648422;298358;129;4672664;103;975758;24347;22808
62402;Halinghen;162;3944199;180507;94;3171525;68;772674;24347;22809
55232;Harville;68;1655591;99172;37;1265550;31;390041;24347;22810
70319;Magny-Jobert;45;1095613;16793;26;863166;19;232447;24347;22811
86235;Saint-Maurice-la-Clouère;658;16020431;811711;345;12702951;313;3317480;24347;22812
71503;Saules;72;1753054;90970;42;1453468;30;299586;24348;22813
50425;Rauville-la-Bigot;536;13050627;373441;321;10324630;215;2725997;24348;22814
55468;Samogneux;40;973955;39086;25;777588;15;196367;24349;22815
02091;Blanzy-lès-Fismes;52;1266154;62044;30;1018221;22;247933;24349;22816
22259;Quévert;2014;49041608;1799696;1195;39712393;819;9329215;24350;22817
46289;Saint-Pierre-Toirac;70;1704548;56260;35;1301601;35;402947;24351;22818
67022;Bassemberg;142;3457809;177459;86;2785206;56;672603;24351;22819
25601;Vercel-Villedieu-le-Camp;756;18409352;858092;419;14551668;337;3857684;24351;22820
71267;Lugny;511;12443564;593786;307;10439294;204;2004270;24351;22821
46281;Saint-Médard-de-Presque;110;2678789;110449;71;2279570;39;399219;24353;22822
82039;Cayrac;262;6380393;284637;152;5169086;110;1211307;24353;22823
22389;Yffiniac;2613;63635202;2419206;1664;52685522;949;10949680;24353;22824
80664;Rancourt;98;2386642;94109;58;1914255;40;472387;24353;22825
31185;Folcarde;64;1558633;66663;39;1288078;25;270555;24354;22826
59305;Herzeele;776;18898428;717028;442;15121579;334;3776849;24354;22827
35301;Saint-M'Hervon;216;5260469;111949;138;4291845;78;968624;24354;22828
70402;Oyrières;214;5211774;233255;126;4204404;88;1007370;24354;22829
61046;Bizou;82;1997059;92493;45;1724395;37;272664;24354;22830
02636;Regny;122;2971283;153560;67;2381389;55;589894;24355;22831
65380;Sabalos;69;1680547;47190;47;1437647;22;242900;24356;22832
22372;Trémuson;1002;24404664;791681;620;19820865;382;4583799;24356;22833
54585;Virecourt;257;6259492;256193;157;5013907;100;1245585;24356;22834
70505;Le Tremblois;89;2167760;68956;58;1802409;31;365351;24357;22835
31261;Lafitte-Vigordane;504;12275878;398084;287;9730138;217;2545740;24357;22836
25228;Étupes;1992;48518971;2311122;1194;39903904;798;8615067;24357;22837
27270;Fresne-l'Archevêque;273;6649644;274372;169;5452565;104;1197079;24358;22838
40061;Campagne;529;12885318;523436;304;10280488;225;2604830;24358;22839
51498;Saint-Mard-sur-Auve;34;828179;57142;21;670889;13;157290;24358;22840
67521;Weinbourg;253;6162644;281385;146;4898006;107;1264638;24358;22841
51094;Brusson;90;2192338;40012;57;1816620;33;375718;24359;22842
83124;Seillans;1458;35515883;2015387;752;27625250;706;7890633;24359;22843
71095;La Chapelle-sous-Dun;228;5553970;229713;125;4219281;103;1334689;24360;22844
16098;La Chèvrerie;83;2021844;104267;36;1524587;47;497257;24360;22845
05151;Saint-Martin-de-Queyrières;616;15005881;574082;386;12299811;230;2706070;24360;22846
83059;Forcalqueiret;1358;33082252;1373256;767;26483901;591;6598351;24361;22847
45279;Saint-Germain-des-Prés;1012;24653893;1130597;652;20619999;360;4033894;24362;22848
25239;Feule;87;2119482;76136;50;1670232;37;449250;24362;22849
28211;Logron;320;7796034;337190;211;6569868;109;1226166;24363;22850
51598;Vauclerc;286;6967902;307789;184;5734076;102;1233826;24363;22851
19176;Rosiers-d'Égletons;594;14471946;594883;389;12057631;205;2414315;24364;22852
55404;Pierrefitte-sur-Aire;141;3435322;160405;74;2695140;67;740182;24364;22853
25059;Beutal;132;3216103;119873;87;2699683;45;516420;24364;22854
64144;Boumourt;72;1754286;69541;35;1357730;37;396556;24365;22855
83069;Hyères;35027;853453936;54510114;20059;702430580;14968;151023356;24366;22856
50579;Sottevast;638;15545533;402329;396;12548530;242;2997003;24366;22857
76283;Fresles;120;2923935;196681;73;2433010;47;490925;24366;22858
40255;Saint-Cricq-Villeneuve;232;5653150;187600;137;4595388;95;1057762;24367;22859
61129;Courgeon;193;4703159;148903;113;3803274;80;899885;24369;22860
21259;Fain-lès-Montbard;170;4142737;166992;106;3397564;64;745173;24369;22861
30354;Montagnac;107;2607503;98211;69;2243512;38;363991;24369;22862
57644;Seingbouse;996;24271786;916639;598;19359906;398;4911880;24369;22863
64444;Pardies-Piétat;217;5288358;229343;112;4165021;105;1123337;24370;22864
38547;Villard-Bonnot;3986;97140522;3959113;2598;81493460;1388;15647062;24370;22865
73275;Saint-Pierre-de-Genebroz;178;4337946;149833;109;3401700;69;936246;24370;22866
60263;Frétoy-le-Château;124;3022002;141680;71;2402407;53;619595;24371;22867
02395;Jumencourt;72;1754753;82634;42;1427719;30;327034;24372;22868
45247;Pannes;1890;46065566;1885504;1194;37719884;696;8345682;24373;22869
64017;Alos-Sibas-Abense;155;3777897;122973;81;2873607;74;904290;24374;22870
38139;Creys-Mépieu;742;18085237;688210;457;14689774;285;3395463;24374;22871
72072;Château-l'Hermitage;116;2827390;63028;72;2310501;44;516889;24374;22872
55182;Éton;96;2339918;106508;54;1737792;42;602126;24374;22873
67004;Allenwiller;275;6703137;208264;173;5387224;102;1315913;24375;22874
11437;Villesèquelande;406;9896273;229856;221;7616740;185;2279533;24375;22875
68171;Kruth;512;12480146;453644;330;10345698;182;2134448;24375;22876
89061;Butteaux;155;3778248;157789;94;3088343;61;689905;24376;22877
32254;Miramont-d'Astarac;203;4948352;214011;103;3968624;100;979728;24376;22878
64526;Soumoulou;788;19208566;758570;453;15546056;335;3662510;24376;22879
89112;Collan;112;2730165;160387;67;2229147;45;501018;24376;22880
26258;Puy-Saint-Martin;460;11213353;517839;266;9003058;194;2210295;24377;22881
25377;Mésandans;112;2730216;98413;68;2143959;44;586257;24377;22882
71085;Change;123;2998397;156913;68;2405853;55;592544;24377;22883
39232;Fort-du-Plasne;231;5631162;228115;156;4801098;75;830064;24377;22884
43265;Les Villettes;587;14309816;381670;363;11370018;224;2939798;24378;22885
14734;Vendes;163;3973648;129600;99;3204779;64;768869;24378;22886
67029;Berg;228;5558414;220217;136;4275412;92;1283002;24379;22887
64386;Mirepeix;667;16261265;574177;394;12994992;273;3266273;24380;22888
55470;Saudrupt;118;2876834;156272;69;2351574;49;525260;24380;22889
39183;Crotenay;334;8142920;223836;199;6582081;135;1560839;24380;22890
50407;Poilley;426;10385912;288441;257;8436551;169;1949361;24380;22891
05177;Vars;402;9800903;596660;253;8210300;149;1590603;24380;22892
29273;Santec;1294;31548296;1382416;713;25216806;581;6331490;24380;22893
27126;Campigny;540;13166518;475382;328;10736252;212;2430266;24382;22894
57529;Ottange;1260;30724624;307374;322;10919303;938;19805321;24385;22895
54334;Mairy-Mainville;260;6340182;199606;125;4126656;135;2213526;24385;22896
85222;Saint-Gilles-Croix-de-Vie;5018;122368181;6000423;2900;97084053;2118;25284128;24386;22897
13074;Peyrolles-en-Provence;2474;60331342;2502424;1436;48759218;1038;11572124;24386;22898
33007;Arbanats;584;14241915;652952;367;11771004;217;2470911;24387;22899
14527;Biéville-Quétiéville;192;4682316;250808;107;3713819;85;968497;24387;22900
26174;Margès;505;12315605;461998;293;9850654;212;2464951;24387;22901
10109;Courtenot;130;3170428;138801;81;2637149;49;533279;24388;22902
46007;Arcambal;533;12998990;514950;328;10546823;205;2452167;24388;22903
02015;Ancienville;40;975538;57403;26;840431;14;135107;24388;22904
81068;Combefa;83;2024264;67141;52;1681125;31;343139;24389;22905
25017;Amondans;45;1097498;11844;28;916032;17;181466;24389;22906
88463;Taintrux;847;20657362;770818;520;16635071;327;4022291;24389;22907
73008;Aix-les-Bains;18261;445389093;26152478;10566;363775554;7695;81613539;24390;22908
54083;Bonviller;99;2414649;97096;60;1977929;39;436720;24390;22909
65056;Ayzac-Ost;253;6170840;323332;134;4635342;119;1535498;24391;22910
29010;Bodilis;666;16244255;531376;404;13041811;262;3202444;24391;22911
72306;Saint-Ouen-en-Belin;614;14976191;457162;373;11894050;241;3082141;24391;22912
14559;Saint-Aubin-des-Bois;133;3244045;223429;51;2467294;82;776751;24391;22913
27606;Saint-Symphorien;232;5658826;245947;142;4688122;90;970704;24391;22914
67094;Dieffenthal;139;3390433;118295;88;2868837;51;521596;24392;22915
39344;Monnet-la-Ville;183;4463672;187868;108;3493093;75;970579;24392;22916
41221;Saint-Léonard-en-Beauce;358;8732365;419633;201;6914253;157;1818112;24392;22917
32200;Lasséran;186;4536974;124576;121;3815257;65;721717;24392;22918
71490;Saint-Vincent-Bragny;490;11952271;408921;287;9539464;203;2412807;24392;22919
44186;Sainte-Pazanne;2744;66933113;1921074;1597;52813688;1147;14119425;24393;22920
73316;Villard-Sallet;148;3610222;129835;96;2955101;52;655121;24393;22921
57700;Vaudreching;281;6854546;290490;154;5095010;127;1759536;24393;22922
73170;Monthion;264;6439921;209757;168;5284612;96;1155309;24394;22923
54156;Diarville;254;6196128;285417;143;4948384;111;1247744;24394;22924
60590;Saint-Omer-en-Chaussée;581;14173441;745891;378;12049687;203;2123754;24395;22925
03258;Saint-Rémy-en-Rollat;922;22492351;964585;579;18878545;343;3613806;24395;22926
80166;Canaples;340;8294393;322319;179;6667527;161;1626866;24395;22927
57380;Laneuveville-lès-Lorquin;53;1292959;56034;37;1086665;16;206294;24395;22928
29099;Lampaul-Ploudalmézeau;393;9587475;278898;226;7544164;167;2043311;24396;22929
45042;Les Bordes;1016;24787099;1185434;629;20887644;387;3899455;24397;22930
14475;Noyers-Bocage;550;13418321;451743;340;10897644;210;2520677;24397;22931
89054;Brannay;425;10368725;515466;276;8763975;149;1604750;24397;22932
01337;Saint-Bénigne;612;14931850;537694;362;12110813;250;2821037;24398;22933
25194;Dannemarie;57;1390713;65848;39;1183424;18;207289;24398;22934
27209;Écaquelon;301;7344052;330707;196;6199439;105;1144613;24399;22935
70205;Échavanne;124;3025473;146338;78;2478318;46;547155;24399;22936
41231;Saint-Viâtre;713;17397469;838031;428;13953408;285;3444061;24400;22937
88326;Neuvillers-sur-Fave;182;4441051;207628;92;3538160;90;902891;24401;22938
60654;Vandélicourt;142;3465003;112533;94;2980004;48;484999;24401;22939
57684;Vahl-Ebersing;268;6539595;277996;158;5076298;110;1463297;24401;22940
17007;Anais;160;3904245;103982;95;3082806;65;821439;24402;22941
43263;Vielprat;40;976138;112837;16;774328;24;201810;24403;22942
71248;Lacrost;398;9712653;456617;246;8051038;152;1661615;24404;22943
50498;Saint-Joseph;397;9688262;280336;236;7638888;161;2049374;24404;22944
54161;Domèvre-sur-Vezouze;147;3587524;210551;78;2841499;69;746025;24405;22945
58051;Challuy;764;18645399;881643;497;15617088;267;3028311;24405;22946
62229;Cléty;325;7931759;248396;197;6386886;128;1544873;24405;22947
88137;Dolaincourt;45;1098279;54072;25;862035;20;236244;24406;22948
79279;Saint-Martin-lès-Melle;483;11788377;596444;267;9210946;216;2577431;24407;22949
21549;Saint-Germain-le-Rocheux;54;1317991;51280;31;1069167;23;248824;24407;22950
08431;Sugny;52;1269188;36862;30;999435;22;269753;24407;22951
22349;Trédrez-Locquémeau;824;20112216;898247;479;16099786;345;4012430;24408;22952
39165;Conte;36;878692;52999;21;757840;15;120852;24408;22953
71427;Saint-Huruge;31;756652;28486;18;595301;13;161351;24408;22954
62855;Villers-au-Flos;117;2855964;123543;65;2246312;52;609652;24410;22955
93073;Tremblay-en-France;17886;436613602;22458041;10837;362682850;7049;73930752;24411;22956
86290;La Villedieu-du-Clain;782;19090791;591979;501;15674534;281;3416257;24413;22957
45084;Châtenoy;266;6494096;333608;162;5304305;104;1189791;24414;22958
26273;Rochefort-Samson;504;12304749;448260;309;9979796;195;2324953;24414;22959
71398;Saint-Christophe-en-Bresse;532;12988471;453936;339;10661242;193;2327229;24414;22960
41089;La Fontenelle;102;2490289;138029;56;1963362;46;526927;24415;22961
41084;La Ferté-Imbault;596;14551394;767851;335;11665120;261;2886274;24415;22962
53045;La Brûlatte;347;8472107;249813;221;6892628;126;1579479;24415;22963
60465;Noirémont;90;2197400;86142;56;1786679;34;410721;24416;22964
08100;Champlin;41;1001049;33736;21;738469;20;262580;24416;22965
39150;Choisey;585;14283479;642681;387;12025389;198;2258090;24416;22966
25209;Échay;54;1318555;49756;29;1055292;25;263263;24418;22967
52248;Is-en-Bassigny;318;7764869;306918;178;6275420;140;1489449;24418;22968
10156;Fontvannes;312;7618689;257624;199;6279939;113;1338750;24419;22969
84114;Saint-Pantaléon;114;2783862;108344;63;2308084;51;475778;24420;22970
49192;Maulévrier;1602;39122313;1416498;922;30906657;680;8215656;24421;22971
25314;Indevillers;127;3101489;139274;73;2594391;54;507098;24421;22972
02321;Fontaine-lès-Vervins;462;11282606;429812;255;8947816;207;2334790;24421;22973
89066;Cerisiers;532;12992107;785798;290;10356817;242;2635290;24421;22974
04245;Volx;1732;42298061;1814746;1015;33869993;717;8428068;24422;22975
57344;Imling;384;9378157;462541;239;7928369;145;1449788;24422;22976
38257;Montrevel;229;5592786;201496;137;4397379;92;1195407;24423;22977
33055;Blaignan;140;3419177;215751;78;2782350;62;636827;24423;22978
41039;La Chapelle-Saint-Martin-en-Plaine;367;8963327;331582;234;7401905;133;1561422;24423;22979
53241;Saint-Michel-de-Feins;81;1978315;76031;41;1465343;40;512972;24424;22980
26225;Parnans;340;8304411;340475;176;6267115;164;2037296;24425;22981
21577;Saint-Usage;639;15607886;729884;363;12212098;276;3395788;24425;22982
95612;Le Thillay;2234;54567531;2780771;1408;46158195;826;8409336;24426;22983
73022;Attignat-Oncin;294;7181417;288646;187;5935056;107;1246361;24427;22984
45060;La Bussière;453;11065405;559712;266;9137881;187;1927524;24427;22985
39402;Pagney;194;4739099;150202;105;3772766;89;966333;24428;22986
59181;Dourlers;308;7524090;378857;168;6120161;140;1403929;24429;22987
16402;Vibrac;183;4470516;280444;105;3702614;78;767902;24429;22988
91021;Arpajon;6437;157251302;9671709;4052;133145776;2385;24105526;24429;22989
52500;Valcourt;365;8916773;398911;246;7680985;119;1235788;24430;22990
76284;Fresnay-le-Long;135;3297999;99751;84;2648905;51;649094;24430;22991
01094;Chavannes-sur-Reyssouze;397;9698739;339239;234;7903489;163;1795250;24430;22992
27183;La Couture-Boussey;1222;29853906;1228092;730;23961927;492;5891979;24430;22993
58056;Champvoux;155;3786746;164329;92;3072924;63;713822;24431;22994
49194;Mazé;2455;59977396;1767977;1469;47998545;986;11978851;24431;22995
77289;Melz-sur-Seine;192;4690765;152859;124;4024645;68;666120;24431;22996
57189;Eincheville;115;2809587;131422;60;2168597;55;640990;24431;22997
80371;Froyelles;49;1197132;36725;25;927645;24;269487;24431;22998
01145;Dompierre-sur-Veyle;593;14487878;545851;348;11554858;245;2933020;24431;22999
08075;Boult-aux-Bois;88;2150130;90660;46;1762261;42;387869;24433;23000
19242;Saint-Solve;225;5497654;235185;134;4467496;91;1030158;24434;23001
10246;Montceaux-lès-Vaudes;136;3323030;155645;83;2735810;53;587220;24434;23002
33080;Cadaujac;2989;73034937;3246530;1942;61219583;1047;11815354;24435;23003
63432;Thuret;438;10702555;469331;255;8530403;183;2172152;24435;23004
31583;Villematier;565;13805901;605268;335;11342026;230;2463875;24435;23005
39490;Saint-Loup;143;3494303;117547;90;2902304;53;591999;24436;23006
42149;Montrond-les-Bains;2735;66834645;3080395;1630;53560830;1105;13273815;24437;23007
37004;Anché;232;5669532;326220;133;4611281;99;1058251;24438;23008
05025;Buissard;96;2346054;80448;50;1815375;46;530679;24438;23009
08124;Clavy-Warby;201;4912078;168964;129;4135436;72;776642;24438;23010
50493;Saint-Jean-des-Champs;692;16911345;487333;395;13375894;297;3535451;24438;23011
64068;Asson;1038;25367407;1250077;584;20729522;454;4637885;24439;23012
01037;Bénonces;141;3445881;139182;77;2767233;64;678648;24439;23013
33550;Villenave-d'Ornon;16614;406028098;19361164;10509;341390624;6105;64637474;24439;23014
30298;Saint-Sébastien-d'Aigrefeuille;258;6305276;330509;157;5355675;101;949601;24439;23015
02749;Troësnes;107;2614988;70539;67;2115738;40;499250;24439;23016
70384;Neuvelle-lès-la-Charité;125;3054938;133492;78;2468781;47;586157;24440;23017
27204;Doudeauville-en-Vexin;150;3665936;153771;98;2962957;52;702979;24440;23018
35144;Langan;458;11193661;414322;278;9134383;180;2059278;24440;23019
50369;Négreville;382;9336238;244640;221;7375783;161;1960455;24440;23020
55464;Saint-Pierrevillers;92;2248561;63288;42;1595853;50;652708;24441;23021
53085;Crennes-sur-Fraubée;99;2419652;79093;58;1943172;41;476480;24441;23022
14397;Mandeville-en-Bessin;178;4350498;165488;101;3443722;77;906776;24441;23023
24153;La Dornac;220;5377065;243850;131;4492875;89;884190;24441;23024
11014;Armissan;829;20261778;1052014;472;16626284;357;3635494;24441;23025
40175;Maurrin;236;5768138;199749;139;4423398;97;1344740;24441;23026
06021;Bonson;403;9850153;412136;239;8036162;164;1813991;24442;23027
80047;Aveluy;283;6917280;312221;162;5616194;121;1301086;24443;23028
90071;Montreux-Château;598;14617193;690054;367;11852354;231;2764839;24443;23029
37096;Dierre;298;7284435;306102;182;5969227;116;1315208;24444;23030
90008;Bavilliers;2600;63556439;3554130;1457;51317726;1143;12238713;24445;23031
27601;Saint-Samson-de-la-Roque;214;5231273;196776;129;4306351;85;924922;24445;23032
11355;Saint-Martin-de-Villereglan;169;4131509;203127;85;3271353;84;860156;24447;23033
59506;Romeries;203;4962843;190370;120;4169670;83;793173;24448;23034
06126;Saint-Martin-du-Var;1378;33688837;1582191;825;27203353;553;6485484;24448;23035
41080;Faverolles-sur-Cher;739;18067105;838187;446;14609647;293;3457458;24448;23036
85044;Chaix;247;6038803;264411;145;4808784;102;1230019;24449;23037
33096;Carbon-Blanc;3955;96695106;4457821;2484;80164483;1471;16530623;24449;23038
51334;Luxémont-et-Villotte;238;5818982;244932;150;4905233;88;913749;24450;23039
95088;Bonneuil-en-France;386;9437997;527060;238;7969969;148;1468028;24451;23040
62721;Roquetoire;946;23130428;785135;547;18352054;399;4778374;24451;23041
60344;Lalandelle;246;6015008;276333;155;5001903;91;1013105;24451;23042
68142;Hohrod;177;4327902;264874;111;3590260;66;737642;24451;23043
2B037;Biguglia;4117;100669065;5598951;2412;82983455;1705;17685610;24452;23044
41086;Fontaines-en-Sologne;333;8142644;399692;195;6692642;138;1450002;24452;23045
54145;Crévic;495;12103945;479860;302;9795959;193;2307986;24452;23046
81202;Parisot;497;12152850;584886;281;9620214;216;2532636;24452;23047
07126;Lagorce;571;13962356;711307;293;10991270;278;2971086;24452;23048
21307;Grésigny-Sainte-Reine;79;1931763;59906;49;1639001;30;292762;24453;23049
45328;Treilles-en-Gâtinais;160;3912452;169328;97;3245164;63;667288;24453;23050
80056;Bavelincourt;57;1393870;39306;33;1077386;24;316484;24454;23051
39078;Brevans;366;8950432;409112;226;7339822;140;1610610;24455;23052
73045;Le Bois;229;5600258;256617;152;4679739;77;920519;24455;23053
68315;Soultz-Haut-Rhin;3827;93592024;4352256;2227;76063241;1600;17528783;24456;23054
57728;Voimhaut;112;2739056;89990;67;2071193;45;667863;24456;23055
51639;La Ville-sous-Orbais;28;684772;38361;13;527159;15;157613;24456;23056
01376;Saint-Maurice-de-Beynost;2023;49475368;2203486;1215;40316369;808;9158999;24456;23057
50546;Saint-Samson-de-Bonfossé;463;11323556;377940;291;9255844;172;2067712;24457;23058
31006;Albiac;97;2372562;96594;58;1941317;39;431245;24459;23059
21128;Chailly-sur-Armançon;141;3448875;231137;74;2497289;67;951586;24460;23060
14467;Noron-l'Abbaye;147;3595678;151221;81;2788374;66;807304;24460;23061
72151;Juigné-sur-Sarthe;611;14945427;499487;377;12165767;234;2779660;24461;23062
08308;Mont-Saint-Martin;48;1174194;70205;26;962478;22;211716;24462;23063
27645;Tocqueville;68;1663451;65556;41;1366159;27;297292;24463;23064
51043;Bazancourt;1013;24780815;854468;643;20303913;370;4476902;24463;23065
17008;Andilly;1030;25196805;1034711;645;20513527;385;4683278;24463;23066
61172;Fontenai-les-Louvets;138;3375895;115381;83;2744130;55;631765;24463;23067
17326;Saint-Eugène;168;4109917;125549;79;3221239;89;888678;24464;23068
69062;Coise;362;8855949;379311;211;6979179;151;1876770;24464;23069
61471;Sérigny;229;5602312;324910;134;4408368;95;1193944;24464;23070
51206;Dampierre-le-Château;55;1345575;58703;32;1004479;23;341096;24465;23071
19202;Sainte-Féréole;992;24269779;1069980;598;19774182;394;4495597;24466;23072
77514;Villeparisis;13629;333442364;17374206;9012;285979770;4617;47462594;24466;23073
01039;Béon;235;5749459;249989;138;4511474;97;1237985;24466;23074
68185;Lièpvre;977;23903628;1242237;575;18971212;402;4932416;24466;23075
54088;Bouvron;120;2935970;97417;64;2335630;56;600340;24466;23076
10215;Magny-Fouchard;145;3547667;185885;82;2803625;63;744042;24467;23077
12020;Balsac;313;7658112;258952;211;6583534;102;1074578;24467;23078
89327;Rousson;230;5627554;299278;157;4857838;73;769716;24468;23079
02157;Chambry;411;10056763;506011;267;8822112;144;1234651;24469;23080
95500;Pontoise;16904;413631457;26951934;10104;348501702;6800;65129755;24469;23081
40081;Cère;213;5212024;187835;135;4312097;78;899927;24470;23082
68213;Mollau;220;5383360;204273;141;4381874;79;1001486;24470;23083
81038;Brens;1134;27749525;1351729;637;22254856;497;5494669;24470;23084
62088;Bayenghem-lès-Seninghem;166;4062141;145727;97;3157259;69;904882;24471;23085
35288;Saint-Malo;28912;707498193;43182101;15402;566810567;13510;140687626;24471;23086
10012;Arsonval;173;4233526;135841;105;3487005;68;746521;24471;23087
89486;Yrouerre;100;2447146;121908;60;2041773;40;405373;24471;23088
43046;Chadrac;1453;35557974;1789825;863;29045914;590;6512060;24472;23089
76697;Torcy-le-Grand;402;9837985;388039;248;8137298;154;1700687;24473;23090
80033;Assevillers;149;3646496;135324;67;2675600;82;970896;24473;23091
70494;Sornay;162;3964787;92288;94;3066984;68;897803;24474;23092
25278;Gonsans;257;6289901;255500;163;5215890;94;1074011;24474;23093
40035;Bénesse-lès-Dax;281;6877316;298633;179;5733833;102;1143483;24474;23094
40021;Azur;394;9643285;637060;223;7804080;171;1839205;24475;23095
71449;Saint-Martin-d'Auxy;43;1052457;28709;22;789588;21;262869;24476;23096
38082;Charavines;1002;24525132;980525;615;19865913;387;4659219;24476;23097
25164;Corcondray;72;1762313;64395;48;1519385;24;242928;24477;23098
14040;Barbeville;102;2496722;96689;66;2134978;36;361744;24478;23099
26008;Ancône;707;17305788;647275;420;14049588;287;3256200;24478;23100
76690;Thil-Manneville;282;6903038;313605;179;5771757;103;1131281;24479;23101
61434;Saint-Nicolas-des-Laitiers;45;1101572;30674;25;893440;20;208132;24479;23102
50257;Jobourg;235;5752662;208197;136;4696969;99;1055693;24479;23103
95424;Montigny-lès-Cormeilles;10172;249015875;13519626;6020;208574458;4152;40441417;24481;23104
30259;Saint-Hilaire-de-Brethmas;2411;59023560;2691808;1263;47045325;1148;11978235;24481;23105
51214;Dommartin-Varimont;71;1738150;83054;39;1356540;32;381610;24481;23106
14394;Maizières;228;5581753;272943;125;4442526;103;1139227;24481;23107
61368;Saint-Aubin-des-Grois;33;807904;30197;19;628783;14;179121;24482;23108
14456;Moult;963;23577048;727970;577;18759072;386;4817976;24483;23109
21109;Brion-sur-Ource;140;3427616;106598;83;2860923;57;566693;24483;23110
71191;Essertenne;251;6145373;227896;162;5191373;89;954000;24484;23111
55510;Thonne-les-Près;75;1836274;90908;44;1460847;31;375427;24484;23112
32229;Mansempuy;39;954863;41311;22;783004;17;171859;24484;23113
41277;Villebout;73;1787344;70832;47;1534388;26;252956;24484;23114
28264;Montireau;72;1762938;70659;49;1451497;23;311441;24485;23115
27153;Chauvincourt-Provemont;170;4162522;167995;110;3468094;60;694428;24485;23116
57593;Roncourt;489;11973448;398898;274;9131086;215;2842362;24486;23117
45054;Briarres-sur-Essonne;318;7786633;371556;214;6691538;104;1095095;24486;23118
24437;Saint-Laurent-des-Vignes;464;11361700;407942;285;9401561;179;1960139;24486;23119
76389;Lintot-les-Bois;97;2375284;123908;60;1918145;37;457139;24487;23120
14571;Saint-Denis-de-Mailloc;156;3820144;148865;96;3046679;60;773465;24488;23121
04121;Mézel;380;9305534;497746;203;7307291;177;1998243;24488;23122
18198;Saint-Ambroix;222;5436434;319778;133;4430406;89;1006028;24488;23123
61194;Goulet;202;4946823;200184;130;4164788;72;782035;24489;23124
62496;Lefaux;116;2840823;114552;64;2153638;52;687185;24490;23125
65303;Mascaras;180;4408372;161646;105;3588176;75;820196;24491;23126
55128;Courcelles-sur-Aire;30;734729;57394;16;598739;14;135990;24491;23127
78029;Aubergenville;6336;155177087;7610948;4061;130149618;2275;25027469;24491;23128
33528;Le Temple;304;7445459;346477;178;6080625;126;1364834;24492;23129
80799;Villers-Bretonneux;2233;54690178;2190612;1345;45101146;888;9589032;24492;23130
42271;Saint-Paul-en-Jarez;2220;54372245;2211880;1192;43429523;1028;10942722;24492;23131
10423;La Villeneuve-au-Chêne;223;5461818;248876;135;4413714;88;1048104;24492;23132
27225;Les Essarts;213;5216911;240980;129;4394397;84;822514;24493;23133
21380;Marcigny-sous-Thil;30;734794;25726;17;554456;13;180338;24493;23134
01363;Saint-Jean-le-Vieux;882;21603088;817294;578;17835776;304;3767312;24493;23135
03267;Saulcet;358;8768684;374324;217;7243419;141;1525265;24494;23136
64362;Luxe-Sumberraute;174;4262021;82875;83;3389827;91;872194;24494;23137
30306;Salinelles;271;6638010;388491;142;5320752;129;1317258;24495;23138
60342;Laigneville;2245;54990845;2551318;1448;46386217;797;8604628;24495;23139
57251;Goin;162;3968241;139298;104;3249675;58;718566;24495;23140
46017;Bannes;71;1739178;97102;36;1315751;35;423427;24495;23141
68167;Kirchberg;432;10582254;436896;274;8825210;158;1757044;24496;23142
40300;Seyresse;439;10753733;508646;278;8973387;161;1780346;24496;23143
21495;Pont;59;1445268;76207;38;1221665;21;223603;24496;23144
10063;Brienne-la-Vieille;244;5977126;291269;143;4902482;101;1074644;24496;23145
81209;Pont-de-Larn;1596;39097576;1658573;879;30985374;717;8112202;24497;23146
62548;Marck;4815;117957382;4629131;2867;96533443;1948;21423939;24498;23147
59612;Vertain;266;6516479;282479;153;5392910;113;1123569;24498;23148
51502;Saint-Martin-aux-Champs;54;1322911;65752;35;1086950;19;235961;24498;23149
10279;Pars-lès-Chavanges;43;1053445;83010;23;865507;20;187938;24499;23150
88393;Rollainville;167;4091348;130737;104;3318805;63;772543;24499;23151
81090;Fénols;129;3160447;148703;67;2518780;62;641667;24500;23152
83144;La Valette-du-Var;12829;314305770;16337326;7712;257947462;5117;56358308;24500;23153
25154;Chouzelot;149;3650578;129889;88;2868575;61;782003;24501;23154
85109;Les Herbiers;8237;201811862;7675727;4892;164103409;3345;37708453;24501;23155
21399;Meilly-sur-Rouvres;106;2597151;131374;62;2204002;44;393149;24501;23156
63018;Aulhat-Saint-Privat;212;5194403;185889;120;4115915;92;1078488;24502;23157
39115;Château-des-Prés;99;2425746;118396;59;1979561;40;446185;24502;23158
27633;Les Thilliers-en-Vexin;259;6346171;335841;165;5279257;94;1066914;24503;23159
04123;Mison;568;13917631;692230;336;11602541;232;2315090;24503;23160
73068;Chamousset;305;7473578;266202;194;6122838;111;1350740;24504;23161
60437;Mouchy-le-Châtel;45;1102662;60800;30;914989;15;187673;24504;23162
70405;Pennesières;100;2450402;108119;62;1975102;38;475300;24504;23163
85148;Montreuil;422;10341064;440866;246;8154132;176;2186932;24505;23164
29207;Plourin-lès-Morlaix;2328;57047551;2531853;1410;47044362;918;10003189;24505;23165
81236;Saint-Agnan;116;2842588;106685;66;2309581;50;533007;24505;23166
02267;Dommiers;152;3724843;177236;76;2925620;76;799223;24506;23167
14745;Vierville-sur-Mer;152;3724907;169353;84;2969629;68;755278;24506;23168
14276;Fontaine-le-Pin;167;4092550;132964;96;3130774;71;961776;24506;23169
19156;Palazinges;66;1617425;52181;45;1297600;21;319825;24506;23170
22344;Trébrivan;391;9583041;258249;169;7313600;222;2269441;24509;23171
76470;Normanville;322;7891986;252469;200;6381685;122;1510301;24509;23172
27018;Appeville-Annebault;513;12573271;639753;314;10346164;199;2227107;24509;23173
59527;Saint-André-lez-Lille;6510;159556674;8198157;4042;134429232;2468;25127442;24509;23174
01404;Serrières-sur-Ain;86;2107867;148452;55;1760720;31;347147;24510;23175
54194;Fillières;237;5809121;119837;89;3302441;148;2506680;24511;23176
54162;Domgermain;614;15050009;514328;361;12074520;253;2975489;24511;23177
01015;Arbignieu;270;6618090;328226;170;5548375;100;1069715;24511;23178
42269;Saint-Paul-d'Uzore;69;1691297;35587;47;1415473;22;275824;24512;23179
60584;Saint-Leu-d'Esserent;2569;62970238;3121652;1608;52409203;961;10561035;24512;23180
01441;Vieu-d'Izenave;338;8284932;323421;217;6812469;121;1472463;24512;23181
57216;Fleisheim;58;1421700;35115;27;984863;31;436837;24512;23182
17049;Blanzay-sur-Boutonne;52;1274644;62929;25;1030044;27;244600;24512;23183
27614;Sancourt;72;1764895;62054;45;1418545;27;346350;24512;23184
50604;Tréauville;384;9412776;370102;235;7896332;149;1516444;24512;23185
64001;Aast;92;2255159;86407;61;1970470;31;284689;24513;23186
19200;Saint-Étienne-la-Geneste;44;1078581;37543;28;870727;16;207854;24513;23187
28322;Rueil-la-Gadelière;259;6349069;283241;160;5226557;99;1122512;24514;23188
27346;Houville-en-Vexin;111;2721068;86332;77;2300411;34;420657;24514;23189
30222;La Roque-sur-Cèze;110;2696608;171143;69;2327318;41;369290;24515;23190
51240;Étrepy;65;1593466;57165;34;1144957;31;448509;24515;23191
55304;Louppy-le-Château;95;2328938;98469;65;2019927;30;309011;24515;23192
05123;La Roche-des-Arnauds;743;18215238;741196;443;14563199;300;3652039;24516;23193
17466;Vérines;1067;26158421;855520;695;21730809;372;4427612;24516;23194
54128;Choloy-Ménillot;374;9169032;385398;235;7517579;139;1651453;24516;23195
89430;Varennes;165;4045285;159232;111;3463961;54;581324;24517;23196
39066;Bornay;91;2231053;60286;62;1845004;29;386049;24517;23197
34165;Montbazin;1510;37021975;2017100;829;30293304;681;6728671;24518;23198
52198;Fays;42;1029752;27845;27;864341;15;165411;24518;23199
40123;Herm;578;14171401;554451;354;11719309;224;2452092;24518;23200
53072;Commer;591;14490688;397401;366;11491650;225;2999038;24519;23201
18290;Vouzeron;255;6252357;251114;168;5284645;87;967712;24519;23202
19043;La Chapelle-aux-Brocs;228;5590537;201277;155;4752465;73;838072;24520;23203
14218;Danestal;164;4021266;135313;103;3347770;61;673496;24520;23204
50388;Orval;478;11720848;607779;272;9422045;206;2298803;24521;23205
50349;Montmartin-sur-Mer;759;18612062;988527;411;14530131;348;4081931;24522;23206
59666;Zegerscappel;724;17753824;552270;419;14045377;305;3708447;24522;23207
77445;Savigny-le-Temple;13650;334733205;13968040;8399;277601536;5251;57131669;24523;23208
63246;Murat-le-Quaire;296;7258719;376440;179;6040867;117;1217852;24523;23209
85113;L'Île-d'Yeu;2921;71631038;3691406;1692;57255642;1229;14375396;24523;23210
08019;Les Grandes-Armoises;28;686643;20514;16;573936;12;112707;24523;23211
81250;Saint-Genest-de-Contest;139;3408700;138979;72;2664077;67;744623;24523;23212
34298;Sauvian;2368;58071262;2809423;1341;46758606;1027;11312656;24523;23213
17067;Brie-sous-Matha;108;2648531;275090;44;2078420;64;570111;24523;23214
08279;Mars-sous-Bourcq;25;613090;25865;11;426207;14;186883;24524;23215
2B069;Casabianca;32;784761;58125;15;615247;17;169514;24524;23216
26160;Laveyron;525;12875614;727219;283;9982278;242;2893336;24525;23217
77148;Crouy-sur-Ourcq;932;22858451;1078826;561;18633798;371;4224653;24526;23218
70193;Cult;105;2575277;84872;62;2022242;43;553035;24526;23219
64516;Sedzère;191;4684589;200298;106;3844006;85;840583;24527;23220
43262;Vieille-Brioude;683;16752073;801102;419;13953335;264;2798738;24527;23221
62650;Pelves;378;9271505;395913;238;7796023;140;1475482;24528;23222
55560;Villers-aux-Vents;66;1618849;54930;41;1342716;25;276133;24528;23223
80063;Beauchamps;555;13613092;533539;314;10993944;241;2619148;24528;23224
86296;Voulon;218;5347152;208921;117;4083278;101;1263874;24528;23225
05059;La Freissinouse;360;8830424;329840;221;7196981;139;1633443;24529;23226
84113;Saint-Martin-de-la-Brasque;448;10989016;494603;272;9149279;176;1839737;24529;23227
54060;Belleville;750;18397568;697883;452;15002580;298;3394988;24530;23228
64557;Vignes;219;5372187;207435;115;4004234;104;1367953;24531;23229
63088;La Chapelle-sur-Usson;39;956707;97358;19;749020;20;207687;24531;23230
60314;Hétomesnil;125;3066385;68400;77;2338641;48;727744;24531;23231
40064;Canenx-et-Réaut;95;2330470;77341;60;1908362;35;422108;24531;23232
73224;Saint-Avre;467;11456166;463280;303;9478660;164;1977506;24531;23233
29153;Névez;1700;41704285;2164716;935;32792072;765;8912213;24532;23234
22166;Penvénan;1619;39717976;2037772;844;30796200;775;8921776;24532;23235
60658;Vauciennes;350;8586500;329653;239;7256005;111;1330495;24533;23236
40248;Saint-André-de-Seignanx;816;20019892;796606;488;16153285;328;3866607;24534;23237
37211;Saint-Branchs;1336;32777812;1234122;842;26844073;494;5933739;24534;23238
25378;Meslières;203;4980536;215722;129;4152193;74;828343;24535;23239
01246;Mézériat;1143;28043352;1284143;668;22708711;475;5334641;24535;23240
65205;Gouaux;47;1153221;78906;27;939259;20;213962;24537;23241
77397;Saâcy-sur-Marne;1019;25005084;1117661;656;21351632;363;3653452;24539;23242
54058;Béchamps;46;1128814;55506;28;923025;18;205789;24539;23243
31293;Lespinasse;1325;32514836;1424907;878;27386343;447;5128493;24539;23244
60083;Bonneuil-en-Valois;539;13226885;614134;335;10986457;204;2240428;24540;23245
47176;Mongaillard;90;2208633;77739;42;1619534;48;589099;24540;23246
85107;La Guyonnière;1305;32025785;953920;825;25899230;480;6126555;24541;23247
60601;Saint-Vaast-lès-Mello;554;13596933;634742;351;11209878;203;2387055;24543;23248
79104;Cours;260;6381370;237932;152;5192634;108;1188736;24544;23249
64352;Lourenties;164;4025257;180149;97;3285197;67;740060;24544;23250
34155;Maureilhan;1084;26606848;1118678;563;20817212;521;5789636;24545;23251
86279;Vaux-sur-Vienne;296;7265422;278184;184;5896238;112;1369184;24545;23252
85098;La Génétouze;880;21600135;607667;589;17978783;291;3621352;24546;23253
38479;Semons;187;4590070;211082;106;3552835;81;1037235;24546;23254
27157;Le Chesne;295;7241030;309279;175;5844416;120;1396614;24546;23255
32090;Castillon-Savès;173;4246441;198457;107;3570835;66;675606;24546;23256
83130;Solliès-Pont;6401;157118748;8206427;3642;129304090;2759;27814658;24546;23257
02672;Saint-Bandry;133;3264643;111164;82;2758963;51;505680;24546;23258
30275;Saint-Just-et-Vacquières;131;3215552;171036;76;2734120;55;481432;24546;23259
51618;Le Vézier;96;2356462;93035;63;1971175;33;385287;24546;23260
39331;Mignovillard;391;9597723;408155;227;7749603;164;1848120;24547;23261
86032;Bonneuil-Matours;1087;26682420;1158743;642;21629309;445;5053111;24547;23262
59142;Cerfontaine;320;7855085;296602;207;6634650;113;1220435;24547;23263
59663;Wormhout;2766;67902290;2692060;1592;54130696;1174;13771594;24549;23264
57589;Rohrbach-lès-Bitche;1171;28747809;1480901;624;22725279;547;6022530;24550;23265
65230;Izaourt;141;3461550;174417;83;2765341;58;696209;24550;23266
64078;Auriac;121;2970613;117237;77;2536428;44;434185;24551;23267
80301;Famechon;135;3314346;196555;77;2673454;58;640892;24551;23268
40281;Saint-Pierre-du-Mont;5244;128745783;6461407;3307;108119248;1937;20626535;24551;23269
57333;Hommarting;425;10434271;309455;266;8531341;159;1902930;24551;23270
80774;Vaire-sous-Corbie;154;3781188;153651;101;3230302;53;550886;24553;23271
46116;Frontenac;41;1006709;51700;20;821955;21;184754;24554;23272
60067;Béthisy-Saint-Martin;581;14265913;539144;361;11700930;220;2564983;24554;23273
80103;Biarre;41;1006732;52570;20;786591;21;220141;24554;23274
41092;Fougères-sur-Bièvre;429;10534217;392243;247;8338865;182;2195352;24555;23275
01204;Lalleyriat;123;3020481;101398;77;2411310;46;609171;24557;23276
54208;Francheville;152;3732965;163776;103;3197486;49;535479;24559;23277
40082;Classun;140;3438258;215887;72;2664970;68;773288;24559;23278
67420;Russ;683;16774216;561711;442;13726999;241;3047217;24560;23279
33477;Saint-Seurin-de-Cursac;457;11223786;731241;230;9011790;227;2211996;24560;23280
61221;Landigou;222;5452276;166955;142;4495390;80;956886;24560;23281
36154;Le Pêchereau;1088;26722042;1416763;612;21256142;476;5465900;24561;23282
24345;Queyssac;273;6705272;351663;163;5581457;110;1123815;24561;23283
67263;Lembach;915;22473748;976131;533;17714109;382;4759639;24561;23284
62766;Saint-Omer-Capelle;496;12182652;406169;281;9397835;215;2784817;24562;23285
32134;Frégouville;150;3684328;110546;83;2895895;67;788433;24562;23286
71582;La Vineuse;167;4101912;185109;103;3336779;64;765133;24562;23287
61249;Marcei;97;2382559;74368;63;1953734;34;428825;24562;23288
37224;Saint-Laurent-en-Gâtines;461;11323390;460133;286;9170948;175;2152442;24563;23289
30081;Chusclan;562;13804228;656217;348;11505235;214;2298993;24563;23290
42099;Fraisses;2051;50378578;2313530;1248;40818884;803;9559694;24563;23291
80203;Colincamps;46;1129907;54012;28;942737;18;187170;24563;23292
53150;Ménil;468;11496463;404591;289;9371440;179;2125023;24565;23293
33130;Coimères;475;11668892;593389;283;9726534;192;1942358;24566;23294
64324;Lasseube;892;21913396;1198086;490;17625706;402;4287690;24567;23295
89096;Chemilly-sur-Yonne;508;12480138;480421;346;10521703;162;1958435;24567;23296
89268;Mont-Saint-Sulpice;437;10736036;484425;292;9142277;145;1593759;24568;23297
25545;Silley-Amancey;64;1572339;58291;33;1104419;31;467920;24568;23298
54169;Domprix;38;933580;113084;16;756020;22;177560;24568;23299
63244;La Moutade;252;6191120;322708;155;5104561;97;1086559;24568;23300
67289;Menchhoffen;310;7616075;283046;195;6287676;115;1328399;24568;23301
88193;Gemaingoutte;82;2014713;121616;43;1583376;39;431337;24570;23302
56165;Ploërmel;5256;129140208;5691342;2923;105256883;2333;23883325;24570;23303
63059;Busséol;113;2776457;80338;72;2327246;41;449211;24570;23304
64284;Jurançon;4171;102483349;6022241;2359;84010047;1812;18473302;24570;23305
31106;Caraman;1276;31352431;1383000;727;25673261;549;5679170;24571;23306
76630;Saint-Ouen-sous-Bailly;109;2678245;124404;68;2246088;41;432157;24571;23307
24407;Sainte-Foy-de-Longas;136;3341687;234716;66;2725503;70;616184;24571;23308
49260;La Romagne;891;21893071;806889;534;17397810;357;4495261;24571;23309
14084;Bonnemaison;200;4914274;163547;122;3963115;78;951159;24571;23310
05147;Saint-Julien-en-Champsaur;186;4570305;223754;85;3609287;101;961018;24572;23311
80693;Sailly-Laurette;159;3907023;169746;90;3121297;69;785726;24572;23312
67232;Keffenach;107;2629262;86297;78;2295419;29;333843;24573;23313
60158;Coivrel;123;3022454;111776;72;2393525;51;628929;24573;23314
65444;Tibiran-Jaunac;166;4079206;204336;60;3032314;106;1046892;24574;23315
57167;Dalstein;162;3980940;88659;77;2546680;85;1434260;24574;23316
62288;Ecques;1009;24795303;953338;587;19767042;422;5028261;24574;23317
24355;La Roque-Gageac;265;6512175;313635;160;5488324;105;1023851;24574;23318
76208;Cuy-Saint-Fiacre;353;8674776;467639;212;7305913;141;1368863;24574;23319
77222;Guignes;1765;43373902;1925762;1170;37403377;595;5970525;24574;23320
62899;Wissant;610;14991314;892718;298;11359768;312;3631546;24576;23321
77088;La Chapelle-la-Reine;1320;32441550;1581475;816;27151512;504;5290038;24577;23322
43227;Saint-Victor-Malescours;400;9831484;379548;237;7852379;163;1979105;24579;23323
76045;Auzouville-l'Esneval;187;4596324;186213;117;3806418;70;789906;24579;23324
65279;Lortet;136;3342809;96991;70;2669288;66;673521;24579;23325
34344;La Grande-Motte;6906;169746341;12876965;3939;141325418;2967;28420923;24580;23326
43229;Saint-Vidal;271;6661148;229420;174;5599499;97;1061649;24580;23327
38452;Saint-Romain-de-Surieu;178;4375303;164572;102;3506991;76;868312;24580;23328
14584;Saint-Germain-de-Tallevende-la-Lande-Vaumont;1068;26251949;1172514;594;21064447;474;5187502;24580;23329
35013;Bains-sur-Oust;1762;43311053;1697459;1010;34717171;752;8593882;24581;23330
14307;Goupillières;85;2089401;45369;56;1786304;29;303097;24581;23331
33268;Margaux;855;21017002;969806;463;16844181;392;4172821;24581;23332
14408;May-sur-Orne;949;23327843;865908;596;19328936;353;3998907;24581;23333
51322;Lignon;56;1376642;93272;30;1055056;26;321586;24583;23334
02541;Neufchâtel-sur-Aisne;224;5506635;243985;141;4481147;83;1025488;24583;23335
84072;Mazan;3151;77462028;3826844;1683;61664396;1468;15797632;24583;23336
74190;Morillon;385;9464817;424447;247;7764025;138;1700792;24584;23337
86219;Saint-Cyr;537;13201621;478716;335;10767220;202;2434401;24584;23338
63146;Égliseneuve-près-Billom;456;11210396;420604;282;9146455;174;2063941;24584;23339
07228;Saint-Désirat;459;11284432;437910;290;9325165;169;1959267;24585;23340
80317;Fleury;117;2876524;104846;64;2142153;53;734371;24586;23341
50172;Émondeville;183;4499205;159655;97;3481350;86;1017855;24586;23342
27059;Bernouville;153;3761800;188759;93;3167934;60;593866;24587;23343
02025;Artemps;174;4278217;110831;99;3525004;75;753213;24587;23344
38080;Charancieu;365;8974520;309691;226;7238587;139;1735933;24588;23345
60617;Sermaize;137;3368541;178792;86;2812497;51;556044;24588;23346
89425;Turny;425;10450084;518242;238;8490459;187;1959625;24588;23347
65173;Esterre;114;2803191;124378;70;2117726;44;685465;24589;23348
68223;Muhlbach-sur-Munster;438;10770619;568986;280;9012701;158;1757918;24590;23349
21383;Marcilly-sur-Tille;821;20188984;694977;507;16308526;314;3880458;24591;23350
39302;Louvatange;50;1229556;31634;33;1022892;17;206664;24591;23351
24197;Ginestet;418;10279096;425088;261;8447923;157;1831173;24591;23352
51015;Argers;56;1377106;38399;30;982558;26;394548;24591;23353
60295;Halloy;237;5828133;287502;145;4853408;92;974725;24591;23354
89458;Villenavotte;108;2655974;105224;72;2182562;36;473412;24592;23355
80351;Fréchencourt;138;3393782;142434;87;2903953;51;489829;24593;23356
22265;Rospez;870;21396047;769773;512;17124669;358;4271378;24593;23357
27217;Émanville;288;7082950;364273;168;5702673;120;1380277;24594;23358
63259;Olloix;174;4279294;190581;99;3447307;75;831987;24594;23359
67206;Hoffen;661;16256549;711988;440;13720997;221;2535552;24594;23360
14581;Saint-Germain-d'Ectot;144;3541633;162383;69;2663211;75;878422;24595;23361
08079;Boutancourt;147;3615438;151461;86;2860046;61;755392;24595;23362
02597;Perles;41;1008388;44805;23;778752;18;229636;24595;23363
80157;Bussy-lès-Poix;49;1205174;45060;30;993257;19;211917;24595;23364
57261;Gros-Réderching;683;16798837;739598;392;13349497;291;3449340;24596;23365
31581;Villaudric;676;16626721;616375;404;13439010;272;3187711;24596;23366
24419;Saint-Germain-et-Mons;408;10035109;411371;253;8251001;155;1784108;24596;23367
28033;Belhomert-Guéhouville;448;11019191;553848;284;9181669;164;1837522;24596;23368
64387;Momas;266;6542758;236492;154;5177371;112;1365387;24597;23369
72007;Ardenay-sur-Mérize;226;5558912;196962;130;4401669;96;1157243;24597;23370
27508;Saint-Antonin-de-Sommaire;95;2336847;86699;62;1973387;33;363460;24598;23371
72155;Laigné-en-Belin;1192;29321342;991058;752;24284449;440;5036893;24598;23372
59202;Erquinghem-Lys;2466;60660150;2478206;1552;49735586;914;10924564;24599;23373
39463;Rogna;124;3050275;97740;82;2605964;42;444311;24599;23374
40066;Carcarès-Sainte-Croix;271;6666344;347016;160;5493243;111;1173101;24599;23375
72203;Montabon;427;10503822;431142;252;8398169;175;2105653;24599;23376
10302;Praslin;40;983966;41353;20;707304;20;276662;24599;23377
51544;Sommepy-Tahure;313;7699573;390959;173;6174178;140;1525395;24599;23378
77531;Voulx;1009;24821767;1287737;582;20272700;427;4549067;24600;23379
21489;Poiseul-la-Grange;40;984023;100361;15;787189;25;196834;24601;23380
67032;Bernardvillé;134;3296512;214244;80;2747109;54;549403;24601;23381
55198;Fresnes-en-Woëvre;383;9422122;674826;192;7423188;191;1998934;24601;23382
42096;Fontanès;304;7478717;264264;164;5595759;140;1882958;24601;23383
54111;Chaligny;1564;38476125;1436653;995;31326488;569;7149637;24601;23384
55433;Rigny-la-Salle;185;4551209;221432;100;3585486;85;965723;24601;23385
08379;Saint-Étienne-à-Arnes;126;3099780;117844;64;2212623;62;887157;24601;23386
29289;Trégarvan;98;2410985;119749;51;2019170;47;391815;24602;23387
21205;Courcelles-lès-Semur;121;2976857;111910;79;2563795;42;413062;24602;23388
80397;Gueudecourt;54;1328602;56461;31;1060822;23;267780;24604;23389
60446;Nanteuil-le-Haudouin;1967;48396498;2145546;1271;40784260;696;7612238;24604;23390
80155;Bussus-Bussuel;153;3764470;197905;84;3036209;69;728261;24604;23391
38165;Fitilieu;908;22341077;1045597;553;18172655;355;4168422;24605;23392
46083;Cressensac;352;8660889;347219;179;6963423;173;1697466;24605;23393
69130;Meaux-la-Montagne;101;2485120;92598;62;2034447;39;450673;24605;23394
39001;Abergement-la-Ronce;400;9842152;338464;252;8153066;148;1689086;24605;23395
86245;Saint-Sauveur;561;13803878;543055;362;11434398;199;2369480;24606;23396
71455;Saint-Martin-du-Tartre;87;2140755;103050;47;1556197;40;584558;24606;23397
73254;Sainte-Marie-d'Alvey;70;1722468;55631;50;1529933;20;192535;24607;23398
37150;Mazières-de-Touraine;658;16191285;678918;400;13132086;258;3059199;24607;23399
22171;Plaintel;2161;53176635;1966449;1308;43314983;853;9861652;24607;23400
14409;Merville-Franceville-Plage;1356;33367747;1937159;819;27619415;537;5748332;24607;23401
07260;Saint-Lager-Bressac;440;10827308;387147;269;8810649;171;2016659;24608;23402
14418;Le Mesnil-Durand;174;4281891;213158;93;3397616;81;884275;24609;23403
62894;Wimille;2226;54780268;3306573;1124;43379243;1102;11401025;24609;23404
59357;La Longueville;1124;27660854;1574141;624;22385567;500;5275287;24609;23405
28424;Yèvres;945;23256146;1154997;584;18944834;361;4311312;24610;23406
71577;Villegaudin;104;2559499;136670;69;2145023;35;414476;24611;23407
10249;Montiéramey;235;5783559;236069;143;4794673;92;988886;24611;23408
24331;Pomport;415;10213617;482203;214;8034648;201;2178969;24611;23409
72253;Roézé-sur-Sarthe;1339;32956367;1207468;820;27191290;519;5765077;24613;23410
22232;Plourhan;998;24564134;935125;590;19786801;408;4777333;24613;23411
17004;Île-d'Aix;139;3421274;221782;78;2806388;61;614886;24613;23412
31524;Salles-et-Pratviel;75;1846032;77626;56;1639850;19;206182;24614;23413
64406;Morlanne;301;7408793;290557;161;5945775;140;1463018;24614;23414
95094;Bouqueval;173;4258219;194662;114;3612262;59;645957;24614;23415
88365;Racécourt;88;2166102;137743;48;1695624;40;470478;24615;23416
02289;Essises;233;5735279;253212;151;4683801;82;1051478;24615;23417
57316;Henriville;406;9993669;350271;246;7959107;160;2034562;24615;23418
02716;Servais;153;3766174;141578;95;3205463;58;560711;24616;23419
72053;Challes;637;15680225;738866;402;12980743;235;2699482;24616;23420
71245;Jugy;173;4258621;171412;106;3496835;67;761786;24616;23421
88269;Liézey;164;4037084;171642;103;3418710;61;618374;24616;23422
89340;Sainte-Colombe-sur-Loing;114;2806375;182131;67;2368026;47;438349;24617;23423
71394;Saint-Bonnet-de-Joux;449;11053276;582296;223;8170987;226;2882289;24618;23424
62858;Villers-lès-Cagnicourt;134;3298931;148272;81;2750924;53;548007;24619;23425
83150;Vinon-sur-Verdon;2169;53398577;2561431;1235;42105853;934;11292724;24619;23426
08404;Sault-Saint-Remy;87;2141894;73096;50;1694362;37;447532;24619;23427
39469;Rouffange;59;1452611;57317;32;1132545;27;320066;24621;23428
76545;Rouxmesnil-Bouteilles;1085;26713684;1231964;728;22761700;357;3951984;24621;23429
11366;Sainte-Valière;310;7632562;251924;130;5957177;180;1675385;24621;23430
27019;Armentières-sur-Avre;89;2191295;66531;53;1825979;36;365316;24621;23431
50603;Tourville-sur-Sienne;439;10808759;565511;257;8837352;182;1971407;24621;23432
59251;Frasnoy;158;3890213;134444;90;3265421;68;624792;24622;23433
67290;Merkwiller-Pechelbronn;501;12335466;527716;290;9886500;211;2448966;24622;23434
02479;Merval;35;861764;32479;20;737191;15;124573;24622;23435
50536;Saint-Pierre-d'Arthéglise;86;2117497;110714;40;1628611;46;488886;24622;23436
62681;Quiestède;305;7509820;213945;183;5978028;122;1531792;24622;23437
71001;L'Abergement-de-Cuisery;402;9898765;399157;246;8108456;156;1790309;24624;23438
73245;Saint-Jean-de-Chevelu;405;9972728;371910;248;7920848;157;2051880;24624;23439
14252;Estrées-la-Campagne;108;2659475;102327;60;2086023;48;573452;24625;23440
51277;Sainte-Marie-du-Lac-Nuisement;148;3644531;172393;86;2925007;62;719524;24625;23441
34078;Claret;766;18863036;759546;442;15160274;324;3702762;24625;23442
76359;Héronchelles;70;1723857;66633;42;1395275;28;328582;24627;23443
57540;Phalsbourg;2519;62035060;2866812;1427;49931042;1092;12104018;24627;23444
81271;Saint-Sulpice;4251;104688885;3968674;2577;86238674;1674;18450211;24627;23445
54590;Viviers-sur-Chiers;315;7757593;186442;155;5101619;160;2655974;24627;23446
45302;Saran;8134;200325350;9048448;5140;167545371;2994;32779979;24628;23447
44154;Saint-Brevin-les-Pins;7643;188240086;9105518;4472;156446050;3171;31794036;24629;23448
02486;Missy-lès-Pierrepont;51;1256182;88480;23;996951;28;259231;24631;23449
94021;Chevilly-Larue;10435;257028605;15777529;6567;221068992;3868;35959613;24631;23450
10353;Saint-Mesmin;457;11256888;516919;279;9123263;178;2133625;24632;23451
57740;Waldwisse;395;9729911;323792;190;6332372;205;3397539;24633;23452
33257;Lugaignac;218;5369985;215967;134;4335362;84;1034623;24633;23453
72002;Aillières-Beauvoir;115;2832840;113405;68;2357729;47;475111;24633;23454
41102;Houssay;199;4902113;193246;113;3928437;86;973676;24634;23455
62343;Fontaine-lès-Croisilles;141;3473402;128122;91;2971128;50;502274;24634;23456
62746;Saint-Étienne-au-Mont;2641;65059237;2203515;1246;50777654;1395;14281583;24634;23457
71587;Vitry-lès-Cluny;38;936105;11018;26;812774;12;123331;24634;23458
08408;Sécheval;239;5887666;214494;148;4887156;91;1000510;24635;23459
57195;Epping;304;7489082;286952;181;5882134;123;1606948;24635;23460
59396;Mecquignies;356;8770257;360002;197;7017385;159;1752872;24636;23461
89143;Dollot;179;4409774;269418;107;3635945;72;773829;24636;23462
76266;Flocques;361;8893514;442368;227;7334338;134;1559176;24636;23463
59386;Marquette-lez-Lille;5320;131066938;5690613;3252;109232307;2068;21834631;24637;23464
56237;Saint-Thuriau;1000;24637227;955659;625;20380033;375;4257194;24637;23465
14336;Hottot-les-Bagues;228;5617386;187173;141;4596272;87;1021114;24638;23466
29209;Plouvien;1829;45062590;1454791;1130;36404644;699;8657946;24638;23467
82057;Fabas;269;6627600;214708;156;5413901;113;1213699;24638;23468
54266;Houdreville;224;5519101;204783;138;4450391;86;1068710;24639;23469
26177;Marsaz;374;9215036;300217;216;7247761;158;1967275;24639;23470
43028;Bessamorel;207;5100326;260812;123;4125203;84;975123;24639;23471
01234;Marignieu;90;2217572;74192;53;1751315;37;466257;24640;23472
62446;Hesdigneul-lès-Boulogne;326;8032649;319067;189;6346274;137;1686375;24640;23473
54223;Germiny;106;2611927;121592;62;2108151;44;503776;24641;23474
11054;Les Brunels;152;3745444;144638;81;3077730;71;667714;24641;23475
56029;Calan;503;12394515;404926;320;10089945;183;2304570;24641;23476
80814;Vrély;240;5914006;293159;132;4419048;108;1494958;24642;23477
77033;Bezalles;103;2538103;110206;62;2083559;41;454544;24642;23478
47108;Gaujac;150;3696271;177934;80;2964613;70;731658;24642;23479
10254;Montpothier;185;4558787;167005;122;3824998;63;733789;24642;23480
62354;Frencq;385;9487387;378411;214;7536839;171;1950548;24643;23481
36021;Les Bordes;472;11631417;431557;316;9614371;156;2017046;24643;23482
80165;Camps-en-Amiénois;92;2267141;78561;60;1780477;32;486664;24643;23483
60468;Nourard-le-Franc;168;4140041;201714;105;3411609;63;728432;24643;23484
02220;Coulonges-Cohan;218;5372334;276657;119;4259128;99;1113206;24644;23485
51304;Janvilliers;70;1725062;66156;33;1221223;37;503839;24644;23486
61428;Saint-Maurice-du-Désert;405;9980781;386745;251;8104967;154;1875814;24644;23487
39187;Cuvier;107;2636939;89484;57;2023892;50;613047;24644;23488
61362;Saint-André-de-Messei;282;6949954;219245;180;5647862;102;1302092;24645;23489
14696;Tortisambert;72;1774471;108507;39;1354319;33;420152;24645;23490
39175;Coyron;36;887236;27769;22;760826;14;126410;24645;23491
61050;Boissy-Maugis;207;5101693;184290;111;3933936;96;1167757;24646;23492
59402;Millam;360;8872552;236087;217;7149392;143;1723160;24646;23493
60565;Saint-André-Farivillers;269;6629956;235419;176;5533859;93;1096097;24647;23494
57757;Yutz;8576;211375210;6386270;4006;138300228;4570;73074982;24647;23495
37118;Huismes;810;19964580;785588;483;16095565;327;3869015;24648;23496
41190;Rocé;105;2588120;91734;61;1956223;44;631897;24649;23497
60511;Porquéricourt;189;4658621;258483;111;3873725;78;784896;24649;23498
46082;Cremps;195;4806610;236752;103;3681577;92;1125033;24649;23499
45207;Mignerette;208;5127233;278826;139;4381135;69;746098;24650;23500
39293;Leschères;101;2489811;84721;65;2138801;36;351010;24652;23501
06155;Vallauris;17131;422319426;29610658;9435;347247630;7696;75071796;24652;23502
72350;Teloché;1508;37175989;1200379;946;30526751;562;6649238;24653;23503
76339;Le Hanouard;132;3254144;150822;77;2685267;55;568877;24653;23504
10415;Villemaur-sur-Vanne;260;6409679;204217;145;5004333;115;1405346;24653;23505
40275;Saint-Maurice-sur-Adour;296;7297205;290620;193;5981868;103;1315337;24653;23506
88417;Saint-Gorgon;171;4215644;136186;93;3240431;78;975213;24653;23507
14666;Sannerville;911;22460133;884141;613;19149813;298;3310320;24654;23508
45338;Villemandeur;3798;93637726;4558737;2383;77821279;1415;15816447;24654;23509
08478;Villers-le-Tilleul;119;2933889;92166;76;2390560;43;543329;24655;23510
54001;Abaucourt;168;4141969;168448;96;3315388;72;826581;24655;23511
57346;Insming;314;7741581;311275;159;5955236;155;1786345;24655;23512
76483;Oherville;116;2859953;101235;74;2425022;42;434931;24655;23513
27180;Courcelles-sur-Seine;987;24334412;916944;642;20196056;345;4138356;24655;23514
30014;Arpaillargues-et-Aureillac;560;13807063;720591;310;11281533;250;2525530;24655;23515
21146;Charmes;66;1627317;63123;42;1381005;24;246312;24656;23516
03062;Charroux;211;5202502;264741;120;4172577;91;1029925;24656;23517
40065;Capbreton;5804;143106991;9511129;3300;117327514;2504;25779477;24657;23518
16234;Moulidars;393;9690102;413272;241;8128629;152;1561473;24657;23519
62679;Questrecques;160;3945082;150094;91;3189503;69;755579;24657;23520
32288;Montiron;79;1947947;104958;54;1677124;25;270823;24658;23521
07001;Accons;220;5424840;200925;140;4383436;80;1041404;24658;23522
38072;Chanas;1238;30527900;1305706;767;25069165;471;5458735;24659;23523
41178;Le Plessis-l'Échelle;38;937046;32719;25;763638;13;173408;24659;23524
80446;Huppy;424;10455790;517562;248;8496493;176;1959297;24660;23525
76268;Fongueusemare;86;2120831;74846;46;1661979;40;458852;24661;23526
09179;Malléon;35;863148;62115;21;725220;14;137928;24661;23527
06091;Peille;1292;31862565;1929210;757;26735614;535;5126951;24661;23528
34033;Boisseron;967;23847872;1042569;541;19119625;426;4728247;24662;23529
52515;Verseilles-le-Bas;50;1233097;24485;34;1025407;16;207690;24662;23530
01073;Ceyzérieu;566;13958835;590846;340;11260404;226;2698431;24662;23531
33011;Arès;3809;93939403;5106726;2251;76278866;1558;17660537;24662;23532
45033;Boësses;230;5672450;281662;139;4594366;91;1078084;24663;23533
21014;Antheuil;42;1035865;44817;29;868057;13;167808;24663;23534
61405;Saint-Hilaire-sur-Erre;294;7251324;266903;183;5999670;111;1251654;24664;23535
85106;La Guérinière;876;21606323;1250259;507;17599568;369;4006755;24665;23536
25174;Courtefontaine;126;3107810;124807;72;2504100;54;603710;24665;23537
56018;Billiers;469;11567994;668833;261;9454352;208;2113642;24665;23538
31128;Caujac;396;9767460;367081;219;7752005;177;2015455;24665;23539
88148;Dommartin-lès-Remiremont;998;24616516;958873;624;20277548;374;4338968;24666;23540
30174;Montaren-et-Saint-Médiers;815;20102996;1154085;463;16578551;352;3524445;24666;23541
65007;Andrest;778;19190573;771076;474;15812202;304;3378371;24667;23542
60043;Bailly;335;8263308;338877;220;6983546;115;1279762;24667;23543
37149;Marray;222;5476010;237537;136;4381320;86;1094690;24667;23544
02323;Fontaine-Uterte;67;1652681;63809;44;1411960;23;240721;24667;23545
50411;Ponts;292;7203103;340780;175;5933524;117;1269579;24668;23546
56137;Monterblanc;1506;37150288;1156892;956;30803452;550;6346836;24668;23547
38434;Saint-Ondras;315;7770512;337150;180;6129525;135;1640987;24668;23548
28200;Jaudrais;189;4662312;228527;108;3851701;81;810611;24668;23549
41012;Baillou;128;3157704;131765;84;2660504;44;497200;24670;23550
54524;Thumeréville;46;1134813;49316;29;956931;17;177882;24670;23551
51065;Blacy;367;9053978;398687;227;7434564;140;1619414;24670;23552
80460;Lamaronde;39;962146;46591;21;717324;18;244822;24670;23553
31490;Saint-Jory;2789;68807033;2897946;1686;56213715;1103;12593318;24671;23554
35109;Étrelles;1217;30024678;1075138;721;23955582;496;6069096;24671;23555
50196;Gatteville-le-Phare;284;7006683;325132;146;5316183;138;1690500;24671;23556
61474;Silly-en-Gouffern;227;5600451;289302;138;4634655;89;965796;24672;23557
13083;Rognonas;2329;57462739;2836007;1363;47177952;966;10284787;24673;23558
27592;Saint-Pierre-de-Salerne;136;3355505;173868;79;2760782;57;594723;24673;23559
38264;La Morte;73;1801165;90734;48;1497222;25;303943;24673;23560
67486;Sundhouse;871;21491185;1004780;508;17278972;363;4212213;24674;23561
27177;Coudres;289;7130848;329795;178;5958015;111;1172833;24674;23562
59610;Verchain-Maugré;490;12090645;588351;274;9799276;216;2291369;24675;23563
41184;Prunay-Cassereau;334;8241527;337744;196;6727223;138;1514304;24675;23564
29098;Lampaul-Plouarzel;1169;28846707;1316734;674;22810473;495;6036234;24676;23565
01443;Villars-les-Dombes;2456;60607274;2758878;1468;49108616;988;11498658;24677;23566
42237;Saint-Jean-Bonnefonds;3515;86740956;3889089;2190;71702799;1325;15038157;24677;23567
07066;Chomérac;1658;40915308;2110213;1012;33626822;646;7288486;24678;23568
70080;Bouhans-et-Feurg;146;3603029;165693;90;2966911;56;636118;24678;23569
53137;Loiron;759;18730909;698232;464;15088925;295;3641984;24678;23570
05052;Eygliers;421;10389638;512415;249;8295610;172;2094028;24678;23571
57297;Harprich;120;2961466;167020;81;2556129;39;405337;24679;23572
73077;Les Chapelles;305;7527178;316011;207;6250711;98;1276467;24679;23573
57337;Hoste;331;8169446;280423;195;6574803;136;1594643;24681;23574
05085;Montgenèvre;279;6886129;372827;187;5838111;92;1048018;24681;23575
85096;La Garnache;2408;59433114;1869907;1308;46217128;1100;13215986;24682;23576
27338;Les Hogues;354;8737354;398397;233;7445684;121;1291670;24682;23577
26073;Chantemerle-lès-Grignan;138;3406198;151004;88;2951281;50;454917;24683;23578
34321;Valergues;1043;25744637;1047343;633;21320410;410;4424227;24683;23579
04063;Corbières;554;13674737;634989;339;11453054;215;2221683;24684;23580
36128;Montierchaume;858;21179186;841738;546;17392469;312;3786717;24684;23581
10425;Villery;151;3727358;151710;88;3029921;63;697437;24684;23582
70119;Chambornay-lès-Pin;188;4640747;143514;113;3668223;75;972524;24685;23583
01307;Port;443;10935497;499247;295;9266693;148;1668804;24685;23584
18262;Thauvenay;187;4616118;247986;98;3575856;89;1040262;24685;23585
02512;Montigny-l'Allier;147;3628784;173353;81;2939080;66;689704;24686;23586
59103;Boussières-sur-Sambre;255;6294838;300678;144;5024083;111;1270755;24686;23587
64409;Moumour;451;11133276;545291;270;8960499;181;2172777;24686;23588
76141;Bréauté;635;15675512;568726;382;12803188;253;2872324;24686;23589
61418;Saint-Mard-de-Réno;229;5653113;269554;129;4515251;100;1137862;24686;23590
73133;Hauteville;158;3900516;117983;100;3116459;58;784057;24687;23591
25617;Villars-sous-Dampjoux;211;5208928;225311;135;4341513;76;867415;24687;23592
58153;Magny-Lormes;50;1234392;77478;31;1041798;19;192594;24688;23593
17036;Beaugeay;349;8616463;195873;216;7058121;133;1558342;24689;23594
39334;Moiron;79;1950439;106384;49;1617050;30;333389;24689;23595
25630;Voires;39;962897;32033;24;821893;15;141004;24690;23596
51402;Neuvy;131;3234369;178546;77;2581945;54;652424;24690;23597
57730;Volmerange-lès-Boulay;278;6863802;245495;168;5614381;110;1249421;24690;23598
26323;Saint-Paul-lès-Romans;952;23504861;1031208;560;18936931;392;4567930;24690;23599
47197;Nomdieu;114;2814691;146142;69;2395573;45;419118;24690;23600
08004;Aire;106;2617205;99916;55;1997855;51;619350;24691;23601
22211;Ploubezre;1833;45258030;1821714;1117;36780635;716;8477395;24691;23602
90100;Vauthiermont;125;3086399;107449;82;2590085;43;496314;24691;23603
76369;La Houssaye-Béranger;253;6247000;198867;161;5092190;92;1154810;24692;23604
81042;Burlats;1073;26498317;1228573;595;21181638;478;5316679;24696;23605
51619;Le Vieil-Dampierre;61;1506471;57766;36;1224682;25;281789;24696;23606
71022;Baudemont;348;8594332;303199;212;6909461;136;1684871;24696;23607
31564;Valcabrère;94;2321550;121354;55;1890785;39;430765;24697;23608
64130;Biriatou;560;13830641;523378;369;11589646;191;2240995;24698;23609
55214;Givrauval;145;3581178;125773;99;3143875;46;437303;24698;23610
21366;Magny-lès-Aubigny;106;2617972;109589;59;2091695;47;526277;24698;23611
28065;Bullainville;61;1506572;75353;37;1225639;24;280933;24698;23612
27380;Malleville-sur-le-Bec;119;2939126;158651;70;2530415;49;408711;24699;23613
27436;Nogent-le-Sec;217;5359646;201177;138;4472625;79;887021;24699;23614
74222;Reyvroz;278;6866723;268894;182;5643459;96;1223264;24700;23615
30219;Rogues;45;1111574;59751;23;961431;22;150143;24702;23616
30128;Générac;2141;52886458;2492320;1230;42775651;911;10110807;24702;23617
28396;Trizay-lès-Bonneval;166;4100604;173686;103;3321877;63;778727;24702;23618
49230;Noyant-la-Plaine;145;3581855;99592;91;2933543;54;648312;24702;23619
77321;Mousseaux-lès-Bray;367;9065825;384593;226;7402251;141;1663574;24703;23620
32044;Béraut;185;4569977;206649;104;3731129;81;838848;24703;23621
70079;Bougnon;269;6645000;234860;181;5507693;88;1137307;24703;23622
02062;Belleau;69;1704550;88055;35;1320066;34;384484;24704;23623
63149;Entraigues;339;8374848;367466;211;6930454;128;1444394;24705;23624
38453;Saint-Romans;897;22160347;823139;545;18277021;352;3883326;24705;23625
70413;Plancher-Bas;1017;25125777;1066472;646;20696392;371;4429385;24706;23626
59111;Broxeele;168;4150580;149355;113;3504001;55;646579;24706;23627
71089;La Chapelle-de-Bragny;141;3483675;153678;84;2840717;57;642958;24707;23628
28368;La Saucelle;98;2421296;130827;62;2134694;36;286602;24707;23629
64243;Géus-d'Arzacq;92;2273068;55137;58;1951464;34;321604;24707;23630
85108;L'Herbergement;1411;34862048;957517;865;28488462;546;6373586;24707;23631
10143;Étourvy;108;2668483;132319;54;2079235;54;589248;24708;23632
35360;Vitré;9728;240366138;12587878;5531;196276390;4197;44089748;24709;23633
44008;Barbechat;631;15591313;582157;382;12711603;249;2879710;24709;23634
29178;Ploudalmézeau;3298;81490126;3526084;1852;64191702;1446;17298424;24709;23635
21169;Chevannes;83;2050885;115741;48;1655126;35;395759;24709;23636
02046;Barenton-Bugny;300;7413059;366169;182;6035830;118;1377229;24710;23637
38555;Villeneuve-de-Marc;579;14307317;609309;353;11706327;226;2600990;24710;23638
38395;Saint-Hilaire;702;17347411;776773;424;14565853;278;2781558;24711;23639
27210;Écardenville-la-Campagne;205;5065925;290565;117;4117602;88;948323;24712;23640
31360;Montauban-de-Luchon;306;7562206;351034;179;6226295;127;1335911;24713;23641
60632;Thiescourt;367;9069751;379725;226;7362035;141;1707716;24713;23642
27469;Pont-de-l'Arche;2176;53776031;2549904;1352;44686209;824;9089822;24713;23643
18248;Senneçay;232;5733536;251422;154;4895602;78;837934;24714;23644
44084;Le Loroux-Bottereau;3719;91909844;3009108;2299;75574167;1420;16335677;24714;23645
42256;Saint-Marcellin-en-Forez;2288;56544777;2312777;1393;46507279;895;10037498;24714;23646
62509;Liettres;135;3336427;235745;71;2642955;64;693472;24714;23647
18126;Levet;725;17918267;665042;467;14824642;258;3093625;24715;23648
61478;Taillebois;69;1705345;59480;39;1370157;30;335188;24715;23649
14536;La Rivière-Saint-Sauveur;1268;31340364;1557922;789;26036876;479;5303488;24716;23650
83070;Le Lavandou;4027;99537012;7319902;2191;81029942;1836;18507070;24717;23651
42267;Saint-Nizier-sous-Charlieu;888;21949242;888505;499;17413776;389;4535466;24718;23652
09121;Ferrières-sur-Ariège;442;10925520;457066;288;9096286;154;1829234;24718;23653
38156;Les Éparres;505;12483067;620540;303;10218279;202;2264788;24719;23654
14175;Condé-sur-Seulles;119;2941576;60529;78;2415286;41;526290;24719;23655
02820;Viry-Noureuil;989;24447232;1273236;596;20387360;393;4059872;24719;23656
80119;Bougainville;255;6303402;277735;156;5217190;99;1086212;24719;23657
36083;Giroux;72;1779820;94689;40;1418644;32;361176;24720;23658
72096;Coulans-sur-Gée;796;19677200;643519;484;15917866;312;3759334;24720;23659
76476;Notre-Dame-de-Gravenchon;4441;109785080;5255906;2685;90465632;1756;19319448;24721;23660
36064;Diors;365;9023184;342072;242;7527634;123;1495550;24721;23661
25629;Voillans;112;2768781;104765;67;2262503;45;506278;24721;23662
76759;Yville-sur-Seine;241;5957828;276739;141;4775442;100;1182386;24721;23663
32122;Esclassan-Labastide;178;4400496;193883;98;3426291;80;974205;24722;23664
34127;Lansargues;1665;41163470;2079246;946;33443091;719;7720379;24723;23665
39259;Grange-de-Vaivre;27;667538;32007;15;565065;12;102473;24724;23666
28401;Vaupillon;249;6156220;256777;156;5052705;93;1103515;24724;23667
64262;Higuères-Souye;145;3584964;135729;95;3029923;50;555041;24724;23668
88222;Gugnécourt;83;2052155;77774;49;1709896;34;342259;24725;23669
90049;Foussemagne;443;10953073;397966;263;8866114;180;2086959;24725;23670
31104;Capens;311;7689443;248216;196;6429675;115;1259768;24725;23671
51035;Bannes;142;3511024;160362;79;2736360;63;774664;24726;23672
60012;Andeville;1643;40624930;1592340;1098;34468630;545;6156300;24726;23673
71555;Varennes-le-Grand;957;23662965;968514;596;20014026;361;3648939;24726;23674
08174;Floing;1348;33331110;1831220;777;26974831;571;6356279;24726;23675
18150;Méry-sur-Cher;358;8852630;333891;219;7208890;139;1643740;24728;23676
76529;Riville;159;3931787;153004;92;3126590;67;805197;24728;23677
70438;Ray-sur-Saône;110;2720150;85992;59;2070876;51;649274;24729;23678
62755;Saint-Léonard;1859;45970798;1743209;1092;36621374;767;9349424;24729;23679
31473;Saint-Cézert;205;5069509;176044;123;4093228;82;976281;24729;23680
54277;Jeandelize;197;4871680;208668;106;3767539;91;1104141;24729;23681
90084;Reppe;163;4030941;137866;101;3302582;62;728359;24730;23682
57150;Condé-Northen;326;8061961;256887;184;6217098;142;1844863;24730;23683
80793;Vignacourt;1247;30838697;1258476;784;25527199;463;5311498;24730;23684
84141;Vedène;5646;139636738;6353105;3458;115642805;2188;23993933;24732;23685
10195;Lhuître;148;3660422;268372;77;2884798;71;775624;24733;23686
23195;Saint-Fiel;516;12762133;505561;342;11028798;174;1733335;24733;23687
57563;Raville;116;2869035;74145;71;2302906;45;566129;24733;23688
08448;Thilay;587;14518388;802213;329;11536055;258;2982333;24733;23689
10157;La Fosse-Corduan;122;3017490;143022;80;2590255;42;427235;24734;23690
61479;Tanques;92;2275488;81304;59;1757085;33;518403;24734;23691
62743;Sainte-Austreberthe;235;5812394;420994;124;4692096;111;1120298;24734;23692
02258;Dammard;221;5466163;185538;116;4254035;105;1212128;24734;23693
16366;Segonzac;1244;30769772;2010248;648;24523636;596;6246136;24735;23694
10124;Dierrey-Saint-Julien;133;3289731;129235;80;2686339;53;603392;24735;23695
82120;Montastruc;152;3759745;196314;84;3056099;68;703646;24735;23696
89045;Bleigny-le-Carreau;156;3858698;149024;95;3144568;61;714130;24735;23697
30270;Saint-Jean-du-Pin;765;18922674;1010344;446;15262977;319;3659697;24736;23698
31311;La Magdelaine-sur-Tarn;496;12269036;413183;288;9655124;208;2613912;24736;23699
55301;Longchamps-sur-Aire;73;1805768;104235;34;1373119;39;432649;24737;23700
44012;La Bernerie-en-Retz;1694;41907291;1950126;969;33384431;725;8522860;24739;23701
54264;Houdelmont;115;2844953;98829;67;2294257;48;550696;24739;23702
38044;Biol;719;17787811;663369;442;14331598;277;3456213;24740;23703
65350;Oursbelille;640;15833436;709375;381;12916911;259;2916525;24740;23704
19191;Saint-Cernin-de-Larche;319;7892183;282884;203;6403190;116;1488993;24740;23705
25460;Pointvillers;64;1583411;45103;43;1367808;21;215603;24741;23706
73308;Venthon;357;8832714;395554;232;7488437;125;1344277;24741;23707
68083;Eschbach-au-Val;202;4997824;182777;121;4070571;81;927253;24742;23708
61432;Saint-Michel-Tuboeuf;295;7299045;277847;200;6203205;95;1095840;24743;23709
77459;Sourdun;655;16206510;837355;419;13454884;236;2751626;24743;23710
13065;Mouriès;1950;48249740;2545890;1087;39555943;863;8693797;24743;23711
09265;Saint-Jean-du-Falga;1517;37535916;2135210;835;30198389;682;7337527;24744;23712
42228;Saint-Georges-Haute-Ville;693;17147476;614508;439;14152261;254;2995215;24744;23713
63395;Saint-Sandoux;449;11110711;474017;275;9435489;174;1675222;24745;23714
14420;Le Mesnil-Germain;143;3538604;183599;92;3029835;51;508769;24745;23715
30057;Cabrières;801;19821351;1058090;450;16083731;351;3737620;24746;23716
64535;Tarsacq;251;6211963;192746;150;4918312;101;1293651;24749;23717
30101;Deaux;333;8241452;315725;204;6834789;129;1406663;24749;23718
76382;Lanquetot;540;13364612;537006;356;11335287;184;2029325;24749;23719
57047;Bambiderstroff;537;13290391;504624;329;10684120;208;2606271;24749;23720
21510;Prusly-sur-Ource;104;2573957;131843;73;2270867;31;303090;24750;23721
70324;Mailley-et-Chazelot;330;8167476;395351;211;6872925;119;1294551;24750;23722
68230;Nambsheim;305;7548774;323004;201;6467635;104;1081139;24750;23723
76328;Grigneuseville;158;3910513;113186;96;3157297;62;753216;24750;23724
89360;Saint-Maurice-le-Vieil;197;4875796;226860;120;4114183;77;761613;24750;23725
61210;Joué-du-Plain;121;2994815;93728;63;2347722;58;647093;24751;23726
25214;Écot;259;6410562;227672;173;5434734;86;975828;24751;23727
40108;Gastes;354;8762081;511798;199;7049319;155;1712762;24752;23728
02049;Barisis;407;10074126;475731;237;8154972;170;1919154;24752;23729
67287;Melsheim;298;7376283;265057;178;6014900;120;1361383;24753;23730
88528;Xamontarupt;81;2005014;99687;49;1725249;32;279765;24753;23731
49022;Beaulieu-sur-Layon;696;17228460;604796;411;13635832;285;3592628;24754;23732
85015;Beaufou;631;15619769;587909;359;12337073;272;3282696;24754;23733
71072;Cersot;65;1609037;78953;36;1240418;29;368619;24754;23734
44106;Les Moutiers-en-Retz;867;21462118;895627;524;17505620;343;3956498;24754;23735
35156;Longaulnay;269;6658983;252959;155;5294877;114;1364106;24755;23736
54415;Pagny-sur-Moselle;2150;53222459;2125578;1340;43922614;810;9299845;24755;23737
72141;Gesnes-le-Gandelin;471;11659656;529062;289;9325354;182;2334302;24755;23738
11441;Vinassan;1391;34434394;1504909;849;28392632;542;6041762;24755;23739
83030;Camps-la-Source;975;24136627;1130931;580;19643328;395;4493299;24756;23740
49265;Saint-Aubin-de-Luigné;570;14111293;336508;344;11383048;226;2728245;24757;23741
28157;Fontenay-sur-Conie;79;1955778;90588;52;1654274;27;301504;24757;23742
62127;Bezinghem;157;3886810;129385;81;2866142;76;1020668;24757;23743
62553;Marest;143;3540470;155279;72;2691447;71;849023;24759;23744
07036;Bogy;188;4654639;98937;113;3721730;75;932909;24759;23745
80249;Domqueur;149;3689051;169134;62;2809350;87;879701;24759;23746
54195;Flainval;95;2352138;86923;54;1911079;41;441059;24759;23747
77025;Bazoches-lès-Bray;472;11686476;496299;312;9743299;160;1943177;24759;23748
45039;Bonnée;373;9235360;396403;258;7946808;115;1288552;24760;23749
71279;Marizy;241;5967120;367683;126;4745083;115;1222037;24760;23750
02336;Frières-Faillouël;469;11612511;413984;299;9684710;170;1927801;24760;23751
69016;Azolette;60;1485635;63880;31;1112765;29;372870;24761;23752
59648;Wattignies;7258;179714607;10538785;4090;148279377;3168;31435230;24761;23753
14550;Rumesnil;49;1213400;61249;26;960316;23;253084;24763;23754
76644;Saint-Rémy-Boscrocourt;400;9905545;430372;244;8147330;156;1758215;24764;23755
14627;Saint-Martin-de-Mieux;201;4977788;146955;124;4005960;77;971828;24765;23756
54324;Lorey;55;1362089;34091;38;1138220;17;223869;24765;23757
48033;Canilhac;69;1708821;31153;38;1247900;31;460921;24766;23758
42018;Bessey;203;5027503;140268;131;4149116;72;878387;24766;23759
24144;Creyssac;49;1213539;68741;30;1013991;19;199548;24766;23760
57746;Willerwald;824;20407840;1057456;480;16571026;344;3836814;24767;23761
01358;Saint-Germain-les-Paroisses;214;5300187;227366;132;4332384;82;967803;24767;23762
87185;Saint-Victurnien;918;22737057;1105084;553;18608849;365;4128208;24768;23763
55058;Boncourt-sur-Meuse;164;4062202;155253;93;3112471;71;949731;24770;23764
31487;Saint-Ignan;124;3071509;111405;80;2590059;44;481450;24770;23765
64138;Bordes;1325;32821327;1167364;805;27135557;520;5685770;24771;23766
16349;Sainte-Sévère;290;7183655;393628;176;6095325;114;1088330;24771;23767
79276;Saint-Martin-de-Saint-Maixent;527;13054974;410769;321;10513808;206;2541166;24772;23768
44188;Saint-Philbert-de-Grand-Lieu;4105;101690073;3299909;2477;82269489;1628;19420584;24772;23769
01036;Belmont-Luthézieu;293;7258303;329401;180;5928622;113;1329681;24772;23770
80237;Démuin;234;5796749;229155;141;4656638;93;1140111;24772;23771
50079;Breuville;205;5078388;222304;123;4194740;82;883648;24773;23772
95604;Survilliers;2192;54303163;2623505;1553;47289399;639;7013764;24773;23773
57690;Valmont;1728;42808632;2268554;935;34593616;793;8215016;24774;23774
80718;Saint-Sauveur;772;19125447;963603;496;16384961;276;2740486;24774;23775
46070;Cieurac;245;6069618;250792;159;5159703;86;909915;24774;23776
39046;Bellecombe;39;966205;40398;23;773152;16;193053;24774;23777
89285;Pailly;127;3146419;152156;73;2541001;54;605418;24775;23778
63082;Champs;198;4905519;234457;116;3889940;82;1015579;24775;23779
50105;Catteville;50;1238781;57338;25;940909;25;297872;24776;23780
21611;Sombernon;519;12858703;488873;294;9922700;225;2936003;24776;23781
27617;Saussay-la-Campagne;244;6045341;237448;154;5014846;90;1030495;24776;23782
57171;Delme;510;12636000;487735;279;9933782;231;2702218;24776;23783
18241;Sancerre;918;22745742;1785539;467;18577710;451;4168032;24777;23784
08352;Raillicourt;113;2799900;118686;75;2274548;38;525352;24778;23785
59119;Buysscheure;250;6194628;251812;138;4740153;112;1454475;24779;23786
22368;Tréméreuc;353;8747131;272348;226;7333490;127;1413641;24779;23787
08368;Roizy;118;2923982;129848;68;2470491;50;453491;24780;23788
40162;Lucbardez-et-Bargues;271;6715254;266384;170;5425640;101;1289614;24780;23789
60348;Larbroye;235;5823216;257360;148;4823705;87;999511;24780;23790
22118;Lanvallay;2262;56052122;2566462;1341;46096489;921;9955633;24780;23791
45156;Girolles;360;8921442;363232;225;7285076;135;1636366;24782;23792
55457;Saint-Hilaire-en-Woëvre;86;2131240;68688;51;1664508;35;466732;24782;23793
42336;Virigneux;274;6790240;170324;151;5294531;123;1495709;24782;23794
87113;Le Palais-sur-Vienne;3266;80937710;3709238;2068;68237822;1198;12699888;24782;23795
56246;Le Sourn;1106;27409870;1154101;705;22820059;401;4589811;24783;23796
36215;Ségry;264;6542838;256682;166;5380429;98;1162409;24783;23797
54426;Pierre-la-Treiche;289;7162486;302342;191;6049746;98;1112740;24784;23798
17427;Siecq;118;2924684;214480;60;2373643;58;551041;24785;23799
80079;Belleuse;166;4114406;141254;92;3208665;74;905741;24786;23800
80366;Fricourt;251;6221224;299420;162;5224169;89;997055;24786;23801
28014;Aunay-sous-Crécy;316;7832621;380983;198;6533239;118;1299382;24787;23802
17323;Saint-Denis-d'Oléron;912;22605576;1530016;511;18521206;401;4084370;24787;23803
37089;Cravant-les-Côteaux;429;10633689;676408;245;8762010;184;1871679;24787;23804
38183;Granieu;225;5577190;187139;143;4583032;82;994158;24788;23805
31382;Montgras;55;1363315;48867;31;1074435;24;288880;24788;23806
47051;Castelculier;1295;32100412;1409851;803;26379141;492;5721271;24788;23807
85089;La Ferrière;2515;62342169;2435790;1621;52009565;894;10332604;24788;23808
28419;Vitray-en-Beauce;158;3916569;117019;92;3047607;66;868962;24788;23809
26115;Divajeu;305;7560671;333884;181;6141987;124;1418684;24789;23810
53009;Arquenay;280;6941193;163967;170;5672823;110;1268370;24790;23811
37222;Saint-Jean-Saint-Germain;397;9841760;438763;233;7896611;164;1945149;24790;23812
54509;Sommerviller;508;12593497;501536;349;10660798;159;1932699;24790;23813
62526;Longueville;69;1710550;72842;36;1356641;33;353909;24791;23814
02803;La Ville-aux-Bois-lès-Pontavert;69;1710565;83032;43;1434212;26;276353;24791;23815
02412;Launoy;44;1090811;50717;22;771594;22;319217;24791;23816
27369;Lilly;35;867700;44910;17;688163;18;179537;24791;23817
02576;Osly-Courtil;163;4041066;195479;100;3359963;63;681103;24792;23818
47028;Birac-sur-Trec;411;10189730;477493;226;8273172;185;1916558;24793;23819
25122;Chapelle-d'Huin;217;5380080;175389;123;4272377;94;1107703;24793;23820
89104;Chichée;197;4884269;264490;118;4096563;79;787706;24793;23821
27350;Illiers-l'Évêque;547;13562074;586718;336;11035739;211;2526335;24794;23822
10220;Maizières-la-Grande-Paroisse;828;20529942;884651;523;16935048;305;3594894;24795;23823
62469;Inchy-en-Artois;326;8083374;568916;169;6381561;157;1701813;24796;23824
86027;Biard;920;22811994;1185720;556;19377604;364;3434390;24796;23825
54184;Essey-lès-Nancy;5053;125293146;7124551;3062;104965579;1991;20327567;24796;23826
19203;Sainte-Fortunade;1019;25267388;1025037;639;21017581;380;4249807;24796;23827
59567;Séranvillers-Forenville;185;4587340;204424;114;3896767;71;690573;24796;23828
40124;Herré;72;1785409;188384;31;1366297;41;419112;24797;23829
55380;Neuville-en-Verdunois;46;1140678;56546;29;996834;17;143844;24797;23830
57404;Lindre-Basse;132;3273272;190820;84;2847790;48;425482;24798;23831
85100;Givrand;1079;26756875;1102337;684;21885532;395;4871343;24798;23832
50126;Chavoy;61;1512681;36540;36;1162363;25;350318;24798;23833
14187;Coulonces;376;9324394;443188;246;7895409;130;1428985;24799;23834
57498;Neufchef;1348;33429161;1079752;671;23059113;677;10370048;24799;23835
41105;Josnes;489;12126958;519003;293;10020481;196;2106477;24800;23836
80349;Fransures;71;1760778;50822;40;1402198;31;358580;24800;23837
61204;L'Hermitière;131;3248768;119724;83;2719565;48;529203;24800;23838
78123;Carrières-sous-Poissy;8437;209238778;11778185;5200;176345221;3237;32893557;24800;23839
42133;Marcenod;291;7216885;116542;170;5574579;121;1642306;24800;23840
14626;Saint-Martin-de-Mailloc;433;10738618;379965;270;8783364;163;1955254;24801;23841
30313;Sauzet;366;9077007;489051;207;7337210;159;1739797;24801;23842
50045;Benoîtville;300;7440180;258798;177;6227093;123;1213087;24801;23843
59544;Saint-Saulve;6310;156494750;9552900;3473;128383786;2837;28110964;24801;23844
47246;Saint-Hilaire-de-Lusignan;767;19022532;932955;440;15569544;327;3452988;24801;23845
03156;Lusigny;884;21924308;933038;540;18108998;344;3815310;24801;23846
25612;Vieilley;355;8804623;324785;218;7191153;137;1613470;24802;23847
76450;Montroty;142;3521872;147648;100;3041023;42;480849;24802;23848
80262;Eaucourt-sur-Somme;216;5357243;238348;129;4405411;87;951832;24802;23849
55298;Loisey-Culey;244;6051727;210445;132;4721513;112;1330214;24802;23850
42146;Montarcher;31;768878;48428;18;648517;13;120361;24803;23851
08136;Daigny;188;4662897;174778;104;3387544;84;1275353;24803;23852
07143;Limony;401;9946026;431606;260;8181792;141;1764234;24803;23853
02774;Vendelles;63;1562608;102469;37;1279012;26;283596;24803;23854
38464;Saint-Victor-de-Cessieu;1071;26564392;874576;693;21796714;378;4767678;24803;23855
77398;Sablonnières;369;9152513;419689;215;7388353;154;1764160;24804;23856
44080;Lavau-sur-Loire;378;9375757;449682;231;7715843;147;1659914;24804;23857
26204;Montlaur-en-Diois;77;1909886;100885;37;1414005;40;495881;24804;23858
80455;Lachapelle;35;868143;33029;22;710695;13;157448;24804;23859
39185;Cuisia;226;5605816;287919;129;4509020;97;1096796;24804;23860
10194;Lévigny;58;1438665;81872;34;1198569;24;240096;24805;23861
19207;Saint-Germain-les-Vergnes;553;13717909;538051;325;10953431;228;2764478;24806;23862
21582;Santenay;518;12850063;816809;272;10054136;246;2795927;24807;23863
37273;La Ville-aux-Dames;2715;67354142;3117630;1802;57644692;913;9709450;24808;23864
40046;Biscarrosse;8054;199805767;10182835;4825;164106895;3229;35698872;24808;23865
45287;Saint-Loup-de-Gonois;51;1265259;92380;29;1096690;22;168569;24809;23866
28311;Le Puiset;230;5706138;288040;143;4765400;87;940738;24809;23867
52282;Leffonds;180;4465843;201345;116;3652094;64;813749;24810;23868
17140;Dolus-d'Oléron;2068;51308129;3288253;1158;41165251;910;10142878;24811;23869
61095;La Chapelle-Biche;254;6301891;184638;169;5312434;85;989457;24811;23870
91067;Blandy;64;1587891;57373;46;1319039;18;268852;24811;23871
67220;Ingenheim;175;4341892;202098;103;3514487;72;827405;24811;23872
41115;Lignières;218;5408764;193941;142;4594502;76;814262;24811;23873
31110;Cassagne;367;9105734;374286;216;7511535;151;1594199;24811;23874
49019;Bauné;777;19278615;532577;489;15700594;288;3578021;24812;23875
49217;Montreuil-sur-Maine;322;7989624;289589;186;6176686;136;1812938;24812;23876
83056;Figanières;1392;34539212;1568073;834;28362422;558;6176790;24813;23877
76654;Saint-Vaast-du-Val;204;5062030;146049;123;4077796;81;984234;24814;23878
69269;Yzeron;547;13573429;688722;322;11429970;225;2143459;24814;23879
40163;Lüe;291;7221698;495584;169;5643925;122;1577773;24817;23880
63472;Yronde-et-Buron;377;9355962;413020;242;7821463;135;1534499;24817;23881
26099;Colonzelle;289;7172476;299792;163;5880927;126;1291549;24818;23882
89093;Chaumont;333;8264558;410790;214;6910920;119;1353638;24818;23883
57614;Saint-Jean-Kourtzerode;137;3400206;99153;83;2709008;54;691198;24819;23884
31558;Toutens;136;3375419;95922;83;2793017;53;582402;24819;23885
39501;Sampans;480;11913280;431305;316;9983372;164;1929908;24819;23886
44082;Ligné;2147;53287271;1563423;1318;42736467;829;10550804;24819;23887
39535;Tourmont;258;6403645;278990;163;5279542;95;1124103;24820;23888
70376;Nantilly;259;6428638;243739;158;5197665;101;1230973;24821;23889
11029;Belcastel-et-Buc;36;893565;29669;20;716352;16;177213;24821;23890
39372;Mournans-Charbonny;52;1290728;44801;32;1053021;20;237707;24822;23891
70250;Franchevelle;208;5162949;260779;112;3970743;96;1192206;24822;23892
80590;Neuilly-l'Hôpital;166;4120594;181004;95;3376567;71;744027;24823;23893
39006;Aiglepierre;218;5411503;233168;134;4421358;84;990145;24823;23894
72152;Juillé;246;6106687;285434;144;4989707;102;1116980;24824;23895
81035;Bournazel;97;2408017;95460;51;1903358;46;504659;24825;23896
60385;Marolles;341;8465655;421767;198;6967612;143;1498043;24826;23897
89155;Escolives-Sainte-Camille;391;9707419;457741;256;8209760;135;1497659;24827;23898
54429;Pierreville;176;4369648;185613;115;3698229;61;671419;24828;23899
16243;Nercillac;583;14474478;788554;363;12241928;220;2232550;24828;23900
29079;Henvic;710;17627679;850801;411;14145026;299;3482653;24828;23901
14255;Étouvy;149;3699450;147082;95;3106566;54;592884;24829;23902
82126;Monteils;703;17454929;779684;397;13994089;306;3460840;24829;23903
81299;Teyssode;203;5040378;264867;104;3995016;99;1045362;24829;23904
54158;Dolcourt;53;1315972;39704;31;959238;22;356734;24830;23905
78501;Porcheville;1525;37866707;1815954;953;32246438;572;5620269;24831;23906
29066;Guengat;897;22273388;941620;548;18540818;349;3732570;24831;23907
80605;Offoy;121;3004606;169769;74;2503767;47;500839;24831;23908
80769;Treux;123;3054312;132225;69;2410543;54;643769;24832;23909
25374;Mercey-le-Grand;240;5959986;179711;155;4883087;85;1076899;24833;23910
54440;Puxe;55;1365832;45905;30;1055316;25;310516;24833;23911
81204;Payrin-Augmontel;1207;29974042;1431527;701;24013553;506;5960489;24834;23912
50558;Saint-Symphorien-le-Valois;449;11150322;440087;269;8911518;180;2238804;24834;23913
27011;Amfreville-la-Campagne;459;11398780;481762;293;9504807;166;1893973;24834;23914
16088;Chassors;608;15099757;694884;342;12111628;266;2988129;24835;23915
45010;Ascoux;528;13113737;541109;323;10954982;205;2158755;24837;23916
62167;Boursin;123;3054919;146837;77;2553586;46;501333;24837;23917
89109;Cisery;31;769941;34315;19;671347;12;98594;24837;23918
61101;Le Château-d'Almenêches;91;2260281;68628;53;1803170;38;457111;24838;23919
72340;Souligné-sous-Ballon;572;14207996;531953;360;11600354;212;2607642;24839;23920
81228;Roquemaure;204;5067364;247362;120;4017209;84;1050155;24840;23921
95351;Louvres;5033;125024270;5809750;3251;105731728;1782;19292542;24841;23922
45112;La Cour-Marigny;189;4695034;328710;109;3811425;80;883609;24841;23923
80507;Marcelcave;555;13787754;698893;338;11267815;217;2519939;24843;23924
45332;Varennes-Changy;854;21216416;1103632;480;16785823;374;4430593;24844;23925
25220;Épeugney;290;7204763;294752;185;5979400;105;1225363;24844;23926
86053;Champigny-le-Sec;545;13540412;570001;314;10841321;231;2699091;24845;23927
61373;Sainte-Céronne-lès-Mortagne;143;3552812;142766;89;2909500;54;643312;24845;23928
55479;Seigneulles;103;2559050;123748;65;2160327;38;398723;24845;23929
39079;Briod;109;2708125;75192;75;2261612;34;446513;24845;23930
55069;Brabant-le-Roi;125;3105796;167623;72;2556462;53;549334;24846;23931
59238;Flines-lès-Mortagne;862;21418703;1114143;492;17474153;370;3944550;24848;23932
2A362;Zonza;1529;37992860;2292738;833;30907355;696;7085505;24848;23933
17100;Chérac;637;15828737;894542;364;12966238;273;2862499;24849;23934
42184;Riorges;6189;153790989;7572467;3746;126414855;2443;27376134;24849;23935
85226;Saint-Hilaire-de-Riez;6804;169073896;8461054;4223;139460678;2581;29613218;24849;23936
46238;Rignac;164;4075289;277410;81;3247696;83;827593;24849;23937
60685;Villers-Saint-Sépulcre;482;11977543;496852;316;10077505;166;1900038;24850;23938
44074;Indre;2105;52308928;2145062;1392;43840349;713;8468579;24850;23939
01010;Anglefort;534;13270235;412680;299;9989529;235;3280706;24851;23940
40301;Siest;49;1217728;35657;25;877240;24;340488;24852;23941
38037;Bellegarde-Poussieu;497;12351692;469883;317;10183761;180;2167931;24852;23942
61285;Montgaroult;189;4697281;214801;110;3790294;79;906987;24853;23943
89332;Saint-Agnan;472;11731320;445060;313;9775535;159;1955785;24854;23944
41006;Autainville;221;5492957;253391;132;4569709;89;923248;24855;23945
49246;Les Ponts-de-Cé;6360;158079715;7492651;3752;128867740;2608;29211975;24855;23946
65425;Siarrouy;212;5269376;208128;129;4212595;83;1056781;24856;23947
42100;La Gimond;126;3132009;95331;74;2561896;52;570113;24857;23948
81112;Labastide-de-Lévis;532;13224180;582248;317;10878686;215;2345494;24857;23949
84067;Loriol-du-Comtat;1295;32190585;1490352;767;26436618;528;5753967;24858;23950
62645;Oye-Plage;2688;66817262;2845279;1550;53806305;1138;13010957;24858;23951
68282;Romagny;127;3156977;130321;82;2651562;45;505415;24858;23952
35112;Fleurigné;475;11807821;325621;287;9209609;188;2598212;24859;23953
27182;Courteilles;87;2162705;99607;62;1949634;25;213071;24859;23954
03080;Cognat-Lyonne;357;8874559;398701;221;7432121;136;1442438;24859;23955
26144;Grane;1004;24958474;1310071;584;20279702;420;4678772;24859;23956
81106;Grazac;274;6811670;291390;155;5567998;119;1243672;24860;23957
26234;Piégros-la-Clastre;458;11385935;664987;256;8987081;202;2398854;24860;23958
08263;Lumes;596;14816791;531446;388;12089912;208;2726879;24860;23959
71465;Saint-Micaud;125;3107656;120573;73;2432031;52;675625;24861;23960
49288;Saint-Jean-de-la-Croix;132;3281780;142244;88;2770418;44;511362;24862;23961
72025;Bazouges-sur-le-Loir;647;16085878;673777;389;13170803;258;2915075;24862;23962
30004;Aigues-Vives;1665;41397151;2436840;921;33434156;744;7962995;24863;23963
16016;Ansac-sur-Vienne;478;11884890;426864;234;9291069;244;2593821;24864;23964
11201;Leuc;419;10417950;493360;251;8516057;168;1901893;24864;23965
82161;Saint-Étienne-de-Tulmont;1946;48386298;2309482;1094;39969291;852;8417007;24864;23966
56260;Vannes;31255;777150888;51114561;17898;647014808;13357;130136080;24865;23967
2A085;Cauro;749;18623988;991476;426;15225282;323;3398706;24865;23968
64210;Escurès;80;1989219;96804;49;1711083;31;278136;24865;23969
27179;Courbépine;390;9697611;461041;233;7972571;157;1725040;24866;23970
14070;Beuvron-en-Auge;146;3630467;235498;76;3063142;70;567325;24866;23971
44212;Vallet;4287;106608571;3545716;2514;85897696;1773;20710875;24868;23972
76576;Saint-Eustache-la-Forêt;564;14025736;613338;351;11490516;213;2535220;24868;23973
61263;Ménil-Erreux;111;2760385;118006;67;2244700;44;515685;24868;23974
37049;Chambourg-sur-Indre;695;17283705;684120;430;14082720;265;3200985;24869;23975
33524;Tarnès;141;3506610;142925;88;2884419;53;622191;24870;23976
26322;Saint-Pantaléon-les-Vignes;259;6441419;372688;143;5040700;116;1400719;24870;23977
10082;Chapelle-Vallon;124;3083959;222645;70;2458465;54;625494;24871;23978
60180;Crillon;241;5993855;233000;158;5057070;83;936785;24871;23979
30290;Saint-Paulet-de-Caisson;971;24149589;1041351;562;19778987;409;4370602;24871;23980
06025;Le Broc;728;18106174;890537;440;14881107;288;3225067;24871;23981
14318;Graye-sur-Mer;343;8530796;541033;194;7270965;149;1259831;24871;23982
37136;Le Louroux;240;5969324;241378;141;4827266;99;1142058;24872;23983
16303;Saint-Bonnet;210;5223197;402004;110;4217387;100;1005810;24872;23984
10383;Trancault;93;2313213;202624;44;1853966;49;459247;24873;23985
17006;Allas-Champagne;135;3357958;237563;76;2726929;59;631029;24874;23986
67498;Uhrwiller;371;9228213;381702;236;7756451;135;1471762;24874;23987
28155;Fontaine-les-Ribouts;105;2611768;96370;69;2202413;36;409355;24874;23988
57014;Altrippe;195;4850477;167477;114;3852782;81;997695;24874;23989
24022;Badefols-sur-Dordogne;118;2935275;134783;67;2411281;51;523994;24875;23990
32153;Haulies;65;1616891;53350;31;1154728;34;462163;24875;23991
45190;Mainvilliers;131;3258671;153153;86;2775692;45;482979;24875;23992
64367;Maslacq;454;11293560;379878;261;8772971;193;2520589;24876;23993
69064;Condrieu;2174;54079949;3241866;1246;44354232;928;9725717;24876;23994
54586;Viterne;398;9900651;437086;251;8228434;147;1672217;24876;23995
89271;Moulins-en-Tonnerrois;61;1517532;73488;33;1217392;28;300140;24878;23996
77098;Châteaubleau;182;4527929;179764;114;3748292;68;779637;24879;23997
71070;Buxy;1205;29980402;1580391;675;24609356;530;5371046;24880;23998
30302;Saint-Victor-la-Coste;1021;25402601;1136511;613;20696734;408;4705867;24880;23999
58247;Saint-Jean-aux-Amognes;255;6344590;279663;159;5259717;96;1084873;24881;24000
67504;Valff;704;17516103;748532;458;14608393;246;2907710;24881;24001
46077;Cours;162;4030922;167034;100;3303903;62;727019;24882;24002
03197;Neuilly-le-Réal;769;19134690;845716;466;15627806;303;3506884;24883;24003
28318;Romilly-sur-Aigre;250;6220831;340762;118;4950565;132;1270266;24883;24004
77261;Lorrez-le-Bocage-Préaux;681;16945789;876737;399;14055286;282;2890503;24884;24005
30278;Saint-Laurent-des-Arbres;1345;33469452;1499631;799;27552364;546;5917088;24884;24006
25539;Seloncourt;3449;85828146;4403872;2196;71623060;1253;14205086;24885;24007
34085;Coulobres;189;4703349;223855;100;3858641;89;844708;24885;24008
28101;Civry;179;4454515;271214;97;3456763;82;997752;24886;24009
31467;Saint-Alban;3118;77593372;3449503;2000;65224866;1118;12368506;24886;24010
28283;Nottonville;183;4554186;256078;100;3639807;83;914379;24886;24011
60015;Angy;646;16077072;737962;418;13474245;228;2602827;24887;24012
39526;Tavaux;2257;56172281;2612645;1426;46534615;831;9637666;24888;24013
01172;Germagnat;78;1941339;104608;47;1533062;31;408277;24889;24014
33342;Puisseguin;510;12693399;783764;265;10098396;245;2595003;24889;24015
68073;Dolleren;234;5824471;221090;153;4799319;81;1025152;24891;24016
09305;Tabre;197;4903568;234405;114;3823427;83;1080141;24891;24017
76183;Colleville;388;9657815;392626;251;8004445;137;1653370;24891;24018
57517;Obergailbach;151;3758584;113388;89;3033491;62;725093;24891;24019
30103;Domazan;504;12545291;634976;303;10652282;201;1893009;24891;24020
55299;Loison;43;1070335;26550;23;754965;20;315370;24892;24021
37099;Druye;484;12047590;446828;297;9873611;187;2173979;24892;24022
36059;Condé;127;3161350;131624;89;2853438;38;307912;24893;24023
21041;Avot;83;2066080;83697;50;1682809;33;383271;24893;24024
65146;Chis;142;3534862;122076;87;2869706;55;665156;24893;24025
44183;Saint-Molf;1197;29798646;1104650;716;23582421;481;6216225;24894;24026
79009;Amuré;222;5526593;221328;129;4501681;93;1024912;24895;24027
62584;Mont-Bernanchon;679;16903628;629245;415;13884614;264;3019014;24895;24028
28060;Briconville;96;2389929;67669;66;2052328;30;337601;24895;24029
21429;Montigny-Montfort;174;4331781;205410;105;3543947;69;787834;24895;24030
46038;Bretenoux;803;19990994;1194960;418;16056054;385;3934940;24895;24031
42007;Arcinges;93;2315286;51956;53;1729095;40;586191;24896;24032
50297;La Meauffe;556;13842038;492000;355;11225013;201;2617025;24896;24033
24416;Saint-Germain-de-Belvès;91;2265549;117521;53;1864088;38;401461;24896;24034
85047;Challans;10978;273322892;14092249;6145;219899422;4833;53423470;24897;24035
01319;Relevant;247;6149807;249118;155;5115031;92;1034776;24898;24036
59532;Saint-Georges-sur-l'Aa;142;3535581;150186;79;2820007;63;715574;24898;24037
02360;Guignicourt;1156;28783030;1380240;667;23405111;489;5377919;24899;24038
27620;Selles;230;5726837;247044;142;4752871;88;973966;24899;24039
80114;Bosquel;170;4233221;180502;111;3558366;59;674855;24901;24040
76120;Bosc-Bordel;209;5204449;192156;130;4201024;79;1003425;24902;24041
22356;Trégomeur;448;11156128;398183;273;9110768;175;2045360;24902;24042
37158;Montreuil-en-Touraine;390;9711813;368658;258;8172737;132;1539076;24902;24043
02754;Ugny-le-Gay;93;2315915;107853;58;1908761;35;407154;24902;24044
39164;Conliège;417;10384364;520023;260;8502316;157;1882048;24903;24045
38019;Auberives-sur-Varèze;716;17830454;732902;437;14534091;279;3296363;24903;24046
36040;La Chapelle-Orthemale;73;1817919;98096;43;1403426;30;414493;24903;24047
71325;La Motte-Saint-Jean;678;16885057;828240;394;13747477;284;3137580;24904;24048
89459;Villeneuve-la-Dondagre;140;3486619;136724;93;2976614;47;510005;24904;24049
27224;Épreville-près-le-Neubourg;248;6176432;241041;166;5271541;82;904891;24905;24050
77102;Châtenoy;97;2415862;98583;58;1958778;39;457084;24906;24051
62456;Houchin;355;8841654;440029;213;7332671;142;1508983;24906;24052
83079;La Môle;694;17284945;937076;413;14476275;281;2808670;24906;24053
14097;Bretteville-le-Rabet;114;2839375;111303;56;2121987;58;717388;24907;24054
38552;Villard-Saint-Christophe;195;4857012;168287;126;3989184;69;867828;24908;24055
50235;La Haye-d'Ectot;130;3238010;133286;76;2567459;54;670551;24908;24056
36195;Saint-Georges-sur-Arnon;299;7447464;332051;200;6370031;99;1077433;24908;24057
14037;Banneville-sur-Ajon;216;5380137;220051;136;4518416;80;861721;24908;24058
89329;Rugny;57;1419789;89435;32;1165581;25;254208;24909;24059
72318;Saint-Rigomer-des-Bois;264;6576133;284571;174;5539788;90;1036345;24910;24060
59486;Râches;1415;35248481;1273554;764;28201676;651;7046805;24911;24061
89094;Chaumot;375;9341580;457856;241;7747313;134;1594267;24911;24062
39269;Jeurre;135;3363025;113705;93;2837795;42;525230;24911;24063
59358;Looberghe;616;15345460;714984;367;12446892;249;2898568;24911;24064
21078;Bissey-la-Pierre;38;946641;66715;21;797658;17;148983;24912;24065
85020;Benet;2058;51268200;2346375;1221;41794266;837;9473934;24912;24066
37053;Chanceaux-près-Loches;69;1718910;62455;45;1397470;24;321440;24912;24067
57566;Réding;1281;31912342;1314008;788;26117561;493;5794781;24912;24068
60254;Francières;280;6975454;257804;179;5845277;101;1130177;24912;24069
71505;Savianges;50;1245635;55499;23;948063;27;297572;24913;24070
48157;Sainte-Hélène;43;1071262;65074;24;852021;19;219241;24913;24071
61162;La Ferrière-au-Doyen;95;2366845;96715;54;1949581;41;417264;24914;24072
57087;Bisten-en-Lorraine;153;3811883;257502;95;3180671;58;631212;24914;24073
34139;Lieuran-lès-Béziers;711;17714429;733707;409;14405877;302;3308552;24915;24074
68058;Buhl;1705;42479843;1934050;1008;34241769;697;8238074;24915;24075
11011;Aragon;235;5855264;350131;133;4895144;102;960120;24916;24076
63266;Orsonnette;116;2890274;117877;78;2437146;38;453128;24916;24077
14176;Conteville;53;1320562;40888;35;1108087;18;212475;24916;24078
63424;Surat;271;6752370;269166;177;5584092;94;1168278;24916;24079
80485;Loeuilly;445;11087978;542308;276;9150792;169;1937186;24917;24080
22152;Minihy-Tréguier;640;15947211;804697;366;12978203;274;2969008;24918;24081
74151;Lornay;226;5631438;136965;141;4491277;85;1140161;24918;24082
80809;Vismes;219;5457054;227636;129;4353018;90;1104036;24918;24083
62113;Berles-Monchel;227;5656440;233599;124;4408704;103;1247736;24918;24084
28258;Montainville;192;4784511;221707;131;4177478;61;607033;24919;24085
25101;Burgille;247;6155081;229119;160;5165193;87;989888;24919;24086
73241;Sainte-Hélène-sur-Isère;635;15823894;817445;417;13114955;218;2708939;24920;24087
19123;Malemort-sur-Corrèze;4449;110867108;5677173;2813;93774408;1636;17092700;24920;24088
58119;Frasnay-Reugny;39;971869;80356;15;695543;24;276326;24920;24089
29216;Pluguffan;1984;49441746;2082389;1247;41143445;737;8298301;24920;24090
86259;Senillé;414;10317177;561950;237;8342829;177;1974348;24921;24091
10428;Ville-sur-Terre;68;1694630;71921;42;1321103;26;373527;24921;24092
08220;Hauviné;156;3887750;101387;98;3136809;58;750941;24921;24093
80548;Millencourt-en-Ponthieu;177;4411278;156058;104;3444564;73;966714;24922;24094
89077;Champs-sur-Yonne;956;23826114;1767475;575;20047023;381;3779091;24923;24095
60492;Pimprez;411;10243335;389207;281;8648466;130;1594869;24923;24096
60404;Mogneville;731;18218830;708783;491;15702954;240;2515876;24923;24097
39127;Chaussenans;53;1320946;58557;32;1048953;21;271993;24924;24098
60431;Morlincourt;275;6854424;315473;175;5655386;100;1199038;24925;24099
50132;Les Chéris;131;3265214;114990;79;2649334;52;615880;24925;24100
01273;Neuville-sur-Ain;843;21013353;778890;513;17168161;330;3845192;24927;24101
03111;Estivareilles;633;15779070;807670;397;13018417;236;2760653;24927;24102
72178;Maisoncelles;95;2368123;42569;51;1884255;44;483868;24928;24103
28044;Boisgasson;60;1495707;99170;29;1148017;31;347690;24928;24104
83057;Flassans-sur-Issole;1744;43476341;2241417;966;35051935;778;8424406;24929;24105
80292;Étalon;70;1745041;116733;38;1362184;32;382857;24929;24106
89384;Senan;409;10196114;490060;233;8164821;176;2031293;24929;24107
70232;Ferrières-lès-Scey;73;1819890;56065;40;1412838;33;407052;24930;24108
17066;Brie-sous-Archiac;132;3290803;135020;62;2435339;70;855464;24930;24109
49040;Bouzillé;798;19894536;989135;450;15652176;348;4242360;24930;24110
38194;Izeaux;1101;27449139;1117308;682;22944459;419;4504680;24931;24111
23142;Néoux;180;4487737;334927;80;3468644;100;1019093;24932;24112
02429;Lierval;60;1495926;71995;34;1139038;26;356888;24932;24113
21308;Grignon;128;3191322;156489;77;2630301;51;561021;24932;24114
02494;Monceau-sur-Oise;67;1670510;86054;39;1354717;28;315793;24933;24115
25015;Amancey;349;8701733;344957;182;6538415;167;2163318;24933;24116
01159;Feillens;1766;44032800;2031125;1100;36427055;666;7605745;24934;24117
46175;Lissac-et-Mouret;484;12067955;477562;296;9974508;188;2093447;24934;24118
64094;Bardos;863;21517864;1264170;452;17055988;411;4461876;24934;24119
74085;Les Contamines-Montjoie;700;17453829;910021;423;14218287;277;3235542;24934;24120
53129;Launay-Villiers;181;4513088;123668;110;3648633;71;864455;24934;24121
67204;Hoenheim;6108;152298436;7609951;3978;128861512;2130;23436924;24934;24122
21112;Broin;209;5211291;135430;142;4328483;67;882808;24934;24123
33222;Lalande-de-Pomerol;353;8801859;457753;210;7392705;143;1409154;24934;24124
88106;Ban-sur-Meurthe-Clefcy;484;12068640;386696;285;9727523;199;2341117;24935;24125
14554;Saint-Aignan-de-Cramesnil;258;6433287;244982;148;5103768;110;1329519;24935;24126
38366;Saint-Baudille-et-Pipet;154;3840213;197768;77;3040518;77;799695;24936;24127
61256;Médavy;74;1845311;75887;44;1447388;30;397923;24937;24128
60388;Martincourt;69;1720636;38574;49;1415152;20;305484;24937;24129
72326;Saosnes;104;2593435;118848;68;2170198;36;423237;24937;24130
25424;Nods;272;6782912;319538;145;5103743;127;1679169;24937;24131
59393;Maulde;508;12668309;550995;324;10886647;184;1781662;24938;24132
72107;Crannes-en-Champagne;173;4314500;194189;107;3512173;66;802327;24939;24133
35016;Baulon;952;23742897;775831;558;18808127;394;4934770;24940;24134
80623;Piennes-Onvillers;190;4738783;274950;115;4040635;75;698148;24941;24135
70534;Vellefrie;65;1621170;60093;40;1310317;25;310853;24941;24136
87001;Aixe-sur-Vienne;3247;80983686;3991528;1936;67609955;1311;13373731;24941;24137
38276;Nivolas-Vermelle;1340;33423120;1842628;782;27476168;558;5946952;24943;24138
62385;Grand-Rullecourt;205;5113433;225659;90;3848086;115;1265347;24944;24139
59516;Rubrouck;436;10875539;447423;233;8565802;203;2309737;24944;24140
41224;Saint-Marc-du-Cor;106;2644092;125446;69;2217007;37;427085;24944;24141
76092;Beuzevillette;320;7982475;235301;211;6597669;109;1384806;24945;24142
02747;Trefcon;46;1147481;60684;29;966878;17;180603;24945;24143
60451;Neuilly-sous-Clermont;858;21404338;935112;589;18492203;269;2912135;24947;24144
60159;Compiègne;22532;562103584;40759244;12059;462893535;10473;99210049;24947;24145
05079;Le Monêtier-les-Bains;662;16515249;1119368;397;13569453;265;2945796;24948;24146
27037;Barc;552;13771827;655381;355;11531104;197;2240723;24949;24147
58105;Druy-Parigny;183;4565734;128968;103;3580191;80;985543;24949;24148
37201;Rivière;403;10055118;464570;254;8384625;149;1670493;24951;24149
29238;Roscanvel;494;12325690;607173;290;9998373;204;2327317;24951;24150
38476;Savas-Mépin;410;10229835;457658;267;8764355;143;1465480;24951;24151
80069;Beaumont-Hamel;112;2794498;138680;67;2358302;45;436196;24951;24152
24026;Bassillac;971;24227432;1124203;619;20108003;352;4119429;24951;24153
30050;Bragassargues;83;2070942;132299;51;1766266;32;304676;24951;24154
22117;Lantic;785;19586810;665000;502;15928601;283;3658209;24951;24155
31320;Marquefave;544;13573758;679100;316;11038943;228;2534815;24952;24156
52106;Chanoy;72;1796575;55520;52;1552119;20;244456;24952;24157
79302;Saivres;760;18964817;917438;450;15375963;310;3588854;24954;24158
27325;Hecmanville;80;1996310;115766;47;1601001;33;395309;24954;24159
50610;Urville;100;2495397;82386;57;1985478;43;509919;24954;24160
73104;Dullin;213;5315273;206268;135;4347248;78;968025;24954;24161
59310;Hon-Hergies;442;11029825;629704;246;8834807;196;2195018;24954;24162
38280;Notre-Dame-de-Vaulx;299;7461400;329242;198;6336913;101;1124487;24955;24163
73119;Freney;54;1347549;38176;32;1084853;22;262696;24955;24164
76048;Avesnes-en-Bray;156;3892994;139841;101;3326340;55;566654;24955;24165
89457;Villemer;146;3643535;156469;87;2879129;59;764406;24956;24166
63470;Volvic;2394;59744763;2649478;1482;50078864;912;9665899;24956;24167
39279;Larnaud;305;7611650;289647;194;6322194;111;1289456;24956;24168
84047;Gargas;1654;41277715;1952095;1007;33986386;647;7291329;24956;24169
38232;Meyssiès;312;7786456;308161;201;6421951;111;1364505;24957;24170
65029;Arras-en-Lavedan;277;6913042;299773;166;5749252;111;1163790;24957;24171
79112;Épannes;417;10407002;450686;260;8608934;157;1798068;24957;24172
32250;Meilhan;46;1148057;94622;20;850956;26;297101;24958;24173
57403;Liéhon;66;1647260;69538;42;1398195;24;249065;24958;24174
14715;Trouville-sur-Mer;3452;86168918;5741864;1799;70439777;1653;15729141;24962;24175
65465;Vielle-Aure;198;4942489;237905;116;3824271;82;1118218;24962;24176
26380;Gervans;294;7339160;420698;178;6040527;116;1298633;24963;24177
67553;Wolschheim;160;3994109;133508;92;3088776;68;905333;24963;24178
67056;Bootzheim;339;8462700;329115;217;7209141;122;1253559;24964;24179
33116;Cazats;172;4293846;147496;106;3505047;66;788799;24964;24180
64296;Lacadée;71;1772503;82619;42;1442709;29;329794;24965;24181
56065;Gourhel;304;7589361;248234;196;6365061;108;1224300;24965;24182
66202;Targassonne;101;2521467;83817;57;2118937;44;402530;24965;24183
77509;Villeneuve-les-Bordes;317;7913925;327985;208;6858950;109;1054975;24965;24184
34274;Saint-Martin-de-Londres;1372;34252388;1557339;772;27625140;600;6627248;24965;24185
73223;Saint-André;263;6565941;285902;181;5495580;82;1070361;24966;24186
15204;Saint-Paul-des-Landes;768;19174353;679818;467;15705912;301;3468441;24967;24187
69077;Dracé;478;11934092;320145;302;9821318;176;2112774;24967;24188
16116;Criteuil-la-Magdeleine;252;6291894;781254;115;4943507;137;1348387;24968;24189
46100;Faycelles;361;9013465;325620;215;7137130;146;1876335;24968;24190
02172;Chaudun;119;2971226;123408;70;2362660;49;608566;24968;24191
16297;Graves-Saint-Amant;198;4943735;257803;120;4208694;78;735041;24968;24192
60088;Bornel;1904;47540139;2144961;1268;40808179;636;6731960;24969;24193
01007;Ambronay;1300;32459627;1223047;828;27221278;472;5238349;24969;24194
71307;Montceaux-l'Étoile;164;4094924;147955;89;3038545;75;1056379;24969;24195
80546;Miannay;304;7590702;377756;189;6339013;115;1251689;24969;24196
90032;Danjoutin;2041;50962722;3496847;1220;42343053;821;8619669;24969;24197
71296;Messey-sur-Grosne;376;9388570;403794;242;7979750;134;1408820;24970;24198
38071;Champ-sur-Drac;1735;43323614;1828104;1152;36657327;583;6666287;24970;24199
26345;Suze-la-Rousse;1041;25994607;1302925;593;21341999;448;4652608;24971;24200
62064;Avesnes-lès-Bapaume;80;1997682;73900;49;1578036;31;419646;24971;24201
63096;Chas;197;4919366;226418;121;4114638;76;804728;24971;24202
77391;Rouilly;248;6192950;240589;165;5225354;83;967596;24972;24203
28225;Magny;319;7966037;318175;205;6575580;114;1390457;24972;24204
45160;Greneville-en-Beauce;337;8415679;388656;214;6920777;123;1494902;24972;24205
14579;Saint-Georges-d'Aunay;366;9140083;409628;191;7097125;175;2042958;24973;24206
35031;La Bouëxière;1924;48048520;1642157;1154;38797494;770;9251026;24973;24207
01292;Le Petit-Abergement;76;1897968;56403;48;1511554;28;386414;24973;24208
61337;Préaux-du-Perche;278;6942787;241180;169;5700088;109;1242699;24974;24209
02155;Chaillevois;106;2647284;146636;73;2295173;33;352111;24974;24210
16252;Orival;91;2272691;156906;43;1774646;48;498045;24975;24211
14137;Carpiquet;1279;31943152;1505550;774;25769296;505;6173856;24975;24212
59404;Les Moëres;434;10839261;444029;255;8807213;179;2032048;24975;24213
39099;Champdivers;224;5594574;230947;134;4576258;90;1018316;24976;24214
25614;Vieux-Charmont;1509;37689065;1611609;963;31396136;546;6292929;24976;24215
77513;Villenoy;2285;57071470;2768894;1531;49519710;754;7551760;24977;24216
57054;Baudrecourt;102;2547621;105087;58;1961941;44;585680;24977;24217
83116;Saint-Maximin-la-Sainte-Baume;8713;217622982;11044091;4919;176985072;3794;40637910;24977;24218
68269;Ribeauvillé;2833;70760003;3951584;1610;57509640;1223;13250363;24977;24219
67162;Gottesheim;172;4296113;138094;100;3159766;72;1136347;24977;24220
61283;Montabard;167;4171436;215440;94;3341974;73;829462;24979;24221
39499;Saligney;91;2273065;123122;51;1756381;40;516684;24979;24222
73130;Grignon;1063;26552681;1092503;681;21962975;382;4589706;24979;24223
57326;Hinckange;138;3447104;111146;81;2733899;57;713205;24979;24224
89240;Malay-le-Petit;192;4796061;198074;119;3875525;73;920536;24979;24225
41253;Talcy;154;3846843;172494;106;3313644;48;533199;24980;24226
51469;Rouffy;50;1248983;56791;32;984282;18;264701;24980;24227
66052;Codalet;215;5370690;319645;114;4294354;101;1076336;24980;24228
77368;Poigny;261;6519854;274294;164;5370285;97;1149569;24980;24229
39351;Montcusel;100;2498046;96617;67;2127943;33;370103;24980;24230
30030;Baron;187;4671535;168162;100;3825688;87;845847;24981;24231
84090;Peypin-d'Aigues;347;8668759;428817;203;7057711;144;1611048;24982;24232
38147;Doissin;414;10343001;393683;252;8397660;162;1945341;24983;24233
17136;Croix-Chapeau;640;15989350;612857;407;13461136;233;2528214;24983;24234
76243;Ernemont-sur-Buchy;139;3472735;105675;92;2873702;47;599033;24984;24235
50076;Bréhal;1827;45645745;2241368;1025;36270495;802;9375250;24984;24236
56241;Sauzon;570;14241377;761281;351;11662723;219;2578654;24985;24237
28407;Vichères;164;4097670;180478;101;3337255;63;760415;24986;24238
64027;Anos;86;2148871;40247;53;1706848;33;442023;24987;24239
77490;Vendrest;375;9370172;418887;249;8098805;126;1271367;24987;24240
01096;Chaveyriat;490;12243904;453934;306;10053809;184;2190095;24988;24241
80545;Mézières-en-Santerre;290;7246436;332919;185;5899633;105;1346803;24988;24242
55426;Resson;225;5622241;233856;141;4543780;84;1078461;24988;24243
76386;Limpiville;181;4522874;197694;111;3760481;70;762393;24988;24244
89484;Volgré;171;4272998;180086;109;3578236;62;694762;24988;24245
81198;Orban;177;4423002;329045;90;3598651;87;824351;24989;24246
74167;Marlens;472;11794989;489374;328;10220593;144;1574396;24989;24247
68242;Oberhergheim;664;16593022;729970;430;13958727;234;2634295;24989;24248
2B120;Furiani;2986;74618885;4386958;1751;62352890;1235;12265995;24990;24249
54270;Hussigny-Godbrange;1749;43707438;683633;568;20197261;1181;23510177;24990;24250
72119;Domfront-en-Champagne;494;12345831;421354;329;10303585;165;2042246;24992;24251
73313;Verthemex;97;2424219;123398;62;2084501;35;339718;24992;24252
24015;Audrix;148;3698974;163907;82;2958487;66;740487;24993;24253
71122;Cheilly-lès-Maranges;271;6773437;279848;165;5498545;106;1274892;24994;24254
26217;La Motte-Fanjas;92;2299506;90830;57;1887336;35;412170;24995;24255
59244;Fontaine-Notre-Dame;921;23020167;1109480;496;18592345;425;4427822;24995;24256
01004;Ambérieu-en-Bugey;7542;188517805;9411190;4346;155198607;3196;33319198;24996;24257
40156;Liposthey;240;5999029;265598;132;4715193;108;1283836;24996;24258
70417;Pontcey;151;3774444;188051;92;3063876;59;710568;24996;24259
71423;Saint-Gervais-en-Vallière;211;5274395;267267;118;4053065;93;1221330;24997;24260
42041;Chambéon;251;6274305;207172;158;5192270;93;1082035;24997;24261
46111;Fourmagnac;83;2074832;99195;50;1691185;33;383647;24998;24262
39139;Chêne-Bernard;40;999926;70533;23;878007;17;121919;24998;24263
02180;Chéry-lès-Pouilly;347;8674457;395682;200;6878205;147;1796252;24998;24264
29290;Tréglonou;308;7699531;247741;212;6501550;96;1197981;24998;24265
14277;Fontenay-le-Marmion;862;21548989;709660;559;17900163;303;3648826;24999;24266
33284;Mios;4133;103322920;3934091;2607;86092754;1526;17230166;24999;24267
77456;Soisy-Bouy;411;10275159;446324;263;8813196;148;1461963;25000;24268
27184;Crasville;74;1850030;73411;53;1617041;21;232989;25000;24269
03145;Lignerolles;387;9675356;384519;254;8207768;133;1467588;25001;24270
32014;Augnax;44;1100077;16361;24;782643;20;317434;25002;24271
50101;Carneville;122;3050324;160297;72;2466889;50;583435;25003;24272
30230;Saint-André-de-Roquepertuis;295;7375789;368468;171;6076904;124;1298885;25003;24273
04226;Uvernet-Fours;362;9051094;538427;214;7572908;148;1478186;25003;24274
21050;Baubigny;130;3250572;167690;83;2728675;47;521897;25004;24275
26247;Ponsas;287;7176397;379437;172;5758107;115;1418290;25005;24276
02693;Saint-Rémy-Blanzy;114;2850562;148329;68;2361074;46;489488;25005;24277
64252;Gurmençon;440;11002613;494048;266;8953451;174;2049162;25006;24278
02167;Chassemy;394;9852408;549532;234;7945265;160;1907143;25006;24279
58207;Parigny-les-Vaux;530;13253396;597680;346;11447831;184;1805565;25006;24280
31393;Mourvilles-Hautes;97;2425663;101103;61;2036625;36;389038;25007;24281
45184;Lion-en-Sullias;216;5401607;198219;127;4227388;89;1174219;25007;24282
10439;Viviers-sur-Artaut;67;1675507;151142;36;1406854;31;268653;25008;24283
33207;Izon;2661;66545438;2524508;1644;54628615;1017;11916823;25008;24284
87129;Royères;458;11453669;438990;298;9456931;160;1996738;25008;24285
38490;Sillans;951;23783112;949033;601;19553442;350;4229670;25009;24286
30205;Pougnadoresse;103;2575976;82366;56;2024750;47;551226;25009;24287
09103;Crampagna;400;10003900;474789;261;8568304;139;1435596;25010;24288
59615;Vieux-Berquin;1239;30987383;1209420;720;24933788;519;6053595;25010;24289
57066;Berthelming;292;7302946;518659;150;5741951;142;1560995;25010;24290
77119;Clos-Fontaine;146;3651525;123712;100;3160822;46;490703;25010;24291
49307;Saint-Mathurin-sur-Loire;1269;31738551;1367469;738;25757711;531;5980840;25011;24292
61105;Chemilli;113;2826281;214960;67;2342311;46;483970;25011;24293
51246;Favresse;116;2901357;130213;79;2475355;37;426002;25012;24294
62462;Huclier;56;1400668;24472;33;1105675;23;294993;25012;24295
48095;Mende;6733;168409725;9517408;4202;142618776;2531;25790949;25013;24296
54437;Pulligny;619;15482840;619258;402;13033638;217;2449202;25013;24297
76133;Le Bourg-Dun;268;6703502;408709;151;5450365;117;1253137;25013;24298
63235;Montcel;244;6103336;233251;170;5280307;74;823029;25014;24299
81179;Montgey;158;3952166;201209;90;3277184;68;674982;25014;24300
60302;Haudivillers;434;10856139;402145;289;9075862;145;1780277;25014;24301
65084;Bernac-Dessus;149;3727175;169360;81;2944868;68;782307;25015;24302
53049;Châlons-du-Maine;296;7404329;142741;197;6102126;99;1302203;25015;24303
51191;Courtémont;41;1025603;52274;21;766638;20;258965;25015;24304
14649;Saint-Pierre-du-Bû;235;5878862;243855;152;5018116;83;860746;25016;24305
08305;Montigny-sur-Vence;113;2826972;113424;71;2389616;42;437356;25017;24306
26031;La Bâtie-Rolland;495;12383759;503457;303;10102522;192;2281237;25018;24307
67429;Saint-Pierre;330;8255935;353546;200;6856806;130;1399129;25018;24308
37186;Pont-de-Ruan;440;11008170;344440;288;8991430;152;2016740;25019;24309
80684;Rouy-le-Petit;64;1601280;71286;39;1355459;25;245821;25020;24310
14659;Saint-Sylvain;672;16813474;679824;408;13394158;264;3419316;25020;24311
50083;Bricquebosq;277;6930631;274522;176;5695906;101;1234725;25020;24312
67272;Lochwiller;223;5579713;179656;152;4816009;71;763704;25021;24313
62600;Nédon;77;1926631;91061;41;1457916;36;468715;25021;24314
27245;Fleury-la-Forêt;164;4103683;247699;93;3377173;71;726510;25022;24315
54294;Landremont;78;1951858;92764;50;1697329;28;254529;25024;24316
16129;Éraville;123;3077960;157359;62;2468834;61;609126;25024;24317
61144;Dancé;194;4854731;212440;120;4045551;74;809180;25024;24318
88427;Saint-Menge;64;1601606;63839;37;1241925;27;359681;25025;24319
46021;Béduer;408;10210414;546240;248;8429181;160;1781233;25026;24320
59581;Steenwerck;1804;45149218;1993148;1039;36121790;765;9027428;25027;24321
09269;Saint-Martin-de-Caralp;197;4930422;342782;105;4035549;92;894873;25028;24322
59265;Gommegnies;1183;29607870;1454747;673;24013377;510;5594493;25028;24323
22067;Grâces;1359;34013250;1665202;807;27862831;552;6150419;25028;24324
54231;Gondrecourt-Aix;76;1902140;65940;37;1286661;39;615479;25028;24325
63439;Usson;144;3604092;153886;85;2869181;59;734911;25028;24326
60126;Cannectancourt;255;6382300;275507;157;5220995;98;1161305;25029;24327
68043;Bollwiller;2051;51335155;2302703;1310;42232739;741;9102416;25029;24328
60440;Moyenneville;299;7483826;254526;180;6004855;119;1478971;25030;24329
57053;Bassing;62;1551853;84036;41;1273732;21;278121;25030;24330
89291;Passy;190;4756119;224109;123;3978564;67;777555;25032;24331
36085;Guilly;133;3329302;272653;70;2660740;63;668562;25032;24332
57126;Chambrey;183;4580956;192215;114;3728746;69;852210;25033;24333
59653;Wavrin;4041;101161920;4586884;2431;84159970;1610;17001950;25034;24334
46011;Autoire;216;5407553;347149;118;4267875;98;1139678;25035;24335
28262;Montigny-le-Gannelon;266;6659394;329185;171;5663609;95;995785;25035;24336
87166;Saint-Martin-le-Vieux;473;11841715;480077;319;10189078;154;1652637;25035;24337
52411;Puellemontier;113;2828999;136245;73;2365767;40;463232;25035;24338
57130;Château-Bréhain;50;1251839;88075;23;903861;27;347978;25037;24339
27125;Calleville;330;8262241;381988;214;7220586;116;1041655;25037;24340
58022;Balleray;115;2879463;136620;72;2391698;43;487765;25039;24341
65270;Lespouey;106;2654166;110984;70;2198088;36;456078;25039;24342
15012;Arpajon-sur-Cère;3615;90518196;4566499;2313;76274720;1302;14243476;25040;24343
35351;Le Verger;674;16877097;473369;443;14337522;231;2539575;25040;24344
85126;Longèves;621;15550127;581216;400;13003637;221;2546490;25040;24345
69211;Saint-Jean-d'Ardières;1755;43946740;1492757;1101;35704400;654;8242340;25041;24346
64389;Monassut-Audiracq;169;4231997;149739;112;3527473;57;704524;25041;24347
01146;Dompierre-sur-Chalaronne;206;5158675;151072;129;4297898;77;860777;25042;24348
45273;Saint-Denis-de-l'Hôtel;1568;39266933;1891906;999;32862691;569;6404242;25043;24349
24540;Sorges;705;17655217;841113;418;14728915;287;2926302;25043;24350
40128;Horsarrieu;353;8840396;250597;210;7143626;143;1696770;25044;24351
50458;Saint-Côme-du-Mont;272;6811990;483531;152;5542890;120;1269100;25044;24352
62664;Pommier;102;2554500;94389;51;1886651;51;667849;25044;24353
76024;Ardouval;88;2203929;116577;48;1743959;40;459970;25045;24354
27220;Épieds;201;5034080;247744;138;4378810;63;655270;25045;24355
77227;Hermé;361;9041352;466599;208;7560092;153;1481260;25045;24356
89213;Laduz;161;4032483;121401;103;3302646;58;729837;25046;24357
79216;Prahecq;1083;27125346;1080747;672;22531101;411;4594245;25046;24358
37129;Ligré;584;14627729;765302;360;12299953;224;2327776;25047;24359
83091;Pierrefeu-du-Var;3224;80755373;4430002;1968;68692227;1256;12063146;25048;24360
45173;Jargeau;2392;59915685;2690044;1479;49662095;913;10253590;25048;24361
80112;Bonnay;141;3531860;194468;86;2977217;55;554643;25049;24362
14555;Saint-André-d'Hébertot;236;5911641;265330;143;4844431;93;1067210;25049;24363
70321;Magny-Vernois;663;16608068;679328;419;13858296;244;2749772;25050;24364
60655;Varesnes;209;5235470;248214;140;4409541;69;825929;25050;24365
71006;Amanzé;90;2254527;77508;53;1834553;37;419974;25050;24366
12158;Montsalès;151;3782638;222667;82;2893688;69;888950;25051;24367
56088;Île-d'Arz;154;3857877;230016;86;3084672;68;773205;25051;24368
80779;Vauchelles-les-Quesnoy;440;11022968;468015;275;9127285;165;1895683;25052;24369
2A300;San-Gavino-di-Carbini;520;13027671;852710;273;10260918;247;2766753;25053;24370
66053;Collioure;1733;43417483;2840414;954;35061727;779;8355756;25053;24371
74269;Seyssel;1238;31016938;1124369;672;23980083;566;7036855;25054;24372
17073;Bussac-sur-Charente;683;17112082;669322;423;14295876;260;2816206;25054;24373
35312;Saint-Senoux;856;21446581;679878;526;17496598;330;3949983;25054;24374
45237;Orville;64;1603658;73020;37;1289076;27;314582;25057;24375
31166;Empeaux;131;3282653;209152;73;2589186;58;693467;25058;24376
21081;Blaisy-Haut;62;1553634;42723;39;1293116;23;260518;25059;24377
63049;Bouzel;365;9146604;336831;244;7673165;121;1473439;25059;24378
33459;Saint-Pey-d'Armens;162;4059671;291608;95;3405627;67;654044;25060;24379
27167;Condé-sur-Risle;307;7693468;348384;196;6653778;111;1039690;25060;24380
67115;Ebersheim;1216;30474312;1204643;798;25740919;418;4733393;25061;24381
18107;La Groutte;63;1578899;44857;37;1322846;26;256053;25062;24382
47075;La Croix-Blanche;457;11453520;519976;281;9400784;176;2052736;25062;24383
42201;Saint-Appolinard;321;8045033;317104;193;6534954;128;1510079;25062;24384
45152;Gémigny;107;2681741;93737;74;2170912;33;510829;25063;24385
21341;Lantilly;54;1353451;89447;28;1081011;26;272440;25064;24386
57191;Elzange;358;8972915;171437;168;5928540;190;3044375;25064;24387
25217;Émagny;310;7770024;363294;193;6419848;117;1350176;25065;24388
13036;Eyragues;2474;62010236;2987356;1288;50229271;1186;11780965;25065;24389
62261;Cucq;3259;81687582;5232357;1788;65833148;1471;15854434;25065;24390
61507;Villiers-sous-Mortagne;165;4135941;124744;90;3244246;75;891695;25066;24391
27103;Bourg-Achard;1709;42839010;2168212;962;34309694;747;8529316;25067;24392
41053;Choue;293;7344637;384088;171;5987558;122;1357079;25067;24393
59607;Vendegies-au-Bois;234;5865819;253673;131;4740221;103;1125598;25068;24394
76621;Saint-Martin-Osmonville;529;13260927;456164;331;10887476;198;2373451;25068;24395
69022;Bibost;252;6317229;182951;148;5036152;104;1281077;25068;24396
71150;Crêches-sur-Saône;1631;40889200;1925554;1008;33456653;623;7432547;25070;24397
51610;Verrières;211;5290056;176630;134;4204858;77;1085198;25071;24398
71232;Hautefond;106;2657615;88331;69;2161600;37;496015;25072;24399
65156;Dours;132;3309499;194222;80;2783589;52;525910;25072;24400
88083;Certilleux;121;3033724;98542;77;2517015;44;516709;25072;24401
54002;Abbéville-lès-Conflans;126;3159200;71373;75;2489936;51;669264;25073;24402
52021;Attancourt;143;3585476;132082;105;3148525;38;436951;25073;24403
61117;Condé-sur-Sarthe;1232;30890820;1238004;766;25338043;466;5552777;25074;24404
18287;Vinon;179;4488320;274251;103;3621746;76;866574;25074;24405
79213;Pompaire;1061;26604676;1194955;607;21440391;454;5164285;25075;24406
33555;Marcheprime;2295;57547499;2104321;1447;48051435;848;9496064;25075;24407
31118;Castelnau-d'Estrétefonds;3057;76657402;3508355;1915;64215809;1142;12441593;25076;24408
74058;La Chapelle-d'Abondance;495;12412697;725460;308;10451411;187;1961286;25076;24409
41219;Saint-Laurent-des-Bois;164;4112777;190955;94;3318076;70;794701;25078;24410
80594;Neuville-lès-Loeuilly;61;1529772;76259;32;1201724;29;328048;25078;24411
30091;Congénies;848;21266639;955022;508;17387861;340;3878778;25079;24412
59296;Hecq;167;4188268;120942;109;3427464;58;760804;25079;24413
46055;Capdenac;621;15574437;776346;382;12854855;239;2719582;25080;24414
28389;Thiville;194;4865481;198011;124;4036657;70;828824;25080;24415
61226;Lignerolles;85;2131866;132372;48;1743736;37;388130;25081;24416
12133;Luc-la-Primaube;3244;81364631;3778322;2089;68696515;1155;12668116;25082;24417
10141;Essoyes;434;10885498;956273;221;8985681;213;1899817;25082;24418
24429;Saint-Jory-las-Bloux;148;3712231;261118;73;2906630;75;805601;25083;24419
01346;Saint-Didier-d'Aussiat;436;10936392;408118;260;8608361;176;2328031;25083;24420
11231;Mézerville;42;1053517;61169;22;879582;20;173935;25084;24421
28183;Gommerville;319;8001715;398528;202;6580586;117;1421129;25084;24422
76203;Croix-Mare;358;8980118;284409;246;7708175;112;1271943;25084;24423
80527;Méneslies;167;4189051;217748;87;3307295;80;881756;25084;24424
02035;Audigny;128;3210804;162994;64;2554910;64;655894;25084;24425
72213;Mulsanne;2320;58196993;2500240;1496;48738407;824;9458586;25085;24426
45009;Aschères-le-Marché;599;15026006;580461;374;12389713;225;2636293;25085;24427
54371;Moineville;526;13194798;533786;318;10844122;208;2350676;25085;24428
12281;Toulonjac;379;9507635;409369;246;7948887;133;1558748;25086;24429
62623;Nouvelle-Église;241;6045850;286918;137;4909407;104;1136443;25087;24430
47209;Pont-du-Casse;2357;59129555;3274100;1429;50312059;928;8817496;25087;24431
59315;Houdain-lez-Bavay;454;11389497;527632;250;9228662;204;2160835;25087;24432
63341;Saint-Ferréol-des-Côtes;323;8103163;396644;199;6753158;124;1350005;25087;24433
42098;Fourneaux;303;7601609;219675;171;5762950;132;1838659;25088;24434
21361;Lux;265;6648374;300659;164;5577339;101;1071035;25088;24435
61435;Saint-Nicolas-de-Sommaire;137;3437091;174185;80;2883687;57;553404;25088;24436
28296;Péronville;151;3788361;204114;92;3092005;59;696356;25088;24437
83138;Tourrettes;1654;41496563;2385053;882;33263366;772;8233197;25089;24438
34297;Sauteyrargues;191;4791971;200579;118;3972777;73;819194;25089;24439
31048;Baziège;1734;43506768;1757158;1086;36330308;648;7176460;25090;24440
55369;Naives-Rosières;447;11215430;503738;272;9177120;175;2038310;25090;24441
70497;Tavey;240;6021763;242914;161;4927067;79;1094696;25091;24442
57738;Waldhouse;189;4742221;222310;119;3857858;70;884363;25091;24443
01235;Marlieux;480;12044278;477407;273;9519183;207;2525095;25092;24444
58290;Thaix;28;702603;45558;14;552505;14;150098;25093;24445
15221;Sansac-de-Marmiesse;686;17214222;739927;435;14502262;251;2711960;25094;24446
08235;Issancourt-et-Rumel;215;5395332;233231;138;4499772;77;895560;25095;24447
21630;Thoisy-le-Désert;111;2785558;100920;63;2189233;48;596325;25095;24448
90022;Châtenois-les-Forges;1497;37569427;1625219;998;31763633;499;5805794;25096;24449
31571;Vendine;122;3061953;114595;69;2407686;53;654267;25098;24450
62504;Leulinghem;110;2760835;64218;65;2152182;45;608653;25099;24451
16217;Merpins;582;14607487;696661;380;12316919;202;2290568;25099;24452
06048;Contes;4051;101677183;5533098;2505;85479095;1546;16198088;25099;24453
21452;Neuilly-lès-Dijon;952;23894660;1037146;611;19669135;341;4225525;25099;24454
41065;Coulommiers-la-Tour;260;6526049;250836;162;5223483;98;1302566;25100;24455
76093;Bézancourt;186;4668795;244288;105;3671680;81;997115;25101;24456
15160;Reilhac;565;14182191;667931;330;11566937;235;2615254;25101;24457
45203;Meung-sur-Loire;3425;85973172;4570743;2069;70604022;1356;15369150;25102;24458
81054;Cambounet-sur-le-Sor;428;10743542;435573;271;8931567;157;1811975;25102;24459
35105;Erbrée;796;19981382;656443;509;16264395;287;3716987;25102;24460
29160;Plabennec;4092;102725730;3694292;2481;84682884;1611;18042846;25104;24461
53101;Fromentières;373;9363912;379098;229;7447787;144;1916125;25104;24462
72190;Marolles-lès-Saint-Calais;143;3590025;146022;98;3072412;45;517613;25105;24463
59431;Nieppe;4030;101173450;5184236;2346;82555410;1684;18618040;25105;24464
39121;Châtenois;188;4719810;176724;135;4102667;53;617143;25105;24465
18006;Annoix;133;3339235;186353;83;2877207;50;462028;25107;24466
64536;Thèze;420;10545071;422628;251;8568732;169;1976339;25107;24467
89300;Pisy;43;1079618;66523;25;895628;18;183990;25107;24468
60118;Caisnes;253;6352329;307092;146;5227678;107;1124651;25108;24469
08261;Louvergny;52;1305624;97148;33;1145528;19;160096;25108;24470
81058;Carbes;105;2636440;104479;63;2207463;42;428977;25109;24471
57273;Guerstling;209;5247936;226168;103;4097656;106;1150280;25110;24472
19273;Turenne;481;12077811;677160;272;10085065;209;1992746;25110;24473
76362;Heurteauville;177;4444504;205354;113;3682033;64;762471;25110;24474
29165;Plobannalec-Lesconil;2022;50773112;2478057;1201;41521653;821;9251459;25110;24475
72056;Champfleur;712;17879008;717831;453;15003543;259;2875465;25111;24476
22019;Bringolo;203;5097558;119285;124;4104435;79;993123;25111;24477
30319;Serviers-et-Labaume;295;7407805;396458;150;5745014;145;1662791;25111;24478
35233;Québriac;704;17678351;625028;429;14437325;275;3241026;25111;24479
35212;Pancé;593;14891182;708855;375;12427983;218;2463199;25112;24480
80053;Balâtre;39;979364;30837;24;767348;15;212016;25112;24481
14538;Rocquancourt;379;9517428;296150;247;7952945;132;1564483;25112;24482
72177;Maigné;178;4470061;265458;109;3718904;69;751157;25113;24483
69184;Sainte-Catherine;478;12003988;526014;289;9826772;189;2177216;25113;24484
69035;Cenves;196;4922695;259725;105;3833424;91;1089271;25116;24485
81211;Poulan-Pouzols;218;5475343;203515;129;4420722;89;1054621;25116;24486
38483;Sermérieu;802;20143448;816533;483;16359147;319;3784301;25117;24487
09174;Loubières;153;3843368;153453;103;3279925;50;563443;25120;24488
83117;Saint-Paul-en-Forêt;892;22408122;1224815;494;18113136;398;4294986;25121;24489
73088;Cohennoz;94;2361404;179703;50;1882714;44;478690;25121;24490
67202;Hochfelden;1903;47806020;2350155;1155;39249499;748;8556521;25121;24491
54348;Manonville;110;2763362;86487;65;2167506;45;595856;25121;24492
10096;Chennegy;243;6104787;265961;155;5165731;88;939056;25123;24493
80102;Biaches;212;5326040;198336;130;4498220;82;827820;25123;24494
81018;Arthès;1391;34948023;1708255;810;28474606;581;6473417;25124;24495
62629;Noyellette;97;2437159;91876;67;2085143;30;352016;25125;24496
79327;Thorigné;619;15552954;588726;405;12995352;214;2557602;25126;24497
77251;Lieusaint;5195;130535205;5492962;3441;112000385;1754;18534820;25127;24498
10272;Ormes;101;2538216;121880;61;1952018;40;586198;25131;24499
01046;Biziat;415;10429443;430803;246;8345763;169;2083680;25131;24500
41071;Crouy-sur-Cosson;265;6659836;363727;157;5529021;108;1130815;25131;24501
89076;Champlost;452;11359620;562950;282;9500230;170;1859390;25132;24502
89363;Sainte-Pallaye;57;1432522;76950;33;1169014;24;263508;25132;24503
81043;Busque;387;9726162;404614;244;8049930;143;1676232;25132;24504
31182;Fenouillet;2967;74567545;4338273;1821;62564097;1146;12003448;25132;24505
61140;Crulai;501;12591333;590474;328;10655651;173;1935682;25132;24506
76215;Derchigny;268;6735629;325704;166;5621450;102;1114179;25133;24507
21002;Agey;162;4071611;145787;107;3345226;55;726385;25133;24508
60379;Mareuil-la-Motte;308;7741132;384601;191;6435464;117;1305668;25134;24509
28234;Marchéville;262;6585126;261757;171;5561361;91;1023765;25134;24510
51126;La Chapelle-Felcourt;34;854568;34994;20;739587;14;114981;25134;24511
12176;Onet-le-Château;6267;157518006;8934178;3886;132354253;2381;25163753;25135;24512
89160;Étigny;416;10456171;430622;286;8958991;130;1497180;25135;24513
42299;Savigneux;1821;45771579;2209563;1090;37197189;731;8574390;25135;24514
44101;La Montagne;3066;77067228;2777397;1984;64213930;1082;12853298;25136;24515
15118;Marmanhac;434;10909206;789208;202;8478016;232;2431190;25136;24516
07097;Glun;336;8445877;349693;224;7315464;112;1130413;25137;24517
38505;Thodure;383;9627330;218160;207;7657446;176;1969884;25137;24518
45174;Jouy-en-Pithiverais;149;3745410;150453;93;3044428;56;700982;25137;24519
44045;Cordemais;1616;40621361;1354699;1015;32974341;601;7647020;25137;24520
31394;Moustajon;102;2564010;122865;68;2154904;34;409106;25137;24521
38134;Cour-et-Buis;440;11060656;474851;277;9255680;163;1804976;25138;24522
27308;Guitry;144;3619888;188436;83;2855373;61;764515;25138;24523
67221;Ingolsheim;143;3594937;134448;100;3165859;43;429078;25139;24524
38323;Pressins;558;14028188;542004;327;10944437;231;3083751;25140;24525
12043;Calmont;984;24738455;1076821;574;20252373;410;4486082;25141;24526
32322;Pompiac;94;2363335;108557;50;1864934;44;498401;25142;24527
27063;Berville-la-Campagne;95;2388500;121204;58;1961518;37;426982;25142;24528
38442;Saint-Pierre-de-Chartreuse;568;14281021;662016;349;12026738;219;2254283;25143;24529
54059;Belleau;397;9981897;425754;236;8158100;161;1823797;25143;24530
38042;Bévenais;478;12018664;416441;291;9767846;187;2250818;25144;24531
33162;Eysines;11799;296674819;16993582;7374;253647418;4425;43027401;25144;24532
77419;Saint-Mammès;1805;45385234;2387577;1193;38866573;612;6518661;25144;24533
16204;Malaville;230;5783178;306254;128;4519783;102;1263395;25144;24534
32145;Gée-Rivière;28;704040;31916;16;577941;12;126099;25144;24535
54378;Montigny-sur-Chiers;265;6663263;220935;141;4401375;124;2261888;25144;24536
02465;Marigny-en-Orxois;253;6361847;423068;158;5283936;95;1077911;25146;24537
09245;Rieux-de-Pelleport;656;16496760;973370;382;13893495;274;2603265;25148;24538
10309;Prusy;52;1307674;46402;32;1062254;20;245420;25148;24539
39224;Fétigny;49;1232243;64547;28;993288;21;238955;25148;24540
25572;Trouvans;42;1056210;13376;27;805106;15;251104;25148;24541
27252;Fontaine-la-Louvet;176;4426025;239754;110;3776645;66;649380;25148;24542
68328;Storckensohn;124;3118350;136534;73;2476673;51;641677;25148;24543
80773;Vadencourt;49;1232257;28213;29;1040478;20;191779;25148;24544
30033;Beauvoisin;2245;56459808;2923165;1218;45788408;1027;10671400;25149;24545
25527;Saint-Vit;2511;63152663;2899941;1534;52184779;977;10967884;25150;24546
45164;Guilly;352;8853512;386843;199;6881320;153;1972192;25152;24547
37257;Thilouze;797;20046226;748260;511;16691631;286;3354595;25152;24548
39120;Châtelneuf;79;1987018;88230;38;1518024;41;468994;25152;24549
30157;Mars;94;2364341;122844;56;2023268;38;341073;25153;24550
37110;Francueil;686;17254886;646586;417;13829780;269;3425106;25153;24551
80625;Pierrepont-sur-Avre;311;7822620;304575;215;6693073;96;1129547;25153;24552
73042;Billième;151;3798144;147851;101;3183362;50;614782;25153;24553
59159;Craywick;284;7143831;231288;171;5705552;113;1438279;25154;24554
39487;Saint-Laurent-en-Grandvaux;1068;26864959;1123930;607;21863283;461;5001676;25154;24555
44063;Gétigné;1755;44146469;1471018;1054;34811190;701;9335279;25155;24556
74274;Val-de-Fier;314;7899093;213218;209;6488461;105;1410632;25156;24557
67322;Neuwiller-lès-Saverne;620;15597272;695543;378;12600197;242;2997075;25157;24558
21666;Vernot;51;1283005;85125;34;1117585;17;165420;25157;24559
77174;Everly;319;8025467;324531;197;6403697;122;1621770;25158;24560
80041;Aumont;76;1912078;131666;44;1606261;32;305817;25159;24561
62444;Hervelinghen;123;3094629;149018;59;2426731;64;667898;25160;24562
57479;Montenach;239;6013242;85488;94;3169017;145;2844225;25160;24563
80426;Heilly;215;5409551;266565;139;4750578;76;658973;25161;24564
39423;Plaisia;72;1811578;70805;44;1489979;28;321599;25161;24565
34154;Mauguio;10755;270608789;15467728;6489;224427092;4266;46181697;25161;24566
14057;Bellengreville;804;20230697;1030339;490;16880529;314;3350168;25163;24567
41234;Santenay;148;3724152;141103;98;3076611;50;647541;25163;24568
10216;Mailly-le-Camp;745;18747286;1024614;461;15280914;284;3466372;25164;24569
72008;Arnage;2830;71219337;2951975;1827;60124042;1003;11095295;25166;24570
67550;Woerth;923;23228077;1206728;565;19058549;358;4169528;25166;24571
45219;Moulon;96;2415973;93661;56;1955104;40;460869;25166;24572
80116;Bouchoir;155;3900894;336541;77;3116153;78;784741;25167;24573
28164;Fresnay-l'Évêque;368;9261486;500248;226;7599785;142;1661701;25167;24574
02566;Ognes;596;14999606;769008;357;12492622;239;2506984;25167;24575
67104;Drachenbronn-Birlenbach;433;10897391;428602;297;9262704;136;1634687;25167;24576
89423;Tronchoy;100;2516788;190854;57;2074209;43;442579;25168;24577
81287;Sieurac;119;2995107;107991;67;2377921;52;617186;25169;24578
17472;Villedoux;926;23306873;650508;620;19473135;306;3833738;25169;24579
01030;Beauregard;465;11703909;522641;266;9483654;199;2220255;25170;24580
84027;Caderousse;1464;36848545;1725587;842;29980773;622;6867772;25170;24581
02509;Monthiers;89;2240264;161098;58;1873174;31;367090;25172;24582
53262;Soulgé-sur-Ouette;557;14020688;482136;312;10993175;245;3027513;25172;24583
47137;Laplume;759;19105984;858868;435;15795277;324;3310707;25173;24584
27174;Corneville-sur-Risle;705;17747145;761507;423;14804153;282;2942992;25173;24585
28005;Alluyes;399;10044425;455691;263;8443883;136;1600542;25174;24586
26072;Chantemerle-les-Blés;578;14550674;639401;342;11891424;236;2659250;25174;24587
28130;Digny;526;13242424;647940;327;10971083;199;2271341;25176;24588
39131;La Chaux-du-Dombief;299;7527584;375654;180;6216667;119;1310917;25176;24589
54395;Nancy;57491;1447421291;113176613;32405;1246968920;25086;200452371;25176;24590
01335;Saint-André-le-Bouchoux;155;3902433;113851;99;3133480;56;768953;25177;24591
76207;Cuverville-sur-Yères;112;2819843;173685;62;2236450;50;583393;25177;24592
44100;Monnières;1000;25178049;813248;657;21184038;343;3994011;25178;24593
02556;Noircourt;51;1284148;58060;26;1050660;25;233488;25179;24594
77019;Balloy;174;4381317;203488;102;3546335;72;834982;25180;24595
91687;Viry-Châtillon;17477;440096370;25609915;11376;376795154;6101;63301216;25181;24596
18128;Limeux;103;2593730;192029;65;2111812;38;481918;25182;24597
28270;Moriers;130;3273736;174905;89;2773110;41;500626;25183;24598
77481;Vanvillé;106;2669371;138455;70;2292282;36;377089;25183;24599
19013;Aubazines;476;11987045;561053;286;9789337;190;2197708;25183;24600
40251;Saint-Barthélemy;189;4759623;205815;116;3936952;73;822671;25183;24601
51217;Dormans;1705;42937359;3252571;916;35299153;789;7638206;25183;24602
01427;Trévoux;3551;89426729;4512353;2126;73626626;1425;15800103;25184;24603
63200;Lussat;476;11987454;489084;292;9920187;184;2067267;25184;24604
02688;Saint-Pierre-lès-Franqueville;25;629622;13367;11;471332;14;158290;25185;24605
65464;Vielle-Adour;270;6799945;303332;177;5650178;93;1149767;25185;24606
45037;Boisseaux;185;4659251;117613;113;3578641;72;1080610;25185;24607
85284;Soullans;2311;58203282;2784183;1357;46923356;954;11279926;25185;24608
47139;Lasserre;43;1082969;50520;29;977326;14;105643;25185;24609
03162;Marigny;105;2644685;120825;72;2264505;33;380180;25187;24610
01268;Murs-et-Gélignieux;128;3224105;152304;76;2612589;52;611516;25188;24611
04036;Le Brusquet;539;13576833;633172;348;11749643;191;1827190;25189;24612
54056;Bazailles;85;2141176;54303;45;1514883;40;626293;25190;24613
42073;Cottance;378;9522578;329955;214;7610492;164;1912086;25192;24614
45293;Saint-Maurice-sur-Fessard;605;15241196;718645;364;12316248;241;2924948;25192;24615
60305;Hautefontaine;173;4358320;285855;105;3757851;68;600469;25193;24616
57753;Wuisse;33;831361;27503;19;676402;14;154959;25193;24617
59121;Cagnoncles;295;7431935;290339;169;6076150;126;1355785;25193;24618
67276;Lutzelhouse;981;24714814;955033;615;20031983;366;4682831;25193;24619
45130;Dry;727;18316402;786204;447;14977747;280;3338655;25195;24620
02791;Veslud;139;3502055;156736;88;2997440;51;504615;25195;24621
21079;Blagny-sur-Vingeanne;70;1763717;78132;46;1450579;24;313138;25196;24622
65121;Camalès;231;5820370;239952;126;4654245;105;1166125;25196;24623
52042;Beauchemin;57;1436248;56135;39;1263474;18;172774;25197;24624
66030;Calce;126;3174888;259314;72;2562246;54;612642;25198;24625
76113;Boissay;169;4258575;194728;110;3581014;59;677561;25199;24626
08389;Saint-Marcel;200;5039753;352942;132;4289000;68;750753;25199;24627
57637;Schneckenbusch;161;4057021;141680;111;3519361;50;537660;25199;24628
33037;Beautiran;1169;29457884;1339162;716;24503855;453;4954029;25199;24629
44137;Prinquiau;1563;39386378;1207053;1016;32201412;547;7184966;25199;24630
76338;La Hallotière;97;2444403;184894;50;1880962;47;563441;25200;24631
10400;Vaupoisson;80;2016013;151700;44;1648466;36;367547;25200;24632
89136;Cuy;424;10685245;469863;286;8914764;138;1770481;25201;24633
39411;Perrigny;873;22000542;1155671;533;17935410;340;4065132;25201;24634
74034;Le Biot;276;6955688;297613;165;5631271;111;1324417;25202;24635
65456;Uglas;163;4107910;166711;112;3496589;51;611321;25202;24636
46224;Pradines;1945;49022570;2535180;1168;40403227;777;8619343;25204;24637
26092;Chavannes;307;7737813;272968;179;6417813;128;1320000;25205;24638
63124;Cournon-d'Auvergne;10749;270934812;13163983;6901;228088520;3848;42846292;25206;24639
90025;Chavannes-les-Grands;170;4285800;226177;97;3419511;73;866289;25211;24640
84024;Cabrières-d'Aigues;468;11798583;604273;269;9504793;199;2293790;25211;24641
52140;Colombey-les-Deux-Églises;369;9302823;500262;214;7480208;155;1822615;25211;24642
70116;Chagey;349;8799065;370159;229;7291934;120;1507131;25212;24643
56234;Saint-Pierre-Quiberon;1495;37692459;2137726;874;30511585;621;7180874;25212;24644
82151;Roquecor;230;5798926;396426;91;4400486;139;1398440;25213;24645
89239;Malay-le-Grand;884;22288518;1036833;593;19082511;291;3206007;25213;24646
80180;Cavillon;54;1361553;52224;31;1065650;23;295903;25214;24647
34246;Saint-Christol;760;19163943;931270;428;15492315;332;3671628;25216;24648
89426;Val-de-Mercy;173;4362419;170479;111;3693634;62;668785;25216;24649
67535;Wimmenau;584;14726811;503543;382;12271785;202;2455026;25217;24650
59281;Hantay;566;14273736;662035;325;11667858;241;2605878;25219;24651
38364;Saint-Barthélemy-de-Séchilienne;238;6002040;238535;153;4897698;85;1104342;25219;24652
47101;Fourques-sur-Garonne;712;17956597;878422;409;14440545;303;3516052;25220;24653
72043;Bourg-le-Roi;169;4262226;227176;102;3513291;67;748935;25220;24654
02537;Nanteuil-la-Fosse;85;2143861;78048;51;1743513;34;400348;25222;24655
89315;Préhy;79;1992556;100728;40;1605229;39;387327;25222;24656
79086;Cherveux;884;22296987;753132;531;18151066;353;4145921;25223;24657
60693;Villeselve;184;4641078;125791;110;3851856;74;789222;25223;24658
67269;Littenheim;140;3531285;150072;88;2969721;52;561564;25223;24659
74233;Saint-Félix;1166;29410763;1238334;745;24254811;421;5155952;25224;24660
54383;Mont-sur-Meurthe;553;13949666;459048;349;11599152;204;2350514;25225;24661
72238;Pizieux;45;1135176;48380;28;968690;17;166486;25226;24662
18023;Baugy;725;18288992;650288;400;14459842;325;3829150;25226;24663
22339;Taden;1273;32116186;1571867;823;27308008;450;4808178;25229;24664
61005;Appenai-sous-Bellême;127;3204109;123194;83;2686195;44;517914;25229;24665
77247;Lescherolles;242;6105689;259461;153;5093379;89;1012310;25230;24666
70136;Charmoille;245;6181570;259198;155;5042571;90;1138999;25231;24667
50251;Huberville;164;4137880;151316;98;3424098;66;713782;25231;24668
62674;Quelmes;247;6232074;241552;148;4988972;99;1243102;25231;24669
55547;Verneuil-Petit;66;1665318;56682;38;1265993;28;399325;25232;24670
32448;Touget;264;6661320;196831;153;5338501;111;1322819;25232;24671
63180;Joze;585;14761993;702991;325;12086817;260;2675176;25234;24672
62152;Boisleux-Saint-Marc;112;2826270;88285;78;2344290;34;481980;25235;24673
28030;Beauche;156;3936633;200992;93;3234853;63;701780;25235;24674
85224;Saint-Hilaire-de-Loulay;2122;53550019;1413424;1338;43399799;784;10150220;25236;24675
30029;Barjac;939;23698942;3420503;377;18375295;562;5323647;25238;24676
18218;Saint-Just;330;8328733;340843;214;6824485;116;1504248;25239;24677
38124;Corbelin;1158;29226916;1534386;652;23485651;506;5741265;25239;24678
31202;Fronton;2858;72134953;3534369;1637;58647828;1221;13487125;25240;24679
13081;Rognac;6617;167013237;7937155;4158;140696772;2459;26316465;25240;24680
67302;Monswiller;1111;28042105;1276407;707;23187306;404;4854799;25240;24681
76008;Ancourt;347;8758509;362659;232;7580709;115;1177800;25241;24682
43147;Paulhac;349;8809250;350432;214;7206400;135;1602850;25241;24683
60516;Puiseux-en-Bray;204;5149318;231797;124;4202407;80;946911;25242;24684
83096;Pourcieux;608;15347697;683351;349;12380387;259;2967310;25243;24685
85240;Saint-Malô-du-Bois;679;17139960;367227;409;13522819;270;3617141;25243;24686
37250;Sorigny;1194;30140153;1303645;772;25170601;422;4969552;25243;24687
28028;Bazoches-en-Dunois;136;3433060;222574;73;2732963;63;700097;25243;24688
28331;Saint-Denis-d'Authou;265;6689542;392917;146;5282233;119;1407309;25244;24689
38378;Saint-Clair-du-Rhône;2010;50740211;2125092;1265;42012456;745;8727755;25244;24690
30148;Liouc;118;2978836;131887;68;2453666;50;525170;25244;24691
46177;Loubressac;268;6765669;338895;147;5504268;121;1261401;25245;24692
60366;Litz;194;4897572;252927;117;4031478;77;866094;25245;24693
16216;Mérignac;433;10931292;755277;229;8977446;204;1953846;25245;24694
07272;Saint-Maurice-d'Ardèche;190;4796656;272761;104;3747397;86;1049259;25246;24695
71090;La Chapelle-de-Guinchay;1896;47866882;2017736;1161;38927169;735;8939713;25246;24696
54558;Velaine-sous-Amance;157;3963685;173026;108;3355598;49;608087;25246;24697
14419;Le Mesnil-Eudes;149;3761748;193133;88;3085927;61;675821;25247;24698
16145;Foussignac;317;8003238;394711;192;6634959;125;1368279;25247;24699
54279;Jezainville;485;12245197;534079;304;10153201;181;2091996;25248;24700
14748;Vieux-Bourg;54;1363420;106035;33;1165143;21;198277;25249;24701
86081;Colombiers;724;18280463;807780;438;15039955;286;3240508;25249;24702
33246;Ligueux;86;2171448;91035;43;1701095;43;470353;25249;24703
59667;Zermezeele;88;2221958;48055;51;1698759;37;523199;25250;24704
89354;Saint-Martin-du-Tertre;860;21715275;959728;569;18265104;291;3450171;25250;24705
76104;Blosseville;160;4040073;194352;98;3362317;62;677756;25250;24706
76679;Sommesnil;41;1035299;50756;22;778995;19;256304;25251;24707
37192;Reignac-sur-Indre;629;15883456;737123;398;13065521;231;2817935;25252;24708
21130;Chambeire;177;4469636;143427;119;3783283;58;686353;25252;24709
57460;Merten;868;21919393;1175680;532;17919408;336;3999985;25253;24710
89210;Jully;78;1969860;94512;48;1685334;30;284526;25255;24711
38338;La Rivière;352;8889675;309488;220;7280046;132;1609629;25255;24712
01414;Sutrieu;121;3055891;120313;68;2427068;53;628823;25255;24713
67396;Rexingen;109;2752841;111709;65;2139588;44;613253;25255;24714
33201;Haux;443;11188203;614921;252;9263215;191;1924988;25256;24715
67174;Gumbrechtshoffen;664;16769938;761210;420;13798457;244;2971481;25256;24716
41130;Maves;318;8031440;294878;196;6481735;122;1549705;25256;24717
27577;Sainte-Opportune-la-Mare;236;5960452;213976;153;5025205;83;935247;25256;24718
54221;Gerbécourt-et-Haplemont;113;2854207;107322;78;2429569;35;424638;25258;24719
45045;Bouilly-en-Gâtinais;197;4975975;251659;116;3990554;81;985421;25259;24720
45276;Saint-Firmin-sur-Loire;295;7451366;386918;193;6142580;102;1308786;25259;24721
49347;Tiercé;2238;56529937;2301235;1317;45596148;921;10933789;25259;24722
50255;Hyenville;173;4369922;151925;103;3393127;70;976795;25260;24723
25040;Badevel;464;11720694;590161;303;10169461;161;1551233;25260;24724
45145;Ferrières-en-Gâtinais;2002;50571181;2603582;1224;41878039;778;8693142;25260;24725
32313;Pessoulens;80;2020884;78764;39;1584630;41;436254;25261;24726
13061;Saint-Pierre-de-Mézoargues;134;3385111;270618;56;2554012;78;831099;25262;24727
65094;Bizous;57;1439955;94067;33;1223855;24;216100;25262;24728
57571;Rémering-lès-Puttelange;562;14197803;628886;343;11693355;219;2504448;25263;24729
70018;Ancier;262;6619073;335763;154;5392928;108;1226145;25264;24730
89302;Plessis-Saint-Jean;121;3057011;153494;77;2504910;44;552101;25265;24731
02163;Charly-sur-Marne;1464;36987341;2781350;798;30189320;666;6798021;25265;24732
68256;Pfastatt;5390;136187469;7524794;3321;112745503;2069;23441966;25267;24733
10145;Faux-Villecerf;106;2678416;82772;60;1950765;46;727651;25268;24734
14615;Sainte-Marguerite-des-Loges;102;2577351;172244;52;2107413;50;469938;25268;24735
64470;Saint-Armou;305;7706966;286487;183;6291390;122;1415576;25269;24736
28226;Maillebois;525;13266145;630534;309;10765333;216;2500812;25269;24737
02139;Caillouël-Crépigny;225;5685619;243882;138;4594367;87;1091252;25269;24738
28248;Le Mesnil-Thomas;177;4472720;286136;101;3562242;76;910478;25270;24739
14039;Barbery;344;8692806;258260;223;7164471;121;1528335;25270;24740
88200;Gigney;32;808653;53172;17;615025;15;193628;25270;24741
59130;Cappelle-Brouck;530;13393538;504967;305;10834095;225;2559443;25271;24742
89153;Épineuil;342;8642807;480515;210;6951108;132;1691699;25271;24743
80105;Billancourt;93;2350300;113904;54;1975556;39;374744;25272;24744
60578;Saintines;494;12484413;614728;316;10497352;178;1987061;25272;24745
24041;Bézenac;93;2350547;132737;44;1795990;49;554557;25275;24746
41088;Fontaine-Raoul;110;2780267;125488;75;2401182;35;379085;25275;24747
31537;Savarthès;92;2325336;136171;52;1887165;40;438171;25275;24748
05130;Saint-Apollinaire;81;2047330;88958;47;1606966;34;440364;25276;24749
10167;Grandville;56;1415525;98197;28;1087457;28;328068;25277;24750
37219;Saint-Genouph;531;13422530;542209;342;11289688;189;2132842;25278;24751
26079;Charpey;633;16001552;711659;372;12677934;261;3323618;25279;24752
25032;Autechaux;172;4348149;113449;115;3598014;57;750135;25280;24753
81116;Labastide-Saint-Georges;943;23839610;1023380;538;18982800;405;4856810;25281;24754
81006;Algans;123;3109538;144270;72;2665964;51;443574;25281;24755
50576;Siouville-Hague;603;15244436;679965;390;13034242;213;2210194;25281;24756
39039;La Barre;124;3134878;143114;76;2514389;48;620489;25281;24757
73271;Saint-Pierre-d'Alvey;144;3640534;158165;81;2901419;63;739115;25281;24758
33302;Néac;230;5814780;390935;128;4859169;102;955611;25282;24759
62467;Humeroeuille;79;1997252;110346;43;1685885;36;311367;25282;24760
45270;Saint-Benoît-sur-Loire;1177;29756562;1864413;680;24160550;497;5596012;25282;24761
19196;Saint-Cyr-la-Roche;230;5814807;219190;133;4724712;97;1090095;25282;24762
45192;Manchecourt;352;8899226;336520;234;7505260;118;1393966;25282;24763
28114;Courbehaye;75;1896159;104571;38;1516941;37;379218;25282;24764
08173;Flize;610;15423146;705742;373;12485277;237;2937869;25284;24765
68155;Ingersheim;2677;67687191;3862450;1658;56584607;1019;11102584;25285;24766
47091;Estillac;1058;26751557;1010342;690;22630853;368;4120704;25285;24767
54256;Haussonville;158;3995054;164928;98;3312334;60;682720;25285;24768
70174;Cordonnet;69;1744769;79435;39;1429111;30;315658;25287;24769
27348;Igoville;845;21367133;852906;556;18274629;289;3092504;25287;24770
72275;Saint-Corneille;566;14312229;395369;371;11872133;195;2440096;25287;24771
36075;Fontenay;51;1289643;61937;24;1002547;27;287096;25287;24772
80334;Fossemanant;56;1416087;67327;36;1225066;20;191021;25287;24773
77239;Jouy-le-Châtel;780;19724497;952149;467;16275021;313;3449476;25288;24774
80724;Saleux;1341;33911246;1649334;867;28776527;474;5134719;25288;24775
02185;Chézy-en-Orxois;203;5133507;286587;112;3994317;91;1139190;25288;24776
68166;Kingersheim;7213;182409607;9212949;4556;152276095;2657;30133512;25289;24777
24236;Léguillac-de-l'Auche;481;12164100;584344;295;10207494;186;1956606;25289;24778
38548;Villard-de-Lans;2570;64993765;3326114;1560;53720869;1010;11272896;25289;24779
76197;Criquetot-sur-Longueville;96;2427785;90939;58;1985138;38;442647;25289;24780
59517;Les Rues-des-Vignes;382;9660652;514476;227;7735073;155;1925579;25290;24781
51116;Champguyon;136;3439491;165081;82;2850459;54;589032;25290;24782
36142;Niherne;843;21320000;875255;543;17758386;300;3561614;25291;24783
55489;Sivry-la-Perche;139;3515459;168516;80;2809618;59;705841;25291;24784
08462;Vaux-Champagne;69;1745091;67000;42;1377846;27;367245;25291;24785
58300;Urzy;945;23900183;1167294;621;20627063;324;3273120;25291;24786
33048;Berthez;107;2706178;106673;59;2085712;48;620466;25291;24787
34063;Caux;1421;35939330;2451443;640;28085753;781;7853577;25292;24788
41054;Choussy;170;4299573;190116;107;3648732;63;650841;25292;24789
60114;Buicourt;75;1896879;65548;48;1588380;27;308499;25292;24790
28162;Fresnay-le-Comte;179;4527503;149093;127;3904937;52;622566;25293;24791
45151;Gaubertin;138;3490531;154712;84;2877259;54;613272;25294;24792
88068;La Bourgonce;442;11180109;301744;279;9037689;163;2142420;25294;24793
46217;Pern;256;6475775;225980;125;5186459;131;1289316;25296;24794
2A104;Eccica-Suarella;576;14570591;771686;362;12406056;214;2164535;25296;24795
60308;Hémévillers;220;5565170;208728;143;4810521;77;754649;25296;24796
76068;Bec-de-Mortagne;353;8929839;359304;209;7288972;144;1640867;25297;24797
16012;Angeac-Champagne;277;7007594;444964;157;5695145;120;1312449;25298;24798
67126;Erckartswiller;150;3794749;147466;103;3205859;47;588890;25298;24799
51137;Châtillon-sur-Morin;119;3010610;136481;79;2629530;40;381080;25299;24800
39305;La Loye;294;7438005;289480;195;6248009;99;1189996;25299;24801
81213;Pratviel;44;1113176;71526;19;861809;25;251367;25299;24802
18005;Allouis;472;11941356;504704;310;10276679;162;1664677;25299;24803
88133;Dignonville;101;2555314;122768;61;2093771;40;461543;25300;24804
73244;Saint-Jean-de-Belleville;293;7413004;354973;198;6226276;95;1186728;25300;24805
42200;Saint-André-le-Puy;669;16926806;794473;406;13788850;263;3137956;25302;24806
02399;Juvincourt-et-Damary;239;6047736;228800;140;4826814;99;1220922;25304;24807
33252;Loupes;330;8350830;292350;231;7292992;99;1057838;25306;24808
05034;Châteauneuf-de-Chabre;186;4706841;260826;117;4070303;69;636538;25306;24809
64301;Lagor;638;16146022;601833;389;13028778;249;3117244;25307;24810
18212;Saint-Germain-des-Bois;312;7895879;401320;194;6528826;118;1367053;25307;24811
74264;Scionzier;4039;102216309;4204067;2493;83742016;1546;18474293;25307;24812
62360;Fréthun;572;14476354;752567;323;11597511;249;2878843;25308;24813
76010;Ancretiéville-Saint-Victor;163;4125344;101172;98;3234584;65;890760;25309;24814
80674;Rivery;1930;48847966;2501708;1225;41172746;705;7675220;25310;24815
69092;Gleizé;4041;102277041;5505373;2389;85064327;1652;17212714;25310;24816
31500;Saint-Mamet;333;8428332;434071;195;7051239;138;1377093;25310;24817
59397;Merckeghem;313;7922753;348691;195;6503617;118;1419136;25312;24818
08452;Thugny-Trugny;132;3341307;159139;77;2681676;55;659631;25313;24819
57348;Ippling;409;10353203;469210;260;8561139;149;1792064;25313;24820
69200;Saint-Forgeux;760;19239688;837783;463;16058584;297;3181104;25315;24821
42236;Saint-Hilaire-sous-Charlieu;275;6961835;287373;167;5746088;108;1215747;25316;24822
64343;Limendous;268;6784687;199810;160;5490218;108;1294469;25316;24823
90041;Étueffont;776;19645662;932636;488;16279155;288;3366507;25317;24824
76249;Étaimpuis;357;9038103;357462;231;7604647;126;1433456;25317;24825
88109;Cleurie;343;8683807;371059;212;7061870;131;1621937;25317;24826
29299;Tréouergat;155;3924195;128507;93;3154703;62;769492;25317;24827
30083;Codognan;1320;33420693;1715652;781;27356531;539;6064162;25319;24828
34296;Saussines;511;12938416;607683;294;10692990;217;2245426;25320;24829
62697;Récourt;109;2759870;80673;66;2204275;43;555595;25320;24830
21326;Jours-lès-Baigneux;44;1114080;62047;25;883192;19;230888;25320;24831
59210;Esquelbecq;1105;27979753;1365582;634;22619940;471;5359813;25321;24832
27452;Perriers-la-Campagne;199;5038988;178899;136;4261238;63;777750;25322;24833
84091;Piolenc;2703;68446850;4231117;1563;55730975;1140;12715875;25323;24834
30265;Saint-Jean-de-Crieulon;118;2988177;190597;60;2359890;58;628287;25324;24835
01445;Villemotier;317;8027605;292589;210;6588567;107;1439038;25324;24836
28019;Baigneaux;120;3038857;136066;79;2560568;41;478289;25324;24837
31330;Mauressac;209;5292689;139355;123;4298574;86;994115;25324;24838
81026;Bellegarde;217;5495589;246423;109;4355771;108;1139818;25325;24839
76599;Saint-Léger-du-Bourg-Denis;1814;45940262;2029927;1182;39372993;632;6567269;25325;24840
77404;Sainte-Colombe;942;23857015;1112891;605;20104172;337;3752843;25326;24841
25500;Ronchaux;44;1114353;71305;19;795673;25;318680;25326;24842
44073;Héric;2711;68659837;2645158;1610;55587452;1101;13072385;25326;24843
72216;Neuvillalais;269;6812890;178551;170;5541234;99;1271656;25327;24844
14066;Bernières-sur-Mer;1372;34748447;1934335;851;29052928;521;5695519;25327;24845
14691;Tilly-la-Campagne;61;1544953;70120;42;1365854;19;179099;25327;24846
17153;Esnandes;1069;27074731;1075142;650;21620420;419;5454311;25327;24847
50416;Querqueville;2301;58279574;2317576;1451;48764082;850;9515492;25328;24848
65354;Pailhac;39;987802;58075;23;836032;16;151770;25328;24849
24480;Saint-Paul-de-Serre;148;3748601;206237;88;3143321;60;605280;25328;24850
14284;Fourneaux-le-Val;80;2026285;73977;46;1628372;34;397913;25329;24851
31475;Saint-Clar-de-Rivière;615;15577373;607373;382;12969760;233;2607613;25329;24852
45271;Saint-Brisson-sur-Loire;595;15070855;697479;378;12759062;217;2311793;25329;24853
42233;Saint-Haon-le-Vieux;478;12107503;413335;289;9837457;189;2270046;25330;24854
57220;Flocourt;68;1722497;72023;35;1302923;33;419574;25331;24855
81242;Saint-Avit;118;2989138;138305;65;2236147;53;752991;25332;24856
45230;Noyers;433;10968748;556107;275;9199340;158;1769408;25332;24857
49141;Forges;143;3622615;101062;80;2808040;63;814575;25333;24858
33509;Savignac-de-l'Isle;283;7169331;457167;169;6100043;114;1069288;25333;24859
62689;Ransart;197;4990758;177162;128;4229562;69;761196;25334;24860
16236;Mouthiers-sur-Boëme;1320;33441328;1448646;836;28043039;484;5398289;25334;24861
71313;Monthelon;180;4560210;168358;111;3590427;69;969783;25335;24862
26176;Marsanne;670;16974157;704671;383;13644543;287;3329614;25335;24863
62069;Azincourt;144;3648225;162624;67;2748208;77;900017;25335;24864
31485;Saint-Germier;50;1266750;45046;28;1019647;22;247103;25335;24865
41285;Villeny;249;6308625;219348;143;4978526;106;1330099;25336;24866
01194;Jassans-Riottier;3178;80518539;3511780;1984;66347950;1194;14170589;25336;24867
24102;Chancelade;2429;61543330;2920286;1526;51329176;903;10214154;25337;24868
39460;La Rixouse;105;2660382;106703;69;2234594;36;425788;25337;24869
50483;Saint-Gilles;442;11199026;410903;285;9415321;157;1783705;25337;24870
63403;Saint-Vincent;222;5624902;242133;115;4536873;107;1088029;25337;24871
56143;Muzillac;2711;68691333;2763469;1555;55141220;1156;13550113;25338;24872
02406;Landricourt;66;1672357;62241;40;1377330;26;295027;25339;24873
51359;Mécringes;95;2407256;93894;65;2069391;30;337865;25340;24874
67070;Burbach;157;3978309;171562;102;3270647;55;707662;25340;24875
72375;Villaines-la-Gonais;281;7120652;303642;195;6175305;86;945347;25340;24876
19068;Dampniat;393;9959140;544689;247;8364288;146;1594852;25341;24877
42068;Combre;193;4890933;133306;135;4132826;58;758107;25342;24878
89030;Bazarnes;250;6335555;425328;151;5270247;99;1065308;25342;24879
27253;Fontaine-la-Soret;208;5271206;247695;139;4511008;69;760198;25342;24880
41027;Briou;75;1900784;84131;51;1709030;24;191754;25344;24881
60529;Rémécourt;42;1064511;41062;29;909168;13;155343;25346;24882
60434;Mortemer;115;2914779;130187;70;2412506;45;502273;25346;24883
60230;Le Fay-Saint-Quentin;283;7172896;338273;185;6159843;98;1013053;25346;24884
57487;Moulins-lès-Metz;3000;76039592;3983927;1834;62034037;1166;14005555;25347;24885
89074;Champigny;1139;28871186;1480718;724;24089220;415;4781966;25348;24886
67557;Zellwiller;365;9252157;349868;214;7514087;151;1738070;25348;24887
31014;Arguenos;38;963268;76468;21;786729;17;176539;25349;24888
41062;Couddes;302;7655554;397864;167;6314160;135;1341394;25350;24889
42212;Saint-Cyr-de-Favières;409;10367994;396322;255;8531527;154;1836467;25350;24890
14310;Grainville-Langannerie;351;8897721;252835;201;7071152;150;1826569;25350;24891
69095;Grézieu-le-Marché;374;9481318;369056;229;7686550;145;1794768;25351;24892
64443;Pardies;508;12878369;572682;316;10580960;192;2297409;25351;24893
60270;Genvry;167;4233653;218892;108;3580064;59;653589;25351;24894
83134;Taradeau;1019;25833931;1347883;612;21385127;407;4448804;25352;24895
73054;Bourg-Saint-Maurice;4728;119866149;6722188;2988;101576988;1740;18289161;25352;24896
26366;Veaunes;158;4005683;209419;92;3289185;66;716498;25352;24897
03184;Montilly;284;7200275;316812;179;6057990;105;1142285;25353;24898
78255;Freneuse;2067;52407266;2388932;1316;44000925;751;8406341;25354;24899
31463;Roumens;118;2992015;115669;73;2430314;45;561701;25356;24900
05113;Rambaud;188;4767117;194327;121;4002550;67;764567;25357;24901
16056;Bourg-Charente;485;12298238;700727;284;10150057;201;2148181;25357;24902
44117;Le Pallet;1536;38949978;1189291;953;32016992;583;6932986;25358;24903
79133;Germond-Rouvre;588;14910687;589549;376;12504577;212;2406110;25358;24904
89198;Gurgy;883;22391409;884759;608;19218638;275;3172771;25358;24905
80703;Saint-Germain-sur-Bresle;120;3043010;208859;82;2660984;38;382026;25358;24906
45158;Gondreville;195;4944909;226133;125;4109308;70;835601;25359;24907
41297;Yvoy-le-Marron;384;9737948;519644;206;7265354;178;2472594;25359;24908
62241;Cormont;148;3753330;173075;78;2864157;70;889173;25360;24909
41028;Busloup;219;5554274;211985;136;4413837;83;1140437;25362;24910
10148;Ferreux-Quincey;198;5021812;231639;115;4071164;83;950648;25363;24911
59239;Flines-lez-Raches;2887;73222482;3403255;1693;59972858;1194;13249624;25363;24912
08206;Ham-les-Moines;194;4920420;170872;132;4170023;62;750397;25363;24913
80738;Soues;70;1775427;89844;40;1402081;30;373346;25363;24914
32060;Boucagnères;83;2105157;100066;51;1727361;32;377796;25363;24915
28306;Pré-Saint-Martin;90;2282745;100541;58;1893411;32;389334;25364;24916
76147;Bully;452;11464719;500344;264;9386728;188;2077991;25364;24917
39161;Communailles-en-Montagne;29;735570;35996;15;488275;14;247295;25364;24918
71576;Le Villars;166;4210512;287620;98;3463835;68;746677;25365;24919
33451;Saint-Michel-de-Fronsac;285;7228932;378338;158;5819662;127;1409270;25365;24920
27498;Rouge-Perriers;158;4007635;138406;97;3292940;61;714695;25365;24921
72184;Mareil-en-Champagne;173;4388223;235409;110;3633557;63;754666;25365;24922
31413;Pelleport;267;6772607;299860;175;5843732;92;928875;25366;24923
63068;Cellule;560;14205036;692197;336;12309605;224;1895431;25366;24924
29035;Coat-Méal;468;11872525;322723;312;9989311;156;1883214;25369;24925
62002;Ablainzevelle;91;2308714;105296;54;1802492;37;506222;25370;24926
65164;Escoubès-Pouts;53;1344647;86425;33;1122021;20;222626;25371;24927
35041;Brie;411;10427374;424364;257;8647612;154;1779762;25371;24928
62214;Carly;272;6901061;340003;140;5377925;132;1523136;25372;24929
64098;Bassillon-Vauzé;39;989496;63503;20;815629;19;173867;25372;24930
57033;Arzviller;271;6876067;293761;161;5583385;110;1292682;25373;24931
60331;Labosse;244;6191286;245109;157;5355739;87;835547;25374;24932
01192;Izernore;1171;29713631;1243978;758;24672327;413;5041304;25375;24933
24113;La Chapelle-Saint-Jean;46;1167232;43656;22;905519;24;261713;25375;24934
08396;Saint-Quentin-le-Petit;82;2080784;180297;38;1606035;44;474749;25375;24935
54122;Chaudeney-sur-Moselle;366;9287419;349801;232;7597186;134;1690233;25375;24936
57263;Grundviller;344;8729295;430927;187;6838710;157;1890585;25376;24937
51030;Ay;2367;60067818;3249288;1375;49682260;992;10385558;25377;24938
71446;Saint-Marcelin-de-Cray;97;2461596;102896;52;1879159;45;582437;25377;24939
88531;Xonrupt-Longemer;852;21622278;719636;520;17588194;332;4034084;25378;24940
06069;Grasse;29473;747975627;47098116;16807;622621071;12666;125354556;25378;24941
62850;Vieil-Hesdin;202;5126570;292286;102;3890277;100;1236293;25379;24942
55134;Couvonges;82;2081084;141105;52;1836535;30;244549;25379;24943
76335;Gueutteville;39;989806;29703;21;735186;18;254620;25380;24944
41081;Faye;115;2918753;106211;76;2459399;39;459354;25380;24945
21620;Tarsul;91;2309652;114634;60;1978172;31;331480;25381;24946
89342;Saint-Denis;369;9366040;436330;238;7686796;131;1679244;25382;24947
60493;Pisseleu;203;5152871;178319;128;4222381;75;930490;25384;24948
71002;L'Abergement-Sainte-Colombe;564;14316711;547746;350;11595772;214;2720939;25384;24949
69170;Rontalon;591;15002715;557567;363;12342350;228;2660365;25385;24950
39101;Champvans;784;19902314;904808;490;16741384;294;3160930;25386;24951
02463;Marfontaine;38;964667;66519;21;734095;17;230572;25386;24952
55472;Saulvaux;63;1599332;103813;32;1280425;31;318907;25386;24953
41145;Monthou-sur-Bièvre;406;10307405;371730;265;8577957;141;1729448;25388;24954
64224;Eysus;344;8733409;365463;219;7266030;125;1467379;25388;24955
26352;La Touche;116;2945131;108722;61;2306676;55;638455;25389;24956
40062;Campet-et-Lamolère;173;4392366;157389;104;3457720;69;934646;25389;24957
33214;Lacanau;3167;80408334;5187321;1861;66632268;1306;13776066;25389;24958
52267;Laneuville-au-Pont;105;2665896;139284;70;2248420;35;417476;25389;24959
84142;Velleron;1698;43112197;2036038;998;35381620;700;7730577;25390;24960
21062;Bellenot-sous-Pouilly;124;3148482;133011;67;2430997;57;717485;25391;24961
80126;Bouttencourt;516;13101766;585790;313;10768892;203;2332874;25391;24962
76694;Tocqueville-en-Caux;66;1675866;79107;43;1414377;23;261489;25392;24963
61457;Saint-Symphorien-des-Bruyères;271;6881401;359273;184;5849177;87;1032224;25393;24964
09329;Vernajoul;372;9446380;434817;232;7924529;140;1521851;25393;24965
64261;Herrère;200;5078746;267192;126;4200513;74;878233;25394;24966
45284;Saint-Jean-de-Braye;10761;273270636;14790253;6990;233418013;3771;39852623;25395;24967
76237;Épinay-sur-Duclair;242;6145579;168894;155;5043347;87;1102232;25395;24968
27074;Boisney;161;4088690;214408;104;3387213;57;701477;25396;24969
19049;Chasteaux;364;9244149;384153;231;7809339;133;1434810;25396;24970
37258;Thizay;151;3834809;111837;101;3129875;50;704934;25396;24971
03213;Reugny;143;3631812;166584;85;2946499;58;685313;25397;24972
55021;Avillers-Sainte-Croix;37;939705;66894;19;764052;18;175653;25397;24973
13088;Le Rove;2646;67202383;3850676;1649;56989720;997;10212663;25398;24974
28176;Le Gault-Saint-Denis;316;8025735;314297;198;6449328;118;1576407;25398;24975
24577;Vézac;350;8889388;575607;198;7245934;152;1643454;25398;24976
33530;Teuillac;433;10997505;603938;213;8667383;220;2330122;25398;24977
54011;Allondrelle-la-Malmaison;272;6908653;150564;133;4330739;139;2577914;25399;24978
54450;Reherrey;66;1676411;33332;28;1239040;38;437371;25400;24979
59518;Ruesnes;224;5689658;265239;132;4745843;92;943815;25400;24980
71247;Jully-lès-Buxy;173;4394474;251753;103;3617688;70;776786;25402;24981
72343;Souvigné-sur-Sarthe;281;7139005;239089;178;5847275;103;1291730;25406;24982
39008;Amange;190;4827404;157166;119;3930101;71;897303;25407;24983
30177;Monteils;332;8435301;427053;199;6943469;133;1491832;25408;24984
56220;Sainte-Hélène;597;15168379;744294;357;12382434;240;2785945;25408;24985
38410;Saint-Lattier;677;17201934;700671;379;14015370;298;3186564;25409;24986
24557;Trélissac;4083;103745394;5944454;2507;86495616;1576;17249778;25409;24987
61151;Écorcei;190;4827899;233741;124;4203428;66;624471;25410;24988
43207;Saint-Laurent-Chabreuges;134;3405008;138573;84;2843135;50;561873;25411;24989
10343;Saint-Julien-les-Villas;3877;98518484;5831307;2380;82746614;1497;15771870;25411;24990
85058;Chasnais;345;8767364;403648;216;7105693;129;1661671;25413;24991
85008;Aubigny;1619;41143380;1553125;1035;34296937;584;6846443;25413;24992
67110;Durrenbach;563;14307452;606607;372;12163890;191;2143562;25413;24993
17355;Sainte-Lheurine;281;7141086;644237;131;5596064;150;1545022;25413;24994
25502;Roset-Fluans;233;5921529;215394;146;4869193;87;1052336;25414;24995
21163;Chazeuil;109;2770311;107274;66;2216822;43;553489;25416;24996
80694;Sailly-le-Sec;166;4219064;160265;103;3401852;63;817212;25416;24997
63413;La Sauvetat;392;9963098;452208;258;8469435;134;1493663;25416;24998
81051;Cahuzac-sur-Vère;604;15351485;738900;286;12064144;318;3287341;25416;24999
62793;Servins;535;13597786;715771;312;11408282;223;2189504;25416;25000
60119;Cambronne-lès-Ribécourt;1039;26407793;1085444;642;22092824;397;4314969;25417;25001
54570;Villecey-sur-Mad;158;4015831;164615;104;3325061;54;690770;25417;25002
06027;Cagnes-sur-Mer;30699;780300440;51559082;18757;660367322;11942;119933118;25418;25003
39083;Censeau;184;4677394;256493;107;3773367;77;904027;25421;25004
77294;Mitry-Mory;9890;251412534;12953572;6415;213767508;3475;37645026;25421;25005
50453;Sainte-Cécile;437;11109088;469971;263;9048389;174;2060699;25421;25006
01381;Saint-Nizier-le-Désert;423;10753290;435578;262;8722205;161;2031085;25421;25007
70179;Coulevon;117;2974355;137192;70;2507165;47;467190;25422;25008
56133;Missiriac;568;14440663;779566;348;11603900;220;2836763;25424;25009
71024;Baugy;272;6915520;254248;157;5514615;115;1400905;25425;25010
25615;Villars-lès-Blamont;240;6101979;323556;160;5227991;80;873988;25425;25011
45122;Dampierre-en-Burly;693;17620432;772596;464;14922993;229;2697439;25426;25012
88203;Girecourt-sur-Durbion;165;4195382;213077;101;3447898;64;747484;25427;25013
76388;Lintot;228;5797267;233164;153;4934629;75;862638;25427;25014
08378;Saint-Clément-à-Arnes;62;1576459;92900;34;1305573;28;270886;25427;25015
41174;Périgny;103;2619005;117429;71;2271817;32;347188;25427;25016
02007;Aizelles;60;1525639;67459;33;1177301;27;348338;25427;25017
61466;La Selle-la-Forge;707;17977339;583446;442;14786189;265;3191150;25428;25018
54479;Saint-Mard;48;1220538;24485;28;1009872;20;210666;25428;25019
21005;Aiserey;656;16680973;581894;431;14103392;225;2577581;25428;25020
77390;Roissy-en-Brie;11381;289399689;13795498;7299;247240214;4082;42159475;25428;25021
67167;Grendelbruch;696;17698290;880883;426;14773420;270;2924870;25429;25022
14743;Victot-Pontfol;60;1525856;139632;32;1234973;28;290883;25431;25023
35088;Corps-Nuds;1525;38783384;1236468;986;32282405;539;6500979;25432;25024
67349;Oberroedern;274;6968356;249391;183;5821173;91;1147183;25432;25025
39171;Courlaoux;488;12410810;493795;319;10370584;169;2040226;25432;25026
06029;Cannes;50713;1289733244;102916356;27283;1066784112;23430;222949132;25432;25027
67121;Elsenheim;422;10732394;467097;277;8966885;145;1765509;25432;25028
02573;Orgeval;39;991904;48980;22;824898;17;167006;25433;25029
29015;Bourg-Blanc;1675;42603383;1690428;1020;34878613;655;7724770;25435;25030
30314;Savignargues;107;2721554;108376;65;2296178;42;425376;25435;25031
31229;Gratens;344;8749673;435857;195;7035090;149;1714583;25435;25032
39249;Germigney;41;1042840;52576;22;823244;19;219596;25435;25033
14761;Vimont;345;8775129;295585;231;7325899;114;1449230;25435;25034
29094;Kernouës;350;8902351;250262;202;7011045;148;1891306;25435;25035
62431;Herbelles;246;6257189;188547;148;5027148;98;1230041;25436;25036
69137;Montmelas-Saint-Sorlin;250;6359127;335021;133;4932838;117;1426289;25437;25037
60199;Doméliers;118;3001532;129242;72;2517062;46;484470;25437;25038
67213;Hunspach;347;8826870;338979;209;6881830;138;1945040;25438;25039
22002;Andel;522;13278528;401431;332;10858782;190;2419746;25438;25040
74187;Montmin;184;4680587;243024;121;3983364;63;697223;25438;25041
63034;Beauregard-l'Évêque;737;18747989;815441;463;15737570;274;3010419;25438;25042
57621;Saint-Médard;51;1297364;94647;22;938203;29;359161;25439;25043
84140;Vaugines;329;8369648;505269;173;6976410;156;1393238;25440;25044
42179;Pralong;433;11015412;430091;274;9208217;159;1807195;25440;25045
35306;Saint-Père;1136;28899917;1224437;697;23970820;439;4929097;25440;25046
25155;Cléron;168;4273951;225275;101;3475870;67;798081;25440;25047
67180;Haguenau;19511;496372438;29085959;11886;416288699;7625;80083739;25441;25048
51242;Fagnières;2329;59251668;2493001;1574;50402980;755;8848688;25441;25049
94003;Arcueil;11345;288633635;20334665;7028;250455180;4317;38178455;25441;25050
76310;Gouchaupre;100;2544157;106594;62;2057195;38;486962;25442;25051
27394;Martot;262;6665735;279260;158;5520973;104;1144762;25442;25052
81093;Florentin;337;8574095;420677;190;7109754;147;1464341;25442;25053
05119;Risoul;426;10838559;682491;262;9058413;164;1780146;25443;25054
67544;Wissembourg;4424;112559576;6255959;2553;92612110;1871;19947466;25443;25055
89311;Pourrain;769;19565827;911633;478;16357239;291;3208588;25443;25056
31370;Montégut-Bourjac;63;1602949;87583;36;1316452;27;286497;25444;25057
34087;Cournonsec;1339;34070166;1531601;770;27514305;569;6555861;25444;25058
39191;Darbonnay;47;1195898;41785;22;881427;25;314471;25445;25059
21211;Crécey-sur-Tille;82;2086484;72364;55;1809664;27;276820;25445;25060
22272;Saint-Agathon;1173;29847195;1411321;663;24222657;510;5624538;25445;25061
71361;Prizy;33;839697;21441;22;680194;11;159503;25445;25062
59438;Noyelles-sur-Escaut;383;9745808;408176;242;8143587;141;1602221;25446;25063
37070;Chenonceaux;206;5241875;266911;129;4322205;77;919670;25446;25064
38501;Tencin;858;21833020;883527;594;18396981;264;3436039;25446;25065
76291;Froberville;545;13868516;538184;352;11421896;193;2446620;25447;25066
18209;Saint-Georges-de-Poisieux;233;5929231;249546;144;4891737;89;1037494;25447;25067
58114;Fléty;59;1501433;84783;29;1204625;30;296808;25448;25068
62825;Tortequesne;360;9161528;420749;207;7513207;153;1648321;25449;25069
52145;Coublanc;66;1679636;68774;43;1417236;23;262400;25449;25070
57440;Manhoué;77;1959615;101160;48;1635805;29;323810;25450;25071
02311;Filain;65;1654287;80281;38;1344389;27;309898;25451;25072
09234;Pradières;61;1552489;91050;41;1309690;20;242799;25451;25073
71200;Fleury-la-Montagne;329;8373323;326632;207;6817211;122;1556112;25451;25074
63188;Laps;289;7355292;300314;196;6348764;93;1006528;25451;25075
67341;Oberdorf-Spachbach;197;5013889;161947;116;3925906;81;1087983;25451;25076
16193;Louzac-Saint-André;545;13871157;730922;325;11526560;220;2344597;25452;25077
07317;Talencieux;494;12573820;418211;334;10628972;160;1944848;25453;25078
16343;Saint-Preuil;152;3868895;136682;80;2925465;72;943430;25453;25079
38391;Saint-Guillaume;128;3258097;157621;79;2645297;49;612800;25454;25080
26379;Granges-les-Beaumont;483;12294710;487977;309;10264926;174;2029784;25455;25081
38343;Romagnieu;807;20542197;908256;503;16888249;304;3653948;25455;25082
76692;Thiouville;139;3538295;170948;74;2740495;65;797800;25455;25083
30092;Connaux;912;23215338;987620;537;18883979;375;4331359;25455;25084
54081;Boismont;230;5854769;203218;102;3717918;128;2136851;25456;25085
26084;Châteauneuf-sur-Isère;1982;50453420;2260465;1195;41428945;787;9024475;25456;25086
76569;Sainte-Colombe;90;2291069;54350;51;1766970;39;524099;25456;25087
04122;Mirabeau;285;7255172;373494;180;6238443;105;1016729;25457;25088
72352;Terrehault;68;1731070;119171;42;1402872;26;328198;25457;25089
63073;Chadeleuf;218;5549681;193758;140;4718890;78;830791;25457;25090
67087;Dauendorf;773;19678460;877163;469;16335852;304;3342608;25457;25091
06066;Gilette;809;20595378;1149905;477;16794669;332;3800709;25458;25092
85118;Landeronde;1126;28666819;1007213;684;23382401;442;5284418;25459;25093
37010;Auzouer-en-Touraine;933;23753322;827440;603;19516635;330;4236687;25459;25094
25078;Bouclans;485;12347671;543710;283;9884026;202;2463645;25459;25095
49189;Marigné;324;8248841;294684;163;6199492;161;2049349;25459;25096
71356;Pouilloux;474;12068521;471419;307;9986240;167;2082281;25461;25097
25060;Bians-les-Usiers;315;8020257;335008;194;6521786;121;1498471;25461;25098
67057;Bosselshausen;93;2367906;85187;58;2026713;35;341193;25461;25099
79130;Frontenay-Rohan-Rohan;1595;40611864;1640708;967;33104757;628;7507107;25462;25100
81230;Rosières;413;10515901;536095;249;8479412;164;2036489;25462;25101
55166;Dugny-sur-Meuse;700;17823619;608991;424;14635106;276;3188513;25462;25102
14757;Villiers-le-Sec;145;3692110;156187;87;2982297;58;709813;25463;25103
56176;Pluneret;2694;68597258;2925906;1742;57499804;952;11097454;25463;25104
22327;Saint-Samson-sur-Rance;774;19708959;742292;480;16245462;294;3463497;25464;25105
08386;Saint-Loup-en-Champagne;131;3335838;193252;79;2768016;52;567822;25464;25106
03217;Saint-Angel;403;10262316;409191;268;8702008;135;1560308;25465;25107
62471;Inghem;213;5424014;210350;116;4188145;97;1235869;25465;25108
11199;Lavalette;666;16959883;830607;412;14401224;254;2558659;25465;25109
39327;Messia-sur-Sorne;448;11408625;448996;261;9402497;187;2006128;25466;25110
86178;Nieuil-l'Espoir;1181;30076940;1137427;754;25158603;427;4918337;25467;25111
22008;Bobital;536;13650916;508972;340;11378819;196;2272097;25468;25112
50402;Les Pieux;1701;43322699;2090409;978;35419221;723;7903478;25469;25113
27486;Quittebeuf;310;7895447;272908;200;6371569;110;1523878;25469;25114
19233;Saint-Pardoux-le-Vieux;157;3998794;211518;91;3233685;66;765109;25470;25115
02060;Beauvois-en-Vermandois;140;3565828;188489;90;2981861;50;583967;25470;25116
30069;Carnas;248;6316619;351449;133;5085404;115;1231215;25470;25117
65235;Juillan;2215;56417175;2447853;1384;46206289;831;10210886;25471;25118
76248;Estouteville-Écalles;227;5781811;240501;132;4658331;95;1123480;25471;25119
86275;Usseau;318;8100062;459728;185;6609388;133;1490674;25472;25120
77493;Verneuil-l'Étang;1617;41192370;1754707;1061;34766707;556;6425663;25475;25121
65181;Fréchou-Fréchet;70;1783224;66488;41;1418315;29;364909;25475;25122
31027;Auribail;110;2802218;121735;68;2300410;42;501808;25475;25123
85019;Belleville-sur-Vie;1913;48737398;1828848;1200;40156247;713;8581151;25477;25124
49200;La Membrolle-sur-Longuenée;928;23642681;549497;596;19373232;332;4269449;25477;25125
79238;Saint-Aubin-du-Plain;288;7337422;305523;164;5735929;124;1601493;25477;25126
07102;Guilherand-Granges;6515;165985200;8969888;4242;139401140;2273;26584060;25477;25127
47013;Argenton;178;4534994;262087;92;3583829;86;951165;25477;25128
70207;Échenoz-la-Méline;1779;45325121;2484351;1171;39192125;608;6132996;25478;25129
54392;Moutrot;144;3668860;179353;86;2851467;58;817393;25478;25130
62866;Waben;215;5477838;204828;147;4683729;68;794109;25478;25131
60458;La Neuville-sur-Oudeuil;157;4000240;153036;102;3318543;55;681697;25479;25132
57165;Dalem;341;8688421;413208;212;7166573;129;1521848;25479;25133
80629;Poeuilly;60;1528833;80843;39;1323514;21;205319;25481;25134
27660;La Trinité-de-Réville;151;3847654;302343;90;3308837;61;538817;25481;25135
51211;Dommartin-Dampierre;37;942820;64769;19;766920;18;175900;25482;25136
64396;Mont;502;12791889;380457;302;9904052;200;2887837;25482;25137
45093;Chevilly;1384;35272711;1590868;894;29404011;490;5868700;25486;25138
57604;Rustroff;327;8334016;121452;125;4454435;202;3879581;25486;25139
18121;Lantan;60;1529186;242733;28;1196719;32;332467;25486;25140
01343;Saint-Cyr-sur-Menthon;846;21562637;799922;540;18060926;306;3501711;25488;25141
24108;La Chapelle-Gonaguet;561;14298820;691603;368;12263367;193;2035453;25488;25142
64131;Biron;286;7289637;297654;175;5980237;111;1309400;25488;25143
68378;Wolfersdorf;189;4817301;243019;122;4040201;67;777100;25488;25144
76193;La Crique;169;4307710;186862;102;3414539;67;893171;25489;25145
88519;La Voivre;374;9533259;371100;240;7969582;134;1563677;25490;25146
51269;Giffaumont-Champaubert;152;3874506;284494;93;3223824;59;650682;25490;25147
08084;Brienne-sur-Aisne;93;2370606;94729;55;2046152;38;324454;25490;25148
76036;Auppegard;350;8921688;346044;218;7474584;132;1447104;25491;25149
60466;Noroy;104;2651172;107577;71;2327157;33;324015;25492;25150
60372;Luchy;280;7138032;313861;184;6105706;96;1032326;25493;25151
41210;Sainte-Gemmes;57;1453121;81882;31;1151885;26;301236;25493;25152
49147;Gée;202;5149702;134965;130;4167906;72;981796;25494;25153
12274;Sylvanès;49;1249186;73688;22;994842;27;254344;25494;25154
55186;Fains-Véel;1309;33371802;1962261;842;29388558;467;3983244;25494;25155
21031;Aubigny-en-Plaine;221;5634265;315691;134;4791020;87;843245;25494;25156
57259;Grindorff-Bizing;149;3798935;97563;79;2701398;70;1097537;25496;25157
60024;Arsy;457;11652062;576012;297;9822469;160;1829593;25497;25158
69157;Pontcharra-sur-Turdine;1300;33146442;1474437;830;27685810;470;5460632;25497;25159
67395;Reutenbourg;198;5048465;199659;113;4107422;85;941043;25497;25160
55423;Rembercourt-Sommaisne;176;4487540;197265;98;3467451;78;1020089;25497;25161
46213;Padirac;103;2626264;186620;55;2178272;48;447992;25498;25162
02389;Jaulgonne;365;9306724;564749;210;7491147;155;1815577;25498;25163
25561;Thoraise;171;4360199;205124;113;3776552;58;583647;25498;25164
59009;Villeneuve-d'Ascq;30656;781684429;50212793;17011;651211512;13645;130472917;25499;25165
25076;Bonnevaux-le-Prieuré;55;1402427;95979;38;1243936;17;158491;25499;25166
38396;Saint-Honoré;398;10148632;470803;245;8243540;153;1905092;25499;25167
59264;Gognies-Chaussée;419;10684299;590284;233;8667041;186;2017258;25500;25168
28273;Moulhard;80;2040024;138958;48;1682674;32;357350;25500;25169
45091;Chevannes;174;4437054;183886;109;3658566;65;778488;25500;25170
33457;Saint-Pardon-de-Conques;295;7522616;344806;184;6513701;111;1008915;25500;25171
76436;Le Mesnil-sous-Jumièges;319;8134717;426710;204;6919581;115;1215136;25501;25172
30062;Calvisson;2741;69898292;3401584;1618;57597112;1123;12301180;25501;25173
06015;Berre-les-Alpes;708;18055694;967937;446;15438334;262;2617360;25502;25174
53001;Ahuillé;852;21728905;589900;552;17913893;300;3815012;25503;25175
57064;Berling;152;3876552;168808;95;3211929;57;664623;25504;25176
39004;Abergement-lès-Thésy;24;612102;12091;11;435892;13;176210;25504;25177
27085;Bosc-Bénard-Crescy;194;4947855;253224;123;3939464;71;1008391;25504;25178
22282;Saint-Cast-le-Guildo;2255;57514819;3254126;1279;46713590;976;10801229;25505;25179
27378;La Madeleine-de-Nonancourt;647;16502257;807758;442;14354475;205;2147782;25506;25180
84099;Robion;2411;61496055;3370284;1324;49746494;1087;11749561;25506;25181
76012;Angerville-Bailleul;104;2652721;121357;65;2229604;39;423117;25507;25182
02125;Brumetz;91;2321136;78062;56;1876863;35;444273;25507;25183
45168;Ingrannes;266;6784862;313088;172;5714804;94;1070058;25507;25184
50239;Hébécrevon;551;14054704;529848;361;11569336;190;2485368;25508;25185
94044;Limeil-Brévannes;11419;291272400;16532197;7577;252691188;3842;38581212;25508;25186
84065;Lauris;2117;54000906;2920512;1164;43403756;953;10597150;25508;25187
31441;Prunet;76;1938631;77368;46;1613984;30;324647;25508;25188
80028;Arquèves;85;2168275;148468;46;1730284;39;437991;25509;25189
41118;Loreux;134;3418253;175435;89;2964898;45;453355;25509;25190
54435;Prény;191;4872331;200274;123;4014676;68;857655;25510;25191
80682;Rouvroy-en-Santerre;105;2678531;114974;60;2180156;45;498375;25510;25192
61110;La Cochère;78;1989828;111017;43;1622009;35;367819;25511;25193
59620;Villers-au-Tertre;317;8087006;417400;196;6905720;121;1181286;25511;25194
33323;Le Pian-sur-Garonne;432;11020904;569513;268;9140658;164;1880246;25511;25195
76179;Clères;736;18776375;931799;439;15777354;297;2999021;25511;25196
80784;Vaux-sur-Somme;164;4183929;161206;113;3688021;51;495908;25512;25197
57030;Arry;258;6582107;185296;172;5661349;86;920758;25512;25198
51233;Escardes;43;1097037;65071;22;857188;21;239849;25512;25199
63194;Lempty;183;4668915;189739;108;3824968;75;843947;25513;25200
70084;Boulot;338;8623498;315152;222;7184012;116;1439486;25513;25201
10245;Montaulin;405;10332987;425169;276;9053051;129;1279936;25514;25202
39381;Les Nans;53;1352221;80215;25;998957;28;353264;25514;25203
67076;Colroy-la-Roche;280;7143931;467461;166;5959616;114;1184315;25514;25204
16172;Juillaguet;75;1913564;83217;40;1638082;35;275482;25514;25205
76081;Berneval-le-Grand;709;18090976;786474;464;15251366;245;2839610;25516;25206
46340;Saint-Pierre-Lafeuille;185;4720634;173238;120;3973599;65;747035;25517;25207
54031;Autreville-sur-Moselle;157;4006280;240711;104;3478576;53;527704;25518;25208
62184;Buissy;128;3266500;207289;69;2561463;59;705037;25520;25209
08043;Balan;893;22789099;1240624;511;18632318;382;4156781;25520;25210
57656;Sorbey;177;4517009;155795;119;3861691;58;655318;25520;25211
21459;Noiron-sur-Bèze;116;2960528;108088;71;2448053;45;512475;25522;25212
27650;Tournedos-Bois-Hubert;208;5308550;215831;145;4639598;63;668952;25522;25213
14172;Commes;235;5997780;326432;139;4851627;96;1146153;25522;25214
73203;Pontamafrey-Montpascal;181;4619586;192502;128;4000504;53;619082;25523;25215
80031;Arvillers;409;10439219;618434;229;8518267;180;1920952;25524;25216
76234;Émanville;268;6840440;186409;170;5410240;98;1430200;25524;25217
74280;Thônes;3464;88415998;4627873;2212;74296940;1252;14119058;25524;25218
33029;Le Barp;2473;63121744;2643744;1541;52827436;932;10294308;25524;25219
59216;Eswars;186;4747622;256586;120;4060476;66;687146;25525;25220
70260;Frotey-lès-Lure;347;8857224;389036;225;7577736;122;1279488;25525;25221
31149;Colomiers;19368;494374610;28530473;11808;420971323;7560;73403287;25525;25222
27164;Combon;400;10210236;493810;262;8624057;138;1586179;25526;25223
05133;Saint-Chaffrey;1019;26011429;1347080;655;21864342;364;4147087;25526;25224
73089;Coise-Saint-Jean-Pied-Gauthier;628;16031026;664762;419;13523969;209;2507057;25527;25225
62579;Monchy-au-Bois;253;6458428;284134;150;5314861;103;1143567;25527;25226
18035;Brécy;412;10517364;412889;254;8642529;158;1874835;25528;25227
41120;Lunay;725;18507715;975090;438;15579076;287;2928639;25528;25228
46117;Gagnac-sur-Cère;403;10287980;454286;243;8626564;160;1661416;25528;25229
60450;Neuilly-en-Thelle;1694;43246677;2181313;1176;37738897;518;5507780;25529;25230
64525;Siros;334;8526924;370401;212;7094822;122;1432102;25530;25231
51382;Mont-sur-Courville;61;1557316;69113;42;1414142;19;143174;25530;25232
70529;Velet;209;5335752;254937;123;4303874;86;1031878;25530;25233
50284;Macey;57;1455227;72524;34;1229943;23;225284;25530;25234
22367;Tréméloir;361;9216542;336179;231;7751406;130;1465136;25531;25235
19107;Larche;863;22036109;1029092;568;18607597;295;3428512;25534;25236
79024;Azay-le-Brûlé;938;23951203;887612;611;20017921;327;3933282;25534;25237
67254;Kutzenhausen;476;12154530;505093;309;10234132;167;1920398;25535;25238
57217;Flétrange;449;11466004;442298;275;9184792;174;2281212;25537;25239
24499;Saint-Sauveur;434;11083197;540050;271;9128058;163;1955139;25537;25240
47326;Virazeil;925;23622451;1239545;539;19415973;386;4206478;25538;25241
65133;Castéra-Lou;103;2630477;103905;70;2261301;33;369176;25539;25242
36112;Mâron;387;9883613;493685;247;8345241;140;1538372;25539;25243
14364;Lingèvres;237;6052954;259402;138;4996035;99;1056919;25540;25244
14712;Troarn;1913;48857845;2316518;1197;40643451;716;8214394;25540;25245
45277;Saint-Florent;264;6742636;259229;170;5565246;94;1177390;25540;25246
49120;Denée;695;17750758;648351;412;14456432;283;3294326;25541;25247
80615;Ovillers-la-Boisselle;215;5491325;263525;133;4574628;82;916697;25541;25248
60593;Saint-Pierre-lès-Bitry;73;1864549;60163;50;1590256;23;274293;25542;25249
80508;Marché-Allouarde;32;817342;55491;16;603444;16;213898;25542;25250
01232;Marboz;1202;30702324;1316757;721;25087743;481;5614581;25543;25251
57069;Berviller-en-Moselle;260;6641252;293437;161;5360634;99;1280618;25543;25252
47282;Saint-Vincent-de-Lamontjoie;130;3320654;130131;75;2661573;55;659081;25543;25253
70355;Montarlot-lès-Rioz;123;3141890;76656;73;2478093;50;663797;25544;25254
50233;Hautteville-Bocage;63;1609281;75170;31;1192582;32;416699;25544;25255
38389;Saint-Georges-d'Espéranche;1736;44345086;1762113;1088;36864302;648;7480784;25544;25256
57444;Marange-Zondrange;167;4265918;182988;102;3543415;65;722503;25544;25257
14250;Esquay-sur-Seulles;172;4393741;184218;108;3638107;64;755634;25545;25258
64279;Itxassou;1061;27103475;1274300;647;22387858;414;4715617;25545;25259
10113;Couvignon;126;3218718;198950;75;2706693;51;512025;25545;25260
89060;Bussy-le-Repos;213;5441224;237656;139;4599460;74;841764;25546;25261
38181;Goncelin;1245;31804623;1333946;813;27028437;432;4776186;25546;25262
22151;Meslin;485;12389906;420162;296;10162183;189;2227723;25546;25263
45226;Neuvy-en-Sullias;590;15072605;447295;382;12519652;208;2552953;25547;25264
33413;Saint-Germain-du-Puch;1132;28919067;1369152;694;24196808;438;4722259;25547;25265
25495;Roche-lez-Beaupré;1129;28842599;1326500;714;23978207;415;4864392;25547;25266
45343;Villevoques;117;2989086;147704;83;2650783;34;338303;25548;25267
33335;Le Pout;281;7179134;216147;195;6130547;86;1048587;25549;25268
2B168;Monticello;1004;25650805;1617388;574;21172282;430;4478523;25549;25269
55321;Marre;85;2171715;88220;51;1819257;34;352458;25550;25270
62151;Boisleux-au-Mont;245;6259746;234625;152;5144112;93;1115634;25550;25271
01087;Charix;151;3858073;141231;96;3245337;55;612736;25550;25272
76091;Beuzeville-la-Guérard;105;2682773;116637;62;2113492;43;569281;25550;25273
02718;Silly-la-Poterie;81;2069597;132580;49;1758600;32;310997;25551;25274
89201;Héry;1053;26906608;1375506;670;22669996;383;4236612;25552;25275
60394;Ménévillers;53;1354283;60999;34;1124016;19;230267;25553;25276
61440;Saint-Ouen-sur-Iton;462;11805556;523968;298;9955291;164;1850265;25553;25277
56012;Beignon;690;17632451;736247;412;14458595;278;3173856;25554;25278
54094;Bralleville;85;2172250;88226;50;1717719;35;454531;25556;25279
54318;Liverdun;3103;79300462;3676592;1933;65902892;1170;13397570;25556;25280
2A017;Appietto;907;23179719;1271877;574;19935358;333;3244361;25556;25281
10107;Coursan-en-Othe;56;1431182;71232;39;1256882;17;174300;25557;25282
34244;Saint-Brès;1405;35907602;1840995;845;30264759;560;5642843;25557;25283
25618;Villars-sous-Écot;183;4677151;187336;136;4107354;47;569797;25558;25284
31306;Lourde;55;1405709;48216;34;1186978;21;218731;25558;25285
55341;Moirey-Flabas-Crépion;63;1610223;119011;26;1187447;37;422776;25559;25286
60220;Espaubourg;237;6057588;181779;139;4862005;98;1195583;25559;25287
88122;Damas-et-Bettegney;195;4984173;296332;112;3919114;83;1065059;25560;25288
88429;Saint-Nabord;2178;55669435;2699412;1345;46155150;833;9514285;25560;25289
68057;Buethwiller;127;3246346;130791;72;2527059;55;719287;25562;25290
50120;Chanteloup;153;3910967;131751;98;3262997;55;647970;25562;25291
71118;Châtenoy-le-Royal;3208;82002593;4164780;1973;66988499;1235;15014094;25562;25292
54172;Doncourt-lès-Longuyon;131;3348631;62101;62;1987344;69;1361287;25562;25293
54400;Nomeny;605;15465182;709113;366;12930365;239;2534817;25562;25294
22302;Saint-Jacut-de-la-Mer;579;14800721;918759;319;11785763;260;3014958;25563;25295
35134;Les Iffs;137;3502087;124452;75;2738490;62;763597;25563;25296
32329;Préchac;87;2224056;94393;48;1772609;39;451447;25564;25297
35186;Mont-Dol;631;16130861;946546;324;12753182;307;3377679;25564;25298
74308;Vinzier;413;10558168;445389;271;9102524;142;1455644;25565;25299
33338;Prignac-en-Médoc;112;2863348;213989;63;2398582;49;464766;25566;25300
88169;Fays;126;3221291;132604;85;2784884;41;436407;25566;25301
39523;Syam;111;2837815;149874;75;2395814;36;442001;25566;25302
40247;Saint-Agnet;96;2454339;142346;48;1871207;48;583132;25566;25303
10271;Origny-le-Sec;335;8564645;513342;200;7014029;135;1550616;25566;25304
59463;Pitgam;456;11658349;479257;258;9407296;198;2251053;25567;25305
27349;Illeville-sur-Montfort;439;11223844;361620;271;9244925;168;1978919;25567;25306
66101;Llupia;1059;27075443;1258275;674;22561828;385;4513615;25567;25307
02384;Houry;26;664750;34648;13;523593;13;141157;25567;25308
62084;Barly;116;2965817;173837;59;2315434;57;650383;25567;25309
70029;Arpenans;115;2940348;168123;63;2345024;52;595324;25568;25310
42210;Sainte-Croix-en-Jarez;232;5931917;247833;135;4842407;97;1089510;25569;25311
76027;Assigny;195;4985894;320907;108;3995178;87;990716;25569;25312
37083;Cormery;905;23139739;915203;524;18877931;381;4261808;25569;25313
62244;Coulogne;2879;73613181;3745680;1659;59347946;1220;14265235;25569;25314
66093;Laroque-des-Albères;1265;32345144;1638226;719;26317349;546;6027795;25569;25315
11313;Ricaud;143;3656438;118087;91;3093231;52;563207;25569;25316
62768;Saint-Rémy-au-Bois;51;1304046;73248;28;1022865;23;281181;25570;25317
29047;Le Drennec;855;21862012;724232;536;17927999;319;3934013;25570;25318
36009;Arthon;597;15265640;672491;372;12593460;225;2672180;25571;25319
45301;Santeau;193;4935243;202264;121;4087555;72;847688;25571;25320
27497;Rougemontiers;466;11916443;571805;294;9818474;172;2097969;25572;25321
25406;Montrond-le-Château;266;6802481;231400;169;5693648;97;1108833;25573;25322
81095;Frausseilles;57;1457685;96392;27;1181665;30;276020;25573;25323
89403;Stigny;62;1585591;144173;28;1165710;34;419881;25574;25324
88185;Frenelle-la-Grande;62;1585641;65569;39;1333289;23;252352;25575;25325
90045;Fêche-l'Église;425;10869609;520577;274;9097676;151;1771933;25576;25326
77507;Villenauxe-la-Petite;256;6547638;403798;149;5302594;107;1245044;25577;25327
38211;Lieudieu;167;4271357;234616;85;3329729;82;941628;25577;25328
35299;Saint-Méloir-des-Ondes;1979;50617453;2267680;1186;41277812;793;9339641;25577;25329
71094;La Chapelle-sous-Brancion;82;2097372;83801;50;1737878;32;359494;25578;25330
89353;Saint-Martin-d'Ordon;205;5243473;264661;124;4262123;81;981350;25578;25331
71518;Serrières;162;4143652;227530;100;3496726;62;646926;25578;25332
69169;Ronno;298;7623173;263817;192;6355133;106;1268040;25581;25333
14221;Démouville;1680;42980857;1757112;1118;36062011;562;6918846;25584;25334
81130;Lagarrigue;996;25482799;1387416;604;20906135;392;4576664;25585;25335
40326;Vielle-Saint-Girons;775;19828489;952316;468;16378546;307;3449943;25585;25336
02564;Noyant-et-Aconin;255;6524582;300451;169;5561273;86;963309;25587;25337
88237;Hennecourt;168;4298710;157359;110;3535971;58;762739;25588;25338
27522;Saint-Christophe-sur-Condé;226;5783044;229621;133;4757633;93;1025411;25589;25339
10030;Barberey-Saint-Sulpice;637;16300936;651203;433;13720721;204;2580215;25590;25340
57562;Ranguevaux;409;10467109;311881;212;7280853;197;3186256;25592;25341
37276;Villedômer;675;17274900;820029;425;14346296;250;2928604;25592;25342
68079;Elbach;153;3915693;207612;99;3403033;54;512660;25593;25343
91027;Athis-Mons;16632;425695924;26381256;10644;365649546;5988;60046378;25595;25344
69162;Quincié-en-Beaujolais;638;16329840;897233;378;13482060;260;2847780;25595;25345
42191;Roisey;479;12260433;492885;311;10325506;168;1934927;25596;25346
57650;Sierck-les-Bains;886;22679290;544473;358;12975730;528;9703560;25597;25347
02712;Sergy;92;2354965;154319;49;1922997;43;431968;25597;25348
10166;Les Grandes-Chapelles;225;5759572;325697;135;4695615;90;1063957;25598;25349
22351;Treffrin;306;7833065;332150;194;6483893;112;1349172;25598;25350
62559;Marquion;512;13106368;683176;293;10555310;219;2551058;25598;25351
68138;Hirsingue;1285;32894228;2083625;723;27446295;562;5447933;25599;25352
38320;Porcieu-Amblagnieu;869;22245222;1077429;524;18226704;345;4018518;25599;25353
31354;Monestrol;31;793568;41621;20;686925;11;106643;25599;25354
51165;Connantre;588;15052334;835911;345;12502803;243;2549531;25599;25355
54481;Saint-Maurice-aux-Forges;51;1305616;43411;33;1039282;18;266334;25600;25356
64177;Castétis;341;8729955;389391;212;7114561;129;1615394;25601;25357
54546;Vandières;518;13261510;734993;343;11303004;175;1958506;25601;25358
84034;Caumont-sur-Durance;2680;68612142;3722384;1651;58718505;1029;9893637;25602;25359
67143;Fouchy;333;8525346;282310;223;7189104;110;1336242;25602;25360
68097;Fréland;752;19253205;927984;453;15583107;299;3670098;25603;25361
76077;Bénesville;92;2355513;97980;57;1910961;35;444552;25603;25362
42198;Saint-Alban-les-Eaux;537;13749043;783521;338;11380337;199;2368706;25603;25363
28223;Luray;767;19637989;856279;492;16481455;275;3156534;25604;25364
14749;Vieux-Fumé;223;5709612;215333;142;4734452;81;975160;25604;25365
16316;Saint-Fort-sur-le-Né;219;5607432;365096;114;4394725;105;1212707;25605;25366
77265;Luzancy;551;14108266;659559;358;11944091;193;2164175;25605;25367
29126;Loc-Brévalaire;97;2483727;54436;63;2092322;34;391405;25605;25368
73129;Grésy-sur-Isère;669;17130488;818974;417;14029064;252;3101424;25606;25369
36199;Sainte-Lizaigne;667;17079328;765136;436;14210714;231;2868614;25606;25370
64153;Burosse-Mendousse;33;845005;39580;19;690056;14;154949;25606;25371
76143;Bretteville-du-Grand-Caux;619;15850972;538204;374;13025949;245;2825023;25607;25372
64057;Arthez-de-Béarn;929;23789821;867972;574;19555486;355;4234335;25608;25373
44089;Malville;1570;40205281;1324247;1015;33397028;555;6808253;25608;25374
45312;Solterre;267;6837635;365302;180;5908094;87;929541;25609;25375
27247;Flipou;178;4558489;188321;126;4031539;52;526950;25609;25376
69065;Corcelles-en-Beaujolais;432;11063311;405400;291;9351491;141;1711820;25610;25377
47146;Lédat;651;16672408;705158;390;13478199;261;3194209;25610;25378
59366;Lynde;326;8349041;318380;201;6809200;125;1539841;25611;25379
57371;Haute-Kontz;263;6735808;28038;84;2588400;179;4147408;25611;25380
77409;Saint-Germain-Laval;1320;33807098;1387345;883;28646055;437;5161043;25611;25381
02626;Prouvais;195;4994238;257819;116;4070243;79;923995;25611;25382
14025;Aubigny;160;4097866;178351;93;3329803;67;768063;25612;25383
76058;Baromesnil;140;3585640;205065;72;2773246;68;812394;25612;25384
08152;Élan;43;1101324;48707;30;973270;13;128054;25612;25385
80499;Mailly-Raineval;130;3329763;227399;76;2691712;54;638051;25614;25386
67195;Hessenheim;297;7607504;318786;188;6367757;109;1239747;25614;25387
69031;Brussieu;570;14600680;521723;366;12258792;204;2341888;25615;25388
31314;Mancioux;243;6224503;231803;138;5121013;105;1103490;25615;25389
64483;Saint-Jean-de-Luz;8986;230178816;15800015;4987;187355568;3999;42823248;25615;25390
80082;Belloy-sur-Somme;402;10297690;490231;245;8812368;157;1485322;25616;25391
61092;Chandai;352;9016940;427114;209;7441334;143;1575606;25616;25392
71003;Allerey-sur-Saône;420;10758996;624587;246;8756536;174;2002460;25617;25393
27700;Vraiville;299;7659457;352930;182;6317649;117;1341808;25617;25394
76524;Reuville;70;1793206;124189;39;1484864;31;308342;25617;25395
14230;Drubec;64;1639540;84519;42;1394457;22;245083;25618;25396
29237;La Roche-Maurice;969;24823849;1048697;607;21016997;362;3806852;25618;25397
68304;Sentheim;804;20596920;847553;522;17166349;282;3430571;25618;25398
61467;Semallé;204;5226405;238299;130;4391962;74;834443;25620;25399
57331;Hombourg-Budange;251;6430541;258255;129;4509427;122;1921114;25620;25400
10280;Pars-lès-Romilly;412;10555404;565937;249;8558697;163;1996707;25620;25401
64091;Baliros;208;5328986;212838;120;4362893;88;966093;25620;25402
63106;Chauriat;810;20753075;884246;532;17796704;278;2956371;25621;25403
57397;Ley;56;1434803;60574;32;1176608;24;258195;25621;25404
14126;Cambremer;673;17243335;823038;369;13846586;304;3396749;25622;25405
67464;Sermersheim;428;10966057;375401;271;9229374;157;1736683;25622;25406
60257;Fresne-Léguillon;243;6226078;284405;155;5181185;88;1044893;25622;25407
03060;Charmeil;416;10658813;471325;260;8892065;156;1766748;25622;25408
89080;La Chapelle-sur-Oreuse;311;7968796;409620;183;6533826;128;1434970;25623;25409
45212;Montcresson;740;18961333;978666;472;16166370;268;2794963;25623;25410
70480;Sauvigney-lès-Pesmes;93;2383002;172227;46;1911494;47;471508;25624;25411
21685;Villaines-en-Duesmois;142;3638571;208448;83;2919013;59;719558;25624;25412
30098;Crespian;171;4381754;189187;91;3552999;80;828755;25624;25413
57752;Woustviller;1602;41050736;2029681;975;33506053;627;7544683;25625;25414
02643;Ressons-le-Long;390;9994075;469665;227;8040434;163;1953641;25626;25415
18159;Nançay;514;13172554;713475;301;10173220;213;2999334;25628;25416
27603;Saint-Siméon;161;4126045;182128;110;3522726;51;603319;25628;25417
45004;Amilly;6875;176191942;9693035;4177;146831805;2698;29360137;25628;25418
26134;Félines-sur-Rimandoule;40;1025143;56629;14;635140;26;390003;25629;25419
39178;Crans;40;1025155;41780;25;901293;15;123862;25629;25420
47076;Cuq;161;4126258;391463;76;3267278;85;858980;25629;25421
40187;Moliets-et-Maa;616;15787781;930963;355;13180026;261;2607755;25630;25422
76013;Angerville-la-Martel;442;11328286;368286;272;9071573;170;2256713;25630;25423
37205;Saché;670;17171965;648136;426;14128384;244;3043581;25630;25424
25325;Landresse;108;2768091;103050;63;2200879;45;567212;25630;25425
74212;Le Petit-Bornand-les-Glières;601;15404346;600751;359;12326161;242;3078185;25631;25426
21210;Créancey;276;7074244;331476;171;5824099;105;1250145;25631;25427
27084;Bosc-Bénard-Commin;158;4049827;141320;99;3324199;59;725628;25632;25428
35283;Saint-Jean-sur-Vilaine;524;13431157;369386;329;10865332;195;2565825;25632;25429
59058;Beaufort;539;13816309;777308;332;11689985;207;2126324;25633;25430
50454;Saint-Christophe-du-Foc;185;4742268;80919;121;3909932;64;832336;25634;25431
31574;Vernet;1190;30504857;1301678;770;25677116;420;4827741;25634;25432
66120;Nahuja;37;948472;36747;23;734573;14;213899;25634;25433
27562;Saint-Marcel;2724;69829008;3820511;1712;60032116;1012;9796892;25635;25434
45099;Coinces;290;7434170;286565;197;6391996;93;1042174;25635;25435
11279;Pennautier;1326;33994032;2485720;684;27861509;642;6132523;25637;25436
46188;Maxou;144;3691661;153078;89;3010765;55;680896;25637;25437
70410;Pin;342;8767846;406665;213;7278677;129;1489169;25637;25438
88158;Éloyes;1860;47687630;1652480;999;38589864;861;9097766;25639;25439
57358;Kédange-sur-Canner;549;14075626;449426;288;9899935;261;4175691;25639;25440
46322;Trespoux-Rassiels;410;10512199;436433;251;8630635;159;1881564;25640;25441
55508;Thonne-la-Long;145;3717736;164715;79;2760286;66;957450;25640;25442
50324;Le Mesnil-Véneron;56;1435823;82625;27;1092113;29;343710;25640;25443
19227;Saint-Mexant;655;16794046;743755;436;14127595;219;2666451;25640;25444
67082;Dalhunden;524;13435357;570852;337;11421400;187;2013957;25640;25445
21579;Salives;110;2820445;141328;62;2246234;48;574211;25640;25446
50073;Branville-Hague;75;1923033;43602;51;1630240;24;292793;25640;25447
77093;La Chapelle-Moutils;226;5794852;391107;138;4705336;88;1089516;25641;25448
24111;La Chapelle-Montmoreau;47;1205125;70945;23;917117;24;288008;25641;25449
90064;Lepuix-Neuf;160;4102560;199466;97;3356324;63;746236;25641;25450
69103;Juliénas;465;11923103;497406;289;9814492;176;2108611;25641;25451
38374;Saint-Chef;1779;45615498;2039684;1068;38011221;711;7604277;25641;25452
01060;Brénod;285;7308085;333565;184;6052321;101;1255764;25642;25453
77446;Savins;306;7846827;314466;203;6619742;103;1227085;25643;25454
61028;Bazoches-au-Houlme;221;5667177;202030;111;4355915;110;1311262;25643;25455
11030;Belflou;55;1410532;58685;29;1117366;26;293166;25646;25456
80536;Mesnil-Bruntel;183;4693463;347268;113;4027403;70;666060;25647;25457
33141;Croignon;273;7001844;276134;178;5927210;95;1074634;25648;25458
71252;Lalheue;195;5001348;209265;131;4219134;64;782214;25648;25459
10392;Vallant-Saint-Georges;211;5411778;241076;145;4584363;66;827415;25648;25460
01365;Saint-Jean-sur-Veyle;566;14517489;556915;364;12136727;202;2380762;25649;25461
46300;Saux;69;1769822;90606;35;1361654;34;408168;25650;25462
72147;La Guierche;551;14133068;496657;371;12087053;180;2046015;25650;25463
74004;Allèves;177;4540070;204761;105;3703146;72;836924;25650;25464
10176;Jaucourt;93;2385463;137856;62;2004208;31;381255;25650;25465
55531;Vassincourt;131;3360203;140094;85;2863544;46;496659;25650;25466
52316;Mathons;36;923424;67646;18;730092;18;193332;25651;25467
60400;Le Mesnil-sur-Bulles;115;2949848;156181;72;2370271;43;579577;25651;25468
55312;Maizey;95;2436918;112045;66;2068273;29;368645;25652;25469
38295;Parmilieu;329;8439492;301620;210;6853213;119;1586279;25652;25470
26335;Salles-sous-Bois;114;2924343;150057;60;2195014;54;729329;25652;25471
70057;Bay;61;1564788;45224;39;1229883;22;334905;25652;25472
23170;Savennes;129;3309263;171733;85;2887409;44;421854;25653;25473
79259;Saint-Jean-de-Thouars;717;18394423;779081;445;15162445;272;3231978;25655;25474
02003;Acy;513;13160913;611919;301;10593489;212;2567424;25655;25475
35037;Bréal-sous-Montfort;2552;65473740;2316384;1680;55136521;872;10337219;25656;25476
90097;Trévenans;628;16111968;760679;398;13349467;230;2762501;25656;25477
61125;Coulonges-les-Sablons;234;6003560;329556;134;4909263;100;1094297;25656;25478
62237;Conteville-lès-Boulogne;229;5875837;221718;140;4974981;89;900856;25659;25479
86300;Yversay;176;4515929;166377;121;3917412;55;598517;25659;25480
28232;Manou;312;8005520;431971;185;6654542;127;1350978;25659;25481
55361;Moulainville;64;1642225;59875;48;1486746;16;155479;25660;25482
84088;Pernes-les-Fontaines;6093;156346044;8791269;3347;126373073;2746;29972971;25660;25483
50612;Vains;414;10623236;498789;259;8939994;155;1683242;25660;25484
05110;Puy-Saint-Vincent;179;4593168;239808;96;3663879;83;929289;25660;25485
14754;Villers-sur-Mer;1829;46933313;3001135;1078;39305108;751;7628205;25661;25486
38028;La Bâtie-Divisin;484;12419767;537277;289;10241097;195;2178670;25661;25487
76638;Saint-Pierre-en-Val;580;14883546;694234;386;12659482;194;2224064;25661;25488
60483;Orvillers-Sorel;263;6749052;336742;161;5573784;102;1175268;25662;25489
38100;Le Cheylas;1233;31641217;1181810;795;26584583;438;5056634;25662;25490
39448;Rahon;255;6544128;249805;159;5431724;96;1112404;25663;25491
59135;Cassel;1273;32670610;1801014;651;26328185;622;6342425;25664;25492
50240;Helleville;215;5517836;135865;143;4657992;72;859844;25664;25493
60610;Sempigny;419;10753544;530274;257;8820992;162;1932552;25665;25494
35250;Saint-Armel;901;23124328;865475;633;19964829;268;3159499;25665;25495
14287;Frénouville;855;21943781;628793;586;18544391;269;3399390;25665;25496
51340;Maisons-en-Champagne;273;7006619;416996;157;5667709;116;1338910;25665;25497
76307;Gonneville-la-Mallet;673;17273152;691691;407;14099704;266;3173448;25666;25498
42120;Lentigny;825;21175436;741445;531;17422420;294;3753016;25667;25499
25569;Trépot;250;6417095;244700;143;5076486;107;1340609;25668;25500
25462;Pontarlier;10556;270959567;17125329;6472;228657660;4084;42301907;25669;25501
76071;Bellengreville;224;5749808;221358;137;4695468;87;1054340;25669;25502
57531;Oudrenne;379;9728547;180533;176;5925100;203;3803447;25669;25503
64147;Briscous;1348;34602342;1356163;836;29202962;512;5399380;25669;25504
60217;Escames;114;2926330;180411;70;2550932;44;375398;25670;25505
30127;Gaujac;540;13862152;643048;344;11826530;196;2035622;25671;25506
84038;Cheval-Blanc;2251;57785308;2959930;1307;47283348;944;10501960;25671;25507
59628;Volckerinckhove;274;7033848;296711;149;5582438;125;1451410;25671;25508
39281;Le Latet;38;975503;26437;22;733329;16;242174;25671;25509
63204;Malintrat;546;14016502;651998;366;12009880;180;2006622;25671;25510
10342;Saint-Jean-de-Bonneval;200;5134258;199836;127;4351680;73;782578;25671;25511
57168;Danne-et-Quatre-Vents;309;7932743;301970;201;6694089;108;1238654;25672;25512
28304;Prasville;208;5339909;224753;135;4466676;73;873233;25673;25513
44163;Saint-Herblon;1173;30114740;1000354;722;24450342;451;5664398;25673;25514
61456;Saint-Sulpice-sur-Risle;891;22875256;1098039;545;18917868;346;3957388;25674;25515
10104;Cormost;158;4056665;220503;109;3478380;49;578285;25675;25516
69129;Marnand;297;7625591;286016;185;6244345;112;1381246;25675;25517
80121;Bouillancourt-la-Bataille;75;1925681;126624;46;1638904;29;286777;25676;25518
27448;Pacy-sur-Eure;2696;69222340;3702128;1635;58576289;1061;10646051;25676;25519
62120;Beugin;231;5931209;256428;146;5054527;85;876682;25676;25520
10345;Saint-Léger-sous-Brienne;215;5520546;301648;138;4651061;77;869485;25677;25521
80234;Daours;394;10116801;547582;247;8694804;147;1421997;25677;25522
21171;Chevigny-Saint-Sauveur;5476;140609148;6499705;3685;120587943;1791;20021205;25677;25523
62190;Busnes;649;16664768;688155;395;13843210;254;2821558;25678;25524
06123;Saint-Laurent-du-Var;19407;498333730;31668536;12607;428414599;6800;69919131;25678;25525
08228;La Horgne;89;2285368;66177;54;1838661;35;446707;25678;25526
30348;Vézénobres;966;24805421;1568544;535;20262291;431;4543130;25678;25527
13010;Barbentane;2306;59217932;3986366;1314;49190119;992;10027813;25680;25528
89079;Chamvres;397;10195233;541540;246;8531252;151;1663981;25681;25529
31299;Lherm;1736;44582174;1903311;1077;37401428;659;7180746;25681;25530
40202;Narrosse;1706;43813303;2393207;1049;36559779;657;7253524;25682;25531
62009;Adinfer;121;3107696;121012;72;2595159;49;512537;25683;25532
37166;Neuillé-le-Lierre;400;10273451;458316;243;8385513;157;1887938;25684;25533
10204;Longeville-sur-Mogne;70;1797930;72658;42;1428149;28;369781;25685;25534
39174;Coyrière;40;1027415;42328;24;878802;16;148613;25685;25535
21089;Bonnencontre;219;5625411;328693;125;4462202;94;1163209;25687;25536
22287;Saint-Donan;716;18393063;647397;450;15088398;266;3304665;25689;25537
64413;Narcastet;337;8657376;321171;226;7518317;111;1139059;25690;25538
21022;Argilly;247;6345588;263001;164;5374198;83;971390;25691;25539
90005;Auxelles-Bas;259;6653993;246309;173;5589415;86;1064578;25691;25540
62571;Merlimont;1885;48428782;2764174;1142;40090964;743;8337818;25692;25541
27514;Saint-Aubin-du-Thenney;194;4984287;236778;109;3966574;85;1017713;25692;25542
26257;Puygiron;237;6089080;295050;127;4828601;110;1260479;25692;25543
36247;Vineuil;636;16340403;867661;415;13612100;221;2728303;25692;25544
60637;Thury-en-Valois;259;6654455;367070;167;5733195;92;921260;25693;25545
57726;Vittoncourt;194;4984627;222953;118;4051987;76;932640;25694;25546
14031;Les Authieux-Papion;30;770819;37845;19;658508;11;112311;25694;25547
02145;Caumont;284;7297329;322181;182;6224358;102;1072971;25695;25548
93051;Noisy-le-Grand;34855;895605590;56923145;22070;774488642;12785;121116948;25695;25549
08260;Lonny;299;7683016;349892;183;6454094;116;1228922;25696;25550
45185;Lombreuil;160;4111721;150641;94;3148211;66;963510;25698;25551
30232;Saint-André-d'Olérargues;222;5705049;269081;133;4747612;89;957437;25698;25552
80422;Hautvillers-Ouville;296;7606765;360074;184;6390230;112;1216535;25699;25553
59337;Lederzeele;295;7581120;345980;156;6021595;139;1559525;25699;25554
2B150;Lumio;768;19737292;1334690;420;15873167;348;3864125;25700;25555
54486;Saint-Remimont;179;4600278;197835;124;3924006;55;676272;25700;25556
54291;Laloeuf;146;3752241;168824;82;3033710;64;718531;25700;25557
04075;Entrepierres;212;5448485;310041;116;4453293;96;995192;25700;25558
44047;Couëron;9945;255596927;10269709;6444;213598327;3501;41998600;25701;25559
31444;Puysségur;63;1619223;82165;36;1325683;27;293540;25702;25560
21013;Ancey;223;5731620;207370;157;5000404;66;731216;25702;25561
30149;Lirac;470;12080386;616425;284;9926960;186;2153426;25703;25562
71331;Nochize;43;1105237;49019;27;897739;16;207498;25703;25563
76688;Thiergeville;189;4857952;179818;127;4163124;62;694828;25703;25564
14092;Bourguébus;664;17068091;599447;429;14334354;235;2733737;25705;25565
71404;Saint-Désert;514;13212474;771107;303;11387228;211;1825246;25705;25566
67095;Diemeringen;925;23778729;1550256;491;19389055;434;4389674;25707;25567
21621;Tart-l'Abbaye;118;3033478;139670;81;2681047;37;352431;25707;25568
01350;Saint-Étienne-du-Bois;1295;33291517;1384647;837;27890860;458;5400657;25708;25569
57295;Haraucourt-sur-Seille;60;1542465;70497;41;1349515;19;192950;25708;25570
76647;Saint-Romain-de-Colbosc;2186;56197779;3158643;1242;45338283;944;10859496;25708;25571
54522;Thorey-Lyautey;63;1619607;61426;38;1251931;25;367676;25708;25572
53224;Saint-Germain-le-Fouilloux;464;11928686;281993;306;9851903;158;2076783;25708;25573
34191;Pailhès;290;7455591;424865;167;6309209;123;1146382;25709;25574
57137;Cheminot;318;8175522;346774;203;6771406;115;1404116;25709;25575
67146;Friesenheim;331;8509874;395276;200;7057584;131;1452290;25710;25576
38534;Vénosc;493;12674917;769408;324;10543169;169;2131748;25710;25577
76378;Jumièges;955;24554772;1213298;591;20401253;364;4153519;25712;25578
10181;Jully-sur-Sarce;162;4165455;213152;100;3434984;62;730471;25713;25579
39491;Saint-Lupicin;1135;29184304;1560200;680;23936650;455;5247654;25713;25580
46140;Laburgade;167;4294161;280395;94;3440270;73;853891;25714;25581
14637;Saint-Ouen-du-Mesnil-Oger;101;2597139;99027;66;2124236;35;472903;25714;25582
76176;Clasville;150;3857423;165688;90;3216577;60;640846;25716;25583
76406;Maniquerville;166;4269033;92270;106;3555419;60;713614;25717;25584
45179;Lailly-en-Val;1494;38422049;1756139;982;31777186;512;6644863;25718;25585
89361;Saint-Maurice-Thizouaille;128;3291889;155601;79;2792091;49;499798;25718;25586
38064;Cessieu;1380;35490800;1455869;897;29767250;483;5723550;25718;25587
14625;Saint-Martin-de-la-Lieue;471;12113362;611685;298;10270018;173;1843344;25718;25588
28333;Saint-Denis-des-Puits;58;1491683;50074;41;1294154;17;197529;25719;25589
89214;Lailly;112;2880512;147355;67;2331458;45;549054;25719;25590
73285;Séez;1332;34261037;1829060;877;28728718;455;5532319;25721;25591
02475;Menneville;187;4809928;142890;118;3910480;69;899448;25722;25592
57430;Mainvillers;148;3806829;106415;99;3086152;49;720677;25722;25593
72066;La Chapelle-Saint-Fray;222;5710254;216148;147;4920791;75;789463;25722;25594
67468;Siltzheim;342;8796882;421609;214;7200098;128;1596784;25722;25595
50580;Sotteville;223;5736063;182418;139;4712252;84;1023811;25722;25596
88204;Girmont;523;13453157;615750;333;11329528;190;2123629;25723;25597
26187;Molières-Glandaz;61;1569296;67838;39;1253039;22;316257;25726;25598
95012;Amenucourt;100;2572644;111483;75;2275331;25;297313;25726;25599
62150;Boisjean;260;6688879;240960;161;5481988;99;1206891;25726;25600
02761;Variscourt;86;2212647;69447;61;1892035;25;320612;25728;25601
14690;Tierceville;77;1981102;69877;50;1643939;27;337163;25729;25602
32331;Preignan;635;16338207;647169;421;13829710;214;2508497;25729;25603
54514;Tellancourt;278;7153099;154450;115;4112599;163;3040500;25731;25604
40020;Aurice;351;9031609;363552;198;7366395;153;1665214;25731;25605
35040;Breteil;1680;43229586;1623308;1118;36281082;562;6948504;25732;25606
62097;Beaumetz-lès-Loges;522;13432062;749766;307;11140950;215;2291112;25732;25607
65050;Avajan;47;1209420;87847;31;1043914;16;165506;25732;25608
29282;Trébabu;182;4683387;177670;116;3873854;66;809533;25733;25609
45250;Pers-en-Gâtinais;123;3165178;212694;74;2652784;49;512394;25733;25610
81273;Saïx;1857;47787617;2380474;1082;38971514;775;8816103;25734;25611
55099;Champneuville;61;1569775;64031;40;1376457;21;193318;25734;25612
57570;Rémering;251;6459703;383381;147;5192978;104;1266725;25736;25613
59282;Hardifort;185;4761152;187424;109;3805752;76;955400;25736;25614
76072;Belleville-en-Caux;313;8055629;371019;188;6476897;125;1578732;25737;25615
70181;Courcuire;70;1801587;86368;42;1419794;28;381793;25737;25616
36190;Sainte-Fauste;150;3860799;175808;104;3332062;46;528737;25739;25617
65226;Ibos;1473;37913077;2062186;892;32210246;581;5702831;25739;25618
17179;Les Gonds;890;22907633;942771;534;18369470;356;4538163;25739;25619
67474;Soultz-sous-Forêts;1579;40641895;1950268;971;33593550;608;7048345;25739;25620
89189;Gisy-les-Nobles;317;8159447;480515;186;6776599;131;1382848;25740;25621
85234;Saint-Jean-de-Monts;5307;136602496;6722900;2933;110484854;2374;26117642;25740;25622
04053;Châteauneuf-Val-Saint-Donat;278;7156119;336429;167;5807770;111;1348349;25741;25623
93046;Livry-Gargan;22837;587871052;35617559;14762;505966876;8075;81904176;25742;25624
10019;Val-d'Auzon;202;5199946;287780;121;4337530;81;862416;25742;25625
51602;Vavray-le-Petit;34;875247;52596;20;717946;14;157301;25743;25626
52327;Moëslains;240;6178388;267367;163;5204959;77;973429;25743;25627
02426;Levergies;286;7362688;382974;167;5885860;119;1476828;25744;25628
25300;Guyans-Durnes;113;2909037;67806;77;2393838;36;515199;25744;25629
55518;Cousances-lès-Triconville;79;2033822;114959;39;1519508;40;514314;25745;25630
64203;Doumy;144;3707269;152167;90;3066854;54;640415;25745;25631
27671;Vannecrocq;75;1930907;131733;44;1654389;31;276518;25745;25632
67444;Scherlenheim;66;1699242;65313;36;1297863;30;401379;25746;25633
56179;Pont-Scorff;1787;46011098;2146708;1077;38340212;710;7670886;25748;25634
61417;Saint-Loyer-des-Champs;201;5175380;242813;133;4437952;68;737428;25748;25635
57568;Rémelfing;803;20676344;1100511;496;17234450;307;3441894;25749;25636
85290;Thiré;281;7235524;296730;175;5980842;106;1254682;25749;25637
28054;Le Boullay-Mivoye;234;6025449;260208;161;5286504;73;738945;25750;25638
10267;Nogent-sur-Aube;177;4557735;297016;97;3722154;80;835581;25750;25639
41155;Muides-sur-Loire;718;18488613;922307;449;15298534;269;3190079;25750;25640
64151;Burgaronne;55;1416259;62512;32;1167426;23;248833;25750;25641
76683;Sotteville-sur-Mer;188;4841084;190655;88;3591177;100;1249907;25750;25642
47020;Baleyssagues;87;2240291;96099;48;1824742;39;415549;25750;25643
27162;Collandres-Quincarnon;108;2781076;107150;66;2280593;42;500483;25751;25644
14708;Tracy-Bocage;167;4300831;157957;101;3371463;66;929368;25753;25645
89229;Lixy;223;5743101;285603;139;4876309;84;866792;25754;25646
64003;Abidos;116;2987592;124123;74;2468690;42;518902;25755;25647
21352;Longeault;304;7829666;310381;218;6754556;86;1075110;25755;25648
86268;Tercé;561;14449020;548606;367;12229595;194;2219425;25756;25649
38465;Saint-Victor-de-Morestel;545;14037292;664590;332;11445166;213;2592126;25756;25650
89393;Serrigny;67;1725733;75992;46;1460821;21;264912;25757;25651
25250;Foucherans;210;5409256;187007;146;4631707;64;777549;25758;25652
76581;Saint-Germain-des-Essourts;204;5254895;253051;117;4118185;87;1136710;25759;25653
46296;Saint-Vincent-Rive-d'Olt;278;7161107;403111;153;5631403;125;1529704;25759;25654
53184;Préaux;67;1725920;33215;38;1279149;29;446771;25760;25655
60603;Salency;458;11798082;698231;278;9734599;180;2063483;25760;25656
69109;Lantignié;393;10124208;452775;237;8216920;156;1907288;25761;25657
84094;Puyméras;352;9068108;686348;177;7391557;175;1676551;25762;25658
70149;Chenebier;370;9532148;408134;249;8159474;121;1372674;25763;25659
76571;Sainte-Croix-sur-Buchy;342;8811115;323340;231;7669421;111;1141694;25763;25660
25123;Charbonnières-les-Sapins;90;2318746;53665;51;1747574;39;571172;25764;25661
31116;Castelginest;5250;135265706;6659748;3453;114789101;1797;20476605;25765;25662
73131;Hautecour;175;4508860;225536;118;3953062;57;555798;25765;25663
39400;Our;81;2086963;89768;52;1763838;29;323125;25765;25664
21633;Thorey-sous-Charny;116;2988981;174695;73;2491398;43;497583;25767;25665
64126;Bidos;681;17547769;895918;414;14163055;267;3384714;25768;25666
18257;Sury-près-Léré;321;8271781;439667;198;6996629;123;1275152;25769;25667
73150;Mâcot-la-Plagne;1125;28990601;1788504;748;24713063;377;4277538;25769;25668
07115;Labeaume;370;9535166;654445;207;7679108;163;1856058;25771;25669
62703;Rémy;151;3891386;137870;98;3227602;53;663784;25771;25670
25172;Courchapon;96;2474039;107057;59;1999315;37;474724;25771;25671
59182;Drincham;113;2912306;171237;61;2266810;52;645496;25773;25672
01148;Dortan;1040;26803796;1196541;656;22430585;384;4373211;25773;25673
62416;Hautecloque;113;2912359;106255;72;2511327;41;401032;25773;25674
80164;Camon;2449;63119461;3401735;1488;53265310;961;9854151;25774;25675
14414;Le Mesnil-Bacley;113;2912622;148045;68;2376307;45;536315;25775;25676
47163;Mauvezin-sur-Gupie;285;7346095;387571;159;5994761;126;1351334;25776;25677
04066;Curbans;227;5851114;321424;139;4872631;88;978483;25776;25678
52366;Ormancey;42;1082589;62798;25;921399;17;161190;25776;25679
17409;Saint-Sulpice-de-Royan;1668;42994506;2185042;980;34972520;688;8021986;25776;25680
60333;Lachapelle-aux-Pots;848;21858641;1162801;498;18068279;350;3790362;25777;25681
61192;Godisson;54;1391952;73857;33;1172578;21;219374;25777;25682
89144;Domats;458;11806326;605321;282;9787606;176;2018720;25778;25683
80106;Blangy-sous-Poix;92;2371617;129471;54;1936689;38;434928;25778;25684
14760;Villy-Bocage;356;9177173;319868;234;7674035;122;1503138;25779;25685
01244;Meximieux;3983;102676391;5456173;2421;85074911;1562;17601480;25779;25686
61482;Tessé-Froulay;199;5129986;244985;128;4290974;71;839012;25779;25687
77168;Égreville;1127;29052849;1500134;676;24039144;451;5013705;25779;25688
21427;Montceau-et-Écharnant;93;2397465;145329;55;1926226;38;471239;25779;25689
60652;Valdampierre;487;12554709;550657;323;10694426;164;1860283;25780;25690
51166;Contault;35;902313;42348;19;707016;16;195297;25780;25691
61175;Forges;114;2939037;110996;78;2519878;36;419159;25781;25692
22307;Saint-Julien;1012;26090417;1085902;644;21364059;368;4726358;25781;25693
52108;Charmes;79;2036707;101421;47;1704573;32;332134;25781;25694
45002;Aillant-sur-Milleron;217;5594511;452338;126;4718398;91;876113;25781;25695
57422;Louvigny;430;11086022;407076;272;9179564;158;1906458;25781;25696
26125;Eurre;638;16449074;695755;395;13619239;243;2829835;25782;25697
79185;Mougon;1052;27123969;1078129;649;22426013;403;4697956;25783;25698
53056;La Chapelle-Anthenaise;404;10417112;316451;267;8802499;137;1614613;25785;25699
41087;Fontaine-les-Coteaux;211;5440677;310834;123;4470767;88;969910;25785;25700
60004;Achy;199;5131272;244408;128;4221015;71;910257;25785;25701
64227;Gabaston;342;8818823;473104;204;7176038;138;1642785;25786;25702
45088;Chaussy;168;4332210;227463;102;3377091;66;955119;25787;25703
59521;Sailly-lez-Cambrai;230;5931065;398939;129;4809159;101;1121906;25787;25704
21542;Saint-Bernard;207;5338057;149771;133;4186374;74;1151683;25788;25705
37254;Tauxigny;660;17020309;638099;425;14263161;235;2757148;25788;25706
45111;Courcy-aux-Loges;241;6215081;267699;157;5325511;84;889570;25789;25707
38016;Arzay;109;2811051;151612;66;2280565;43;530486;25789;25708
25005;Accolans;49;1263703;29079;29;1031968;20;231735;25790;25709
10442;Voué;299;7711916;317972;183;6222356;116;1489560;25792;25710
47269;Saint-Pierre-de-Clairac;430;11090815;531586;259;9120128;171;1970687;25793;25711
61416;Saint-Léonard-des-Parcs;35;902742;75876;17;777141;18;125601;25793;25712
03013;Avermes;2174;56075692;2724605;1398;47335465;776;8740227;25794;25713
64547;Ustaritz;3485;89892106;4561916;2175;75321073;1310;14571033;25794;25714
43137;Monistrol-sur-Loire;4580;118137828;5306001;2626;95517371;1954;22620457;25794;25715
67196;Hilsenheim;1246;32139691;1439008;774;26427176;472;5712515;25794;25716
64189;Ciboure;4375;112854880;7021797;2539;92121933;1836;20732947;25795;25717
02268;Domptin;342;8822107;462194;217;7468491;125;1353616;25796;25718
26087;Châtillon-Saint-Jean;627;16174107;647867;385;13319777;242;2854330;25796;25719
21643;Tréclun;194;5004715;204935;122;4213322;72;791393;25798;25720
60267;Le Gallet;73;1883311;55396;43;1481112;30;402199;25799;25721
08450;This;111;2863727;106953;72;2355594;39;508133;25799;25722
88496;Vaudoncourt;81;2089777;72891;54;1829832;27;259945;25800;25723
53037;Bouessay;344;8875163;276225;229;7341404;115;1533759;25800;25724
62720;Rombly;23;593409;19976;11;452680;12;140729;25800;25725
78391;Méricourt;226;5830976;337924;152;4960009;74;870967;25801;25726
28240;Meaucé;286;7379249;359195;195;6333934;91;1045315;25802;25727
25389;Montbéliardot;57;1470722;67844;39;1246394;18;224328;25802;25728
79292;Sainte-Radegonde;1079;27841976;1462029;629;22905449;450;4936527;25803;25729
77194;Forges;205;5289718;227807;138;4611367;67;678351;25804;25730
24512;Saint-Vincent-le-Paluel;150;3870560;263398;99;3329695;51;540865;25804;25731
81036;Bout-du-Pont-de-Larn;649;16746994;741224;412;13848605;237;2898389;25804;25732
80472;Lesboeufs;87;2245017;172475;45;1818389;42;426628;25805;25733
41114;Lestiou;141;3638612;173890;92;3042134;49;596478;25806;25734
28341;Saint-Jean-de-Rebervilliers;121;3122602;113785;85;2688289;36;434313;25807;25735
38525;Vasselin;222;5729136;250081;142;4812241;80;916895;25807;25736
63404;Saint-Yvoine;283;7303410;325900;180;6166489;103;1136921;25807;25737
84077;Modène;224;5780872;257491;129;4682420;95;1098452;25807;25738
67391;Reinhardsmunster;256;6606729;275841;175;5763992;81;842737;25808;25739
12102;Flavin;1183;30530366;1365441;758;25713983;425;4816383;25808;25740
44049;Le Croisic;2805;72390448;4516720;1621;59663848;1184;12726600;25808;25741
16171;Juillac-le-Coq;349;9007124;486152;201;7333069;148;1674055;25808;25742
81326;Sainte-Croix;196;5058586;274822;122;4423352;74;635234;25809;25743
67002;Adamswiller;214;5523169;247076;124;4409815;90;1113354;25809;25744
02534;Muscourt;26;671043;16947;13;498714;13;172329;25809;25745
31051;Beaufort;161;4155342;180459;93;3322271;68;833071;25810;25746
08072;Bosseval-et-Briancourt;210;5420057;236760;122;4346808;88;1073249;25810;25747
04183;Saint-Julien-du-Verdon;85;2193845;186912;53;1870649;32;323196;25810;25748
70383;Neuvelle-lès-Cromary;161;4155487;189384;102;3461297;59;694190;25810;25749
42056;Chavanay;1511;39000516;2199477;938;32356837;573;6643679;25811;25750
60370;Lormaison;653;16854769;746952;453;14629322;200;2225447;25811;25751
76196;Criquetot-l'Esneval;1266;32678026;1578892;726;26303307;540;6374719;25812;25752
32120;Encausse;207;5343148;238543;133;4528947;74;814201;25812;25753
45109;Coulmiers;295;7614651;326007;193;6305683;102;1308968;25812;25754
17333;Saint-Georges-de-Didonne;3583;92486287;6063587;2099;76501454;1484;15984833;25813;25755
67493;Triembach-au-Val;248;6401666;284655;156;5354140;92;1047526;25813;25756
44054;Erbray;1420;36656757;1128633;835;29871716;585;6785041;25815;25757
80387;Grattepanche;156;4027098;167379;95;3345200;61;681898;25815;25758
85009;Auzay;315;8131854;310122;202;6826257;113;1305597;25815;25759
64440;Ozenx-Montestrucq;198;5111459;196583;113;4133388;85;978071;25815;25760
43032;Blavozy;853;22020887;976958;554;18496999;299;3523888;25816;25761
25468;Pouligney-Lusans;374;9655557;367068;246;8201683;128;1453874;25817;25762
44033;La Chapelle-Launay;1370;35369702;1173666;901;29485650;469;5884052;25817;25763
44064;Gorges;2054;53029010;1739633;1305;43962402;749;9066608;25817;25764
42338;Vougy;767;19802933;929414;498;16626976;269;3175957;25819;25765
28233;Marboué;613;15827023;719855;376;13145140;237;2681883;25819;25766
10370;Soligny-les-Étangs;131;3382285;213176;76;2786347;55;595938;25819;25767
67019;Baldenheim;594;15336765;665000;364;12335572;230;3001193;25819;25768
39227;Foncine-le-Bas;115;2969287;205053;71;2504142;44;465145;25820;25769
67311;Muttersholtz;1056;27266731;1313021;675;22846747;381;4419984;25821;25770
12157;Montrozier;802;20708405;994492;499;17388808;303;3319597;25821;25771
71276;Marcilly-la-Gueurce;71;1833298;77407;44;1539157;27;294141;25821;25772
54339;Malzéville;4650;120071460;7508989;2775;101332055;1875;18739405;25822;25773
62289;Écuires;415;10716370;480678;263;9123484;152;1592886;25823;25774
53074;Contest;403;10406520;262830;245;8246573;158;2159947;25823;25775
06011;Beaulieu-sur-Mer;2353;60761824;4329109;1437;51444773;916;9317051;25823;25776
05108;Puy-Saint-Eusèbe;71;1833457;99887;44;1477078;27;356379;25823;25777
35331;Talensac;1155;29826218;1194240;772;25311619;383;4514599;25824;25778
47092;Fals;195;5035619;193296;126;4192401;69;843218;25824;25779
49370;Verrie;211;5449017;184412;131;4310476;80;1138541;25825;25780
56161;Ploemel;1442;37239522;1564971;846;30445882;596;6793640;25825;25781
10037;Bercenay-en-Othe;232;5991484;319874;144;5096484;88;895000;25825;25782
25598;Venise;229;5914090;292187;149;4904041;80;1010049;25826;25783
67437;Saverne;6735;173939030;11616968;3816;143605180;2919;30333850;25826;25784
27399;Mercey;29;748977;35369;16;598247;13;150730;25827;25785
35229;Pocé-les-Bois;570;14722409;365318;378;12055287;192;2667122;25829;25786
45027;Beauchamps-sur-Huillard;231;5966457;384353;138;4872327;93;1094130;25829;25787
67267;Lingolsheim;9159;236570578;13205988;5669;199032699;3490;37537879;25829;25788
72005;Ancinnes;461;11907340;457844;307;10158176;154;1749164;25829;25789
55494;Sommelonne;251;6483337;296852;172;5610470;79;872867;25830;25790
61347;Résenlieu;101;2608881;133531;58;1974742;43;634139;25831;25791
65019;Arcizac-Adour;275;7103456;345257;174;5938641;101;1164815;25831;25792
55583;Woël;120;3099709;79442;59;2406810;61;692899;25831;25793
14750;Vieux-Pont-en-Auge;150;3874711;253837;86;3206708;64;668003;25831;25794
60659;Vaudancourt;97;2505663;108647;67;2187425;30;318238;25832;25795
17413;Saint-Vivien;650;16790797;810449;398;13889000;252;2901797;25832;25796
24318;Paunat;171;4417284;183597;82;3442690;89;974594;25832;25797
67459;Schwenheim;380;9816257;368558;243;8111072;137;1705185;25832;25798
40179;Mées;953;24618398;1140392;598;20443274;355;4175124;25833;25799
02030;Aubencheul-aux-Bois;139;3590905;235262;67;2725853;72;865052;25834;25800
51184;Courdemanges;235;6071249;365784;148;5109002;87;962247;25835;25801
83139;Tourtour;354;9145761;753149;173;7487422;181;1658339;25835;25802
30262;Saint-Hippolyte-de-Montaigu;134;3462015;277297;68;2788315;66;673700;25836;25803
02487;Missy-sur-Aisne;355;9172420;539070;217;7689273;138;1483147;25838;25804
45346;Vitry-aux-Loges;1065;27518312;1528127;643;22769344;422;4748968;25839;25805
42022;Bonson;1926;49766212;2064420;1214;41231650;712;8534562;25839;25806
34202;Pignan;3471;89689953;4488881;2075;74623153;1396;15066800;25840;25807
64097;Barzun;296;7648833;362491;189;6406020;107;1242813;25841;25808
58028;Beaumont-Sardolles;66;1705497;167670;35;1334492;31;371005;25841;25809
69151;Le Perréon;705;18217965;688183;436;14973148;269;3244817;25841;25810
29296;Tréméoc;601;15530993;519037;374;12844233;227;2686760;25842;25811
37052;Chançay;581;15014768;675086;385;12886004;196;2128764;25843;25812
31142;Cier-de-Luchon;141;3643879;193190;89;3140899;52;502980;25843;25813
81253;Saint-Grégoire;253;6538534;388470;136;5299203;117;1239331;25844;25814
33028;Baron;560;14472737;632178;350;12242132;210;2230605;25844;25815
71584;Viré;614;15868633;742280;410;13678302;204;2190331;25845;25816
08040;Les Ayvelles;477;12327947;582955;300;10430788;177;1897159;25845;25817
60252;Fournival;250;6461392;282018;166;5508472;84;952920;25846;25818
60281;Gournay-sur-Aronde;325;8399936;438652;217;7319600;108;1080336;25846;25819
77120;Cocherel;304;7857262;362189;198;6719313;106;1137949;25846;25820
40084;Clermont;380;9822558;333400;209;7694641;171;2127917;25849;25821
26102;Condillac;85;2197163;206785;44;1803374;41;393789;25849;25822
45313;Sougy;454;11735594;574622;305;10008269;149;1727325;25849;25823
36101;Luant;768;19852598;865803;489;16671932;279;3180666;25850;25824
27570;Saint-Martin-la-Campagne;54;1395907;51637;38;1224717;16;171190;25850;25825
67379;Preuschdorf;498;12873799;604722;299;10398331;199;2475468;25851;25826
16174;Julienne;245;6333546;315336;147;5256124;98;1077422;25851;25827
56115;Locmaria-Grand-Champ;688;17785745;493612;446;14695080;242;3090665;25851;25828
63229;Moissat;563;14554426;581624;356;12073097;207;2481329;25852;25829
58214;Pougues-les-Eaux;1367;35339907;2058860;844;29908072;523;5431835;25852;25830
35296;Saint-Médard-sur-Ille;628;16235531;596204;398;13443980;230;2791551;25853;25831
67208;Hohengoeft;251;6489149;238459;174;5601931;77;887218;25853;25832
53155;Montenay;686;17735808;606739;386;14340545;300;3395263;25854;25833
59219;Estrun;340;8790346;339656;217;7436222;123;1354124;25854;25834
80517;Marquivillers;87;2249322;107451;55;1838470;32;410852;25854;25835
02711;Serches;148;3826515;210300;100;3276620;48;549895;25855;25836
57586;Rochonvillers;93;2404524;50540;36;1267167;57;1137357;25855;25837
28081;Charonville;142;3671440;90176;89;2931579;53;739861;25855;25838
64527;Souraïde;713;18434817;983721;424;15211144;289;3223673;25855;25839
01336;Saint-André-sur-Vieux-Jonc;568;14686168;629079;373;12317216;195;2368952;25856;25840
27557;Saint-Léger-de-Rôtes;236;6102096;281988;167;5213685;69;888411;25856;25841
45078;Chapelon;139;3594109;163355;84;2947845;55;646264;25857;25842
47024;Beaupuy;795;20556443;970516;480;16821391;315;3735052;25857;25843
59391;Mastaing;489;12644243;519980;295;10578064;194;2066179;25857;25844
49076;La Chapelle-Saint-Laud;306;7912373;217056;188;6455895;118;1456478;25857;25845
57339;Hultehouse;199;5145651;195446;124;4349775;75;795876;25858;25846
47002;Agmé;73;1887673;61143;42;1594062;31;293611;25859;25847
77061;Cannes-Écluse;1239;32039038;1523575;828;27155238;411;4883800;25859;25848
29055;Le Folgoët;1635;42279154;1522805;995;34163442;640;8115712;25859;25849
54144;Crévéchamps;198;5120575;197786;140;4379068;58;741507;25861;25850
51588;Valmy;163;4215608;250099;104;3512716;59;702892;25863;25851
67463;Seltz;1816;46967521;2720914;1137;39400822;679;7566699;25863;25852
76233;Ellecourt;80;2069140;117063;49;1816744;31;252396;25864;25853
38262;Morêtel-de-Mailles;217;5612604;215122;140;4823205;77;789399;25865;25854
25223;Éternoz;187;4836759;126163;82;3778351;105;1058408;25865;25855
25077;La Bosse;38;982892;48679;22;764525;16;218367;25866;25856
45306;La Selle-en-Hermoy;438;11329411;611386;294;9645407;144;1684004;25866;25857
57696;Varsberg;529;13683864;880692;314;11353195;215;2330669;25867;25858
74271;Seytroux;242;6259997;318920;165;5428455;77;831542;25868;25859
01141;Cuzieu;216;5587590;231774;139;4647351;77;940239;25868;25860
81294;Técou;436;11278723;389919;249;9117167;187;2161556;25869;25861
54490;Saizerais;728;18832571;673830;466;15818340;262;3014231;25869;25862
64133;Boeil-Bezing;625;16168876;667990;396;13464989;229;2703887;25870;25863
62376;Gonnehem;1329;34381698;1730334;769;27990646;560;6391052;25870;25864
83008;Bagnols-en-Forêt;1415;36606790;1969413;844;30361834;571;6244956;25871;25865
51350;Margny;56;1448770;80432;29;1169775;27;278995;25871;25866
51381;Montmort-Lucy;336;8692918;437078;209;7166830;127;1526088;25872;25867
57056;Bébing;103;2664846;115558;64;2195250;39;469596;25872;25868
16276;Reignac;379;9805951;968038;201;7961460;178;1844491;25873;25869
63390;Saint-Quintin-sur-Sioule;202;5226588;323270;125;4455634;77;770954;25874;25870
27302;Le Gros-Theil;506;13092347;573192;329;10906857;177;2185490;25874;25871
44203;Le Temple-de-Bretagne;852;22045242;721546;578;18489300;274;3555942;25875;25872
38033;Beaulieu;323;8357789;305553;199;6910877;124;1446912;25876;25873
71550;Uchizy;437;11307625;694303;240;9227324;197;2080301;25876;25874
51107;Chaintrix-Bierges;162;4191888;170311;106;3540167;56;651721;25876;25875
57697;Vasperviller;158;4088538;171606;100;3351174;58;737364;25877;25876
21251;Essey;140;3622772;211637;83;3089066;57;533706;25877;25877
02022;Arcy-Sainte-Restitue;212;5485963;321285;107;4384692;105;1101271;25877;25878
45314;Sully-la-Chapelle;223;5771007;235651;146;4925109;77;845898;25879;25879
80521;Maurepas;125;3234961;244138;70;2637835;55;597126;25880;25880
30070;Carsan;341;8824997;352815;207;7516929;134;1308068;25880;25881
03023;Bellerive-sur-Allier;5167;133721308;8561163;2932;110535408;2235;23185900;25880;25882
78310;Houdan;2038;52743582;3419510;1277;44390044;761;8353538;25880;25883
08119;Cheveuges;219;5667840;231948;139;4756821;80;911019;25881;25884
06012;Beausoleil;8085;209253652;15516416;5272;181702671;2813;27550981;25882;25885
17373;Saint-Médard-d'Aunis;951;24615047;953975;594;20410141;357;4204906;25883;25886
70076;Bonnevent-Velloreille;171;4426210;175687;103;3609843;68;816367;25884;25887
88134;Dinozé;302;7817204;338093;187;6500468;115;1316736;25885;25888
17369;Saint-Martin-de-Ré;1590;41161742;3641607;814;34259510;776;6902232;25888;25889
16388;Trois-Palis;452;11701444;450049;296;9864511;156;1836933;25888;25890
58257;Saint-Maurice;33;854355;68799;19;753299;14;101056;25890;25891
02162;La Chapelle-sur-Chézy;129;3339774;174769;75;2741768;54;598006;25890;25892
02421;Lesges;37;957934;47206;20;755809;17;202125;25890;25893
45283;Saint-Hilaire-sur-Puiseaux;84;2174902;131026;57;1911179;27;263723;25892;25894
33546;Vignonet;259;6705977;398112;152;5494265;107;1211712;25892;25895
17168;Fouras;2703;69986281;3936751;1581;57298489;1122;12687792;25892;25896
60183;Croissy-sur-Celle;135;3495471;137371;77;2810105;58;685366;25892;25897
26313;Saint-Marcel-lès-Valence;2960;76641517;3374005;1834;64006237;1126;12635280;25892;25898
47009;Andiran;123;3184822;198688;65;2571352;58;613470;25893;25899
02590;Pargny-la-Dhuys;91;2356288;122740;55;1986694;36;369594;25893;25900
70575;Voray-sur-l'Ognon;423;10953202;508221;274;9281277;149;1671925;25894;25901
84062;Lagnes;965;24989699;1441337;562;20574967;403;4414732;25896;25902
38256;Montferrat;940;24342472;1190897;575;20283319;365;4059153;25896;25903
54309;Lemainville;195;5049948;201329;119;4056694;76;993254;25897;25904
54304;Laxou;8201;212384120;15536829;4697;180353115;3504;32031005;25897;25905
68205;Meyenheim;678;17558654;909931;493;15436969;185;2121685;25898;25906
14278;Fontenay-le-Pesnel;514;13311516;464800;354;11344114;160;1967402;25898;25907
37264;Vallères;566;14658520;528686;349;11819014;217;2839506;25898;25908
25241;Flagey;70;1812892;45562;39;1460389;31;352503;25898;25909
32199;Lasserade;106;2745273;135836;46;1815532;60;929741;25899;25910
76667;Sauqueville;188;4868988;244228;125;4219966;63;649022;25899;25911
76727;Vatteville-la-Rue;536;13882131;576317;339;11599273;197;2282858;25899;25912
50302;Le Mesnil-Amey;144;3729564;166808;92;3129000;52;600564;25900;25913
80238;Dernancourt;242;6267791;265827;163;5559115;79;708676;25900;25914
29161;Pleuven;1477;38254450;1804981;917;31432879;560;6821571;25900;25915
25524;Saint-Maurice-Colombier;466;12069683;617000;290;10097641;176;1972042;25901;25916
51082;Braux-Sainte-Cohière;49;1269131;57974;33;1067787;16;201344;25901;25917
73206;Pralognan-la-Vanoise;444;11499939;702853;275;9670223;169;1829716;25901;25918
86146;Marigny-Brizay;671;17379485;575670;417;14640750;254;2738735;25901;25919
57111;Bronvaux;301;7796195;293184;186;6165974;115;1630221;25901;25920
01412;Sulignat;289;7485661;303644;186;6140965;103;1344696;25902;25921
41010;Azé;532;13780040;705333;307;11648425;225;2131615;25902;25922
57572;Rémilly;1121;29037134;1406215;685;23796243;436;5240891;25903;25923
41286;Villeporcher;80;2072254;95551;51;1760464;29;311790;25903;25924
14755;Villerville;450;11656636;761979;240;9065244;210;2591392;25904;25925
50215;Gouville-sur-Mer;1183;30644280;1971472;658;24690941;525;5953339;25904;25926
14488;Ouistreham;5780;149735736;8843306;3432;124245888;2348;25489848;25906;25927
97229;Schoelcher;12164;315123116;18363452;5804;251750090;6360;63373026;25906;25928
71372;Romanèche-Thorins;1010;26166017;1297913;603;21595379;407;4570638;25907;25929
26157;La Laupie;356;9222889;358573;216;7574709;140;1648180;25907;25930
71255;Lesme;107;2772153;148323;82;2506834;25;265319;25908;25931
68181;Levoncourt;129;3342218;141057;79;2817966;50;524252;25909;25932
01213;Leyment;604;15648917;598924;402;13169851;202;2479066;25909;25933
89263;Monéteau;2272;58865458;3443521;1490;50372969;782;8492489;25909;25934
84133;La Tour-d'Aigues;2326;60265012;3319568;1300;49573162;1026;10691850;25909;25935
32432;Seysses-Savès;130;3368230;219555;75;2785504;55;582726;25909;25936
62163;Bouret-sur-Canche;145;3756924;129635;74;2932482;71;824442;25910;25937
57544;Plaine-de-Walsch;321;8317228;374443;204;6846591;117;1470637;25910;25938
31476;Saint-Élix-le-Château;401;10390680;444768;230;8558687;171;1831993;25912;25939
49199;Melay;792;20522720;632226;476;16274863;316;4247857;25913;25940
31495;Saint-Léon;585;15159162;689933;356;12593824;229;2565338;25913;25941
38015;Artas;862;22337309;889088;567;18779820;295;3557489;25913;25942
41061;Cormeray;760;19694322;881723;524;16864412;236;2829910;25914;25943
76340;Harcanville;245;6349038;262501;159;5322087;86;1026951;25914;25944
57643;Secourt;95;2461879;70634;62;2116328;33;345551;25915;25945
38175;Froges;1815;47035960;2202916;1169;39874199;646;7161761;25915;25946
41270;Verdes;263;6815710;471324;140;5211071;123;1604639;25915;25947
02587;Parfondru;186;4820455;263484;110;4073727;76;746728;25916;25948
02726;Sommette-Eaucourt;82;2125163;77945;48;1729715;34;395448;25917;25949
18079;Crézancy-en-Sancerre;293;7593642;499758;166;6324506;127;1269136;25917;25950
06130;Saint-Vallier-de-Thiey;1858;48153548;2665093;1163;40871469;695;7282079;25917;25951
67487;Surbourg;880;22807228;1124204;573;19449556;307;3357672;25917;25952
84084;La Motte-d'Aigues;698;18091383;913139;428;15111928;270;2979455;25919;25953
67198;Hinsbourg;61;1581060;66916;40;1288886;21;292174;25919;25954
02756;Urvillers;328;8501475;349738;211;7071405;117;1430070;25919;25955
25508;Roulans;569;14748008;577256;366;12270852;203;2477156;25919;25956
14290;Fresney-le-Puceux;392;10160329;327032;257;8615487;135;1544842;25919;25957
25540;Semondans;170;4406446;166092;123;3783945;47;622501;25920;25958
77283;May-en-Multien;437;11327648;549996;292;9778482;145;1549166;25921;25959
27280;Gauciel;340;8813570;432303;270;7892443;70;921127;25922;25960
95527;Roissy-en-France;1598;41424568;2609022;1099;36154112;499;5270456;25923;25961
14663;Saint-Vigor-le-Grand;1144;29656009;1636476;687;24367849;457;5288160;25923;25962
01206;Lantenay;144;3732962;133330;97;3169022;47;563940;25923;25963
31433;Portet-sur-Garonne;5162;133819853;8396695;3076;110983263;2086;22836590;25924;25964
25616;Villars-Saint-Georges;131;3396209;136221;89;2964286;42;431923;25925;25965
61391;Saint-Georges-des-Groseillers;1841;47728919;2313675;1149;39363776;692;8365143;25926;25966
54171;Doncourt-lès-Conflans;559;14492519;528967;344;11844060;215;2648459;25926;25967
57296;Hargarten-aux-Mines;559;14493377;543358;344;11863859;215;2629518;25927;25968
26068;Le Chalon;103;2670631;107556;54;2096176;49;574455;25928;25969
26006;Allex;1272;32981215;1384415;759;27010447;513;5970768;25929;25970
83125;Seillons-Source-d'Argens;1091;28288172;1308977;617;22764054;474;5524118;25929;25971
02521;Montreuil-aux-Lions;680;17631820;807956;429;14712351;251;2919469;25929;25972
84057;Joucas;197;5108183;290212;106;3951215;91;1156968;25930;25973
24439;Saint-Laurent-sur-Manoire;487;12627947;688062;315;10678151;172;1949796;25930;25974
04159;Redortiers;43;1115009;134325;16;881098;27;233911;25930;25975
33498;Salles;3262;84585919;4075246;1918;69804917;1344;14781002;25931;25976
52276;Laville-aux-Bois;116;3008054;130871;84;2608563;32;399491;25932;25977
22360;Trégueux;4384;113687824;4929470;2883;96178791;1501;17509033;25932;25978
65196;Gensac;57;1478204;126477;24;1067512;33;410692;25933;25979
76414;Martin-Église;838;21732237;1100397;538;18345250;300;3386987;25933;25980
16385;Touvre;618;16027434;655926;429;13853749;189;2173685;25934;25981
41290;Villeromain;122;3164008;151392;77;2492219;45;671789;25934;25982
08239;Juniville;571;14808659;540767;332;11735768;239;3072891;25935;25983
60456;La Neuville-Roy;500;12967400;635657;320;10754566;180;2212834;25935;25984
42048;Chandon;721;18700128;694375;474;15511458;247;3188670;25936;25985
28063;Brunelles;295;7651297;369257;197;6620792;98;1030505;25937;25986
63224;Ménétrol;896;23240860;1187027;590;19942955;306;3297905;25938;25987
21207;Courlon;45;1167232;68255;25;916178;20;251054;25938;25988
60559;La Rue-Saint-Pierre;388;10064429;462444;267;8690879;121;1373550;25939;25989
62870;Wailly-Beaucamp;483;12528704;563905;285;10088783;198;2439921;25939;25990
69227;Saint-Martin-en-Haut;1974;51211353;2461721;1048;40276614;926;10934739;25943;25991
90088;Rougegoutte;506;13127805;551431;324;10834863;182;2292942;25944;25992
89469;Perceneige;525;13621076;809056;329;11437940;196;2183136;25945;25993
39116;La Châtelaine;68;1764319;55764;42;1430496;26;333823;25946;25994
61251;Marchemaisons;76;1971922;91094;44;1566298;32;405624;25946;25995
14297;Gavrus;231;5993702;219053;138;4824783;93;1168919;25947;25996
14320;Grimbosq;143;3710713;162248;92;3025167;51;685546;25949;25997
09298;Sorgeat;52;1349363;96076;31;1124423;21;224940;25949;25998
62713;Robecq;648;16815400;753628;398;14135843;250;2679557;25950;25999
67238;Kindwiller;311;8070551;327540;194;6696809;117;1373742;25950;26000
31253;Labastidette;1191;30907384;1246938;772;26124984;419;4782400;25951;26001
54313;Létricourt;106;2750820;91716;69;2353071;37;397749;25951;26002
58278;Sermoise-sur-Loire;818;21228754;915014;530;17775516;288;3453238;25952;26003
28128;Dangers;221;5735415;235784;156;5043178;65;692237;25952;26004
43233;Sanssac-l'Église;542;14066138;585160;347;11806840;195;2259298;25952;26005
70331;Mantoche;284;7370463;437075;156;5956333;128;1414130;25952;26006
77101;Châtenay-sur-Seine;510;13236393;621005;337;11202065;173;2034328;25954;26007
53143;Maisoncelles-du-Maine;247;6410725;146566;160;5079348;87;1331377;25954;26008
59548;Saint-Waast;313;8123755;361853;180;6725864;133;1397891;25954;26009
01255;Montagnieu;290;7527086;406007;182;6196178;108;1330908;25955;26010
49039;Bourgneuf-en-Mauges;360;9344006;133986;179;7167200;181;2176806;25956;26011
33470;Saint-Romain-la-Virvée;416;10797866;476142;257;8897986;159;1899880;25956;26012
33023;Ayguemorte-les-Graves;554;14379947;594720;377;12415955;177;1963992;25957;26013
31481;Sainte-Foy-de-Peyrolières;1022;26528130;1333609;599;21715568;423;4812562;25957;26014
67545;Witternheim;259;6722962;277682;157;5524942;102;1198020;25957;26015
01117;Conzieu;66;1713347;67385;39;1387775;27;325572;25960;26016
40268;Saint-Laurent-de-Gosse;291;7554310;310167;161;5926740;130;1627570;25960;26017
38443;Saint-Pierre-de-Chérennes;239;6204551;308378;142;5041754;97;1162797;25960;26018
67155;Gertwiller;635;16485375;769120;425;14053451;210;2431924;25961;26019
53215;Saint-Fort;866;22482599;991513;487;17949635;379;4532964;25961;26020
21487;Pluvet;213;5529845;260163;135;4606020;78;923825;25962;26021
25297;Le Gratteris;79;2051021;72153;43;1597134;36;453887;25962;26022
24560;Urval;58;1505844;105840;30;1203502;28;302342;25963;26023
74010;Annecy;32457;842677365;49762407;20052;698058165;12405;144619200;25963;26024
45321;Thimory;364;9450513;575824;216;7656246;148;1794267;25963;26025
74281;Thonon-les-Bains;20540;533283183;28923827;11603;418316130;8937;114967053;25963;26026
80412;Hamelet;286;7425526;256518;210;6565559;76;859967;25963;26027
53103;Le Genest-Saint-Isle;984;25548102;943759;635;21282964;349;4265138;25964;26028
45225;La Neuville-sur-Essonne;202;5244660;252714;136;4553755;66;690905;25964;26029
38353;Saint-Alban-du-Rhône;422;10956879;494715;275;9213712;147;1743167;25964;26030
71535;Tavernay;254;6595028;327653;156;5398127;98;1196901;25965;26031
25019;Appenans;203;5270903;257346;122;4394760;81;876143;25965;26032
76610;Sainte-Marie-des-Champs;817;21215284;879066;533;17994952;284;3220332;25967;26033
02013;Amifontaine;193;5011756;188801;116;3966895;77;1044861;25968;26034
76353;Héberville;55;1428239;69791;33;1218445;22;209794;25968;26035
27407;Mesnil-Verclives;148;3843262;173652;101;3221651;47;621611;25968;26036
51472;Saint-Amand-sur-Fion;533;13841525;655042;338;11536653;195;2304872;25969;26037
17225;Les Mathes;1173;30462035;1739440;714;25563559;459;4898476;25969;26038
77342;Obsonville;58;1506222;82989;38;1264832;20;241390;25969;26039
77314;Montolivet;130;3376094;186799;83;2860883;47;515211;25970;26040
22144;La Méaugon;655;17010810;711715;424;14523391;231;2487419;25971;26041
59141;Cauroir;292;7583468;301367;174;6351503;118;1231965;25971;26042
22173;Planguenoual;1155;29996833;1623230;697;24668886;458;5327947;25971;26043
76425;Mentheville;112;2908795;92567;78;2446315;34;462480;25971;26044
88050;Belmont-sur-Buttant;148;3843802;174776;76;3089234;72;754568;25972;26045
32098;Cazaux-Savès;123;3194537;105986;77;2691833;46;502704;25972;26046
10305;Prémierfait;53;1376571;75798;32;1102171;21;274400;25973;26047
88472;Thuillières;76;1974004;85526;47;1619643;29;354361;25974;26048
21195;Cormot-le-Grand;85;2207783;92312;50;1845309;35;362474;25974;26049
60515;Pronleroy;197;5116952;305857;118;4164574;79;952378;25974;26050
86177;Neuville-de-Poitou;2907;75507579;4086148;1692;62747868;1215;12759711;25974;26051
25099;Bugny;86;2233801;101111;61;2008615;25;225186;25974;26052
57640;Schwerdorff;216;5610486;228701;131;4559082;85;1051404;25974;26053
89308;Pont-sur-Vanne;111;2883205;150813;68;2323283;43;559922;25975;26054
28132;Donnemain-Saint-Mamès;346;8987640;387241;229;7598170;117;1389470;25976;26055
21415;Minot;115;2987301;195418;64;2428211;51;559090;25977;26056
57760;Zetting;478;12416860;543272;291;10191492;187;2225368;25977;26057
37021;Beaumont-la-Ronce;605;15716079;810827;392;13286855;213;2429224;25977;26058
57638;Schoeneck;1548;40212442;2362738;947;33166064;601;7046378;25977;26059
03110;Espinasse-Vozelle;502;13040551;737056;315;10736748;187;2303803;25977;26060
41046;Chaumont-sur-Tharonne;612;15898196;889245;371;13012683;241;2885513;25977;26061
80246;Dommartin;202;5247533;308462;136;4584341;66;663192;25978;26062
67451;Schleithal;792;20574591;938954;493;17241500;299;3333091;25978;26063
27421;Mousseaux-Neuville;336;8728734;499024;213;7467611;123;1261123;25978;26064
01174;Giron;86;2234147;93964;47;1652273;39;581874;25978;26065
32019;Auterive;316;8209271;407980;198;6746153;118;1463118;25979;26066
86010;Aslonnes;540;14028551;644149;358;12102916;182;1925635;25979;26067
49341;Souzay-Champigny;377;9794084;427133;223;7818689;154;1975395;25979;26068
54066;Bettainvillers;158;4104751;134573;79;2881188;79;1223563;25979;26069
04109;Mallefougasse-Augès;145;3767057;189900;86;2976168;59;790889;25980;26070
76631;Saint-Paër;687;17848303;599701;464;15313166;223;2535137;25980;26071
52069;Braux-le-Châtel;78;2026461;49755;47;1708399;31;318062;25980;26072
60211;Éragny-sur-Epte;299;7768337;349309;188;6364014;111;1404323;25981;26073
24535;Simeyrols;132;3429564;102990;73;2800802;59;628762;25982;26074
68028;Bergheim;1123;29179955;1796283;696;23970800;427;5209155;25984;26075
57274;Guerting;437;11355443;421561;285;9160399;152;2195044;25985;26076
60092;Boullarre;118;3066270;174061;72;2533248;46;533022;25985;26077
42012;Bard;325;8445272;426922;192;6986348;133;1458924;25985;26078
27646;Le Torpt;174;4521510;109909;116;3822387;58;699123;25986;26079
69042;La Chapelle-sur-Coise;249;6470673;145631;150;5083108;99;1387565;25987;26080
71501;Sassangy;90;2338819;126385;48;1814691;42;524128;25987;26081
47172;Moncaut;280;7276722;289030;173;6062742;107;1213980;25988;26082
06036;Castillon;199;5171717;329982;126;4495008;73;676709;25989;26083
61443;Saint-Paul;322;8368423;313703;192;6689898;130;1678525;25989;26084
77204;Germigny-sous-Coulombs;95;2469001;122114;58;2024367;37;444634;25989;26085
47158;Marmont-Pachas;62;1611356;115034;37;1386391;25;224965;25990;26086
25131;Châtelblanc;62;1611378;100343;36;1303948;26;307430;25990;26087
16369;Sigogne;555;14424843;877811;327;11947061;228;2477782;25991;26088
85294;La Tranche-sur-Mer;1993;51800297;3267535;1142;42336553;851;9463744;25991;26089
71494;La Salle;302;7849513;388832;202;6602525;100;1246988;25992;26090
01177;Grand-Corent;90;2339266;78057;67;2036694;23;302572;25992;26091
35054;Chanteloup;770;20013990;470063;511;16652941;259;3361049;25992;26092
05106;Prunières;180;4678596;339679;94;3713560;86;965036;25992;26093
57073;Betting;481;12502787;774679;298;10409416;183;2093371;25993;26094
71362;Pruzilly;156;4055260;175117;96;3381757;60;673503;25995;26095
86114;Jardres;553;14375747;424546;360;11852266;193;2523481;25996;26096
57689;Valmestroff;132;3431573;89953;71;2446976;61;984597;25997;26097
25421;Narbief;32;831901;29434;16;588201;16;243700;25997;26098
54385;Morfontaine;526;13674750;152712;195;6684010;331;6990740;25998;26099
14335;Hotot-en-Auge;164;4263640;199614;103;3547504;61;716136;25998;26100
89467;Villethierry;420;10919320;494765;284;9371015;136;1548305;25998;26101
79284;Sainte-Ouenne;390;10139442;466570;254;8625807;136;1513635;25999;26102
64109;Bénéjacq;973;25296833;1108471;575;20283239;398;5013594;25999;26103
25473;Pugey;392;10191560;390548;261;8657906;131;1533654;25999;26104
57425;Luppy;275;7149778;222429;171;5778640;104;1371138;25999;26105
57505;Niderviller;616;16015619;779861;407;13455731;209;2559888;25999;26106
27219;Épégard;263;6837858;259157;180;5880544;83;957314;25999;26107
67120;Eichhoffen;283;7357956;282049;182;6133125;101;1224831;26000;26108
39453;Ravilloles;249;6474077;282174;160;5357672;89;1116405;26000;26109
57084;Bioncourt;158;4108153;145204;97;3406720;61;701433;26001;26110
26355;Triors;314;8164870;434455;164;6706221;150;1458649;26003;26111
36057;Coings;435;11311559;544697;298;9642883;137;1668676;26004;26112
28370;Saumeray;245;6371376;235702;142;5135524;103;1235852;26006;26113
77238;Jouarre;2190;56955462;3036029;1249;47513967;941;9441495;26007;26114
38186;Gresse-en-Vercors;229;5955638;240900;137;4873874;92;1081764;26007;26115
01113;Condeissiat;371;9648867;334907;233;7973327;138;1675540;26008;26116
42182;Renaison;1639;42627449;1776908;1018;35401759;621;7225690;26008;26117
35123;Goven;2164;56281941;2328594;1411;47613044;753;8668897;26008;26118
38418;Sainte-Marie-du-Mont;124;3225048;184516;79;2806165;45;418883;26008;26119
60210;Épineuse;126;3277076;145943;74;2644327;52;632749;26009;26120
64452;Ponson-Dessus;141;3667231;191449;80;3097346;61;569885;26009;26121
60629;Thérines;86;2236753;95465;53;1856844;33;379909;26009;26122
45106;Coudray;213;5540110;272519;146;4706074;67;834036;26010;26123
51234;Esclavolles-Lurey;340;8843580;547964;223;7531803;117;1311777;26011;26124
69145;Odenas;417;10846529;460232;258;8892983;159;1953546;26011;26125
48137;Saint-Bauzile;314;8167790;293321;208;6988421;106;1179369;26012;26126
76442;Monchy-sur-Eu;276;7179480;320405;174;5894381;102;1285099;26013;26127
27463;Plasnes;369;9598846;431445;235;8222005;134;1376841;26013;26128
24060;Bourniquel;38;988507;25233;16;568876;22;419631;26013;26129
14046;Bavent;875;22762607;925532;575;19193169;300;3569438;26014;26130
34095;Fabrègues;3514;91414755;4957209;2142;76625295;1372;14789460;26014;26131
64496;Saint-Pierre-d'Irube;2646;68834307;3313579;1668;56879946;978;11954361;26014;26132
27105;Bourgtheroulde-Infreville;1539;40036892;1946984;994;33936228;545;6100664;26015;26133
88516;Vittel;3389;88164459;5601063;2083;74842263;1306;13322196;26015;26134
27532;Saint-Denis-du-Béhélan;99;2575574;137280;60;2140343;39;435231;26016;26135
18247;Savigny-en-Septaine;349;9080075;378794;238;7610614;111;1469461;26017;26136
67122;Wangenbourg-Engenthal;775;20163646;1038400;465;16738424;310;3425222;26018;26137
89230;Looze;223;5801966;265475;138;4877177;85;924789;26018;26138
30185;Mus;690;17952734;770676;422;14996308;268;2956426;26018;26139
71033;Bey;401;10433548;452957;264;8812025;137;1621523;26019;26140
02100;Bony;66;1717296;137395;31;1379956;35;337340;26020;26141
62574;Mingoval;106;2758140;114457;62;2244648;44;513492;26020;26142
62114;Bermicourt;74;1925547;85255;40;1476832;34;448715;26021;26143
42180;Précieux;466;12125764;517133;276;9713271;190;2412493;26021;26144
93057;Les Pavillons-sous-Bois;11529;300001103;17822061;7451;259408790;4078;40592313;26021;26145
28111;Coudray-au-Perche;175;4553902;240331;105;3851501;70;702401;26022;26146
80425;Hédauville;60;1561391;143157;30;1215158;30;346233;26023;26147
45157;Givraines;216;5621086;252240;140;4715477;76;905609;26024;26148
33016;Asques;257;6688198;473434;146;5582916;111;1105282;26024;26149
57113;Brouderdorff;451;11737125;406001;294;9857240;157;1879885;26025;26150
45134;Épieds-en-Beauce;681;17722813;746657;423;14459514;258;3263299;26025;26151
80452;Jumel;220;5725438;262307;135;4862989;85;862449;26025;26152
50044;Belval;144;3747560;188020;84;3012000;60;735560;26025;26153
63315;Saint-Amant-Tallende;964;25088091;1375853;545;20518055;419;4570036;26025;26154
12201;Rodelle;543;14131618;662376;315;12018945;228;2112673;26025;26155
51224;Écriennes;92;2394324;107494;57;1997052;35;397272;26025;26156
27058;Bernières-sur-Seine;174;4528573;177198;122;3942356;52;586217;26026;26157
56158;Plescop;2844;74018840;3293190;1909;62716256;935;11302584;26026;26158
77262;Louan-Villegruis-Fontaine;255;6636745;391411;161;5638507;94;998238;26026;26159
73320;Villargondran;509;13247660;618079;361;11458406;148;1789254;26027;26160
18208;Sainte-Gemme-en-Sancerrois;241;6272751;397937;151;5338169;90;934582;26028;26161
85166;Olonne-sur-Mer;8110;211087986;10238561;4887;174191700;3223;36896286;26028;26162
74238;Saint-Jean-d'Aulps;721;18766471;1176178;445;15562335;276;3204136;26028;26163
45345;Vimory;620;16137625;818226;387;13452185;233;2685440;26028;26164
76149;Butot;140;3644097;139109;94;3103865;46;540232;26029;26165
25370;Mathay;1140;29673479;1354445;769;25478179;371;4195300;26029;26166
41186;Rahart;156;4060603;163539;109;3530348;47;530255;26030;26167
25517;Saint-Gorgon-Main;132;3435912;129938;85;2896918;47;538994;26030;26168
67012;Aschbach;328;8537975;345317;199;6886743;129;1651232;26030;26169
86292;Villiers;399;10386332;348575;265;8822399;134;1563933;26031;26170
81027;Belleserre;84;2186745;118468;47;1769891;37;416854;26033;26171
45324;Tigy;1245;32411773;1620269;781;26603985;464;5807788;26034;26172
16202;Mainxe;360;9372314;555204;214;7805574;146;1566740;26034;26173
68195;Lutterbach;3464;90182827;5213432;2139;76394972;1325;13787855;26034;26174
2B093;Corbara;494;12861056;982485;268;10501504;226;2359552;26035;26175
46044;Caillac;290;7550217;359121;166;6132164;124;1418053;26035;26176
02739;Terny-Sorny;163;4243897;161039;108;3697274;55;546623;26036;26177
63167;Gimeaux;220;5728034;251412;154;5028872;66;699162;26037;26178
74159;Magland;1718;44735150;2091277;1086;37101871;632;7633279;26039;26179
76240;Épreville;502;13071774;541570;320;11008193;182;2063581;26039;26180
14181;Cormelles-le-Royal;2588;67391381;3185438;1636;56382623;952;11008758;26040;26181
86124;Lavoux;583;15182050;667993;388;13038207;195;2143843;26041;26182
63063;Cébazat;4226;110051118;5707002;2675;93038634;1551;17012484;26041;26183
21494;Poncey-sur-l'Ignon;42;1093747;74828;23;894425;19;199322;26042;26184
41026;Brévainville;99;2578165;121665;49;1806305;50;771860;26042;26185
38463;Saint-Vérand;945;24609896;1201763;592;20412498;353;4197398;26042;26186
67320;Neuve-Église;334;8698207;348578;200;6994404;134;1703803;26043;26187
57105;Boustroff;67;1744864;50924;43;1364883;24;379981;26043;26188
14077;Blangy-le-Château;388;10104879;632805;221;8175318;167;1929561;26044;26189
63014;Aubière;5164;134490905;8023383;3249;115715584;1915;18775321;26044;26190
62074;Bailleulval;131;3411783;176390;80;2855276;51;556507;26044;26191
89053;Branches;255;6641272;368029;168;5559973;87;1081299;26044;26192
88152;Dompierre;126;3281586;107619;73;2489514;53;792072;26044;26193
67187;Heidolsheim;222;5781990;182760;146;4816784;76;965206;26045;26194
38365;Saint-Baudille-de-la-Tour;403;10496429;371869;267;8756777;136;1739652;26046;26195
65120;Calavanté;140;3646428;146390;94;3164519;46;481909;26046;26196
08163;Faissault;116;3021455;122482;61;2265975;55;755480;26047;26197
35245;Romillé;1799;46858976;1746068;1139;38879960;660;7979016;26047;26198
02706;Septmonts;291;7580285;348934;169;6151423;122;1428862;26049;26199
60234;Fitz-James;1215;31649955;1624489;866;27668283;349;3981672;26049;26200
28374;Serazereux;276;7189622;302857;177;5892646;99;1296976;26049;26201
33281;Mérignac;38802;1010776760;66631609;25205;873785990;13597;136990770;26050;26202
31287;Lavernose-Lacasse;1392;36262283;1586043;879;30444798;513;5817485;26050;26203
83129;Six-Fours-les-Plages;22338;581916251;34172227;13441;487461875;8897;94454376;26051;26204
31175;Estancarbon;332;8648838;512086;212;7423209;120;1225629;26051;26205
67090;Diebolsheim;324;8440565;356956;196;6897099;128;1543466;26051;26206
51501;Sainte-Marie-à-Py;109;2839598;155957;64;2383793;45;455805;26051;26207
27360;Jumelles;150;3907724;170630;103;3429685;47;478039;26051;26208
79283;Sainte-Néomaye;675;17584848;774981;451;14954851;224;2629997;26052;26209
60026;Auchy-la-Montagne;250;6512944;276896;153;5211010;97;1301934;26052;26210
45336;Viglain;496;12921868;798932;304;10789991;192;2131877;26052;26211
26131;Eyzahut;92;2396810;184434;51;2037130;41;359680;26052;26212
40273;Saint-Martin-de-Seignanx;2697;70265094;3376147;1637;58373691;1060;11891403;26053;26213
76230;Elbeuf-sur-Andelle;201;5236738;221881;139;4454856;62;781882;26053;26214
73115;Fontaine-le-Puits;71;1849815;82001;44;1508054;27;341761;26054;26215
41148;Montlivault;715;18628514;839839;487;16082935;228;2545579;26054;26216
57149;Colmen;124;3230763;201423;65;2482710;59;748053;26055;26217
56023;Brech;3286;85616349;3811235;1983;70737360;1303;14878989;26055;26218
52028;Aulnoy-sur-Aube;30;781647;70970;14;608865;16;172782;26055;26219
59329;Lambres-lez-Douai;2799;72927995;3987633;1655;59713861;1144;13214134;26055;26220
34263;Saint-Hilaire-de-Beauvoir;189;4924419;246536;100;3962691;89;961728;26055;26221
62785;Savy-Berlette;445;11594817;388622;282;9684390;163;1910427;26056;26222
21536;Sacquenay;152;3960498;227452;91;3327397;61;633101;26056;26223
63054;Le Broc;368;9588640;632987;227;8087124;141;1501516;26056;26224
89337;Saint-Bris-le-Vineux;643;16754207;1132402;377;13891418;266;2862789;26056;26225
71100;Chardonnay;106;2761971;151753;66;2307351;40;454620;26056;26226
07055;Charmes-sur-Rhône;1339;34889691;1717250;812;28679000;527;6210691;26057;26227
62896;Wirwignes;346;9016218;480325;199;7490231;147;1525987;26058;26228
73217;Rotherens;153;3986970;123838;107;3395616;46;591354;26059;26229
31082;Bourg-Saint-Bernard;508;13238256;658611;311;11182814;197;2055442;26060;26230
73120;Fréterive;291;7583470;496126;191;6512251;100;1071219;26060;26231
71170;Demigny;898;23401944;1029429;593;19849867;305;3552077;26060;26232
14595;Saint-Jean-de-Livet;111;2892704;164727;69;2421585;42;471119;26060;26233
73056;Bramans;243;6332788;329344;148;5257360;95;1075428;26061;26234
10056;Bouy-Luxembourg;112;2918898;154113;74;2466771;38;452127;26062;26235
73306;Valloire;775;20198424;1127194;495;16999794;280;3198630;26062;26236
29293;Trégunc;4124;107482363;5407457;2441;87925035;1683;19557328;26063;26237
55401;Les Paroches;218;5681668;261207;129;4582093;89;1099575;26063;26238
42166;Parigny;300;7818816;301031;180;6187518;120;1631298;26063;26239
14058;Bellou;72;1876540;90264;39;1371034;33;505506;26063;26240
87107;Nieul;830;21632655;999614;515;17740825;315;3891830;26063;26241
57641;Schweyen;168;4378661;220450;107;3637724;61;740937;26063;26242
76023;Anvéville;134;3492702;108493;86;2885552;48;607150;26065;26243
71393;Saint-Bonnet-de-Cray;227;5916793;202081;134;4811327;93;1105466;26065;26244
58067;Chaulgnes;789;20566108;1142906;485;17211463;304;3354645;26066;26245
61130;Courgeoût;229;5969129;195247;139;4969398;90;999731;26066;26246
57090;Blanche-Église;61;1590079;65087;41;1349223;20;240856;26067;26247
57074;Bettviller;451;11756287;501793;246;9538542;205;2217745;26067;26248
35049;Cancale;3185;83027337;4582388;1791;66802723;1394;16224614;26068;26249
37193;Restigné;658;17153046;940311;388;14147089;270;3005957;26068;26250
79161;Luzay;313;8160055;359047;189;6558338;124;1601717;26070;26251
33209;Jugazan;150;3910577;234970;88;3220784;62;689793;26071;26252
84001;Althen-des-Paluds;1452;37855730;2023897;862;30641865;590;7213865;26071;26253
25455;Placey;83;2163995;80030;61;1904875;22;259120;26072;26254
11243;Montferrand;257;6700619;388551;146;5531866;111;1168753;26072;26255
51529;Selles;177;4614939;146380;119;3890683;58;724256;26073;26256
37008;Athée-sur-Cher;1309;34130214;1447587;850;29126378;459;5003836;26074;26257
89264;Montacher-Villegardin;407;10612186;532512;271;8948928;136;1663258;26074;26258
77341;Noyen-sur-Seine;206;5371587;258977;113;4414117;93;957470;26076;26259
44016;La Boissière-du-Doré;417;10873727;380647;249;8654430;168;2219297;26076;26260
69097;Les Haies;394;10274219;445738;254;8671290;140;1602929;26077;26261
28198;Jallans;425;11082675;505390;295;9464745;130;1617930;26077;26262
69036;Cercié;526;13716489;516379;334;11220278;192;2496211;26077;26263
57747;Wintersbourg;120;3129301;80859;83;2685371;37;443930;26078;26264
38191;Huez;843;21983431;1376951;557;18875831;286;3107600;26078;26265
87177;Saint-Priest-sous-Aixe;868;22636598;1048732;573;19287796;295;3348802;26079;26266
70041;Autrey-lès-Gray;234;6102541;453369;131;5001003;103;1101538;26079;26267
73061;Césarches;212;5528847;178752;154;4953171;58;575676;26079;26268
71144;Cordesse;94;2451503;108307;65;2085267;29;366236;26080;26269
71082;Champlecy;114;2973164;148222;66;2362350;48;610814;26080;26270
39153;Cize;451;11762360;507323;262;9185192;189;2577168;26081;26271
14241;Épinay-sur-Odon;322;8398471;393183;199;6944645;123;1453826;26082;26272
07245;Saint-Jean-de-Muzols;1323;34506811;1524046;795;28391749;528;6115062;26082;26273
40287;Sanguinet;1914;49923378;2499009;1179;41130670;735;8792708;26083;26274
62662;Polincove;374;9755162;413709;216;7646101;158;2109061;26083;26275
08088;Bulson;62;1617167;43705;45;1388860;17;228307;26083;26276
39049;Bersaillin;212;5529766;156387;116;4532629;96;997137;26084;26277
32054;Biran;215;5608039;509061;111;4606919;104;1001120;26084;26278
33433;Saint-Loubès;4468;116544509;5749974;2864;98806567;1604;17737942;26084;26279
09332;Verniolle;1278;33336408;1956545;729;27192549;549;6143859;26085;26280
70540;Velloreille-lès-Choye;35;912987;34051;20;715843;15;197144;26085;26281
27268;Le Fresne;170;4434683;159846;118;3878663;52;556020;26086;26282
70224;Étuz;338;8817962;345533;232;7603662;106;1214300;26089;26283
89390;Serbonnes;312;8139728;390944;194;6706920;118;1432808;26089;26284
38535;Vernas;125;3261254;138495;85;2809164;40;452090;26090;26285
71475;Saint-Rémy;3448;89962682;4590831;2220;75363208;1228;14599474;26091;26286
28099;Chuisnes;545;14220396;657841;380;12106227;165;2114169;26092;26287
59637;Wandignies-Hamage;650;16960239;855047;398;14306502;252;2653737;26093;26288
31234;Le Grès;191;4983762;176698;128;4340484;63;643278;26093;26289
14732;Vaux-sur-Aure;178;4644745;241848;115;3996936;63;647809;26094;26290
72295;Saint-Longis;273;7123770;302675;173;5754537;100;1369233;26094;26291
76628;Saint-Ouen-du-Breuil;371;9681133;321200;251;8283009;120;1398124;26095;26292
54449;Rehainviller;497;12969304;428325;330;10839960;167;2129344;26095;26293
26061;Bren;280;7306663;359152;169;6076789;111;1229874;26095;26294
51141;La Chaussée-sur-Marne;389;10151234;393319;245;8212752;144;1938482;26096;26295
70407;Perrouse;131;3418588;155063;96;2962371;35;456217;26096;26296
94043;Le Kremlin-Bicêtre;14197;370515823;27486365;9309;326412464;4888;44103359;26098;26297
59260;Ghyvelde;1635;42671633;2057546;967;35534148;668;7137485;26099;26298
07177;Plats;379;9891747;376681;219;8028385;160;1863362;26100;26299
27127;Canappeville;312;8143150;306937;219;7099459;93;1043691;26100;26300
39240;Le Frasnois;89;2322893;124607;61;2033706;28;289187;26100;26301
35198;Moulins;330;8613009;284114;194;6941982;136;1671027;26100;26302
76398;Louvetot;322;8404707;331195;202;7033608;120;1371099;26102;26303
07325;Ucel;1173;30617542;1645432;687;25478757;486;5138785;26102;26304
41051;Chissay-en-Touraine;591;15426557;747935;372;13008118;219;2418439;26102;26305
67475;Sparsbach;133;3471645;140021;91;2950082;42;521563;26103;26306
01028;Baneins;281;7335067;269349;179;6034654;102;1300413;26103;26307
70259;Froideterre;189;4933587;217502;137;4347758;52;585829;26104;26308
58288;Teigny;51;1331298;115681;28;1126465;23;204833;26104;26309
79048;La Crèche;3006;78468689;3571679;1955;66646496;1051;11822193;26104;26310
60409;Monchy-Saint-Éloi;1033;26967384;1237307;673;23084596;360;3882788;26106;26311
45119;Dadonville;1171;30571038;1277205;763;25446707;408;5124331;26107;26312
87094;Meilhac;231;6030831;223347;144;5030315;87;1000516;26107;26313
29134;Locronan;462;12061745;561220;264;9831284;198;2230461;26108;26314
81189;Mouzens;67;1749304;102556;39;1473619;28;275685;26109;26315
68188;Linthal;331;8642098;334119;219;7309854;112;1332244;26109;26316
27540;Sainte-Geneviève-lès-Gasny;341;8903271;401680;237;7738548;104;1164723;26109;26317
14540;Rocques;204;5326317;439401;93;4514593;111;811724;26109;26318
60550;Rothois;99;2584844;105785;69;2209037;30;375807;26110;26319
60539;Rieux;833;21749316;971688;559;18698002;274;3051314;26110;26320
59368;La Madeleine;13376;349242885;25354099;8321;300508013;5055;48734872;26110;26321
49214;Montreuil-Juigné;3579;93446921;3988635;2226;77657866;1353;15789055;26110;26322
40107;Garrosse;152;3968740;209118;85;3232137;67;736603;26110;26323
76336;Gueutteville-les-Grès;182;4752097;153881;117;4059926;65;692171;26110;26324
93074;Vaujours;3609;94232975;5205743;2469;82041414;1140;12191561;26111;26325
83047;La Crau;9286;242464310;12246821;5807;204610180;3479;37854130;26111;26326
71359;Préty;325;8486067;404505;208;7150093;117;1335974;26111;26327
74079;Les Clefs;317;8277291;364623;194;6888015;123;1389276;26111;26328
67300;Molsheim;5160;134734540;8089937;3156;112956863;2004;21777677;26111;26329
63473;Yssac-la-Tourette;198;5170131;296648;135;4489220;63;680911;26112;26330
68253;Ottmarsheim;1033;26973549;1508240;669;22768774;364;4204775;26112;26331
60679;La Villeneuve-sous-Thury;81;2115140;137985;43;1683822;38;431318;26113;26332
80299;La Faloise;125;3264159;311509;76;2771808;49;492351;26113;26333
33480;Saint-Sulpice-de-Faleyrens;819;21386856;1094750;461;17483117;358;3903739;26113;26334
26041;Beausemblant;684;17861672;582304;412;14669025;272;3192647;26114;26335
32348;Roquelaure;331;8643847;458237;210;7424262;121;1219585;26114;26336
21440;Montot;106;2768183;101956;74;2452803;32;315380;26115;26337
60574;Saint-Félix;298;7782527;276796;199;6523863;99;1258664;26116;26338
65424;Sers;46;1201341;41615;29;1022789;17;178552;26116;26339
37225;Saint-Martin-le-Beau;1521;39722722;1793237;995;34178128;526;5544594;26116;26340
73099;Détrier;207;5406220;184034;137;4509425;70;896795;26117;26341
76660;Sandouville;404;10551434;459110;275;9025281;129;1526153;26117;26342
44160;Saint-Géréon;1434;37453240;1372482;927;31154576;507;6298664;26118;26343
08210;Hannogne-Saint-Rémy;63;1645460;122540;29;1354036;34;291424;26118;26344
51307;Jonchery-sur-Suippe;99;2585746;109134;59;2117936;40;467810;26119;26345
57187;Éblange;172;4492425;128821;119;3758951;53;733474;26119;26346
52315;Marnay-sur-Marne;162;4231279;162217;107;3601228;55;630051;26119;26347
57582;Richemont;1025;26772948;1203175;579;20293994;446;6478954;26120;26348
16415;Vindelle;552;14418276;603238;376;12431116;176;1987160;26120;26349
14001;Ablon;630;16456584;863498;395;13704112;235;2752472;26122;26350
39186;Cuttura;198;5172181;299775;131;4345536;67;826645;26122;26351
40308;Sort-en-Chalosse;461;12042347;618394;264;9924305;197;2118042;26122;26352
31547;Seysses;3636;94981782;4880455;2263;80375527;1373;14606255;26123;26353
57022;Angevillers;645;16849818;333474;247;8822963;398;8026855;26124;26354
14311;Grainville-sur-Odon;478;12487472;536530;294;10290556;184;2196916;26124;26355
10002;Ailleville;142;3709704;304019;77;2890627;65;819077;26125;26356
60059;Béhéricourt;108;2821493;120255;72;2272912;36;548581;26125;26357
01317;Ramasse;129;3370208;153854;83;2775766;46;594442;26126;26358
50588;Tamerville;330;8621517;374551;195;7248488;135;1373029;26126;26359
09104;Dalou;402;10502725;654719;230;8567098;172;1935627;26126;26360
44133;Port-Saint-Père;1404;36682178;1563480;876;29822184;528;6859994;26127;26361
21215;Cuiserey;66;1724435;41436;46;1462539;20;261896;26128;26362
73231;Saint-Étienne-de-Cuines;700;18290377;1081888;433;15465158;267;2825219;26129;26363
76515;Quiberville;306;7995601;453300;187;6757096;119;1238505;26129;26364
57622;Saint-Privat-la-Montagne;930;24300481;1019085;555;19473575;375;4826906;26130;26365
69195;Saint-Didier-sous-Riverie;572;14946123;564303;337;12186090;235;2760033;26130;26366
74175;Meillerie;192;5017081;385880;131;4337103;61;679978;26131;26367
81092;Fiac;515;13457328;855938;266;10891813;249;2565515;26131;26368
61379;Saint-Cyr-la-Rosière;151;3945752;299852;85;3397616;66;548136;26131;26369
80350;Franvillers;262;6846325;295198;179;5883549;83;962776;26131;26370
35196;Mordelles;3913;102251832;4705295;2572;86783730;1341;15468102;26131;26371
67450;Schirrhoffen;374;9773126;427133;252;8448569;122;1324557;26131;26372
13100;Saint-Rémy-de-Provence;6363;166275315;12329785;3189;134249292;3174;32026023;26132;26373
71215;Gergy;1267;33109520;1564257;801;27536668;466;5572852;26132;26374
64054;Arros-de-Nay;421;11001842;419632;248;8903783;173;2098059;26133;26375
80761;Tilloy-lès-Conty;147;3841628;199669;98;3271201;49;570427;26134;26376
17145;Échebrune;260;6794736;427902;139;5349348;121;1445388;26134;26377
10052;Boulages;134;3501962;181973;80;2840011;54;661951;26134;26378
29295;Trémaouézan;242;6324734;241801;153;5263697;89;1061037;26135;26379
67496;Uberach;610;15942778;680119;400;13327191;210;2615587;26136;26380
76707;Tourville-sur-Arques;591;15446202;628493;389;13175543;202;2270659;26136;26381
60040;Bailleul-le-Soc;329;8598792;433227;226;7457877;103;1140915;26136;26382
24312;Notre-Dame-de-Sanilhac;1720;44956742;2364060;1057;37458123;663;7498619;26138;26383
61277;La Mesnière;153;3999185;127522;96;3350339;57;648846;26138;26384
57394;Léning;132;3450289;111698;71;2608196;61;842093;26139;26385
67005;Alteckendorf;437;11423022;400214;276;9480921;161;1942101;26140;26386
27598;Saint-Pierre-du-Vauvray;729;19055939;971155;466;16338835;263;2717104;26140;26387
74111;Entrevernes;103;2692511;109212;67;2313634;36;378877;26141;26388
80470;Léalvillers;97;2535751;153331;56;2038971;41;496780;26142;26389
14332;La Hoguette;337;8809942;355148;202;7399036;135;1410906;26142;26390
71477;Saint-Romain-sous-Gourdon;251;6561921;304414;160;5418168;91;1143753;26143;26391
72169;Louplande;686;17934216;561057;477;15469760;209;2464456;26143;26392
59592;Thumeries;1962;51292906;2283788;1226;42755574;736;8537332;26143;26393
69171;Sain-Bel;1202;31425873;1535738;781;26485585;421;4940288;26145;26394
73093;La Côte-d'Aime;463;12105307;529006;308;10256088;155;1849219;26145;26395
42326;Véranne;419;10955203;452468;254;9028867;165;1926336;26146;26396
76138;Bracquetuit;156;4078853;189673;87;3281056;69;797797;26146;26397
62864;Vis-en-Artois;339;8863702;361534;198;7199877;141;1663825;26147;26398
72308;Saint-Paterne;791;20682528;875906;535;17705824;256;2976704;26147;26399
51216;Dontrien;108;2823919;160718;60;2275909;48;548010;26147;26400
38423;Saint-Martin-le-Vinoux;2792;73003773;4609468;1617;60971320;1175;12032453;26147;26401
28106;Conie-Molitard;220;5752648;278397;139;4889340;81;863308;26148;26402
02213;Connigis;160;4183799;302260;97;3491746;63;692053;26149;26403
68308;Sickert;182;4759104;224688;123;4091584;59;667520;26149;26404
67135;Ettendorf;417;10904571;387378;262;8929672;155;1974899;26150;26405
76559;Saint-Aubin-de-Crétot;268;7008241;240146;191;5985765;77;1022476;26150;26406
41137;Mesland;284;7426663;382987;168;6186805;116;1239858;26150;26407
71274;Mancey;206;5387043;274469;117;4275672;89;1111371;26151;26408
38024;Badinières;286;7479261;243914;174;6152523;112;1326738;26151;26409
02193;Cierges;40;1046078;45020;25;834426;15;211652;26152;26410
59649;Wattignies-la-Victoire;117;3059823;117199;75;2613518;42;446305;26152;26411
67261;Lauterbourg;1255;32821585;2224078;757;27592830;498;5228755;26153;26412
39422;Plainoiseau;303;7924844;344527;215;6905720;88;1019124;26155;26413
02088;Bièvres;36;941572;41994;22;794622;14;146950;26155;26414
90020;Buc;174;4551019;205868;114;3902119;60;648900;26155;26415
38287;Oyeu;470;12293007;480704;292;10165034;178;2127973;26155;26416
33375;Saint-Aubin-de-Branne;195;5100414;295944;118;4331211;77;769203;26156;26417
14354;Langrune-sur-Mer;1042;27254801;1452750;664;23086037;378;4168764;26156;26418
89255;Michery;552;14438626;854751;360;12110750;192;2327876;26157;26419
76548;Ry;416;10881488;585627;249;8830932;167;2050556;26157;26420
14608;Saint-Loup-de-Fribois;107;2798882;66077;53;2195249;54;603633;26158;26421
81118;Laboulbène;85;2223417;108333;60;1981590;25;241827;26158;26422
01011;Apremont;203;5310376;250687;131;4387312;72;923064;26159;26423
10133;Eaux-Puiseaux;119;3113048;139796;77;2619681;42;493367;26160;26424
55439;Ronvaux;48;1255686;58752;26;932689;22;322997;26160;26425
09328;Verdun;120;3139231;144269;73;2525583;47;613648;26160;26426
89265;Montigny-la-Resle;320;8371466;436575;206;7229373;114;1142093;26161;26427
01084;Chanoz-Châtenay;381;9967724;444726;227;7986630;154;1981094;26162;26428
60639;Tillé;608;15906665;832603;415;13718662;193;2188003;26162;26429
72296;Saint-Maixent;390;10203318;599010;242;8589183;148;1614135;26162;26430
06067;Gorbio;738;19307840;1140066;436;16246790;302;3061050;26162;26431
77215;Gretz-Armainvilliers;4427;115821671;6253654;2956;100640776;1471;15180895;26163;26432
33365;Saint-Aignan;120;3139525;153622;68;2602044;52;537481;26163;26433
83064;Garéoult;2986;78122906;3918202;1813;65046830;1173;13076076;26163;26434
31569;Vaudreuille;191;4997153;226690;116;4094162;75;902991;26163;26435
38259;Montseveroux;480;12558395;605213;297;10427728;183;2130667;26163;26436
61396;Saint-Germain-de-Martigny;42;1098878;52405;23;909848;19;189030;26164;26437
57158;Craincourt;127;3323036;161199;75;2712556;52;610480;26166;26438
01041;Bettant;415;10859529;579185;266;9097847;149;1761682;26168;26439
76119;Bosc-Bérenger;92;2407436;82457;57;2022545;35;384891;26168;26440
74276;Taninges;1942;50819455;2230600;1221;42168055;721;8651400;26169;26441
55042;Belleray;245;6411353;279405;169;5460953;76;950400;26169;26442
62660;Plouvain;228;5966633;262759;148;5176225;80;790408;26169;26443
32425;Ségoufielle;492;12875676;584218;304;10758748;188;2116928;26170;26444
08309;Mont-Saint-Remy;27;706604;25040;13;506786;14;199818;26171;26445
68104;Geiswasser;165;4318154;187115;109;3654731;56;663423;26171;26446
57472;Moncheux;65;1701095;77870;39;1442205;26;258890;26171;26447
29239;Roscoff;2152;56321760;3288575;1229;45719360;923;10602400;26172;26448
60417;Montherlant;72;1884399;66958;53;1693223;19;191176;26172;26449
30260;Saint-Hilaire-d'Ozilhan;495;12955409;845123;287;10847959;208;2107450;26173;26450
72079;Chérisay;152;3978238;174563;110;3512360;42;465878;26173;26451
45162;Guigneville;285;7459449;371821;191;6266201;94;1193248;26174;26452
59635;Wambaix;179;4685188;190792;113;3945373;66;739815;26174;26453
57359;Kemplich;69;1806034;25266;35;1229803;34;576231;26174;26454
29095;Kersaint-Plabennec;605;15835873;485866;420;13610612;185;2225261;26175;26455
53136;Loigné-sur-Mayenne;401;10496192;302417;276;9009257;125;1486935;26175;26456
62595;Moulle;537;14056078;438212;319;11606628;218;2449450;26175;26457
60222;Essuiles;259;6779397;249320;172;5816289;87;963108;26175;26458
28294;Oysonville;278;7276928;333355;198;6313564;80;963364;26176;26459
01082;Chanay;272;7120061;233466;167;5679014;105;1441047;26177;26460
08170;Fleigneux;108;2827197;125681;72;2412008;36;415189;26178;26461
45256;Presnoy;131;3429331;212692;74;2846879;57;582452;26178;26462
70096;Brevilliers;320;8377332;379892;191;6762840;129;1614492;26179;26463
45228;Nibelle;613;16048109;726016;373;13256035;240;2792074;26180;26464
22325;Saint-Quay-Portrieux;2145;56156553;3589715;1240;46161453;905;9995100;26180;26465
49222;Mozé-sur-Louet;1025;26834780;1006313;630;22064084;395;4770696;26180;26466
35121;Gosné;866;22672316;805903;562;18835669;304;3836647;26181;26467
52447;Saint-Ciergues;106;2775175;248411;64;2292045;42;483130;26181;26468
54417;Parey-Saint-Césaire;124;3246433;126136;87;2813239;37;433194;26181;26469
64373;Mazères-Lezons;1067;27935196;1403834;671;23290525;396;4644671;26181;26470
27307;Guiseniers;223;5838450;289269;157;5041338;66;797112;26181;26471
08417;Sévigny-la-Forêt;111;2906147;94986;64;2323767;47;582380;26182;26472
51215;Dompremy;67;1754204;77789;40;1464527;27;289677;26182;26473
41066;Courbouzon;237;6205286;250563;156;5041627;81;1163659;26183;26474
51363;Merlaut;131;3430036;183112;82;2930406;49;499630;26183;26475
28405;Vert-en-Drouais;583;15265000;724189;381;12874070;202;2390930;26184;26476
69108;Lancié;445;11652367;519438;265;9606486;180;2045881;26185;26477
72047;Brette-les-Pins;960;25137781;837903;626;20865373;334;4272408;26185;26478
67517;Wangen;369;9662350;457256;226;8084538;143;1577812;26185;26479
55317;Manheulles;77;2016351;90135;49;1698863;28;317488;26186;26480
36125;Migny;65;1702125;79692;44;1431453;21;270672;26187;26481
37134;Louans;343;8982182;374885;195;7260722;148;1721460;26187;26482
44029;La Chapelle-Basse-Mer;2654;69508899;2955403;1695;57937625;959;11571274;26190;26483
60304;Haute-Épine;138;3614491;174314;87;3000217;51;614274;26192;26484
62015;Airon-Notre-Dame;103;2697820;118106;66;2298152;37;399668;26192;26485
83055;Fayence;3138;82192399;5402590;1760;67098059;1378;15094340;26193;26486
27653;Tourny;508;13306761;730565;328;11351015;180;1955746;26194;26487
55475;Sauvoy;38;995407;63297;25;831976;13;163431;26195;26488
07044;Brossainc;118;3091067;127471;61;2451004;57;640063;26195;26489
08340;Poilcourt-Sydney;88;2305257;99817;53;1914234;35;391023;26196;26490
33109;Castres-Gironde;1073;28108807;1215068;671;23564184;402;4544623;26196;26491
65334;Omex;139;3641347;131142;94;3087017;45;554330;26197;26492
50442;Le Rozel;154;4034332;258217;95;3396307;59;638025;26197;26493
80326;Fontaine-sous-Montdidier;68;1781401;107511;44;1535129;24;246272;26197;26494
38284;Ornacieux;193;5056186;244062;119;4187535;74;868651;26198;26495
28286;Ollé;299;7833276;322841;205;6757198;94;1076078;26198;26496
33072;Brannens;103;2698575;163002;57;2306726;46;391849;26200;26497
22357;Trégon;134;3510823;214399;90;2983721;44;527102;26200;26498
14623;Saint-Martin-de-Fontenay;1276;33431562;1389717;825;28076546;451;5355016;26200;26499
44223;Geneston;1666;43650206;1549559;1072;36225845;594;7424361;26201;26500
28075;La Chapelle-du-Noyer;561;14698637;713127;380;12478446;181;2220191;26201;26501
32082;Castéra-Lectourois;167;4375912;248362;85;3414011;82;961901;26203;26502
42060;Chenereilles;238;6236527;135646;154;5082680;84;1153847;26204;26503
41208;Saint-Étienne-des-Guérets;52;1362712;62370;37;1172488;15;190224;26206;26504
41289;Villermain;191;5005373;238962;121;4134553;70;870820;26206;26505
10293;Poivres;78;2044099;129799;44;1617406;34;426693;26206;26506
70374;Motey-Besuche;58;1519972;82088;37;1283634;21;236338;26206;26507
59120;Caëstre;940;24634212;1183330;533;20141995;407;4492217;26207;26508
86272;Thuré;1446;37895372;1660251;965;32282238;481;5613134;26207;26509
76549;Saâne-Saint-Just;79;2070372;98240;46;1693588;33;376784;26207;26510
10270;Onjon;134;3511796;180255;72;2683209;62;828587;26207;26511
01006;Ambléon;62;1624923;90063;34;1207341;28;417582;26208;26512
60507;Pontoise-lès-Noyon;230;6027972;273085;150;4957183;80;1070789;26209;26513
17437;Talmont-sur-Gironde;57;1493968;100693;30;1173022;27;320946;26210;26514
53033;La Boissière;63;1651256;99802;37;1371545;26;279711;26210;26515
57416;Lorry-Mardigny;308;8072922;295549;194;6626229;114;1446693;26211;26516
80729;Sauvillers-Mongival;90;2359068;255990;52;1987578;38;371490;26212;26517
55248;Houdelaincourt;195;5111334;303467;96;4111715;99;999619;26212;26518
27635;Le Thuit;70;1834846;75981;46;1471377;24;363469;26212;26519
02610;Pommiers;333;8728672;464330;218;7384505;115;1344167;26212;26520
25620;Ville-du-Pont;160;4193988;225766;107;3605254;53;588734;26212;26521
50541;Saint-Planchers;729;19108981;835561;454;16158529;275;2950452;26213;26522
38429;Saint-Michel-les-Portes;129;3381502;152535;88;2982586;41;398916;26213;26523
59125;Cantaing-sur-Escaut;216;5662088;250152;130;4687852;86;974236;26213;26524
62832;Tubersent;246;6448541;269012;159;5438144;87;1010397;26214;26525
27597;Saint-Pierre-du-Val;282;7392366;409130;170;6146816;112;1245550;26214;26526
74148;Leschaux;154;4036972;219877;117;3638122;37;398850;26214;26527
57121;Burtoncourt;92;2411830;86297;57;1896251;35;515579;26216;26528
76662;Sassetot-le-Malgardé;55;1441857;91046;34;1173797;21;268060;26216;26529
41166;Oisly;181;4745124;256876;112;3926718;69;818406;26216;26530
62077;Bajus;160;4194608;156497;94;3410822;66;783786;26216;26531
63275;Perrier;468;12269353;676664;280;10070156;188;2199197;26217;26532
62727;Ruitz;812;21287862;986261;504;17412427;308;3875435;26217;26533
62477;Izel-lès-Hameau;360;9438029;400906;218;7780941;142;1657088;26217;26534
21451;Nesle-et-Massoult;49;1284737;59706;29;1059985;20;224752;26219;26535
08237;Joigny-sur-Meuse;355;9308023;446092;195;7397501;160;1910522;26220;26536
77211;Grandpuits-Bailly-Carrois;499;13083734;640739;329;11250530;170;1833204;26220;26537
62366;Gauchin-Légal;164;4300133;207889;95;3499603;69;800530;26220;26538
89115;Compigny;85;2228734;112959;52;1786715;33;442019;26220;26539
76079;Bénouville;99;2595841;193101;57;2164392;42;431449;26221;26540
80036;Aubigny;263;6896174;375121;177;5909856;86;986318;26221;26541
57370;Koenigsmacker;1097;28764700;701808;525;18619162;572;10145538;26221;26542
37160;Morand;173;4536455;153977;118;3803180;55;733275;26222;26543
26173;Marches;394;10331883;414820;227;8040493;167;2291390;26223;26544
91200;Dourdan;5733;150337280;9703819;3553;128130231;2180;22207049;26223;26545
33507;Sauviac;183;4799101;190842;90;3892592;93;906509;26225;26546
73309;Verel-de-Montbel;139;3645349;182793;88;3073516;51;571833;26226;26547
25431;Onans;183;4799623;188834;121;4062318;62;737305;26227;26548
59339;Leers;4994;130982730;5882306;3239;109357290;1755;21625440;26228;26549
64431;Os-Marsillon;225;5901447;231539;148;4961437;77;940010;26229;26550
95250;Fosses;4773;125191623;5817003;3230;108189133;1543;17002490;26229;26551
31255;Labroquère;182;4773706;316498;103;3918909;79;854797;26229;26552
57750;Woelfling-lès-Sarreguemines;352;9232761;364066;212;7386419;140;1846342;26229;26553
45049;Bouzy-la-Forêt;634;16629770;875043;405;14257320;229;2372450;26230;26554
25551;Soulce-Cernay;67;1757512;106305;47;1544073;20;213439;26232;26555
39392;Offlanges;104;2728153;117074;62;2122696;42;605457;26232;26556
02364;Guyencourt;114;2990688;139093;72;2432583;42;558105;26234;26557
40063;Candresse;421;11044863;548985;274;9374495;147;1670368;26235;26558
78528;Rolleboise;223;5850564;323616;145;5250861;78;599703;26236;26559
27345;La Houssaye;119;3122132;146068;75;2600945;44;521187;26236;26560
44109;Nantes;160466;4210410262;293379641;94768;3600562864;65698;609847398;26239;26561
27278;Garennes-sur-Eure;983;25793360;1205010;630;21715109;353;4078251;26239;26562
54022;Arnaville;309;8108039;346275;212;6962888;97;1145151;26240;26563
60518;Puits-la-Vallée;100;2624035;123793;64;2252008;36;372027;26240;26564
80505;Mametz;90;2361761;102671;61;2040781;29;320980;26242;26565
35091;Le Crouais;234;6140602;221971;142;4948854;92;1191748;26242;26566
68004;Altkirch;3226;84658057;5018354;1866;70450058;1360;14207999;26242;26567
12072;Comprégnac;134;3516566;216124;75;2821205;59;695361;26243;26568
25427;Noironte;200;5248609;203321;140;4477665;60;770944;26243;26569
84006;Auribeau;46;1207183;111767;21;1011028;25;196155;26243;26570
16199;Magnac-sur-Touvre;1730;45401424;2196688;1137;38620384;593;6781040;26244;26571
59340;Leffrinckoucke;2373;62276309;3344697;1439;52538999;934;9737310;26244;26572
59050;Bas-Lieu;189;4960073;258661;114;4213160;75;746913;26244;26573
35023;Bédée;1967;51622260;1971891;1226;42608152;741;9014108;26244;26574
82167;Saint-Nauphary;855;22439126;1116659;515;18431698;340;4007428;26245;26575
81214;Puéchoursi;47;1233510;75378;27;998326;20;235184;26245;26576
67394;Retschwiller;156;4094458;158111;97;3356743;59;737715;26247;26577
76004;Ambrumesnil;250;6561695;296460;148;5275236;102;1286459;26247;26578
49242;Le Plessis-Macé;553;14514872;487779;362;12071653;191;2443219;26248;26579
07337;Vernosc-lès-Annonay;1163;30526187;1195786;789;25942837;374;4583350;26248;26580
61354;Les Rotours;57;1496148;63234;34;1219977;23;276171;26248;26581
35252;Saint-Aubin-des-Landes;437;11470635;376078;262;9276148;175;2194487;26249;26582
37228;Saint-Nicolas-de-Bourgueil;628;16484155;928372;354;13583373;274;2900782;26249;26583
39114;Château-Chalon;88;2309939;120973;48;1896790;40;413149;26249;26584
27561;Saint-Maclou;283;7429083;329656;170;6120969;113;1308114;26251;26585
84096;Rasteau;443;11629373;560046;243;9474455;200;2154918;26251;26586
76160;Carville-la-Folletière;181;4751534;156406;120;4038236;61;713298;26252;26587
54260;Hériménil;446;11708714;476651;276;9676612;170;2032102;26253;26588
30287;Saint-Michel-d'Euzet;347;9109941;573879;209;7793240;138;1316701;26253;26589
29181;Plouédern;1416;37176649;1473228;948;31304417;468;5872232;26255;26590
42066;Cleppé;282;7404030;338496;171;6034708;111;1369322;26255;26591
67230;Kaltenhouse;1143;30010132;1615198;693;25162866;450;4847266;26256;26592
62013;Agny;1028;26990823;1370053;657;22924700;371;4066123;26256;26593
91359;Maisse;1462;38385880;1967328;978;32873838;484;5512042;26256;26594
07155;Mercuer;697;18300748;940337;445;15178683;252;3122065;26256;26595
01299;Le Plantay;277;7273112;371868;159;6391126;118;881986;26257;26596
08042;Balaives-et-Butz;105;2757166;76067;63;2229207;42;527959;26259;26597
71384;Saint-Ambreuil;289;7588797;504634;164;6282948;125;1305849;26259;26598
01112;Condamine;203;5330600;197276;145;4643394;58;687206;26259;26599
28340;Saint-Hilaire-sur-Yerre;279;7326525;339479;178;6008362;101;1318163;26260;26600
25528;Samson;40;1050416;26781;25;830041;15;220375;26260;26601
08236;Jandun;137;3597997;174875;82;3043130;55;554867;26263;26602
52249;Isômes;79;2074895;92058;56;1807777;23;267118;26264;26603
29177;Plouarzel;1811;47565276;1679312;1122;39127695;689;8437581;26265;26604
25340;Lombard;115;3020467;164838;71;2574147;44;446320;26265;26605
77014;Avon;8257;216872576;13933327;5394;187519723;2863;29352853;26265;26606
62050;Auchy-lès-Hesdin;929;24400983;2671708;274;18420525;655;5980458;26266;26607
62774;Sangatte;2410;63300823;3273859;1450;52687230;960;10613593;26266;26608
54320;Loisy;179;4701925;203964;124;4088091;55;613834;26268;26609
76651;Saint-Sylvain;96;2521753;120346;60;2186650;36;335103;26268;26610
62831;Troisvaux;138;3625115;184749;78;2987583;60;637532;26269;26611
17289;Préguillac;221;5805447;229107;127;4711033;94;1094414;26269;26612
88147;Dommartin-aux-Bois;219;5753179;579017;118;4694594;101;1058585;26270;26613
59565;Sepmeries;320;8406913;375930;202;7083495;118;1323418;26272;26614
50149;Couville;487;12794524;419503;330;10816227;157;1978297;26272;26615
29059;Garlan;498;13083528;645881;318;11039326;180;2044202;26272;26616
77030;Bellot;421;11060655;531627;273;9381091;148;1679564;26272;26617
60048;Baugy;159;4177405;233667;100;3414060;59;763345;26273;26618
67286;Meistratzheim;776;20387839;862055;531;17404890;245;2982949;26273;26619
60235;Flavacourt;372;9773792;489478;241;8365371;131;1408421;26274;26620
50620;Vasteville;530;13925627;504546;340;11554689;190;2370938;26275;26621
45146;La Ferté-Saint-Aubin;3868;101640658;5164700;2465;85161209;1403;16479449;26277;26622
08250;Leffincourt;92;2417536;124640;57;2001136;35;416400;26278;26623
25259;Frasne;992;26067611;1178367;611;21478432;381;4589179;26278;26624
50429;Regnéville-sur-Mer;480;12613786;739312;279;10162072;201;2451714;26279;26625
33423;Saint-Julien-Beychevelle;390;10248769;927146;220;8547581;170;1701188;26279;26626
73071;Champagny-en-Vanoise;405;10643075;607212;253;8800945;152;1842130;26279;26627
74042;Bonneville;6522;171396907;7117794;3858;135660459;2664;35736448;26280;26628
60390;Maulers;127;3337601;118918;83;2865168;44;472433;26280;26629
01140;Curtafond;352;9251254;340004;229;7622744;123;1628510;26282;26630
74073;Chevenoz;317;8331833;410334;199;7083758;118;1248075;26283;26631
27233;Fatouville-Grestain;384;10093234;458846;242;8355621;142;1737613;26284;26632
28386;Thimert-Gâtelles;602;15823483;861748;395;13428865;207;2394618;26285;26633
86260;Sérigny;171;4494950;273003;77;3534818;94;960132;26286;26634
54535;Tronville;110;2891536;91810;67;2443139;43;448397;26287;26635
74294;Verchaix;384;10094224;432206;257;8636733;127;1457491;26287;26636
57386;Laudrefang;192;5047282;190020;117;3954894;75;1092388;26288;26637
39037;Bans;100;2628896;125011;57;2160451;43;468445;26289;26638
64545;Urrugne;5258;138228052;7171571;3213;114206651;2045;24021401;26289;26639
42264;Saint-Médard-en-Forez;485;12750218;470154;317;10623657;168;2126561;26289;26640
51574;Togny-aux-Boeufs;92;2418615;169796;56;2034324;36;384291;26289;26641
32198;Lartigue;88;2313501;110650;50;1946545;38;366956;26290;26642
27234;Fauville;175;4600720;233431;117;4037128;58;563592;26290;26643
67275;Lupstein;410;10779138;537905;266;9107359;144;1671779;26291;26644
28212;Loigny-la-Bataille;116;3049736;131251;75;2566582;41;483154;26291;26645
62172;Boyelles;164;4311710;162095;102;3487713;62;823997;26291;26646
39162;Condamine;129;3391579;135600;86;2915448;43;476131;26291;26647
01179;Grièges;1028;27029405;1367164;658;22735036;370;4294369;26293;26648
59582;Strazeele;420;11043197;344185;275;9109027;145;1934170;26293;26649
64328;Ledeuix;575;15118664;618635;366;12237898;209;2880766;26293;26650
59161;Crèvecoeur-sur-l'Escaut;338;8887395;409464;221;7633180;117;1254215;26294;26651
40133;Labenne;2706;71152218;2967576;1713;59964022;993;11188196;26294;26652
97304;Kourou;11894;312755095;46642007;3937;254614191;7957;58140904;26295;26653
80575;Mouflières;44;1157000;34710;30;991707;14;165293;26295;26654
38106;Cholonge;148;3891780;173194;96;3289670;52;602110;26296;26655
89482;Viviers;72;1893369;99579;45;1581326;27;312043;26297;26656
86041;Buxerolles;5771;151759693;9326899;3764;131202803;2007;20556890;26297;26657
08148;L'Écaille;88;2314153;61956;56;1959404;32;354749;26297;26658
90003;Anjoutey;336;8835968;368328;215;7396329;121;1439639;26298;26659
67418;Rountzenheim;562;14780064;735349;373;12773190;189;2006874;26299;26660
60397;Le Mesnil-Conteville;50;1314954;62458;31;1056376;19;258578;26299;26661
14091;Bourgeauville;76;1998841;145710;46;1725704;30;273137;26301;26662
88428;Saint-Michel-sur-Meurthe;1039;27327020;1429655;640;22679548;399;4647472;26301;26663
33194;Grézillac;385;10126025;668729;229;8474885;156;1651140;26301;26664
42020;Boisset-lès-Montrond;523;13755687;541314;328;11273737;195;2481950;26302;26665
85146;Montaigu;2913;76618227;3978414;1649;63256811;1264;13361416;26302;26666
67040;Bindernheim;483;12704348;568379;328;10921694;155;1782654;26303;26667
67271;Lobsann;300;7890951;322370;187;6520997;113;1369954;26303;26668
68178;Lautenbachzell;535;14072328;695786;350;11796763;185;2275565;26303;26669
64039;Aren;114;2998603;105216;68;2467136;46;531467;26304;26670
51187;Courlandon;127;3340622;118352;71;2556464;56;784158;26304;26671
31275;Laréole;81;2130654;192471;40;1698291;41;432363;26304;26672
59617;Vieux-Mesnil;290;7628302;388783;180;6419445;110;1208857;26304;26673
77384;Réau;638;16782272;916604;416;14392508;222;2389764;26305;26674
01127;Courmangoux;260;6839581;312218;168;5719578;92;1120003;26306;26675
67345;Oberhoffen-sur-Moder;1798;47299127;2012069;1229;40567144;569;6731983;26307;26676
30020;Aubord;1191;31331974;1432752;732;25963394;459;5368580;26307;26677
89034;Beine;274;7208240;437469;166;5917302;108;1290938;26307;26678
53212;Saint-Denis-du-Maine;181;4761725;137351;116;3896594;65;865131;26308;26679
38393;Saint-Hilaire-de-la-Côte;729;19178831;979764;434;15625600;295;3553231;26308;26680
80210;Contre;69;1815313;68594;41;1481388;28;333925;26309;26681
81156;Marssac-sur-Tarn;1625;42752684;1919007;963;35033469;662;7719215;26309;26682
07191;Rochemaure;1174;30888016;1500065;738;25955615;436;4932401;26310;26683
23193;Sainte-Feyre;1372;36097699;1878149;923;31204514;449;4893185;26310;26684
72093;Cormes;485;12761261;593724;324;10974606;161;1786655;26312;26685
61322;Parfondeval;60;1578740;109596;39;1279260;21;299480;26312;26686
57228;Fossieux;78;2052519;116116;53;1745995;25;306524;26314;26687
67216;Huttenheim;1314;34578123;1487239;853;29063595;461;5514528;26315;26688
27568;Sainte-Marthe;247;6499895;263134;166;5414278;81;1085617;26315;26689
68036;Biesheim;1330;35000610;1762060;891;30004304;439;4996306;26316;26690
30352;Villevieille;917;24132620;1362670;510;19344197;407;4788423;26317;26691
59546;Saint-Sylvestre-Cappel;565;14869639;757364;337;12173715;228;2695924;26318;26692
41207;Saint-Dyé-sur-Loire;609;16027651;732644;386;13270439;223;2757212;26318;26693
71324;Moroges;309;8132306;389812;189;6606430;120;1525876;26318;26694
51283;Hans;89;2342377;116218;51;1858927;38;483450;26319;26695
63148;Ennezat;1260;33162986;1596715;784;27804509;476;5358477;26320;26696
02434;Lizy;132;3474401;137025;89;2937756;43;536645;26321;26697
10008;Argançon;63;1658339;132680;32;1321277;31;337062;26323;26698
55185;Èvres;48;1263504;43155;24;1035310;24;228194;26323;26699
76399;Lucy;91;2395408;74120;44;1816761;47;578647;26323;26700
47083;Doudrac;52;1368835;142380;27;1124763;25;244072;26324;26701
21300;Gissey-sur-Ouche;183;4817454;197495;122;4187013;61;630441;26325;26702
63457;Vic-le-Comte;2668;70236102;3213618;1694;58892647;974;11343455;26325;26703
67037;Biblisheim;188;4949181;209354;120;4062725;68;886456;26325;26704
38063;Burcin;224;5897084;248422;138;4896254;86;1000830;26326;26705
76117;Bordeaux-Saint-Clair;314;8266547;350616;198;6979787;116;1286760;26327;26706
22154;Morieux;474;12479144;556285;293;10429550;181;2049594;26327;26707
29247;Saint-Évarzec;1894;49864651;2270954;1198;41548128;696;8316523;26328;26708
51546;Somme-Suippe;203;5344984;159619;129;4398606;74;946378;26330;26709
21360;Lusigny-sur-Ouche;57;1500836;93337;35;1247026;22;253810;26330;26710
65369;Pouyastruc;346;9110389;390357;214;7552815;132;1557574;26331;26711
73038;Bellentre;535;14087063;833405;350;12051044;185;2036019;26331;26712
76001;Allouville-Bellefosse;579;15246576;720222;360;12696603;219;2549973;26333;26713
91552;Saint-Germain-lès-Arpajon;4861;128010431;6976067;3088;110810450;1773;17199981;26334;26714
74231;Saint-Eusèbe;246;6478243;249989;173;5457693;73;1020550;26334;26715
61264;Ménil-Froger;35;921706;62467;24;789015;11;132691;26334;26716
76271;Fontaine-le-Bourg;776;20435767;921943;503;17369074;273;3066693;26335;26717
21385;Marey-sur-Tille;165;4345305;184437;108;3729321;57;615984;26335;26718
39307;Maisod;175;4608841;223787;115;3858973;60;749868;26336;26719
29221;Porspoder;1092;28760143;1540243;637;23314763;455;5445380;26337;26720
80035;Aubercourt;38;1000827;54564;19;806449;19;194378;26338;26721
35350;Vergéal;350;9218450;444399;207;7179757;143;2038693;26338;26722
64228;Gabat;123;3239771;153363;56;2487931;67;751840;26340;26723
67141;Forstheim;314;8270952;361357;212;6900941;102;1370011;26341;26724
21204;Courcelles-lès-Montbard;54;1422406;90230;39;1292639;15;129767;26341;26725
09056;Bézac;171;4504315;216782;107;3775665;64;728650;26341;26726
18189;Quantilly;242;6374606;252209;157;5485379;85;889227;26341;26727
60212;Ercuis;761;20045970;1089148;502;17377943;259;2668027;26342;26728
67258;Landersheim;93;2449779;75947;58;1949129;35;500650;26342;26729
45236;Orveau-Bellesauve;199;5242212;217932;142;4561597;57;680615;26343;26730
41292;Villexanton;105;2765999;116718;75;2461903;30;304096;26343;26731
49028;Béhuard;70;1844110;97069;36;1489189;34;354921;26344;26732
31180;Falga;56;1475290;54000;27;1182326;29;292964;26344;26733
78168;Coignières;2325;61251888;3262732;1400;50352390;925;10899498;26345;26734
71253;Lans;439;11565570;446996;312;10068919;127;1496651;26345;26735
25608;Le Vernoy;78;2054980;48961;54;1751768;24;303212;26346;26736
38273;Nantes-en-Ratier;255;6718414;308710;169;5752351;86;966063;26347;26737
70182;Courmont;53;1396443;62177;32;1134454;21;261989;26348;26738
08122;Chooz;429;11303628;522649;270;9560752;159;1742876;26349;26739
2A035;Belvédère-Campomoro;106;2792985;234691;59;2348863;47;444122;26349;26740
72249;La Quinte;376;9907737;356150;256;8417759;120;1489978;26350;26741
50643;Virandeville;413;10883243;511836;262;9067884;151;1815359;26352;26742
21254;L'Étang-Vergy;119;3135865;174321;79;2695866;40;439999;26352;26743
27195;Dame-Marie;55;1449369;75467;32;1188863;23;260506;26352;26744
35231;Poligné;538;14177938;543821;364;12179647;174;1998291;26353;26745
56248;Surzur;1960;51652432;2161802;1223;42745948;737;8906484;26353;26746
86058;La Chapelle-Moulière;329;8670560;307096;215;7399901;114;1270659;26354;26747
22044;Coëtmieux;765;20161140;692186;491;16727085;274;3434055;26354;26748
55236;Haudainville;465;12254956;590463;295;10090708;170;2164248;26355;26749
14026;Audrieu;486;12809394;475063;317;10742395;169;2066999;26357;26750
01373;Saint-Martin-du-Frêne;558;14707888;607501;349;12119761;209;2588127;26358;26751
70054;Battrans;117;3083913;123278;85;2722656;32;361257;26358;26752
27223;Épreville-en-Roumois;221;5825214;262711;153;5075695;68;749519;26358;26753
02721;Sissy;263;6932322;378528;164;5786036;99;1146286;26359;26754
05161;La Salle-les-Alpes;583;15367360;950004;362;12615023;221;2752337;26359;26755
60190;Cuvergnon;160;4217481;214655;102;3587283;58;630198;26359;26756
60224;Étavigny;71;1871520;70016;41;1538904;30;332616;26359;26757
88054;Bertrimoutier;181;4771269;206724;122;4014302;59;756967;26361;26758
39210;Équevillon;311;8199294;388729;183;6502924;128;1696370;26364;26759
86198;Pouillé;302;7962021;249660;202;6726290;100;1235731;26364;26760
25100;Bulle;206;5431225;218992;128;4448547;78;982678;26365;26761
73158;Mognard;204;5378665;215873;131;4546282;73;832383;26366;26762
27608;Saint-Victor-de-Chrétienville;238;6275824;278445;156;5239812;82;1036012;26369;26763
18237;Sainte-Thorette;261;6882337;371222;173;5985580;88;896757;26369;26764
33229;Lanton;3936;103789495;6278033;2427;86960444;1509;16829051;26369;26765
26324;Saint-Paul-Trois-Châteaux;4713;124278542;6290185;2860;103602866;1853;20675676;26369;26766
64142;Bougarber;368;9703959;383264;245;8189043;123;1514916;26369;26767
83088;Néoules;1251;32988279;1817176;731;27561098;520;5427181;26370;26768
76467;Néville;609;16059720;963565;360;13415948;249;2643772;26371;26769
28320;Rouvray-Saint-Florentin;101;2663463;115223;64;2172947;37;490516;26371;26770
71343;Paris-l'Hôpital;140;3691952;208001;83;2976715;57;715237;26371;26771
60562;Sacy-le-Grand;780;20571070;1089575;514;17800381;266;2770689;26373;26772
27185;Crestot;210;5538388;246497;127;4522178;83;1016210;26373;26773
27100;Boulleville;504;13292157;594624;313;10962925;191;2329232;26373;26774
14365;Lion-sur-Mer;1408;37133742;1910276;896;31421383;512;5712359;26373;26775
16382;Torsac;419;11050477;586049;268;9588474;151;1462003;26373;26776
08320;La Neuville-en-Tourne-à-Fuy;265;6989181;283731;147;5397474;118;1591707;26374;26777
72073;Chaufour-Notre-Dame;523;13793953;533422;373;12025238;150;1768715;26375;26778
62876;Warlencourt-Eaucourt;67;1767149;82877;40;1473828;27;293321;26375;26779
29080;Hôpital-Camfrout;1124;29646060;1178138;731;24782339;393;4863721;26375;26780
76290;Frichemesnil;217;5723867;186516;151;4929291;66;794576;26377;26781
2A006;Alata;1812;47796140;2567032;1175;41246144;637;6549996;26378;26782
42211;Saint-Cyprien;1166;30756461;1505687;752;26183373;414;4573088;26378;26783
70121;Champey;458;12081321;471956;301;10155401;157;1925920;26378;26784
28230;Maisons;181;4774565;202484;126;4095012;55;679553;26379;26785
01129;Crans;133;3508408;166289;79;2955747;54;552661;26379;26786
55200;Fromeréville-les-Vallons;114;3007367;134401;68;2531773;46;475594;26380;26787
01151;Druillat;603;15907683;692060;395;13269581;208;2638102;26381;26788
30013;Argilliers;195;5144526;201698;125;4202929;70;941597;26382;26789
90006;Auxelles-Haut;171;4511361;267597;108;3810610;63;700751;26382;26790
33199;Gujan-Mestras;11761;310287196;17661609;7315;261631397;4446;48655799;26383;26791
73280;Saint-Sorlin-d'Arves;217;5725845;400973;140;4877704;77;848141;26386;26792
67093;Dieffenbach-lès-Woerth;182;4802431;262467;105;3819694;77;982737;26387;26793
32301;Ordan-Larroque;505;13325851;756465;281;11414561;224;1911290;26388;26794
32245;Maumusson-Laguian;83;2190241;123820;43;1741939;40;448302;26388;26795
35188;Montfort-sur-Meu;3292;86874573;4010907;2068;73615920;1224;13258653;26390;26796
85120;Landevieille;708;18684231;653540;414;15057629;294;3626602;26390;26797
62816;Tilloy-lès-Hermaville;100;2639140;78989;67;2227142;33;411998;26391;26798
64442;Parbayse;118;3114263;76976;81;2632980;37;481283;26392;26799
27460;Plainville;96;2533638;113903;66;2150810;30;382828;26392;26800
67400;Riedseltz;574;15149363;617995;369;12685272;205;2464091;26393;26801
64255;Halsou;288;7601153;366405;180;6502153;108;1099000;26393;26802
21622;Tart-le-Bas;124;3272770;155248;86;2852958;38;419812;26393;26803
14432;Missy;256;6756771;273717;152;5461430;104;1295341;26394;26804
59174;Dimechaux;167;4407792;224556;91;3581788;76;826004;26394;26805
67192;Herbsheim;481;12695807;606993;330;10854751;151;1841056;26395;26806
10028;Balnot-la-Grange;81;2138040;171822;46;1787105;35;350935;26396;26807
31534;Saussens;107;2824370;153216;71;2440025;36;384345;26396;26808
38282;Optevoz;383;10110688;400677;251;8323879;132;1786809;26399;26809
76468;Nointot;624;16472831;569822;407;13896945;217;2575886;26399;26810
80491;Longuevillette;39;1029567;39523;25;861403;14;168164;26399;26811
68137;Hindlingen;325;8579932;404895;193;7266919;132;1313013;26400;26812
45020;Le Bardon;532;14044793;622814;358;12023953;174;2020840;26400;26813
02131;Bucy-le-Long;996;26295191;1163462;651;22122115;345;4173076;26401;26814
69012;Les Ardillats;283;7471440;405941;172;6151833;111;1319607;26401;26815
42142;Merle-Leignec;164;4329846;183087;93;3581427;71;748419;26402;26816
63282;Plauzat;761;20091619;963044;495;16959179;266;3132440;26402;26817
28090;Les Châtelets;51;1346511;71455;31;1138991;20;207520;26402;26818
89013;Appoigny;1779;46970070;2775211;1151;39885050;628;7085020;26403;26819
90072;Morvillars;618;16316809;680521;378;13728239;240;2588570;26403;26820
60080;Boissy-le-Bois;106;2798823;176883;66;2312182;40;486641;26404;26821
14552;Ryes;252;6654139;257580;154;5503216;98;1150923;26405;26822
72086;Commerveil;71;1874801;73043;46;1570776;25;304025;26406;26823
28168;Gallardon;1864;49222199;2480783;1183;41304525;681;7917674;26407;26824
77449;Serris;4257;112418218;6829351;2940;98409394;1317;14008824;26408;26825
27320;La Haye-du-Theil;141;3723521;182934;94;3211948;47;511573;26408;26826
33063;Bordeaux;140591;3712736696;304597908;81084;3212815021;59507;499921675;26408;26827
55523;Vacherauville;84;2218292;105089;53;1859154;31;359138;26408;26828
17336;Saint-Georges-des-Coteaux;1375;36313713;1753891;879;30730867;496;5582846;26410;26829
38263;Morette;232;6127177;344799;144;5176700;88;950477;26410;26830
62207;Campigneulles-les-Petites;297;7844285;334747;191;6582554;106;1261731;26412;26831
68358;Wasserbourg;229;6048398;264784;150;5086846;79;961552;26412;26832
80085;Bernâtre;26;686720;45385;15;593319;11;93401;26412;26833
60207;Éméville;149;3935436;211920;92;3228233;57;707203;26412;26834
59425;Neuville-en-Avesnois;142;3750688;159906;79;2954497;63;796191;26413;26835
69173;Sarcey;499;13180905;556795;330;11240580;169;1940325;26415;26836
27406;Mesnil-sur-l'Estrée;520;13735664;666877;373;12257270;147;1478394;26415;26837
34004;Agel;141;3724486;106999;46;3057066;95;667420;26415;26838
45086;Châtillon-le-Roi;146;3856622;154730;110;3434389;36;422233;26415;26839
84147;Villelaure;1744;46068236;2293551;1024;37919671;720;8148565;26415;26840
80149;Buigny-Saint-Maclou;269;7105781;322797;180;6078517;89;1027264;26416;26841
14308;Goustranville;97;2562312;167131;59;2197179;38;365133;26416;26842
76153;Calleville-les-Deux-Églises;159;4200156;179369;91;3328719;68;871437;26416;26843
49069;Champtoceaux;1222;32280501;1529180;707;26104147;515;6176354;26416;26844
54073;Bicqueley;450;11887970;516853;303;9993427;147;1894543;26418;26845
27317;La Haye-Aubrée;221;5838353;210465;127;4554750;94;1283603;26418;26846
56036;Caudan;3659;96663075;4869695;2200;80859364;1459;15803711;26418;26847
42085;Doizieux;413;10910633;524187;249;8936669;164;1973964;26418;26848
69225;Saint-Marcel-l'Éclairé;268;7080072;283301;184;6078525;84;1001547;26418;26849
14028;Auquainville;157;4147768;197161;97;3456315;60;691453;26419;26850
27665;Trouville-la-Haule;414;10937600;465197;252;9135923;162;1801677;26419;26851
45118;Crottes-en-Pithiverais;170;4491414;221492;101;3630519;69;860895;26420;26852
10247;Montfey;72;1902294;96812;39;1545851;33;356443;26421;26853
27067;Bézu-Saint-Éloi;721;19049573;886022;484;16238122;237;2811451;26421;26854
35227;Pleumeleuc;1465;38707153;1356155;1011;32935125;454;5772028;26421;26855
42286;Saint-Romain-les-Atheux;445;11758074;422224;293;9887482;152;1870592;26423;26856
89078;Champvallon;346;9142406;393443;239;7947146;107;1195260;26423;26857
38500;Têche;303;8006213;302509;190;6570378;113;1435835;26423;26858
67060;Bourgheim;295;7794865;343815;193;6621131;102;1173734;26423;26859
14338;Houlgate;1385;36598478;2571153;828;30395021;557;6203457;26425;26860
73322;Villarodin-Bourget;272;7187575;298376;186;6218828;86;968747;26425;26861
21609;Soirans;214;5655084;257822;152;4959386;62;695698;26426;26862
28045;Boissy-en-Drouais;134;3541174;217021;85;3020807;49;520367;26427;26863
14049;Bazenville;74;1955575;93177;52;1684507;22;271068;26427;26864
02443;Lucy-le-Bocage;104;2748393;148646;71;2371465;33;376928;26427;26865
14403;Marolles;397;10491651;472569;245;8745507;152;1746144;26427;26866
77256;Lizines;96;2537171;140609;66;2318763;30;218408;26429;26867
70361;Montessaux;82;2167203;74799;54;1769122;28;398081;26429;26868
03212;Quinssaines;744;19664417;865666;493;16635608;251;3028809;26431;26869
62847;Verquigneul;851;22493355;1066006;512;18599280;339;3894075;26432;26870
40290;Sarron;61;1612353;54601;24;1254501;37;357852;26432;26871
39220;Falletans;197;5207439;228880;134;4478092;63;729347;26434;26872
89187;Gigny;56;1480334;82183;34;1245124;22;235210;26435;26873
61483;Bagnoles-de-l'Orne;1587;41952200;2331921;851;34021843;736;7930357;26435;26874
59575;Sommaing;194;5128378;212313;123;4312848;71;815530;26435;26875
38047;Blandin;75;1982657;110282;46;1696285;29;286372;26435;26876
62441;Hermin;105;2775748;125904;64;2308157;41;467591;26436;26877
77310;Montigny-le-Guesdier;163;4309066;192213;111;3711384;52;597682;26436;26878
25267;Gennes;311;8221606;356141;201;6918173;110;1303433;26436;26879
31486;Saint-Hilaire;517;13667484;549568;336;11482829;181;2184655;26436;26880
39238;Frasne-les-Meulières;61;1612620;48621;40;1311892;21;300728;26436;26881
79137;Granzay-Gript;466;12319392;520727;327;10762806;139;1556586;26436;26882
68050;Bréchaumont;227;6001119;343494;130;4937362;97;1063757;26437;26883
69078;Duerne;373;9861615;371159;226;7877583;147;1984032;26439;26884
77045;Bougligny;383;10126259;530365;252;8734642;131;1391617;26439;26885
86060;Charrais;482;12743802;458601;323;10738382;159;2005420;26439;26886
89275;Neuilly;229;6054789;295414;143;5040410;86;1014379;26440;26887
73190;Notre-Dame-du-Pré;176;4653741;191233;107;3940736;69;713005;26442;26888
55123;Les Hauts-de-Chée;409;10814888;896446;246;8880173;163;1934715;26442;26889
57655;Solgne;526;13908669;569668;336;11818771;190;2089898;26442;26890
67534;Wilwisheim;355;9387374;389352;230;8040620;125;1346754;26443;26891
81131;Lagrave;965;25517792;1268675;568;20883403;397;4634389;26443;26892
54572;Ville-Houdlémont;332;8779379;203375;154;5372570;178;3406809;26444;26893
76228;Ectot-lès-Baons;198;5235917;294266;112;4265021;86;970896;26444;26894
77210;La Grande-Paroisse;1439;38053523;1979415;940;32614704;499;5438819;26444;26895
69142;La Mulatière;3729;98613187;7445881;2332;84629648;1397;13983539;26445;26896
68114;Guevenatten;80;2115625;106827;61;1915350;19;200275;26445;26897
73266;Saint-Oyen;123;3252880;155001;83;2761136;40;491744;26446;26898
63325;Saint-Bonnet-lès-Allier;200;5289287;216977;138;4437844;62;851443;26446;26899
33534;Le Tourne;427;11292934;714698;245;9464966;182;1827968;26447;26900
10357;Saint-Parres-aux-Tertres;1557;41179342;2015591;965;34486157;592;6693185;26448;26901
45064;Cernoy-en-Berry;255;6744529;549842;135;5439139;120;1305390;26449;26902
02607;Ploisy;41;1084422;77829;23;917080;18;167342;26449;26903
45262;Rouvray-Sainte-Croix;75;1983710;85314;48;1642403;27;341307;26449;26904
40213;Orx;309;8173216;466526;194;6980893;115;1192323;26451;26905
45260;Ramoulu;140;3703141;200208;100;3287500;40;415641;26451;26906
08207;Ham-sur-Meuse;123;3253620;117441;76;2718568;47;535052;26452;26907
45280;Saint-Gondon;587;15527521;760194;398;13286323;189;2241198;26452;26908
89437;Venouse;166;4391140;184706;111;3744503;55;646637;26453;26909
42221;Sainte-Foy-Saint-Sulpice;233;6163691;267358;122;4848628;111;1315063;26454;26910
39283;Lavancia-Epercy;321;8491762;351701;211;7097177;110;1394585;26454;26911
62819;Tilques;558;14761431;699861;325;12072839;233;2688592;26454;26912
32349;Roquelaure-Saint-Aubin;52;1375629;32842;31;1119645;21;255984;26454;26913
39177;Crançot;309;8174441;330433;197;6923625;112;1250816;26455;26914
07231;Saint-Étienne-de-Fontbellon;1419;37542548;2403011;794;30446105;625;7096443;26457;26915
33452;Saint-Michel-de-Rieufret;302;7990958;320724;201;6874336;101;1116622;26460;26916
01193;Izieu;115;3042916;176855;70;2414954;45;627962;26460;26917
89039;Béru;51;1349477;113034;33;1168499;18;180978;26460;26918
39397;Orgelet;938;24819910;1304447;478;19243085;460;5576825;26460;26919
38099;Chevrières;359;9499348;539124;201;7588286;158;1911062;26461;26920
35243;Romagné;1064;28154113;923320;666;23067454;398;5086659;26461;26921
55368;Naives-en-Blois;70;1852251;81759;35;1358379;35;493872;26461;26922
77113;Chevru;497;13151086;625716;310;10873925;187;2277161;26461;26923
02785;Vermand;566;14977139;803527;326;12152376;240;2824763;26461;26924
59578;Steenbecque;845;22360199;890350;457;18022155;388;4338044;26462;26925
27599;Saint-Pierre-la-Garenne;525;13892644;820241;354;12292731;171;1599913;26462;26926
32201;Lasseube-Propre;174;4604745;207783;117;3966272;57;638473;26464;26927
74155;Lullin;444;11750099;403130;260;9070741;184;2679358;26464;26928
63284;Pont-du-Château;5682;150370181;7263951;3561;126157523;2121;24212658;26464;26929
56255;Treffléan;979;25909152;1124370;633;21837378;346;4071774;26465;26930
72239;Poillé-sur-Vègre;306;8098548;235294;171;6366462;135;1732086;26466;26931
63427;Teilhède;242;6405005;481769;158;5493657;84;911348;26467;26932
68107;Gommersdorf;197;5214018;258192;138;4525124;59;688894;26467;26933
72200;Moncé-en-Belin;1668;44148882;1554144;1154;37992809;514;6156073;26468;26934
71556;Varennes-lès-Mâcon;291;7702453;414808;190;6504691;101;1197762;26469;26935
71588;Vitry-en-Charollais;550;14557953;553038;368;12324892;182;2233061;26469;26936
88441;Sans-Vallois;57;1508754;55516;35;1213726;22;295028;26469;26937
34327;Vendargues;3255;86158309;4463827;1949;71414733;1306;14743576;26470;26938
54588;Vitrimont;193;5109066;195610;124;4210436;69;898630;26472;26939
54020;Anthelupt;251;6644739;352150;163;5588204;88;1056535;26473;26940
67125;Epfig;1190;31503465;1437278;769;26452408;421;5051057;26474;26941
35131;L'Hermitage;1975;52285222;2236525;1321;44746184;654;7539038;26474;26942
91377;Massy;24847;657797783;40881994;16250;570817859;8597;86979924;26474;26943
67305;Mothern;1097;29042112;1671582;675;23934585;422;5107527;26474;26944
86113;Iteuil;1518;40188052;1787674;978;34364396;540;5823656;26474;26945
67423;Saessolsheim;266;7042293;319168;165;5833631;101;1208662;26475;26946
70151;Chevigney;26;688346;64700;13;546488;13;141858;26475;26947
61505;Villedieu-lès-Bailleul;110;2912309;144263;69;2534356;41;377953;26476;26948
95154;Chennevières-lès-Louvres;155;4103720;162624;111;3488264;44;615456;26476;26949
72381;Voivres-lès-le-Mans;583;15435517;573796;394;13224401;189;2211116;26476;26950
30047;Bouillargues;3258;86263817;4354663;2006;71923682;1252;14340135;26478;26951
36231;Velles;520;13768432;703931;299;11445592;221;2322840;26478;26952
60501;Le Plessis-Brion;779;20627238;1076170;526;17508122;253;3119116;26479;26953
77192;Fontenay-Trésigny;2739;72527976;3715323;1874;62870481;865;9657495;26480;26954
14159;Chouain;109;2886307;86845;68;2256747;41;629560;26480;26955
25109;Cessey;165;4369199;160924;118;3742997;47;626202;26480;26956
30019;Aubais;1341;35510671;1951616;778;29766913;563;5743758;26481;26957
71111;Chassy;178;4713581;247826;107;3919983;71;793598;26481;26958
18040;Bussy;199;5269767;434385;118;4511021;81;758746;26481;26959
16075;Champagne-Vigny;128;3389686;285906;76;2823965;52;565721;26482;26960
57388;Launstroff;122;3230878;8089;38;1279320;84;1951558;26483;26961
28203;Landelles;290;7680195;337299;201;6567554;89;1112641;26483;26962
30256;Saint-Gervais;400;10593569;655496;241;8827187;159;1766382;26484;26963
57118;Budling;88;2330680;58629;47;1536731;41;793949;26485;26964
76669;Sausseuzemare-en-Caux;203;5376713;179957;129;4525303;74;851410;26486;26965
76324;Grèges;404;10700686;462747;261;8985659;143;1715027;26487;26966
63071;Ceyssat;336;8899627;477136;189;7273332;147;1626295;26487;26967
01426;Treffort-Cuisiat;1178;31201969;1612898;741;25982937;437;5219032;26487;26968
47040;Brax;1049;27785967;1276249;667;23461810;382;4324157;26488;26969
67279;Maennolsheim;110;2913730;117577;74;2505701;36;408029;26488;26970
33325;Plassac;510;13509267;764257;285;11026269;225;2482998;26489;26971
71369;Remigny;221;5854299;242193;140;4820226;81;1034073;26490;26972
10283;Pel-et-Der;78;2066282;124167;56;1871658;22;194624;26491;26973
41220;Saint-Laurent-Nouan;2323;61538139;2755621;1506;52270157;817;9267982;26491;26974
01429;Vandeins;299;7920775;299453;206;6770162;93;1150613;26491;26975
44041;La Chevrolière;2623;69486625;2631621;1696;58378488;927;11108137;26491;26976
50242;Herqueville;73;1933873;74281;48;1578910;25;354963;26491;26977
67303;Morsbronn-les-Bains;325;8610025;367406;211;7259208;114;1350817;26492;26978
67481;Stotzheim;534;14147307;600327;339;11750748;195;2396559;26493;26979
43140;Le Monteil;319;8451459;375952;216;7119890;103;1331569;26494;26980
24139;Coursac;947;25089897;1130780;614;21180971;333;3908926;26494;26981
90023;Chaux;546;14465895;838117;351;12740554;195;1725341;26494;26982
62717;Roëllecourt;294;7789340;440972;168;6373645;126;1415695;26494;26983
04200;Salignac;324;8584437;494026;194;7126898;130;1457539;26495;26984
80242;Domart-sur-la-Luce;235;6226368;257311;166;5359446;69;866922;26495;26985
40137;Lacquy;135;3576894;375151;73;2848483;62;728411;26496;26986
30315;Saze;1047;27741045;1502559;630;23302667;417;4438378;26496;26987
95252;Franconville;18593;492681036;30328232;12714;432789142;5879;59891894;26498;26988
25632;Voujeaucourt;1839;48730540;2516134;1177;41210180;662;7520360;26498;26989
60102;Brenouille;1081;28646138;1255891;768;25183408;313;3462730;26500;26990
02230;Couvrelles;108;2862025;161164;63;2458917;45;403108;26500;26991
27515;Saint-Aubin-le-Guichard;163;4319695;259069;104;3702576;59;617119;26501;26992
41252;Suèvres;847;22446735;1011697;563;19004635;284;3442100;26501;26993
07302;Saint-Vincent-de-Barrès;406;10759688;456301;261;8906856;145;1852832;26502;26994
76689;Thiétreville;194;5141417;353227;112;4100211;82;1041206;26502;26995
31050;Beauchalot;277;7341390;611549;135;5932157;142;1409233;26503;26996
67412;Rossfeld;438;11608439;340017;283;9619209;155;1989230;26503;26997
51528;Scrupt;63;1669715;68357;37;1293915;26;375800;26503;26998
89449;Villeblevin;927;24569785;1249325;601;20640986;326;3928799;26505;26999
28147;Favières;286;7580494;338342;196;6542561;90;1037933;26505;27000
10276;Paisy-Cosdon;177;4691457;238179;110;3835857;67;855600;26505;27001
62751;Saint-Inglevert;328;8693850;390241;192;7013447;136;1680403;26506;27002
66020;Bolquère;491;13014545;745391;313;11237474;178;1777071;26506;27003
58126;Gimouille;224;5937432;395085;134;4967790;90;969642;26506;27004
14248;Espins;118;3127825;176390;71;2472309;47;655516;26507;27005
63035;Beauregard-Vendon;558;14791084;636647;364;12587538;194;2203546;26507;27006
01375;Saint-Martin-le-Châtel;376;9966973;370597;247;8319852;129;1647121;26508;27007
30073;Castillon-du-Gard;786;20836163;1071235;446;17086348;340;3749815;26509;27008
67525;Westhoffen;892;23646650;1183077;572;19729502;320;3917148;26510;27009
62314;Estrée-Cauchy;186;4930815;197886;108;4106747;78;824068;26510;27010
67069;Buhl;266;7051596;368447;167;5851259;99;1200337;26510;27011
01366;Sainte-Julie;438;11611556;450383;304;10071576;134;1539980;26510;27012
39133;Chaux-Champagny;33;874897;30253;15;670896;18;204001;26512;27013
89108;Chitry;188;4984301;226864;116;4156884;72;827417;26512;27014
58070;Chazeuil;36;954448;76527;19;803687;17;150761;26512;27015
26038;Beaumont-Monteux;590;15643398;789148;361;13058781;229;2584617;26514;27016
76395;Longueil;311;8246189;504655;174;6770688;137;1475501;26515;27017
85178;Le Poiré-sur-Vie;3931;104232009;3906273;2450;86173899;1481;18058110;26515;27018
90063;Lebetain;263;6973691;365827;199;6157935;64;815756;26516;27019
51134;Châtelraould-Saint-Louvent;131;3474172;214326;85;2942227;46;531945;26520;27020
89033;Beauvoir;196;5198133;300225;137;4464282;59;733851;26521;27021
65057;Azereix;545;14454103;816045;340;12163785;205;2290318;26521;27022
73086;Cléry;217;5755601;254786;145;4875926;72;879675;26524;27023
35068;Châteaubourg;3149;83524150;3139158;2063;70443083;1086;13081067;26524;27024
68329;Stosswihr;742;19680851;987664;472;16391997;270;3288854;26524;27025
02355;Gricourt;474;12572853;548604;308;10808427;166;1764426;26525;27026
77110;Chenou;173;4588895;244766;121;4001181;52;587714;26525;27027
57612;Saint-Hubert;127;3368983;240677;78;2753640;49;615343;26527;27028
27263;Fourmetot;341;9045925;472797;211;7342941;130;1702984;26528;27029
60531;Remy;923;24486554;1251150;603;20885985;320;3600569;26529;27030
89383;Sementron;63;1671406;122610;40;1439318;23;232088;26530;27031
55221;Guerpont;139;3687728;179970;93;3140607;46;547121;26530;27032
32389;Saint-Martin;244;6473433;359017;145;5367619;99;1105814;26530;27033
77108;Chelles;29069;771216140;46985381;18988;671784425;10081;99431715;26531;27034
32234;Marestaing;128;3395976;105530;83;2807926;45;588050;26531;27035
76646;Saint-Riquier-ès-Plains;292;7747129;335912;183;6524067;109;1223062;26531;27036
38074;Chantesse;175;4642997;173613;97;3203451;78;1439546;26531;27037
72129;Fatines;347;9206714;336285;235;7766154;112;1440560;26532;27038
48087;Malbouzon;84;2228754;153723;29;1743903;55;484851;26533;27039
45331;Vannes-sur-Cosson;324;8596818;500568;186;6963644;138;1633174;26533;27040
41094;Fresnes;593;15734575;722805;376;13109332;217;2625243;26534;27041
19229;Saint-Pantaléon-de-Larche;2553;67741479;3071873;1655;56763566;898;10977913;26534;27042
59320;Illies;699;18547427;1119537;397;15055262;302;3492165;26534;27043
45059;Bucy-Saint-Liphard;117;3104513;179674;82;2734039;35;370474;26534;27044
21619;Tanay;114;3024942;118776;79;2637481;35;387461;26535;27045
65245;Lagrange;126;3343441;151598;85;2655132;41;688309;26535;27046
60459;La Neuville-sur-Ressons;116;3078101;142806;86;2721911;30;356190;26535;27047
71416;Saint-Gengoux-de-Scissé;335;8889446;457256;217;7408894;118;1480552;26536;27048
61030;La Bazoque;118;3131438;117407;85;2667651;33;463787;26538;27049
10365;Salon;88;2335318;157599;48;1883025;40;452293;26538;27050
24179;La Feuillade;371;9845604;428445;245;8293316;126;1552288;26538;27051
55543;Velaines;498;13216594;588878;354;11527035;144;1689559;26539;27052
25366;Mancenans-Lizerne;88;2335541;83806;53;1947503;35;388038;26540;27053
27687;Vieux-Villez;100;2654081;125316;72;2329133;28;324948;26541;27054
45058;Bucy-le-Roi;93;2468315;135936;67;2118330;26;349985;26541;27055
02667;Saconin-et-Breuil;116;3078779;147778;76;2609652;40;469127;26541;27056
27034;Bacqueville;277;7351958;268076;174;6074162;103;1277796;26541;27057
26049;Bésayes;626;16614984;794937;355;13484460;271;3130524;26542;27058
27199;Dangu;319;8466935;344200;210;7224225;109;1242710;26542;27059
26377;Vinsobres;664;17624044;1123244;360;14500350;304;3123694;26542;27060
77432;Saint-Rémy-la-Vanne;505;13403850;720168;354;11820592;151;1583258;26542;27061
67106;Drusenheim;2663;70682900;3671753;1733;60182871;930;10500029;26543;27062
62782;Saudemont;219;5812830;289556;131;4763705;88;1049125;26543;27063
02697;Samoussy;188;4990043;200454;131;4292537;57;697506;26543;27064
86209;Roches-Prémarie-Andillé;989;26250892;1195864;663;22431442;326;3819450;26543;27065
76011;Ancretteville-sur-Mer;91;2415421;168195;53;2050658;38;364763;26543;27066
38507;Tignieu-Jameyzieu;3091;82045735;3345280;1962;67873930;1129;14171805;26543;27067
02071;Berny-Rivière;342;9077941;423689;207;7498039;135;1579902;26544;27068
90014;Boron;207;5494709;238738;132;4590621;75;904088;26544;27069
45242;Ouzouer-des-Champs;136;3610111;198737;83;2883600;53;726511;26545;27070
83085;La Motte;1654;43908621;2794475;958;36193309;696;7715312;26547;27071
73250;Saint-Julien-Mont-Denis;961;25512318;1408625;652;21799690;309;3712628;26548;27072
28213;Lormaye;383;10168084;619175;265;8910073;118;1258011;26549;27073
61348;Réveillon;191;5070938;189798;111;4189865;80;881073;26549;27074
08481;Villers-sur-Bar;131;3478031;176150;87;2987827;44;490204;26550;27075
80670;Revelles;287;7620061;338980;200;6567744;87;1052317;26551;27076
34037;Boujan-sur-Libron;1787;47446404;3080216;1001;38854428;786;8591976;26551;27077
38381;Saint-Didier-de-la-Tour;938;24906425;1146218;588;20593522;350;4312903;26553;27078
62255;Crémarest;372;9877704;476708;225;8220103;147;1657601;26553;27079
59524;Sainghin-en-Weppes;2855;75809900;3587039;1781;63333283;1074;12476617;26553;27080
42199;Saint-André-d'Apchon;989;26261675;1076933;647;22139212;342;4122463;26554;27081
72091;Contilly;77;2045015;54765;46;1667348;31;377667;26559;27082
67461;Schwobsheim;141;3744786;134260;92;3216002;49;528784;26559;27083
58176;Montigny-aux-Amognes;300;7967897;408858;206;7072648;94;895249;26560;27084
01229;Malafretaz;514;13651759;596796;340;11602167;174;2049592;26560;27085
41213;Saint-Gourgon;57;1513965;104845;37;1282291;20;231674;26561;27086
30245;Saint-Côme-et-Maruéjols;393;10438567;436604;243;8551156;150;1887411;26561;27087
02085;Bézu-Saint-Germain;439;11660759;481124;281;9636375;158;2024384;26562;27088
28067;Cernay;41;1089060;50603;28;971800;13;117260;26562;27089
60279;Gondreville;126;3346870;190861;95;2943902;31;402968;26562;27090
77259;Longperrier;1236;32831258;1894050;904;29379531;332;3451727;26563;27091
71479;Saint-Sernin-du-Bois;985;26164135;1330793;643;22108500;342;4055635;26563;27092
38438;Saint-Paul-lès-Monestier;142;3771901;256620;84;3236679;58;535222;26563;27093
60137;Cernoy;117;3107903;113932;74;2563652;43;544251;26563;27094
57260;Grosbliederstroff;1907;50656703;3234453;1166;42247581;741;8409122;26564;27095
14583;Saint-Germain-de-Montgommery;85;2257999;138851;50;1888975;35;369024;26565;27096
08377;Saint-Aignan;80;2125244;104152;54;1801958;26;323286;26566;27097
63269;Parent;431;11449819;524282;266;9615109;165;1834710;26566;27098
80611;Oresmaux;443;11768630;565164;288;10072060;155;1696570;26566;27099
71167;Damerey;272;7226217;303334;168;5883847;104;1342370;26567;27100
08191;Givonne;547;14532215;669848;340;12172895;207;2359320;26567;27101
01122;Cormaranche-en-Bugey;426;11317765;562975;287;9790492;139;1527273;26568;27102
52031;Autreville-sur-la-Renne;280;7439153;397687;180;6310607;100;1128546;26568;27103
59097;Boursies;160;4250988;255931;81;3461565;79;789423;26569;27104
86049;Chalais;284;7545521;592788;157;6315432;127;1230089;26569;27105
35033;Bourg-des-Comptes;1463;38872732;1575381;942;32546496;521;6326236;26571;27106
70513;Vaivre-et-Montoille;1289;34253466;1893651;819;28651657;470;5601809;26574;27107
18227;Sainte-Montaine;111;2949684;200489;59;2400031;52;549653;26574;27108
27222;Épreville-en-Lieuvin;111;2949906;141277;74;2605634;37;344272;26576;27109
59199;Erchin;389;10337989;473963;235;8788868;154;1549121;26576;27110
46149;Lamagdelaine;422;11215227;613407;248;9063864;174;2151363;26576;27111
41168;Orçay;128;3401777;175067;85;2910130;43;491647;26576;27112
49264;Saint-André-de-la-Marche;1382;36728620;1037715;868;30206487;514;6522133;26576;27113
61202;Hauterive;244;6484655;322323;153;5249854;91;1234801;26576;27114
10121;Dampierre;167;4438269;255034;88;3469486;79;968783;26576;27115
62619;Noreuil;63;1674318;57440;35;1331308;28;343010;26576;27116
02483;Mézières-sur-Oise;274;7281957;360728;176;5982077;98;1299880;26576;27117
54262;Hoéville;85;2259094;88780;52;1931820;33;327274;26578;27118
80812;Vraignes-en-Vermandois;88;2338958;177590;47;1783839;41;555119;26579;27119
57211;Fèves;456;12120075;498458;264;9614355;192;2505720;26579;27120
89306;Pontaubert;210;5581717;303609;132;4752013;78;829704;26580;27121
82044;Corbarieu;873;23204783;1111378;509;19140649;364;4064134;26581;27122
68102;Geishouse;251;6672333;278291;165;5557827;86;1114506;26583;27123
27682;Vesly;338;8985721;403827;223;7703778;115;1281943;26585;27124
73189;Notre-Dame-du-Cruet;118;3137087;160727;80;2701900;38;435187;26585;27125
88053;Belval;77;2047165;118707;41;1665178;36;381987;26587;27126
31002;Aignes;139;3695563;299617;71;2985248;68;710315;26587;27127
27098;Bouchevilliers;36;957141;26714;21;755438;15;201703;26587;27128
77465;Thoury-Férottes;358;9518535;490032;234;8153723;124;1364812;26588;27129
35021;Beaucé;652;17335444;737415;417;14604020;235;2731424;26588;27130
28334;Saint-Denis-les-Ponts;952;25312088;1293530;617;21144989;335;4167099;26588;27131
84086;Oppède;804;21377150;1669387;427;17740479;377;3636671;26588;27132
10368;Savières;525;13959276;554772;332;11794479;193;2164797;26589;27133
64286;Laà-Mondrans;215;5716840;259236;127;4561558;88;1155282;26590;27134
57117;Buding;291;7737762;172336;156;5351141;135;2386621;26590;27135
02744;Torcy-en-Valois;41;1090232;59502;21;779882;20;310350;26591;27136
81133;Lamillarié;241;6408651;464710;147;5519687;94;888964;26592;27137
50519;Saint-Martin-le-Gréard;216;5744213;182538;154;4937379;62;806834;26594;27138
28394;Tréon;693;18429368;946838;469;15916294;224;2513074;26594;27139
01215;Lhôpital;29;771255;9996;14;414734;15;356521;26595;27140
2B010;Algajola;217;5771161;519181;122;4868691;95;902470;26595;27141
02123;Brissay-Choigny;193;5132903;368424;91;3889371;102;1243532;26595;27142
71162;Curgy;558;14840264;627153;380;12549906;178;2290358;26595;27143
54062;Benney;336;8936302;477048;234;7845308;102;1090994;26596;27144
01431;Vaux-en-Bugey;630;16755666;740506;418;14264026;212;2491640;26596;27145
41128;Marolles;366;9734345;358352;251;8055376;115;1678969;26597;27146
04118;Melve;64;1702198;121654;28;1376521;36;325677;26597;27147
47237;Sainte-Colombe-de-Villeneuve;245;6516285;406793;140;5393661;105;1122624;26597;27148
61224;Larré;213;5665202;224626;137;4623895;76;1041307;26597;27149
57222;Folkling;718;19096893;839604;463;15880169;255;3216724;26597;27150
97205;Case-Pilote;2484;66068317;3666965;1118;51152717;1366;14915600;26598;27151
33397;Sainte-Eulalie;2256;60005643;3163561;1405;50912681;851;9092962;26598;27152
83093;Plan-d'Aups-Sainte-Baume;900;23938597;1051922;554;20026520;346;3912077;26598;27153
41003;Areines;306;8139653;387427;216;7098698;90;1040955;26600;27154
27120;Burey;184;4894513;264116;123;4127942;61;766571;26601;27155
44039;Cheix-en-Retz;403;10720403;363127;258;8931331;145;1789072;26601;27156
02571;Omissy;336;8938121;407210;234;7923565;102;1014556;26602;27157
77345;Orly-sur-Morin;354;9417113;464302;229;8044091;125;1373022;26602;27158
27175;Corny;182;4841604;287860;113;4056416;69;785188;26602;27159
02023;Armentières-sur-Ourcq;56;1489791;77317;33;1168428;23;321363;26603;27160
50385;Omonville-la-Petite;82;2181511;76022;46;1755105;36;426406;26604;27161
90044;Felon;128;3405330;141371;84;2920087;44;485243;26604;27162
69234;Saint-Romain-de-Popey;776;20645718;1022359;498;17402899;278;3242819;26605;27163
28026;Baudreville;151;4017414;282215;93;3347124;58;670290;26605;27164
84081;Morières-lès-Avignon;4405;117202807;6348596;2838;98960193;1567;18242614;26607;27165
10110;Courteranges;251;6678399;245107;160;5564010;91;1114389;26607;27166
27145;Chanteloup;43;1144111;59002;30;986342;13;157769;26607;27167
70535;Velleguindry-et-Levrecey;77;2048793;99210;50;1703122;27;345671;26608;27168
27333;Heudicourt;310;8248608;471254;193;6908595;117;1340013;26608;27169
45263;Rouvres-Saint-Jean;142;3778403;177701;102;3365186;40;413217;26608;27170
84127;Sérignan-du-Comtat;1402;37305363;1820603;883;31444582;519;5860781;26609;27171
14601;Saint-Julien-sur-Calonne;104;2767350;214457;65;2267910;39;499440;26609;27172
14328;Hérouvillette;617;16417906;771744;430;14332434;187;2085472;26609;27173
08125;Cliron;158;4204298;150510;106;3385691;52;818607;26609;27174
33145;Cursan;296;7876415;283798;192;6614416;104;1261999;26610;27175
38492;Sinard;331;8808038;436165;210;7495182;121;1312856;26610;27176
21396;Mauvilly;40;1064426;85701;23;871977;17;192449;26611;27177
88532;Zincourt;45;1197583;50679;27;1031816;18;165767;26613;27178
93032;Gagny;21154;562972256;34241936;13575;486524127;7579;76448129;26613;27179
29137;Logonna-Daoulas;1096;29168454;1125022;712;24226394;384;4942060;26614;27180
10306;Proverville;151;4018811;269997;94;3320387;57;698424;26615;27181
45267;Saint-Aignan-des-Gués;163;4338250;146273;91;3444658;72;893592;26615;27182
54414;Pagney-derrière-Barine;288;7665322;293150;168;6320271;120;1345051;26616;27183
62849;Verton;1217;32392270;1802744;773;27610233;444;4782037;26616;27184
67480;Still;915;24354513;955428;591;20873009;324;3481504;26617;27185
64095;Barinque;289;7692583;279407;180;6500561;109;1192022;26618;27186
10351;Saint-Martin-de-Bossenay;200;5323909;284303;121;4407438;79;916471;26620;27187
31421;Pins-Justaret;2347;62478123;3004672;1551;53774910;796;8703213;26620;27188
28021;Bailleau-le-Pin;762;20284770;879569;512;17169065;250;3115705;26620;27189
10308;Prunay-Belleville;121;3221093;181474;81;2772946;40;448147;26621;27190
62148;Bois-Bernard;476;12671544;711196;299;10703218;177;1968326;26621;27191
49184;Louvaines;248;6601982;182785;150;5296598;98;1305384;26621;27192
60644;Trie-Château;823;21909298;1095358;516;18321245;307;3588053;26621;27193
38026;La Balme-les-Grottes;476;12671752;550052;323;10797803;153;1873949;26621;27194
80224;Cressy-Omencourt;66;1757012;102043;42;1487582;24;269430;26621;27195
82070;Glatens;33;878559;31099;22;714976;11;163583;26623;27196
60006;Les Ageux;598;15921647;847587;386;13452012;212;2469635;26625;27197
2B361;Zilia;178;4739231;937787;66;3757545;112;981686;26625;27198
11357;Saint-Martin-le-Vieil;119;3168368;122399;59;2353727;60;814641;26625;27199
51484;Saint-Gilles;131;3487873;161462;82;2949855;49;538018;26625;27200
10250;Montier-en-l'Isle;122;3248366;177539;77;2702678;45;545688;26626;27201
12001;Agen-d'Aveyron;552;14698223;624194;349;12336590;203;2361633;26627;27202
13115;Vernègues;722;19224864;857512;465;16380089;257;2844775;26627;27203
67489;Thal-Marmoutier;427;11369941;575865;283;9722759;144;1647182;26627;27204
67476;Stattmatten;370;9852273;477973;232;8163990;138;1688283;26628;27205
31573;Verfeil;1763;46945037;2283017;1128;39981162;635;6963875;26628;27206
61246;Mâle;361;9612769;468201;245;8239944;116;1372825;26628;27207
41147;Les Montils;972;25883210;985532;639;21994467;333;3888743;26629;27208
38098;Chélieu;317;8441506;364751;204;7200887;113;1240619;26629;27209
51084;Bréban;48;1278224;68394;31;1095141;17;183083;26630;27210
64300;Lacq;370;9853256;404270;229;7833407;141;2019849;26630;27211
79004;Aigonnay;321;8548434;375277;218;7269194;103;1279240;26631;27212
02207;Commenchon;102;2716337;141222;66;2356160;36;360177;26631;27213
01413;Surjoux;50;1331548;29564;29;977671;21;353877;26631;27214
07197;Roiffieux;1438;38300391;1913716;912;31957678;526;6342713;26634;27215
81104;Giroussens;762;20295817;1037684;448;16718868;314;3576949;26635;27216
57485;Morville-lès-Vic;71;1891085;152725;40;1439309;31;451776;26635;27217
42305;La Talaudière;3463;92237812;4673067;2111;76365118;1352;15872694;26635;27218
79125;Fors;905;24106009;1099912;617;20771030;288;3334979;26636;27219
10263;Neuville-sur-Vanne;205;5460670;269675;127;4629047;78;831623;26637;27220
14401;Manvieux;71;1891269;102446;37;1484955;34;406314;26638;27221
77230;Ichy;93;2477343;130871;66;2192799;27;284544;26638;27222
70203;La Demie;69;1838170;77153;48;1588088;21;250082;26640;27223
48013;Badaroux;508;13533278;615090;341;11503325;167;2029953;26640;27224
49377;Villevêque;1423;37910154;1488957;893;31780795;530;6129359;26641;27225
02605;Pleine-Selve;97;2584230;129048;57;2068356;40;515874;26642;27226
60147;Chevincourt;454;12095456;568797;318;10516690;136;1578766;26642;27227
77077;Chambry;504;13428209;650320;377;12075841;127;1352368;26643;27228
11218;Marquein;40;1065747;58373;22;877125;18;188622;26644;27229
69008;Ancy;306;8153078;241501;192;6851984;114;1301094;26644;27230
67449;Schirrhein;1176;31334147;1423275;794;26713107;382;4621040;26645;27231
19082;Favars;552;14708153;836400;375;12455855;177;2252298;26645;27232
41245;Séris;190;5062704;203882;116;4130119;74;932585;26646;27233
45316;Sury-aux-Bois;421;11218480;509950;265;9320153;156;1898327;26647;27234
63372;Saint-Laure;295;7861222;340838;194;6662593;101;1198629;26648;27235
27634;Thomer-la-Sôgne;180;4796717;269401;120;4154615;60;642102;26648;27236
21064;Benoisey;49;1305774;64137;31;1078003;18;227771;26648;27237
67264;Leutenheim;470;12524803;672996;302;10533970;168;1990833;26649;27238
32336;Puylausic;101;2691535;165528;45;2165040;56;526495;26649;27239
38253;Mont-de-Lans;671;17881852;1084694;431;15305680;240;2576172;26650;27240
16101;Claix;499;13298349;666572;323;11353778;176;1944571;26650;27241
60403;Milly-sur-Thérain;916;24413142;1292540;618;21098912;298;3314230;26652;27242
27002;Acon;232;6183245;335966;151;5399961;81;783284;26652;27243
41035;Champigny-en-Beauce;316;8422770;391275;188;6724293;128;1698477;26654;27244
45337;Villamblain;138;3678313;182069;89;3017182;49;661131;26654;27245
62817;Tilloy-lès-Mofflaines;672;17912108;832034;412;14817504;260;3094604;26655;27246
03093;Creuzier-le-Neuf;557;14847071;693909;382;12864208;175;1982863;26655;27247
67494;Trimbach;258;6878008;281022;164;5831694;94;1046314;26659;27248
52174;Doncourt-sur-Meuse;26;693136;66673;12;512844;14;180292;26659;27249
2B305;San-Martino-di-Lota;1606;42818767;3773165;926;36380560;680;6438207;26662;27250
72150;Joué-l'Abbé;593;15810713;495433;427;13705114;166;2105599;26662;27251
06004;Antibes;49263;1313466129;95692403;30050;1123400455;19213;190065674;26662;27252
21125;Cérilly;139;3706231;220562;86;3106081;53;600150;26664;27253
49271;Saint-Clément-de-la-Place;908;24210507;748471;599;20506650;309;3703857;26664;27254
57569;Rémeling;141;3759714;97991;61;2132927;80;1626787;26665;27255
67084;Dambach-la-Ville;1106;29491201;1761996;669;24678472;437;4812729;26665;27256
42152;Nandax;214;5706259;249454;132;4749003;82;957256;26665;27257
67431;Salenthal;113;3013322;147057;71;2479279;42;534043;26667;27258
29086;Irvillac;690;18400341;968715;411;15145831;279;3254510;26667;27259
60327;Jouy-sous-Thelle;513;13680324;698602;322;11420831;191;2259493;26667;27260
67331;Niederschaeffolsheim;695;18534069;919577;487;16102750;208;2431319;26668;27261
02253;Cuisy-en-Almont;185;4933637;286081;118;4223732;67;709905;26668;27262
35138;Laignelet;522;13920979;542466;330;11506901;192;2414078;26669;27263
76415;Massy;164;4373790;233582;93;3603915;71;769875;26669;27264
85160;Nesmy;1357;36191066;1617209;864;30430911;493;5760155;26670;27265
28048;La Bourdinière-Saint-Loup;336;8961216;374047;235;7690428;101;1270788;26670;27266
28371;Saussay;580;15468832;874815;373;12976650;207;2492182;26670;27267
14003;Agy;133;3547219;131682;89;2995172;44;552047;26671;27268
59537;Saint-Martin-sur-Écaillon;251;6694729;371973;156;5600223;95;1094506;26672;27269
73197;Peisey-Nancroix;408;10882676;641948;266;8842414;142;2040262;26673;27270
88529;Xaronval;47;1253694;62045;31;1088589;16;165105;26674;27271
18186;Preuilly;251;6695575;383592;170;5782962;81;912613;26676;27272
76702;Touffreville-la-Corbeline;429;11443885;547361;288;9839133;141;1604752;26676;27273
49082;Chaudefonds-sur-Layon;500;13337969;748004;288;10932458;212;2405511;26676;27274
13059;Meyrargues;1987;53007389;3035050;1174;44787302;813;8220087;26677;27275
41169;Orchaise;478;12752000;556985;336;11144697;142;1607303;26678;27276
60070;Bienville;233;6216033;344751;155;5513001;78;703032;26678;27277
60005;Acy-en-Multien;419;11178940;585979;290;9712543;129;1466397;26680;27278
2A032;Bastelicaccia;1923;51305896;3092542;1168;43299287;755;8006609;26680;27279
13110;Trets;5775;154078465;9428508;3457;129781268;2318;24297197;26680;27280
11234;Mireval-Lauragais;94;2508156;208576;53;2051929;41;456227;26683;27281
60457;La Neuville-Saint-Pierre;81;2161375;92499;59;1906075;22;255300;26684;27282
51604;Ventelay;127;3388862;158243;80;2797757;47;591105;26684;27283
61045;Bivilliers;37;987308;64244;20;742806;17;244502;26684;27284
51192;Courthiézy;190;5070003;282668;126;4332198;64;737805;26684;27285
76066;Beautot;64;1707809;108500;41;1497916;23;209893;26685;27286
69282;Meyzieu;15505;413764502;21098788;9868;348364640;5637;65399862;26686;27287
08021;Arnicourt;80;2134972;67170;49;1726120;31;408852;26687;27288
32384;Saint-Lary;133;3549400;154453;84;2891789;49;657611;26687;27289
14373;Le Locheur;130;3469403;151257;90;3061673;40;407730;26688;27290
89159;Étaule;233;6218243;440598;149;5290441;84;927802;26688;27291
51195;Couvrot;452;12063112;499598;303;10063709;149;1999403;26688;27292
18253;Soulangis;246;6565695;322102;162;5608548;84;957147;26690;27293
60454;La Neuville-en-Hez;518;13825348;680764;377;12251661;141;1573687;26690;27294
60401;Le Mesnil-Théribus;394;10516141;598061;246;8739677;148;1776464;26691;27295
38405;Saint-Joseph-de-Rivière;611;16309375;666901;387;13552524;224;2756851;26693;27296
27048;Beauficel-en-Lyons;104;2776073;141550;64;2299947;40;476126;26693;27297
29257;Saint-Pabu;1088;29042605;1388518;681;24057517;407;4985088;26694;27298
60408;Monchy-Humières;387;10330457;495875;263;8808740;124;1521717;26694;27299
94079;Villiers-sur-Marne;15344;409591911;25934140;9638;353535724;5706;56056187;26694;27300
61143;Damigny;1488;39721705;1912258;959;33317492;529;6404213;26695;27301
88039;Baudricourt;149;3977569;140160;101;3337393;48;640176;26695;27302
57193;Ennery;1006;26856269;1017165;630;21427905;376;5428364;26696;27303
77418;Saint-Loup-de-Naud;467;12467083;745552;305;10710564;162;1756519;26696;27304
53175;Parné-sur-Roc;584;15590973;509975;379;12904428;205;2686545;26697;27305
08209;Hannogne-Saint-Martin;245;6540867;294761;162;5600701;83;940166;26697;27306
89404;Subligny;265;7074821;286383;165;5834888;100;1239933;26697;27307
76352;La Haye;171;4565657;290945;108;3806812;63;758845;26700;27308
14593;Saint-Hymer;380;10145955;570402;229;8705519;151;1440436;26700;27309
25030;Audeux;233;6221200;298710;166;5444091;67;777109;26700;27310
49135;Feneu;1069;28542842;1260846;627;23216502;442;5326340;26701;27311
77086;La Chapelle-Gauthier;720;19224777;1043619;493;16862400;227;2362377;26701;27312
79300;Sainte-Verge;780;20826851;1125342;458;17356364;322;3470487;26701;27313
84111;Saint-Marcellin-lès-Vaison;183;4886366;255547;107;4070768;76;815598;26701;27314
71403;Saint-Denis-de-Vaux;149;3978876;202274;93;3299507;56;679369;26704;27315
35258;Saint-Brieuc-des-Iffs;153;4085800;141405;98;3487250;55;598550;26705;27316
57131;Château-Rouge;121;3231391;128762;78;2682802;43;548589;26706;27317
27581;Saint-Ouen-des-Champs;174;4646910;210026;123;4154766;51;492144;26706;27318
38180;Gillonnay;483;12899960;520815;322;11084334;161;1815626;26708;27319
54170;Domptail-en-l'Air;36;961495;48189;22;810679;14;150816;26708;27320
21225;Dampierre-et-Flée;75;2003183;121867;39;1628748;36;374435;26709;27321
88328;Nompatelize;287;7666013;387738;178;6366442;109;1299571;26711;27322
95058;Bernes-sur-Oise;1096;29275406;1412012;706;24766489;390;4508917;26711;27323
88362;Le Puid;51;1362316;78806;29;1092152;22;270164;26712;27324
17094;Châtelaillon-Plage;3607;96352480;5799170;2131;79863746;1476;16488734;26713;27325
77151;Dagny;175;4674772;290806;109;3946127;66;728645;26713;27326
76021;Annouville-Vilmesnil;234;6250841;227589;160;5225904;74;1024937;26713;27327
28305;Pré-Saint-Évroult;159;4247501;223050;110;3600033;49;647468;26714;27328
40122;Haut-Mauco;466;12448705;536204;305;10610699;161;1838006;26714;27329
62315;Estréelles;167;4461274;177841;104;3744504;63;716770;26714;27330
58155;La Marche;328;8762284;453620;191;7197825;137;1564459;26714;27331
02322;Fontaine-Notre-Dame;203;5423197;234589;114;4368078;89;1055119;26715;27332
27649;Touffreville;177;4728606;138299;109;3862868;68;865738;26715;27333
39562;Villard-sur-Bienne;92;2457819;115749;64;2155775;28;302044;26715;27334
83054;La Farlède;4489;119928932;7432736;2823;101899999;1666;18028933;26716;27335
77166;Écuelles;1330;35533263;1725178;893;30569654;437;4963609;26717;27336
51090;Broussy-le-Grand;160;4274717;235424;102;3631861;58;642856;26717;27337
01328;Romans;289;7721481;423298;167;6239281;122;1482200;26718;27338
21544;Sainte-Colombe;33;881697;53334;17;698375;16;183322;26718;27339
53243;Saint-Ouën-des-Toits;792;21161135;771762;498;17515527;294;3645608;26719;27340
44166;Saint-Jean-de-Boiseau;2659;71046329;2380643;1695;59376547;964;11669782;26719;27341
60481;Orrouy;315;8416604;502955;194;6918972;121;1497632;26719;27342
68162;Kaysersberg;1554;41523059;2325944;996;34921462;558;6601597;26720;27343
35090;Crevin;1166;31155785;1201809;805;26692618;361;4463167;26720;27344
77076;Chalmaison;379;10127037;468804;258;8716011;121;1411026;26720;27345
27672;Vascoeuil;188;5023488;291877;110;4170511;78;852977;26721;27346
33529;La Teste-de-Buch;15425;412186653;27390726;9339;345632723;6086;66553930;26722;27347
25011;Allenjoie;373;9967375;391868;254;8385786;119;1581589;26722;27348
74049;Brizon;248;6627201;191633;150;4816637;98;1810564;26723;27349
27202;Daubeuf-près-Vatteville;242;6466907;312215;165;5624105;77;842802;26723;27350
01267;Nurieux-Volognat;521;13922852;545722;373;12138276;148;1784576;26723;27351
02528;Mortefontaine;146;3901732;250147;86;3243848;60;657884;26724;27352
27391;Marcilly-sur-Eure;788;21058677;1056913;520;17854664;268;3204013;26724;27353
34134;Lavérune;1529;40861954;2212471;971;34644781;558;6217173;26725;27354
08180;La Francheville;834;22288413;1048560;549;19038523;285;3249890;26725;27355
27255;Fontenay;147;3928535;195943;93;3315952;54;612583;26725;27356
49269;Saint-Christophe-du-Bois;1246;33299272;1052737;834;27919771;412;5379501;26725;27357
81020;Aussac;141;3768232;233367;90;3175947;51;592285;26725;27358
45142;Fay-aux-Loges;1836;49067943;2434920;1182;41607873;654;7460070;26725;27359
89304;Poilly-sur-Tholon;362;9674823;552862;241;8334694;121;1340129;26726;27360
80792;La Vicogne;118;3153844;135029;73;2700781;45;453063;26727;27361
44211;La Turballe;2859;76418401;3962948;1713;63202228;1146;13216173;26729;27362
45290;Saint-Martin-d'Abbat;838;22400186;991293;529;18778356;309;3621830;26731;27363
55541;Vavincourt;259;6923239;340586;177;6100144;82;823095;26731;27364
01188;Illiat;297;7939079;331856;187;6536299;110;1402780;26731;27365
69189;Sainte-Colombe;1108;29618112;1971126;707;25520648;401;4097464;26731;27366
01372;Saint-Martin-de-Bavel;207;5533531;203822;138;4727778;69;805753;26732;27367
18204;Saint-Denis-de-Palin;179;4785148;279470;103;3903095;76;882053;26733;27368
22363;Trélévern;787;21038878;1170064;502;17643245;285;3395633;26733;27369
16138;Fléac;1951;52156213;2576836;1245;44063108;706;8093105;26733;27370
69075;Dième;80;2138726;104134;52;1852635;28;286091;26734;27371
03085;Coulandon;353;9437507;399676;236;8140871;117;1296636;26735;27372
86222;Saint-Georges-lès-Baillargeaux;2096;56040496;2565428;1388;48081321;708;7959175;26737;27373
17020;Arthenac;188;5026955;321020;95;4152396;93;874559;26739;27374
64230;Gan;2941;78641088;3790381;1775;64929950;1166;13711138;26740;27375
60673;Viefvillers;92;2460117;124556;60;2135773;32;324344;26740;27376
10116;Crésantignes;155;4144777;179885;95;3361094;60;783683;26740;27377
60049;Bazancourt;71;1898623;86332;40;1542997;31;355626;26741;27378
63261;Orbeil;445;11900001;555824;306;10437458;139;1462543;26742;27379
76137;Bracquemont;440;11766314;498130;288;10050965;152;1715349;26742;27380
22103;Langrolay-sur-Rance;432;11552462;497137;270;9460291;162;2092171;26742;27381
26205;Montmaur-en-Diois;48;1283608;88047;29;1099689;19;183919;26742;27382
70189;Cromary;117;3128802;140265;74;2593406;43;535396;26742;27383
60037;Baboeuf;283;7568361;269413;167;6176774;116;1391587;26743;27384
56185;Quéven;4476;119711449;5165612;2876;99927310;1600;19784139;26745;27385
45159;Grangermont;116;3102505;163406;73;2584050;43;518455;26746;27386
35137;Javené;855;22868418;634057;584;19245772;271;3622646;26747;27387
77431;Saint-Pierre-lès-Nemours;3143;84066177;4580553;2011;71335498;1132;12730679;26747;27388
73132;Hauteluce;457;12223694;846714;260;10308068;197;1915626;26748;27389
27168;Connelles;93;2487578;109103;60;2058474;33;429104;26748;27390
16232;Mornac;1118;29904981;1458849;784;26244925;334;3660056;26749;27391
42162;Ouches;569;15220326;580859;368;12876743;201;2343583;26749;27392
67011;Artolsheim;470;12572187;595799;316;10678253;154;1893934;26749;27393
14215;Cuverville;924;24716785;996433;635;21096457;289;3620328;26750;27394
21597;Segrois;37;989767;62224;24;882799;13;106968;26750;27395
21559;Sainte-Marie-sur-Ouche;361;9657808;440396;255;8465560;106;1192248;26753;27396
54579;Villers-sous-Prény;185;4949317;294761;129;4265726;56;683591;26753;27397
42208;Saint-Christo-en-Jarez;831;22232624;802130;515;18218228;316;4014396;26754;27398
76385;Limésy;714;19102693;894926;461;16187863;253;2914830;26754;27399
80391;Grivillers;42;1123695;77913;26;951466;16;172229;26755;27400
88376;Rebeuville;150;4013233;159589;92;3370107;58;643126;26755;27401
41024;Boursay;107;2862902;166169;68;2444049;39;418853;26756;27402
89123;Courgis;152;4066995;299231;92;3473587;60;593408;26757;27403
28008;Ardelles;98;2622369;119945;67;2220735;31;401634;26759;27404
38358;Sainte-Anne-sur-Gervonde;299;8001044;360901;195;6668100;104;1332944;26759;27405
12205;La Rouquette;395;10570109;528825;221;8574815;174;1995294;26760;27406
49267;Saint-Barthélemy-d'Anjou;4599;123068599;5223333;2846;102277482;1753;20791117;26760;27407
68296;Saint-Hippolyte;586;15682564;911431;367;13245786;219;2436778;26762;27408
67416;Rott;263;7038429;441124;164;5903938;99;1134491;26762;27409
27459;Les Places;35;936681;39510;24;761457;11;175224;26762;27410
56052;Damgan;1147;30696467;1797164;701;25273510;446;5422957;26762;27411
81098;Fréjeville;308;8243118;350101;192;6866985;116;1376133;26763;27412
58238;Saint-Éloi;1137;30430176;1472604;780;26803009;357;3627167;26764;27413
44122;Petit-Mars;1595;42689484;1472342;1043;36006644;552;6682840;26765;27414
28153;Flacey;111;2970964;163939;76;2607214;35;363750;26765;27415
25349;Loray;259;6932442;348356;145;5602726;114;1329716;26766;27416
40004;Angresse;997;26685945;1527118;626;22409863;371;4276082;26766;27417
88435;Saint-Remy;246;6584517;378003;150;5520317;96;1064200;26766;27418
71021;Baron;135;3613532;159608;85;2990484;50;623048;26767;27419
33164;Fargues;867;23208078;1332554;523;19823124;344;3384954;26768;27420
80757;Thoix;75;2007639;83834;43;1580616;32;427023;26769;27421
22210;Ploubazlanec;1918;51343460;3265200;1096;41664374;822;9679086;26769;27422
03044;Brugheas;795;21282305;1178858;513;18183486;282;3098819;26770;27423
42327;Vérin;349;9342871;493147;223;7974129;126;1368742;26770;27424
64249;Guéthary;849;22728751;1663407;473;18666743;376;4062008;26771;27425
71485;Saint-Vallerin;160;4283515;172811;97;3313310;63;970205;26772;27426
71156;Cruzille;138;3694642;274644;83;3195103;55;499539;26773;27427
89483;Voisines;237;6345172;340015;162;5496237;75;848935;26773;27428
41085;La Ferté-Saint-Cyr;574;15367762;846586;354;12820769;220;2546993;26773;27429
2A351;Villanova;218;5836610;345866;141;5194546;77;642064;26773;27430
18211;Saint-Georges-sur-Moulon;388;10388339;378086;232;8422838;156;1965501;26774;27431
38003;Agnin;518;13869004;548718;328;11612849;190;2256155;26774;27432
62614;Nielles-lès-Ardres;249;6666858;278583;150;5433926;99;1232932;26775;27433
19146;Naves;1280;34272603;1786749;856;29569536;424;4703067;26775;27434
13080;Le Puy-Sainte-Réparade;2884;77223255;4544023;1630;64320787;1254;12902468;26776;27435
85278;Saint-Vincent-sur-Jard;781;20912823;951332;517;17340575;264;3572248;26777;27436
01211;Lent;705;18878401;857542;451;15896683;254;2981718;26778;27437
76380;Lammerville;174;4659396;304697;108;4003013;66;656383;26778;27438
59519;Rumegies;789;21129166;994294;495;18035530;294;3093636;26780;27439
33372;Saint-Antoine-du-Queyret;41;1097972;110937;24;979762;17;118210;26780;27440
62566;Menneville;333;8917799;363530;196;7340796;137;1577003;26780;27441
13030;Cuges-les-Pins;2604;69736415;3976412;1663;59720120;941;10016295;26780;27442
27524;Sainte-Colombe-la-Commanderie;366;9802279;471957;251;8495161;115;1307118;26782;27443
10299;Pouan-les-Vallées;273;7311859;438314;166;5903063;107;1408796;26783;27444
60517;Puiseux-le-Hauberger;462;12374109;608272;293;10783549;169;1590560;26784;27445
14528;Quetteville;194;5196194;339751;117;4353709;77;842485;26785;27446
32277;Montamat;68;1821363;74309;45;1472978;23;348385;26785;27447
34024;Balaruc-le-Vieux;1230;32945512;1719251;769;27939287;461;5006225;26785;27448
77106;Chauffry;540;14463936;728720;359;12450018;181;2013918;26785;27449
80608;Omiécourt;113;3026748;152111;62;2342888;51;683860;26785;27450
39241;Frébuans;204;5464222;258255;146;4836539;58;627683;26785;27451
54366;Messein;981;26276619;1312078;647;22386359;334;3890260;26786;27452
85114;Jard-sur-Mer;1814;48590870;2818613;1107;40280594;707;8310276;26787;27453
61395;Saint-Germain-des-Grois;106;2839388;169727;56;2200802;50;638586;26787;27454
08203;Guignicourt-sur-Vence;157;4205533;182110;93;3409186;64;796347;26787;27455
50648;Yvetot-Bocage;532;14250867;569942;333;11996488;199;2254379;26787;27456
40025;Bascons;472;12644054;738224;282;10583180;190;2060874;26788;27457
58124;Germigny-sur-Loire;393;10527884;587425;257;8837782;136;1690102;26789;27458
68172;Kunheim;921;24672853;1189455;598;20845469;323;3827384;26789;27459
31499;Saint-Lys;4488;120233718;5243279;2636;100377726;1852;19855992;26790;27460
71058;Bresse-sur-Grosne;102;2732641;140896;59;2226409;43;506232;26791;27461
33526;Tayac;73;1955737;98761;38;1540476;35;415261;26791;27462
21369;Magny-Saint-Médard;148;3965182;175713;105;3508607;43;456575;26792;27463
68067;Courtavon;209;5599596;316121;132;4663090;77;936506;26792;27464
83087;Nans-les-Pins;2180;58410573;3221223;1246;47294539;934;11116034;26794;27465
25282;Goux-les-Usiers;346;9270693;369238;224;7585458;122;1685235;26794;27466
63213;Les Martres-d'Artière;989;26499196;1088797;655;22312640;334;4186556;26794;27467
87081;Jourgnac;539;14442012;612667;386;12754965;153;1687047;26794;27468
74143;Les Houches;1832;49087414;2565060;1126;39829098;706;9258316;26794;27469
68117;Gunsbach;497;13317125;591076;323;11166227;174;2150898;26795;27470
67458;Schweighouse-sur-Moder;2681;71837755;3844246;1766;61289227;915;10548528;26795;27471
21506;Premeaux-Prissey;252;6752424;486302;168;5813657;84;938767;26795;27472
14038;Banville;356;9539198;479529;234;8146919;122;1392279;26796;27473
76330;Gruchet-Saint-Siméon;374;10021925;426802;224;8104752;150;1917173;26797;27474
54203;Forcelles-Saint-Gorgon;78;2090192;94316;48;1775176;30;315016;26797;27475
37144;Marçay;250;6699652;302458;156;5583675;94;1115977;26799;27476
67218;Illkirch-Graffenstaden;14676;393328582;24382589;9553;338761009;5123;54567573;26801;27477
45254;Poilly-lez-Gien;1369;36691190;2043819;865;30798063;504;5893127;26801;27478
52168;Dinteville;31;830859;63006;17;722803;14;108056;26802;27479
07179;Pourchères;73;1956560;99526;41;1637529;32;319031;26802;27480
25446;Passavant;101;2707197;101509;54;2142011;47;565186;26804;27481
27584;Saint-Paul-de-Fourques;137;3672156;147947;85;3020249;52;651907;26804;27482
83090;Ollioules;7522;201620485;13208151;4428;170725472;3094;30895013;26804;27483
21388;Marliens;233;6245426;188521;163;5320896;70;924530;26804;27484
27574;Saint-Nicolas-du-Bosc;158;4235118;224061;111;3724940;47;510178;26805;27485
67456;Schopperten;177;4744703;222415;110;3979624;67;765079;26806;27486
10031;Barbuise;214;5736625;290632;130;4681214;84;1055411;26807;27487
30191;Orsan;596;15977256;768360;398;13789419;198;2187837;26807;27488
45299;Saint-Sigismond;146;3913927;191627;94;3259123;52;654804;26808;27489
63181;Jozerand;244;6541821;362731;150;5452892;94;1088929;26811;27490
35107;Ercé-près-Liffré;807;21636526;721404;536;18388079;271;3248447;26811;27491
31263;Lagardelle-sur-Lèze;1322;35444358;1727735;843;29820401;479;5623957;26811;27492
05107;Puy-Saint-André;256;6863898;343301;166;5663208;90;1200690;26812;27493
49077;La Chapelle-sur-Oudon;275;7373875;246956;178;5631879;97;1741996;26814;27494
11002;Airoux;71;1903858;122766;37;1581085;34;322773;26815;27495
74256;Sallanches;9444;253269678;15260781;6147;215347516;3297;37922162;26818;27496
17109;Clavette;642;17217318;804217;454;15137838;188;2079480;26818;27497
08111;Le Châtelet-sur-Retourne;350;9386786;354138;235;8057658;115;1329128;26819;27498
64385;Miossens-Lanusse;119;3191540;110538;73;2658614;46;532926;26820;27499
60184;Croutoy;108;2896553;135882;68;2432367;40;464186;26820;27500
14148;Cerqueux;53;1421504;82770;34;1167104;19;254400;26821;27501
49112;Le Coudray-Macouard;489;13116366;616245;301;10740565;188;2375801;26823;27502
39208;Entre-deux-Monts;71;1904447;75668;40;1505001;31;399446;26823;27503
77176;Faremoutiers;1313;35220173;1855718;878;30379604;435;4840569;26824;27504
67244;Kleingoeft;73;1958255;81800;54;1738866;19;219389;26825;27505
67530;Wickersheim-Wilshausen;244;6545407;358047;153;5460247;91;1085160;26825;27506
27373;Lorleau;71;1904653;77121;45;1585277;26;319376;26826;27507
71504;Saunières;59;1582741;195053;37;1355249;22;227492;26826;27508
06092;Peillon;790;21192707;1136983;517;18137192;273;3055515;26826;27509
68252;Ostheim;849;22775577;1073203;578;19662378;271;3113199;26826;27510
67365;Ostwald;6155;165117766;9213429;3839;138830670;2316;26287096;26827;27511
22213;Plouër-sur-Rance;1828;49039616;2415289;1087;40447128;741;8592488;26827;27512
76433;Mesnil-Panneville;323;8665113;395001;215;7218126;108;1446987;26827;27513
72338;Souillé;298;7994669;239093;200;6728693;98;1265976;26828;27514
17398;Saint-Seurin-de-Palenne;79;2119407;99197;49;1734321;30;385086;26828;27515
21077;Bissey-la-Côte;67;1797492;148149;40;1486410;27;311082;26828;27516
67154;Gerstheim;1700;45609111;2032377;1122;38683347;578;6925764;26829;27517
80357;Fresnoy-au-Val;140;3756126;185010;88;3220980;52;535146;26829;27518
50479;Saint-Germain-de-Varreville;73;1958575;140767;37;1558342;36;400233;26830;27519
31054;Beauteville;83;2226875;79088;49;1759369;34;467506;26830;27520
02188;Chigny;86;2307450;266985;35;1746855;51;560595;26831;27521
29119;Lanrivoaré;716;19211334;683853;481;16265191;235;2946143;26831;27522
52167;Darmannes;133;3568764;175597;93;3099011;40;469753;26833;27523
88073;Brantigny;96;2576079;119793;59;2171687;37;404392;26834;27524
56132;Meucon;1124;30161682;1273954;750;25822161;374;4339521;26834;27525
17443;Thairé;783;21011376;1052868;474;17482734;309;3528642;26834;27526
44079;Le Landreau;1393;37380832;1201829;830;30820849;563;6559983;26835;27527
02142;Castres;115;3086057;145311;84;2765683;31;320374;26835;27528
27259;Foucrainville;41;1100277;49411;30;1017024;11;83253;26836;27529
02387;Itancourt;544;14599032;583220;354;12430857;190;2168175;26836;27530
69239;Saint-Vérand;586;15726165;765448;367;13131748;219;2594417;26836;27531
18069;Colombiers;208;5582078;298118;131;4648347;77;933731;26837;27532
59325;Jolimetz;467;12532896;606346;307;10865279;160;1667617;26837;27533
57707;Vernéville;322;8641559;363489;217;7312564;105;1328995;26837;27534
02221;Coupru;83;2227494;90852;57;1927426;26;300068;26837;27535
38244;Monsteroux-Milieu;390;10466594;493311;248;8801522;142;1665072;26837;27536
50537;Saint-Pierre-de-Coutances;208;5582198;279088;137;4680396;71;901802;26837;27537
29234;Rédené;1417;38030903;1539788;884;31566835;533;6464068;26839;27538
57197;Ernestviller;272;7300433;424170;188;6303655;84;996778;26840;27539
10445;Yèvres-le-Petit;37;993076;69778;16;724746;21;268330;26840;27540
85027;Boufféré;1419;38086135;1163556;945;32259499;474;5826636;26840;27541
47098;Fieux;164;4401833;229147;100;3746838;64;654995;26840;27542
25351;Le Luhier;112;3006227;184206;72;2554214;40;452013;26841;27543
61423;Saint-Martin-d'Écublei;313;8401581;299022;208;7082449;105;1319132;26842;27544
01133;Cressin-Rochefort;218;5851759;244224;141;4924344;77;927415;26843;27545
02679;Saint-Gengoulph;68;1825322;79147;35;1361926;33;463396;26843;27546
42225;Genilac;1812;48640667;1809695;1168;40763599;644;7877068;26844;27547
30041;Blauzac;581;15596397;967074;339;12899196;242;2697201;26844;27548
28395;Trizay-Coutretot-Saint-Serge;235;6308468;303768;162;5516029;73;792439;26845;27549
33363;Sadirac;1946;52239696;2491574;1241;44413119;705;7826577;26845;27550
84102;Roussillon;756;20295236;1195065;445;16708510;311;3586726;26846;27551
69118;Loire-sur-Rhône;1268;34040416;1687955;848;28829500;420;5210916;26846;27552
28007;Anet;1520;40807246;2469393;952;34456775;568;6350471;26847;27553
51514;Saint-Remy-sous-Broyes;59;1584031;86504;38;1407050;21;176981;26848;27554
28032;Beauvilliers;164;4403190;253290;110;3856730;54;546460;26849;27555
73219;Saint-Alban-de-Montbel;313;8403876;396594;198;7185150;115;1218726;26849;27556
02601;Pignicourt;91;2443387;69266;59;1969842;32;473545;26850;27557
59334;Lauwin-Planque;871;23387937;1110768;525;19630844;346;3757093;26852;27558
60276;Godenvillers;86;2309404;93567;49;1866599;37;442805;26854;27559
22377;Tréveneuc;439;11788757;620305;281;9974468;158;1814289;26854;27560
44179;Saint-Mars-du-Désert;1970;52903321;1957591;1308;44475925;662;8427396;26854;27561
68337;Traubach-le-Haut;272;7304459;349672;183;6245291;89;1059168;26855;27562
07056;Charnas;423;11359960;596644;260;9391480;163;1968480;26856;27563
54051;Batilly;658;17671163;650386;383;14278803;275;3392360;26856;27564
83017;Belgentier;1239;33275105;1822740;809;28751328;430;4523777;26856;27565
76492;Ouville-la-Rivière;277;7439410;436701;149;5865051;128;1574359;26857;27566
71109;Chassey-le-Camp;175;4700133;285285;109;3921394;66;778739;26858;27567
28096;La Chaussée-d'Ivry;553;14852558;800573;377;12893886;176;1958672;26858;27568
44002;Aigrefeuille-sur-Maine;1595;42840937;1539990;1015;35735547;580;7105390;26860;27569
42284;Saint-Romain-la-Motte;760;20413613;963151;479;16972325;281;3441288;26860;27570
25162;Corcelles-Ferrières;95;2551741;141563;66;2111604;29;440137;26860;27571
80187;La Chaussée-Tirancourt;347;9320852;413929;226;7915637;121;1405215;26861;27572
90079;Petitmagny;152;4082950;169451;100;3511614;52;571336;26862;27573
28094;Chaudon;858;23048652;1177700;583;19903999;275;3144653;26863;27574
65209;Grézian;49;1316320;89619;29;1095958;20;220362;26864;27575
72245;Préval;294;7898013;286030;206;6699385;88;1198628;26864;27576
90013;Bethonvilliers;114;3062545;143554;71;2568261;43;494284;26864;27577
76534;Rolleville;577;15501487;829800;353;13542805;224;1958682;26866;27578
27389;Marbeuf;195;5238951;287609;120;4361021;75;877930;26866;27579
68266;Réguisheim;966;25953946;1197542;669;22201423;297;3752523;26867;27580
56206;Saint-Avé;5445;146293551;7313298;3482;124651263;1963;21642288;26868;27581
32123;Escorneboeuf;296;7953058;487363;170;6579147;126;1373911;26868;27582
76317;Grainville-Ymauville;205;5508063;172972;134;4379856;71;1128207;26869;27583
84071;Maubec;1036;27836668;1578219;629;23290152;407;4546516;26869;27584
71309;Montcenis;1242;33372033;2004443;779;28131839;463;5240194;26870;27585
11149;Fonters-du-Razès;36;967367;33871;24;771913;12;195454;26871;27586
68109;Griesbach-au-Val;384;10318813;457389;253;8588354;131;1730459;26872;27587
39026;Augerans;86;2311031;114503;63;2058776;23;252255;26872;27588
72231;Parigné-l'Évêque;2380;63956773;3042832;1532;54160852;848;9795921;26873;27589
28133;Douy;280;7524611;364598;188;6498877;92;1025734;26874;27590
62686;Ramecourt;161;4326731;190380;93;3475073;68;851658;26874;27591
73092;Corbel;79;2123068;134827;48;1703324;31;419744;26874;27592
78005;Achères;10753;288982343;16353494;7401;253344112;3352;35638231;26875;27593
76152;Cailly;365;9809359;377742;238;8262610;127;1546749;26875;27594
77311;Montigny-Lencoup;657;17656860;865152;457;15368680;200;2288180;26875;27595
89081;La Chapelle-Vaupelteigne;66;1773770;138491;37;1522159;29;251611;26875;27596
37202;La Roche-Clermault;273;7337040;308677;160;5576953;113;1760087;26876;27597
39438;Ponthoux;42;1128809;45496;30;1011259;12;117550;26876;27598
28272;Mottereau;82;2203871;170347;46;1824913;36;378958;26876;27599
80523;Méaulte;698;18759914;1117210;446;16208906;252;2551008;26877;27600
14384;Luc-sur-Mer;1905;51201510;3057227;1184;43649648;721;7551862;26877;27601
28010;Argenvilliers;179;4811453;338601;103;3985807;76;825646;26880;27602
45125;Dimancheville;61;1639699;87948;41;1381899;20;257800;26880;27603
67342;Oberhaslach;874;23494177;1016364;576;19819870;298;3674307;26881;27604
61425;Saint-Martin-des-Pézerits;66;1774270;108370;44;1542910;22;231360;26883;27605
74234;Saint-Ferréol;462;12420200;627022;312;10568424;150;1851776;26884;27606
14644;Saint-Philbert-des-Champs;344;9247996;549847;200;7657642;144;1590354;26884;27607
77129;Coulombs-en-Valois;329;8844743;583425;210;7479378;119;1365365;26884;27608
62476;Izel-lès-Équerchin;469;12608868;569084;284;10430471;185;2178397;26885;27609
73296;Tignes;1203;32342347;2367536;838;28566486;365;3775861;26885;27610
62893;Wimereux;4079;109663200;7576980;2199;89632686;1880;20030514;26885;27611
25190;Dampierre-les-Bois;888;23873773;1205913;605;20519463;283;3354310;26885;27612
69032;Bully;1065;28633501;1404873;671;23850618;394;4782883;26886;27613
45075;La Chapelle-Saint-Mesmin;5265;141555346;7218294;3611;122224409;1654;19330937;26886;27614
25093;Bretigney;39;1048605;49913;28;919360;11;129245;26887;27615
39479;Saint-Cyr-Montmalin;112;3011445;85021;64;2390077;48;621368;26888;27616
53195;Sacé;190;5108879;132927;125;4051168;65;1057711;26889;27617
28379;Soulaires;236;6346267;274747;164;5438294;72;907973;26891;27618
01005;Ambérieux-en-Dombes;842;22642689;1154864;553;19418600;289;3224089;26892;27619
14293;Fumichon;148;3980001;246247;90;3303024;58;676977;26892;27620
09130;Ganac;406;10918307;770737;224;9011763;182;1906544;26892;27621
25302;Hautepierre-le-Châtelet;52;1398424;70687;26;1098957;26;299467;26893;27622
83131;Solliès-Toucas;2829;76087239;3941297;1761;64021869;1068;12065370;26895;27623
26097;Cliousclat;354;9521503;565137;216;8035720;138;1485783;26897;27624
90060;Lagrange;60;1613826;72431;41;1382546;19;231280;26897;27625
07078;Davézieux;1594;42875226;2165378;1056;36187898;538;6687328;26898;27626
95142;Chars;1001;26924956;1243077;700;23682608;301;3242348;26898;27627
31181;Le Fauga;867;23321291;1077198;555;19808922;312;3512369;26899;27628
45214;Montigny;120;3228077;143928;83;2775627;37;452450;26901;27629
81274;Saliès;379;10195442;391548;264;8960360;115;1235082;26901;27630
64024;Anglet;24090;648071777;44033064;14977;548297919;9113;99773858;26902;27631
26042;Beauvallon;845;22732474;989771;554;19065963;291;3666511;26902;27632
08435;Tagnon;463;12456067;597045;289;10380965;174;2075102;26903;27633
59167;Cuvillers;113;3040041;257766;67;2595802;46;444239;26903;27634
74056;Chamonix-Mont-Blanc;6091;163867231;10875796;3813;138816089;2278;25051142;26903;27635
08060;Bergnicourt;125;3362979;96226;91;2972714;34;390265;26904;27636
25509;Routelle;248;6672235;265597;183;5741350;65;930885;26904;27637
25022;Arcey;703;18914192;820756;455;15705419;248;3208773;26905;27638
55358;Chanteraine;121;3255506;170738;80;2805076;41;450430;26905;27639
70356;Montboillon;126;3390154;140985;85;2905532;41;484622;26906;27640
21393;Massingy;81;2179734;102786;48;1760363;33;419371;26910;27641
49195;Mazières-en-Mauges;504;13563030;502035;333;11442091;171;2120939;26911;27642
16097;Cherves-Richemont;1334;35899027;2131916;827;30026947;507;5872080;26911;27643
51630;Villers-aux-Bois;170;4574910;260569;121;4051844;49;523066;26911;27644
25055;Berthelange;137;3686873;235393;90;3161789;47;525084;26911;27645
01371;Saint-Marcel;541;14559584;503738;363;12369863;178;2189721;26912;27646
35361;Le Vivier-sur-Mer;608;16362857;1311917;321;13305511;287;3057346;26913;27647
01089;Château-Gaillard;908;24437040;1037441;622;20852751;286;3584289;26913;27648
60336;Lachaussée-du-Bois-d'Écu;104;2798962;158538;68;2404833;36;394129;26913;27649
14684;Tessel;111;2987369;85423;74;2598692;37;388677;26913;27650
46303;Sénaillac-Lauzès;77;2072330;123029;50;1789696;27;282634;26913;27651
69235;Saint-Romain-en-Gal;895;24087769;1176002;596;20469278;299;3618491;26914;27652
83058;Flayosc;2675;71994962;4580371;1581;60252889;1094;11742073;26914;27653
89471;Villiers-Louis;232;6244085;301141;148;5181126;84;1062959;26914;27654
67240;Kirchheim;365;9823805;429739;256;8457429;109;1366376;26915;27655
73153;Marthod;733;19728614;890292;518;16874929;215;2853685;26915;27656
39019;Les Arsures;122;3283673;109191;85;2838322;37;445351;26915;27657
67466;Siegen;282;7590223;437292;179;6394122;103;1196101;26916;27658
63089;Chappes;740;19919504;762335;503;16972040;237;2947464;26918;27659
02368;Haramont;294;7914202;447429;175;6598665;119;1315537;26919;27660
71406;Saint-Didier-en-Brionnais;80;2153531;100830;45;1771359;35;382172;26919;27661
28039;Béville-le-Comte;733;19731971;785223;504;17085288;229;2646683;26919;27662
62203;Campagne-lès-Guines;230;6191584;330705;129;5149269;101;1042315;26920;27663
89473;Villiers-sur-Tholon;265;7133852;349733;172;6016537;93;1117315;26920;27664
51417;Orconte;247;6649519;233587;142;5452383;105;1197136;26921;27665
76056;Bardouville;319;8588314;359857;211;7468826;108;1119488;26923;27666
25375;Mérey-sous-Montrond;215;5788409;190021;154;4944023;61;844386;26923;27667
57026;Apach;479;12896268;150597;163;5625409;316;7270859;26923;27668
55501;Stainville;217;5842400;268772;136;4843660;81;998740;26924;27669
28046;Boissy-lès-Perche;279;7511850;410314;177;6170892;102;1340958;26924;27670
39270;Jouhe;263;7081214;282645;180;6040140;83;1041074;26925;27671
49238;Pellouailles-les-Vignes;1144;30802733;1026897;812;26556597;332;4246136;26925;27672
61190;Ginai;45;1211687;85133;26;958437;19;253250;26926;27673
33271;Marions;108;2908145;298596;50;2311016;58;597129;26927;27674
32388;Sainte-Marie;208;5600953;360309;118;4575149;90;1025804;26928;27675
54100;Brin-sur-Seille;350;9424703;381321;245;8051294;105;1373409;26928;27676
76375;Ingouville;150;4039164;212798;90;3304975;60;734189;26928;27677
51091;Broussy-le-Petit;72;1938832;114512;46;1639684;26;299148;26928;27678
18075;Cours-les-Barres;552;14864663;801132;392;12914684;160;1949979;26929;27679
18169;Nozières;124;3339247;210205;66;2706568;58;632679;26929;27680
48016;Balsièges;285;7674907;400942;192;6567693;93;1107214;26929;27681
87148;Saint-Hilaire-Bonneval;478;12872804;667192;315;11073382;163;1799422;26931;27682
21592;Savigny-sous-Mâlain;109;2935542;156171;68;2481987;41;453555;26932;27683
54326;Lubey;116;3124064;88914;67;2281750;49;842314;26932;27684
85088;Le Fenouiller;2452;66041419;3008200;1632;55315216;820;10726203;26934;27685
62001;Ablain-Saint-Nazaire;987;26583878;1372980;598;22277601;389;4306277;26934;27686
73264;Saint-Offenge-Dessus;148;3986313;146012;90;3289715;58;696598;26935;27687
77156;Darvault;442;11905348;652025;299;10362981;143;1542367;26935;27688
52266;Laneuville-à-Rémy;34;915827;83940;18;745491;16;170336;26936;27689
67117;Eckartswiller;238;6411091;375101;143;5241180;95;1169911;26937;27690
77201;Gastins;350;9428097;442611;234;7927668;116;1500429;26937;27691
21162;Chaux;234;6303424;291322;155;5413536;79;889888;26938;27692
76607;Sainte-Marguerite-sur-Fauville;125;3367409;124217;75;2753808;50;613601;26939;27693
39486;Saint-Lamain;67;1804958;126713;42;1540034;25;264924;26940;27694
25576;Vaire-le-Petit;115;3098230;144038;82;2686275;33;411955;26941;27695
14085;Bonneville-la-Louvet;441;11881218;736673;274;10203900;167;1677318;26942;27696
39425;Les Planches-près-Arbois;52;1401028;90230;34;1191150;18;209878;26943;27697
71005;Aluze;119;3206286;139023;81;2773201;38;433085;26944;27698
77280;Mary-sur-Marne;602;16220231;798329;416;14187309;186;2032922;26944;27699
26287;Roynac;255;6870714;427409;147;5708280;108;1162434;26944;27700
01393;Sandrans;260;7005581;311882;162;5549807;98;1455774;26945;27701
67107;Duntzenheim;316;8514699;368129;206;7180452;110;1334247;26945;27702
50554;Saint-Senier-sous-Avranches;666;17945837;684093;458;15320812;208;2625025;26946;27703
68179;Lauw;500;13473030;651813;319;11240919;181;2232111;26946;27704
89195;Gron;658;17730788;953649;438;15256571;220;2474217;26946;27705
73293;Thoiry;239;6440691;289563;162;5627144;77;813547;26948;27706
29260;Saint-Renan;3828;103161073;4654685;2470;87257237;1358;15903836;26949;27707
60460;La Neuville-Vault;84;2263808;106485;60;1959766;24;304042;26950;27708
91161;Chilly-Mazarin;11047;297723282;19302344;7632;263828073;3415;33895209;26951;27709
25599;Vennans;95;2560318;51914;69;2200982;26;359336;26951;27710
45344;Villorceau;575;15496743;589075;409;13361843;166;2134900;26951;27711
17194;La Jarrie;1596;43015071;1941546;1102;37580191;494;5434880;26952;27712
08273;Marby;43;1158956;77131;19;747247;24;411709;26952;27713
01341;Saint-Champ;90;2425860;115525;65;2075637;25;350223;26954;27714
27196;Les Damps;648;17466643;886204;451;15160696;197;2305947;26955;27715
38539;Vertrieu;311;8382982;270210;217;7182406;94;1200576;26955;27716
67210;Le Hohwald;288;7763086;481512;180;6576155;108;1186931;26955;27717
02248;Cuirieux;77;2075630;176104;37;1607610;40;468020;26956;27718
42242;Saint-Joseph;932;25123637;1054163;586;20797874;346;4325763;26957;27719
60375;Maimbeville;184;4960130;183125;135;4315941;49;644189;26957;27720
67427;Saint-Maurice;219;5903704;297495;143;4977539;76;926165;26958;27721
88111;Coinches;186;5014279;347136;112;4285054;74;729225;26958;27722
35216;Parthenay-de-Bretagne;650;17523093;592454;442;15064857;208;2458236;26959;27723
83071;La Londe-les-Maures;6175;166475804;9121081;3682;139555255;2493;26920549;26960;27724
71016;Azé;574;15474884;872840;366;13309583;208;2165301;26960;27725
77008;Armentières-en-Brie;519;13992115;747784;311;12018201;208;1973914;26960;27726
27510;Saint-Aquilin-de-Pacy;308;8303946;578712;194;7069794;114;1234152;26961;27727
71360;Prissé;980;26421742;1347861;636;22230412;344;4191330;26961;27728
53140;Louverné;1929;52007772;1803004;1257;42734831;672;9272941;26961;27729
04047;Champtercier;406;10946342;585019;262;9311983;144;1634359;26961;27730
31368;Montclar-Lauragais;104;2804007;115095;65;2390760;39;413247;26962;27731
45253;Pithiviers-le-Vieil;979;26396405;1323318;659;22680667;320;3715738;26963;27732
62406;Hamelincourt;128;3451242;128118;76;2852800;52;598442;26963;27733
02029;Attilly;203;5473457;298022;133;4707421;70;766036;26963;27734
77241;Juilly;1001;26991008;1446366;684;23661492;317;3329516;26964;27735
58020;Avril-sur-Loire;134;3613201;159451;93;3097579;41;515622;26964;27736
40250;Saint-Avit;311;8386125;381432;212;7247949;99;1138176;26965;27737
32092;Catonvielle;54;1456140;59555;31;1173181;23;282959;26966;27738
39355;Montigny-lès-Arsures;156;4206659;271937;96;3469890;60;736769;26966;27739
50543;Saint-Quentin-sur-le-Homme;606;16341306;854331;387;13684520;219;2656786;26966;27740
27149;La Chapelle-Hareng;45;1213465;77032;28;1009852;17;203613;26966;27741
78354;Magnanville;3017;81359108;4013868;1984;69403603;1033;11955505;26967;27742
59399;Merris;503;13564944;580837;298;11481452;205;2083492;26968;27743
37169;Neuville-sur-Brenne;429;11569334;532914;285;9865577;144;1703757;26968;27744
73156;Meyrieux-Trouet;156;4207100;189847;97;3490471;59;716629;26969;27745
22054;Erquy;2529;68204734;3940724;1433;55280057;1096;12924677;26969;27746
65436;Souyeaux;140;3775823;146934;77;2913269;63;862554;26970;27747
25368;Marchaux;575;15508435;600599;381;12895411;194;2613024;26971;27748
35120;Gévezé;2208;59553743;2157487;1474;51008290;734;8545453;26972;27749
59593;Thun-l'Évêque;363;9790964;569323;214;8238397;149;1552567;26972;27750
21170;Chevigny-en-Valière;158;4261692;216941;92;3525013;66;736679;26973;27751
76423;Ménerval;105;2832206;172699;57;2280582;48;551624;26973;27752
84051;Goult;732;19744570;1445549;384;16261171;348;3483399;26973;27753
01314;Priay;778;20985702;1055260;470;17387900;308;3597802;26974;27754
27131;Carsix;129;3479751;158781;84;2931546;45;548205;26975;27755
01134;Crottet;870;23468204;1048776;580;19982225;290;3485979;26975;27756
76225;Écretteville-lès-Baons;194;5233246;202354;128;4379653;66;853593;26975;27757
30082;Clarensac;2011;54249769;2393407;1300;46327515;711;7922254;26977;27758
73298;Tours-en-Savoie;495;13353443;705847;342;11562499;153;1790944;26977;27759
77068;Cessoy-en-Montois;121;3264207;178232;79;2741502;42;522705;26977;27760
11300;Puginier;79;2131193;123346;50;1824133;29;307060;26977;27761
27419;Mouettes;361;9738967;443076;260;8499427;101;1239540;26978;27762
91207;Égly;2650;71491314;4021773;1765;62132635;885;9358679;26978;27763
91103;Brétigny-sur-Orge;13324;359472887;21580899;9069;315801879;4255;43671008;26979;27764
38305;Le Pin;653;17617793;892786;412;14787433;241;2830360;26980;27765
17273;Pérignac;545;14704096;814097;301;12120098;244;2583998;26980;27766
27610;Saint-Victor-sur-Avre;34;917363;41551;20;771122;14;146241;26981;27767
64374;Mazerolles;504;13598716;543270;306;11065755;198;2532961;26982;27768
27354;Iville;252;6799506;460788;150;5724312;102;1075194;26982;27769
76041;Autretot;314;8472489;332737;202;7063790;112;1408699;26982;27770
14386;Magny-la-Campagne;267;7204603;283640;162;5882845;105;1321758;26984;27771
33448;Saint-Médard-d'Eyrans;1476;39828924;2055143;989;34297327;487;5531597;26984;27772
83036;Cavalaire-sur-Mer;4765;128580714;9536957;2873;108279108;1892;20301606;26984;27773
10059;Braux;77;2077829;176743;38;1658476;39;419353;26985;27774
60504;Ponchon;551;14869620;869649;351;12617767;200;2251853;26987;27775
30226;Saint-Alexandre;611;16488894;914158;383;13992057;228;2496837;26987;27776
14494;Périers-en-Auge;78;2105046;138854;41;1763800;37;341246;26988;27777
71567;Vergisson;131;3535435;254089;86;3065166;45;470269;26988;27778
46327;Valroufié;240;6477197;379918;152;5534649;88;942548;26988;27779
67291;Mertzwiller;1819;49092670;2331566;1094;41158551;725;7934119;26989;27780
71488;Saint-Vincent-des-Prés;66;1781315;105132;37;1471281;29;310034;26990;27781
28256;Moléans;249;6720550;301754;175;5855331;74;865219;26990;27782
27699;Voiscreville;61;1646408;45420;42;1390096;19;256312;26990;27783
38187;Le Gua;968;26126879;1212484;664;22704663;304;3422216;26991;27784
57313;Hémilly;67;1808374;88549;39;1406301;28;402073;26991;27785
27050;Beaumontel;389;10499474;556937;265;9129987;124;1369487;26991;27786
28017;Autheuil;117;3157969;140237;76;2689773;41;468196;26991;27787
25326;Lantenne-Vertière;255;6882811;291933;166;5850331;89;1032480;26991;27788
50423;Rampan;113;3050058;134705;72;2595071;41;454987;26992;27789
50165;Donville-les-Bains;2091;56440772;3334020;1175;46318188;916;10122584;26992;27790
80656;Quevauvillers;634;17113153;1031691;385;14647677;249;2465476;26992;27791
25549;Sombacour;311;8394632;370634;198;6953366;113;1441266;26992;27792
89428;Vallery;302;8152378;513141;195;7068337;107;1084041;26995;27793
24237;Lembras;752;20300011;1416612;438;16997044;314;3302967;26995;27794
89380;Savigny-sur-Clairis;263;7099689;391919;147;5345532;116;1754157;26995;27795
27667;Valailles;177;4778129;238098;114;3981472;63;796657;26995;27796
63350;Saint-Georges-sur-Allier;631;17034058;742205;434;14784636;197;2249422;26995;27797
62418;Hauteville;150;4049372;160642;91;3278590;59;770782;26996;27798
01123;Cormoranche-sur-Saône;540;14577755;763175;353;12220830;187;2356925;26996;27799
71374;Rosey;102;2753616;144778;67;2400659;35;352957;26996;27800
61298;Moulins-sur-Orne;163;4400426;177637;112;3728399;51;672027;26996;27801
04113;Marcoux;276;7451293;367308;189;6468991;87;982302;26997;27802
91514;Quincy-sous-Sénart;4450;120139242;7495592;2880;104147058;1570;15992184;26998;27803
41103;Huisseau-en-Beauce;209;5642554;282635;138;4666754;71;975800;26998;27804
52525;Villars-en-Azois;43;1160935;65798;23;921359;20;239576;26998;27805
27698;Vitot;266;7181639;306799;193;6277556;73;904083;26999;27806
74002;Alby-sur-Chéran;1076;29051879;1068698;723;24513428;353;4538451;27000;27807
19282;Venarsal;255;6885514;287525;173;5998189;82;887325;27002;27808
28029;Bazoches-les-Hautes;155;4185348;224928;86;3182801;69;1002547;27002;27809
08438;Taizy;62;1674201;109869;35;1354182;27;320019;27003;27810
80316;Flesselles;973;26277417;1282766;642;22371343;331;3906074;27007;27811
10100;Clérey;572;15448252;921808;358;12878231;214;2570021;27007;27812
33056;Blanquefort;8218;221947712;12697453;5334;192790474;2884;29157238;27008;27813
37022;Beaumont-en-Véron;1477;39891850;1942591;976;34896550;501;4995300;27009;27814
54114;Champey-sur-Moselle;179;4834647;218556;124;4086366;55;748281;27009;27815
54444;Raucourt;110;2971075;170918;64;2449635;46;521440;27010;27816
54302;Lantéfontaine;407;10993195;470190;245;8802020;162;2191175;27010;27817
02154;Chacrise;182;4916072;275880;105;4063084;77;852988;27011;27818
71420;Saint-Germain-du-Plain;1146;30955127;1410248;697;26018667;449;4936460;27011;27819
26231;Peyrins;1387;37465027;2392211;763;31159384;624;6305643;27012;27820
81011;Ambres;491;13262678;596385;285;10909365;206;2353313;27012;27821
01128;Courtes;141;3808753;122543;82;3032511;59;776242;27012;27822
77228;Hondevilliers;123;3322541;208219;81;2818315;42;504226;27013;27823
07300;Saint-Thomé;223;6023985;313054;134;5175678;89;848307;27013;27824
61236;Loucé;56;1512793;38868;37;1234318;19;278475;27014;27825
25387;Montandon;199;5375882;289474;119;4511133;80;864749;27014;27826
54239;Griscourt;73;1972096;227057;45;1679363;28;292733;27015;27827
67177;Gunstett;361;9752548;401924;237;8169069;124;1583479;27015;27828
57633;Sarreinsming;707;19099873;943729;439;15839154;268;3260719;27015;27829
62880;Le Wast;104;2809615;137077;44;2119755;60;689860;27016;27830
60301;Haucourt;76;2053231;93317;55;1766652;21;286579;27016;27831
37194;Reugny;809;21857037;1075602;521;18248655;288;3608382;27017;27832
08158;Étrépigny;125;3377213;127210;77;2775806;48;601407;27018;27833
21071;Bèze;379;10240464;493675;248;8677676;131;1562788;27020;27834
60091;Bouillancy;212;5728439;265785;150;4946197;62;782242;27021;27835
35199;Moussé;137;3702115;118876;85;2904037;52;798078;27023;27836
02804;Villemontoire;115;3107801;233237;76;2596794;39;511007;27024;27837
58088;Coulanges-lès-Nevers;2041;55156832;3005811;1399;47771898;642;7384934;27024;27838
33185;Génissac;971;26240758;1490826;603;22467719;368;3773039;27024;27839
37066;Chédigny;303;8188463;426720;176;6926200;127;1262263;27025;27840
38231;Meyrieu-les-Étangs;463;12513537;526552;316;10938026;147;1575511;27027;27841
76525;Ricarville;164;4432454;224299;102;3722363;62;710091;27027;27842
08014;Annelles;61;1648737;51420;34;1369850;27;278887;27028;27843
74012;Annemasse;18434;498270902;16021299;8690;331587207;9744;166683695;27030;27844
17291;Puilboreau;3222;87090871;4499523;2058;73643020;1164;13447851;27030;27845
28145;Fains-la-Folie;163;4406193;211796;103;3701923;60;704270;27032;27846
55045;Belrupt-en-Verdunois;276;7460871;330648;194;6508236;82;952635;27032;27847
21193;Corgengoux;194;5244427;166673;125;4076317;69;1168110;27033;27848
60423;Montmacq;619;16734268;914163;415;14218543;204;2515725;27034;27849
65062;Barbazan-Debat;1810;48934921;2758154;1142;41396450;668;7538471;27036;27850
27071;Le Bois-Hellain;114;3082173;178112;71;2612503;43;469670;27037;27851
71249;Laives;519;14032027;862401;317;11579787;202;2452240;27037;27852
68085;Eteimbes;178;4812554;161951;127;4292306;51;520248;27037;27853
45213;Montereau;353;9544688;498547;204;7858978;149;1685710;27039;27854
89038;Bernouil;66;1784632;86767;40;1486964;26;297668;27040;27855
10058;Bragelogne-Beauvoir;170;4596889;426452;94;3919692;76;677197;27041;27856
33396;Saint-Étienne-de-Lisse;152;4110267;229286;79;3356932;73;753335;27041;27857
36245;Villers-les-Ormes;221;5976710;291794;153;5158820;68;817890;27044;27858
59143;La Chapelle-d'Armentières;4223;114206911;6124111;2542;94885606;1681;19321305;27044;27859
71515;Sercy;53;1433431;66050;32;1143365;21;290066;27046;27860
73024;Les Avanchers-Valmorel;474;12819904;966400;295;10996713;179;1823191;27046;27861
60563;Sacy-le-Petit;291;7870548;447080;206;6952564;85;917984;27047;27862
54564;Viéville-en-Haye;80;2163834;109845;49;1895090;31;268744;27048;27863
67319;Neuhaeusel;186;5031002;217984;128;4236136;58;794866;27048;27864
01142;Dagneux;2174;58805464;2652276;1496;50351084;678;8454380;27049;27865
76440;Molagnies;79;2136908;100546;53;1834376;26;302532;27049;27866
79178;Missé;464;12551029;564067;320;10922150;144;1628879;27050;27867
88157;Dounoux;448;12118417;576627;273;10124312;175;1994105;27050;27868
42108;L'Hôpital-le-Grand;445;12037413;496288;291;9909830;154;2127583;27050;27869
76491;Ouville-l'Abbaye;309;8359070;308266;194;6834168;115;1524902;27052;27870
45180;Langesse;47;1271449;99943;31;1134084;16;137365;27052;27871
61032;Beaufai;190;5140003;290612;121;4359284;69;780719;27053;27872
71174;Dezize-lès-Maranges;107;2894652;163089;67;2428540;40;466112;27053;27873
27526;Sainte-Croix-sur-Aizier;136;3679220;155716;81;3099886;55;579334;27053;27874
46221;Planioles;275;7440085;368069;183;6414535;92;1025550;27055;27875
80128;Bouvincourt-en-Vermandois;79;2137355;147785;52;1838856;27;298499;27055;27876
67407;Rohrwiller;895;24215108;1145743;611;20987927;284;3227181;27056;27877
14337;La Houblonnière;152;4112539;186918;91;3389530;61;723009;27056;27878
73198;La Perrière;267;7224135;430938;168;6033814;99;1190321;27057;27879
76562;Saint-Aubin-le-Cauf;447;12094351;471176;287;10231601;160;1862750;27057;27880
76032;Auberville-la-Manuel;64;1731639;57357;31;1122690;33;608949;27057;27881
60628;Therdonne;534;14448425;960297;389;12939570;145;1508855;27057;27882
02149;Cerizy;34;919974;45600;22;819191;12;100783;27058;27883
01264;Montracol;484;13096317;574721;328;11111102;156;1985215;27059;27884
67497;Uhlwiller;367;9930653;429996;235;8287232;132;1643421;27059;27885
68019;Baltzenheim;284;7684881;338179;197;6543163;87;1141718;27059;27886
73010;Albens;1833;49600547;2254879;1218;41863093;615;7737454;27060;27887
67021;Barr;3718;100609167;5822566;2182;82950145;1536;17659022;27060;27888
51111;Chambrecy;70;1894249;69115;50;1654275;20;239974;27061;27889
67484;Stundwiller;243;6575928;287703;165;5595750;78;980178;27061;27890
67409;Roppenheim;492;13314469;747178;312;11256271;180;2058198;27062;27891
69257;Vaux-en-Beaujolais;513;13883013;788029;323;11595024;190;2287989;27062;27892
01240;Matafelon-Granges;346;9363722;447241;231;7908348;115;1455374;27063;27893
35284;Saint-Jouan-des-Guérets;1483;40134272;2092921;933;33628386;550;6505886;27063;27894
54234;Gorcy;1281;34669843;960459;533;20872330;748;13797513;27065;27895
15041;La Chapelle-d'Alagnon;140;3789085;219668;71;2997572;69;791513;27065;27896
46010;Aujols;168;4546907;240254;101;3835117;67;711790;27065;27897
77054;La Brosse-Montceaux;382;10339577;478785;274;9207409;108;1132168;27067;27898
02701;Saulchery;376;10177290;669978;229;8653876;147;1523414;27067;27899
63378;Saint-Maurice;441;11937686;543544;320;10539156;121;1398530;27070;27900
74169;Marnaz;2788;75470456;3517927;1707;62383870;1081;13086586;27070;27901
27556;Saint-Laurent-du-Tencement;35;947463;53150;21;745702;14;201761;27070;27902
49247;La Possonnière;1186;32105569;1522543;693;26431445;493;5674124;27070;27903
53008;Aron;921;24933773;1022037;576;20595003;345;4338770;27073;27904
59426;Neuville-en-Ferrain;5105;138205217;5781718;3469;117840938;1636;20364279;27073;27905
91345;Longjumeau;11864;321193080;19580460;7986;281628093;3878;39564987;27073;27906
74027;La Balme-de-Thuy;217;5874978;339143;143;5018927;74;856051;27074;27907
51373;Moncetz-l'Abbaye;59;1597369;83541;39;1375156;20;222213;27074;27908
39545;Le Vaudioux;84;2274262;112828;46;1890189;38;384073;27075;27909
52087;Buxières-lès-Villiers;103;2788787;147028;70;2446581;33;342206;27076;27910
94034;Fresnes;13472;364772173;23035230;9228;321616095;4244;43156078;27076;27911
54300;Laneuveville-devant-Nancy;2983;80768741;4138753;1916;68506364;1067;12262377;27076;27912
35066;Chartres-de-Bretagne;4023;108934194;5705883;2759;95382693;1264;13551501;27078;27913
54485;Saint-Pancré;157;4251363;166873;73;2901288;84;1350075;27079;27914
38467;Salagnon;607;16436832;731945;392;13567874;215;2868958;27079;27915
67215;Huttendorf;256;6932304;304861;188;6103229;68;829075;27079;27916
42324;Veauchette;451;12212867;406952;308;10266519;143;1946348;27080;27917
21698;Villers-la-Faye;219;5930665;248250;153;5060729;66;869936;27081;27918
76043;Auzebosc;464;12565526;508225;310;10709148;154;1856378;27081;27919
28167;Fruncé;184;4983015;280456;126;4331111;58;651904;27082;27920
27363;Le Landin;102;2762357;146665;63;2309290;39;453067;27082;27921
31387;Montoussin;69;1868730;95238;42;1643361;27;225369;27083;27922
25493;La Rivière-Drugeon;420;11375329;516643;249;9242579;171;2132750;27084;27923
27548;Saint-Germain-sur-Avre;610;16521322;780236;408;14330887;202;2190435;27084;27924
62370;Gennes-Ivergny;69;1868812;172134;31;1481758;38;387054;27084;27925
90080;Phaffans;187;5064800;208472;133;4503246;54;561554;27084;27926
74266;Servoz;522;14138384;675379;333;12105229;189;2033155;27085;27927
80300;Falvy;82;2221020;149608;42;1754579;40;466441;27086;27928
37156;Montlouis-sur-Loire;5485;148567914;7502231;3568;127591231;1917;20976683;27086;27929
02767;Vauxrezis;170;4604689;173816;111;3964040;59;640649;27086;27930
27544;Saint-Germain-de-Fresney;90;2437843;84094;59;1936444;31;501399;27087;27931
89162;Évry;198;5363260;259295;140;4644664;58;718596;27087;27932
31515;Saint-Rustice;229;6203022;258043;152;5239997;77;963025;27087;27933
77072;Chalautre-la-Grande;326;8830673;470377;193;7328272;133;1502401;27088;27934
31165;Eaunes;2857;77391927;3806731;1832;65313678;1025;12078249;27089;27935
27511;Saint-Aubin-d'Écrosville;364;9860243;493487;225;8225316;139;1634927;27089;27936
51122;Changy;64;1733777;66274;45;1478420;19;255357;27090;27937
88507;Villers;121;3277925;133989;84;2815445;37;462480;27090;27938
02005;Aguilcourt;178;4822251;171570;120;4133093;58;689158;27091;27939
44097;Mesquer;1146;31048227;1716542;671;25391980;475;5656247;27093;27940
53065;Châtres-la-Forêt;368;9970255;382175;246;8367850;122;1602405;27093;27941
25631;Vorges-les-Pins;273;7396461;244542;186;6170748;87;1225713;27093;27942
29017;Brélès;429;11623041;497761;261;9511618;168;2111423;27093;27943
77231;Isles-les-Meldeuses;385;10431143;615762;257;8840335;128;1590808;27094;27944
65131;Castelvieilh;129;3495199;105270;75;2406641;54;1088558;27095;27945
38285;Ornon;75;2032163;84380;49;1664011;26;368152;27096;27946
25224;Étouvans;408;11055043;496325;291;9660328;117;1394715;27096;27947
57672;Thionville;23198;628612731;30228457;10602;427099469;12596;201513262;27098;27948
76738;Vieux-Manoir;321;8698372;328296;217;7522388;104;1175984;27098;27949
45170;Intville-la-Guétard;65;1761397;80538;45;1535239;20;226158;27098;27950
59299;Hem;9324;252665883;15774966;4824;207480762;4500;45185121;27098;27951
02254;Cutry;62;1680118;86718;38;1430515;24;249603;27099;27952
38225;Méaudre;711;19267650;723845;429;15994034;282;3273616;27099;27953
91414;Monnerville;222;6016123;319998;149;5232063;73;784060;27100;27954
63133;Dallet;694;18807206;808704;444;16041722;250;2765484;27100;27955
28095;Chauffours;158;4281884;246835;111;3783507;47;498377;27101;27956
38246;Montagnieu;458;12412249;484938;298;10386826;160;2025423;27101;27957
21404;Ménétreux-le-Pitois;227;6152001;299540;150;5200320;77;951681;27101;27958
50058;Blainville-sur-Mer;921;24960394;1743236;503;20096880;418;4863514;27101;27959
35053;Chancé;141;3821421;152270;87;3083196;54;738225;27102;27960
50042;Beauvoir;224;6071581;469278;124;4953575;100;1118006;27105;27961
81261;Saint-Lieux-lès-Lavaur;442;11980563;508362;277;9947557;165;2033006;27105;27962
76543;Rouville;286;7752378;296183;165;6173500;121;1578878;27106;27963
44175;Saint-Lyphard;2252;61043630;2752364;1418;50149302;834;10894328;27106;27964
30331;Tresques;992;26889682;1492065;615;23089701;377;3799981;27107;27965
54123;Chavigny;951;25781215;1288936;642;22389326;309;3391889;27110;27966
57101;Bousbach;607;16455542;746304;396;13565092;211;2890450;27110;27967
67555;Zehnacker;123;3334503;161629;82;2875128;41;459375;27110;27968
67014;Auenheim;453;12280943;591335;282;10305905;171;1975038;27110;27969
59576;Spycker;753;20414390;767767;505;17369022;248;3045368;27111;27970
21650;Urcy;76;2060464;91525;53;1809627;23;250837;27111;27971
16187;Linars;1124;30473738;1662390;762;26463442;362;4010296;27112;27972
83029;Callian;1863;50511035;3340285;1066;41357986;797;9153049;27113;27973
70578;Vregille;99;2684195;139823;64;2253083;35;431112;27113;27974
51288;Heiltz-le-Hutier;125;3389183;221447;74;2800225;51;588958;27113;27975
02346;Gizy;380;10303393;559279;200;8429888;180;1873505;27114;27976
38460;Saint-Sulpice-des-Rivoires;236;6398990;309625;141;5142357;95;1256633;27114;27977
57679;Tritteling-Redlach;267;7239669;355278;179;6009757;88;1229912;27115;27978
54193;Fey-en-Haye;38;1030380;54243;23;886550;15;143830;27115;27979
09081;Le Carlaret;116;3145384;203492;72;2646990;44;498394;27115;27980
45080;Charmont-en-Beauce;204;5531589;348293;129;4758725;75;772864;27116;27981
71513;Senozan;557;15103625;605236;377;12639368;180;2464257;27116;27982
54005;Affracourt;61;1654237;74362;43;1394758;18;259479;27119;27983
77523;Villuis;142;3850911;237728;95;3302110;47;548801;27119;27984
69252;Trèves;321;8705242;275613;217;7308916;104;1396326;27119;27985
84095;Puyvert;422;11444539;732094;226;9239709;196;2204830;27120;27986
28402;Vérigny;145;3932499;149659;93;3214747;52;717752;27121;27987
61077;Cerisé;371;10062171;407651;242;8428074;129;1634097;27122;27988
21242;Échigey;129;3498753;258911;73;2882394;56;616359;27122;27989
2B239;Poggio-d'Oletta;116;3146225;237126;69;2649532;47;496693;27123;27990
38030;Beaucroissant;763;20695431;1049540;528;18196677;235;2498754;27124;27991
14438;Mondrainville;227;6157170;197483;162;5396695;65;760475;27124;27992
39219;Évans;296;8029002;302862;199;6707829;97;1321173;27125;27993
88253;Jeuxey;389;10551793;587969;273;9248342;116;1303451;27125;27994
01119;Corcelles;114;3092322;94241;64;2400595;50;691727;27126;27995
81113;Labastide-Dénat;180;4882620;252239;117;4228314;63;654306;27126;27996
90075;Offemont;1761;47768698;2797686;953;39696732;808;8071966;27126;27997
60081;Bonlier;203;5506667;238668;138;4754070;65;752597;27126;27998
14739;Ver-sur-Mer;912;24739753;1327661;593;21040176;319;3699577;27127;27999
77035;Blennes;315;8544984;434570;202;7117697;113;1427287;27127;28000
57527;Orny;173;4693215;166240;119;4034199;54;659016;27128;28001
27298;Graveron-Sémerville;160;4340567;257877;111;3776337;49;564230;27129;28002
54375;Montauville;589;15978840;715270;393;13621943;196;2356897;27129;28003
76742;Villequier;427;11584087;612197;268;10010429;159;1573658;27129;28004
33318;Pessac;31114;844105166;53400363;19511;727982059;11603;116123107;27129;28005
31269;Lamasquère;694;18827870;744752;469;16132205;225;2695665;27129;28006
60478;Ormoy-le-Davien;152;4123834;174230;107;3561812;45;562022;27130;28007
32169;Labarthe;77;2089075;104209;43;1694101;34;394974;27131;28008
31205;Gagnac-sur-Garonne;1622;44006584;2308214;1117;38226451;505;5780133;27131;28009
74208;Passy;6119;166015433;8103414;3948;138962240;2171;27053193;27131;28010
73282;Saint-Thibaud-de-Couz;467;12670301;470507;315;10636892;152;2033409;27131;28011
67516;Waltenheim-sur-Zorn;352;9550592;390228;224;7986244;128;1564348;27132;28012
67179;Haegen;361;9795049;573310;252;8543192;109;1251857;27133;28013
25128;Chasnans;113;3066059;93907;70;2527378;43;538681;27133;28014
51548;Somme-Vesle;156;4232801;163697;101;3423254;55;809547;27133;28015
12033;Bozouls;1533;41603193;2766577;847;33992411;686;7610782;27138;28016
59505;Rombies-et-Marchipont;359;9742844;393312;228;8204074;131;1538770;27139;28017
10172;Herbisse;97;2632528;177450;56;2153981;41;478547;27139;28018
90001;Andelnans;640;17369389;766296;453;15064619;187;2304770;27140;28019
01430;Varambon;272;7382078;345365;185;6408956;87;973122;27140;28020
87025;Burgnac;397;10775011;419973;271;9211611;126;1563400;27141;28021
51446;Pringy;231;6269598;411461;136;5143604;95;1125994;27141;28022
83048;La Croix-Valmer;2405;65275424;4899390;1437;54916179;968;10359245;27142;28023
41091;Fossé;620;16828122;610685;477;14947117;143;1881005;27142;28024
39389;Ney;316;8577124;359702;174;6632265;142;1944859;27143;28025
45201;Mérinville;105;2849996;179327;64;2358621;41;491375;27143;28026
80147;Buigny-l'Abbé;162;4397169;205738;103;3746096;59;651073;27143;28027
51420;Outrepont;46;1248611;55147;31;1073719;15;174892;27144;28028
02413;Laval-en-Laonnois;134;3637324;232054;82;3131033;52;506291;27144;28029
39482;Saint-Germain-lès-Arlay;245;6650803;290892;157;5455600;88;1195203;27146;28030
28221;Lumeau;98;2660434;154888;58;2196163;40;464271;27147;28031
22055;Étables-sur-Mer;1768;47997496;2338835;1082;39997461;686;8000035;27148;28032
74136;Le Grand-Bornand;1275;34614611;2135781;794;29084391;481;5530220;27149;28033
25235;Ferrières-les-Bois;160;4343863;233088;104;3690408;56;653455;27149;28034
62408;Hames-Boucres;656;17810308;925937;353;14598365;303;3211943;27150;28035
69003;Albigny-sur-Saône;1513;41078466;2717464;826;33459024;687;7619442;27150;28036
07146;Lyas;316;8579700;484756;203;7409982;113;1169718;27151;28037
41226;Saint-Ouen;1820;49416110;2545373;1192;41728293;628;7687817;27152;28038
72162;Lignières-la-Carelle;178;4833281;189935;123;4136839;55;696442;27153;28039
45038;Bondaroy;205;5566431;277135;133;4635462;72;930969;27153;28040
31553;Thil;559;15178824;835313;345;12781223;214;2397601;27154;28041
84108;Saint-Didier;1168;31716511;1819894;662;25959783;506;5756728;27155;28042
90055;Grosne;167;4535173;188355;125;4084719;42;450454;27157;28043
57736;Vry;260;7061285;269439;160;5788636;100;1272649;27159;28044
51175;Corrobert;100;2715911;121244;58;2212177;42;503734;27159;28045
76643;Saint-Quentin-au-Bosc;50;1357976;96576;25;1098349;25;259627;27160;28046
07198;Rompon;519;14095875;473666;335;11876466;184;2219409;27160;28047
07288;Saint-Priest;655;17789620;794435;445;15143687;210;2645933;27160;28048
60585;Saint-Martin-aux-Bois;156;4237621;396840;85;3434066;71;803555;27164;28049
52522;Viéville;163;4427799;235867;97;3634185;66;793614;27164;28050
33293;Montussan;1590;43191569;2089523;1049;36779286;541;6412283;27165;28051
60392;Mélicocq;352;9561923;485791;252;8486136;100;1075787;27165;28052
89328;Rouvray;199;5405867;298060;140;4685942;59;719925;27165;28053
27073;Bois-le-Roi;520;14126408;602966;346;11918965;174;2207443;27166;28054
60149;Chevrières;951;25836229;1335294;645;22439017;306;3397212;27167;28055
60125;Canly;423;11491924;573278;281;9827984;142;1663940;27168;28056
67328;Niedermodern;429;11654979;612066;289;9915607;140;1739372;27168;28057
31518;Saint-Thomas;284;7715692;410537;169;6200025;115;1515667;27168;28058
28326;Saint-Avit-les-Guespières;182;4944590;236540;117;4075535;65;869055;27168;28059
64482;Saint-Jammes;310;8422243;354401;199;7382265;111;1039978;27169;28060
80717;Saint-Sauflieu;505;13720171;736307;343;11872101;162;1848070;27169;28061
63036;Bergonne;193;5243856;277586;121;4383780;72;860076;27170;28062
01203;Laiz;575;15623064;654165;380;13191879;195;2431185;27171;28063
76743;Villers-Écalles;908;24671547;1098257;643;21596982;265;3074565;27171;28064
60268;Gannes;170;4619204;299687;102;3784254;68;834950;27172;28065
34050;Candillargues;733;19917401;1285449;435;16274699;298;3642702;27172;28066
63042;Blanzat;2072;56303249;2840365;1366;48167132;706;8136117;27173;28067
49262;Rou-Marson;331;8994506;301685;228;7611496;103;1383010;27174;28068
42330;Villars;4242;115273683;6002807;2886;98292090;1356;16981593;27174;28069
59483;Quiévelon;75;2038209;205754;44;1740666;31;297543;27176;28070
18004;Allogny;560;15219434;811300;365;13027970;195;2191464;27178;28071
33224;Landerrouet-sur-Ségur;62;1685032;89368;32;1351328;30;333704;27178;28072
73283;Saint-Vital;356;9675414;491919;235;8244656;121;1430758;27178;28073
18008;Arçay;253;6876121;316324;183;6011299;70;864822;27178;28074
67377;Plaine;529;14377722;728977;331;11569535;198;2808187;27179;28075
47238;Sainte-Colombe-en-Bruilhois;848;23048730;1097804;529;19540335;319;3508395;27180;28076
76625;Saint-Nicolas-de-Bliquetuit;273;7420380;348064;184;6377030;89;1043350;27181;28077
50084;Bricqueville-la-Blouette;302;8208681;318130;182;6722215;120;1486466;27181;28078
34330;Vérargues;316;8589380;506734;184;7150463;132;1438917;27182;28079
26077;Charmes-sur-l'Herbasse;437;11878426;681763;262;9890809;175;1987617;27182;28080
11043;Bouilhonnac;130;3533915;165858;83;3028278;47;505637;27184;28081
78276;Gommecourt;343;9324386;547691;249;8424329;94;900057;27185;28082
25628;Villers-sous-Montrond;90;2446651;113676;56;2097500;34;349151;27185;28083
27010;Amécourt;91;2473856;181983;53;2086127;38;387729;27185;28084
90101;Vellescot;121;3289538;130578;82;2880281;39;409257;27186;28085
54474;Sainte-Geneviève;99;2691624;117389;68;2374717;31;316907;27188;28086
67453;Schoenau;280;7612842;259764;192;6349903;88;1262939;27189;28087
91533;Saclas;985;26780992;1512568;670;23042722;315;3738270;27189;28088
72111;Cures;221;6009410;187368;138;4933917;83;1075493;27192;28089
50594;Teurthéville-Hague;441;11992069;401323;291;10189620;150;1802449;27193;28090
60072;Bitry;168;4568425;288608;106;3871592;62;696833;27193;28091
77002;Amillis;450;12237342;919737;265;10152854;185;2084488;27194;28092
01025;Bâgé-la-Ville;1501;40822417;1741344;963;34443048;538;6379369;27197;28093
37263;Truyes;1074;29210264;1318830;728;25408723;346;3801541;27198;28094
26065;Chabrillan;367;9981577;566708;231;8310900;136;1670677;27198;28095
35006;Argentré-du-Plessis;2102;57170229;2877538;1221;45901147;881;11269082;27198;28096
08313;Nanteuil-sur-Aisne;70;1903900;126413;39;1551555;31;352345;27199;28097
02216;Corcy;166;4515065;255042;110;3884874;56;630191;27199;28098
45098;Cléry-Saint-André;1716;46673917;2274791;1163;40282482;553;6391435;27199;28099
76223;Écalles-Alix;253;6881637;369591;160;5764516;93;1117121;27200;28100
42224;Saint-Genest-Malifaux;1473;40066000;2165885;887;33477100;586;6588900;27200;28101
80131;Boves;1555;42296546;2243770;1053;36718203;502;5578343;27200;28102
67293;Minversheim;320;8704427;347918;223;7637472;97;1066955;27201;28103
32307;Pavie;1350;36721823;2124012;898;31806642;452;4915181;27201;28104
27670;Vandrimare;476;12948061;565812;308;10713211;168;2234850;27202;28105
80835;Yzeux;132;3590804;170308;88;3040879;44;549925;27203;28106
73314;Villard-d'Héry;138;3754035;205305;94;3225044;44;528991;27203;28107
57048;Bannay;44;1197021;64180;23;1009509;21;187512;27205;28108
85076;Cugand;1748;47554417;2278308;1061;39292282;687;8262135;27205;28109
42105;Grézieux-le-Fromental;76;2067584;85112;49;1680615;27;386969;27205;28110
27418;Morsan;61;1659523;110230;37;1398998;24;260525;27205;28111
22353;Trégastel;1518;41298062;2242895;927;34371837;591;6926225;27206;28112
21436;Montmain;56;1523594;58994;39;1278962;17;244632;27207;28113
14214;Cussy;88;2394220;104697;58;2040141;30;354079;27207;28114
02171;Chaudardes;44;1197153;55844;29;990902;15;206251;27208;28115
45264;Rozières-en-Beauce;97;2639389;117473;70;2274800;27;364589;27210;28116
74095;Crempigny-Bonneguête;129;3510133;102470;84;2908941;45;601192;27210;28117
43078;Coubon;1677;45634143;2307271;1081;38842193;596;6791950;27212;28118
76485;Omonville;117;3183904;138992;73;2631540;44;552364;27213;28119
83141;Trans-en-Provence;3097;84279064;4592826;1959;71983916;1138;12295148;27213;28120
08339;Perthes;159;4326890;199234;104;3734536;55;592354;27213;28121
10174;Isle-Aubigny;92;2503616;259390;44;1968563;48;535053;27213;28122
40209;Ondres;2606;70917924;3528301;1743;61112645;863;9805279;27213;28123
39352;Monteplain;63;1714538;46305;36;1373723;27;340815;27215;28124
38390;Saint-Gervais;258;7021564;315510;164;5987208;94;1034356;27215;28125
21126;Cessey-sur-Tille;312;8491486;373481;219;7423386;93;1068100;27216;28126
57309;Heining-lès-Bouzonville;251;6831450;336877;158;5686251;93;1145199;27217;28127
81164;Mézens;222;6042578;339050;124;4884109;98;1158469;27219;28128
13087;Rousset;2484;67612112;3806359;1560;56797014;924;10815098;27219;28129
80188;Chaussoy-Epagny;309;8410797;452419;191;7097586;118;1313211;27219;28130
02715;Serval;27;734935;101843;13;585770;14;149165;27220;28131
50178;Fermanville;793;21586494;1279476;509;18500963;284;3085531;27221;28132
40125;Heugas;697;18973681;1017301;442;16096863;255;2876818;27222;28133
64302;Lagos;235;6397245;325598;142;5280375;93;1116870;27222;28134
19038;Chameyrat;918;24990510;1402887;629;21605510;289;3385000;27223;28135
76082;Bernières;324;8820210;376170;212;7551597;112;1268613;27223;28136
10340;Saint-Germain;1158;31525719;1496515;788;27164664;370;4361055;27224;28137
67502;Uttenhoffen;112;3049215;160466;80;2690831;32;358384;27225;28138
76046;Auzouville-sur-Ry;338;9202323;384310;236;8047375;102;1154948;27226;28139
40026;Bas-Mauco;166;4519797;171319;125;3993967;41;525830;27228;28140
01130;Cras-sur-Reyssouze;669;18215345;650703;473;15131600;196;3083745;27228;28141
44024;Brains;1245;33898547;1269420;860;29056491;385;4842056;27228;28142
63270;Parentignat;274;7460463;328145;179;6356086;95;1104377;27228;28143
62131;Bihucourt;157;4274968;224199;92;3439591;65;835377;27229;28144
51545;Sommesous;253;6889435;413672;149;5614118;104;1275317;27231;28145
37245;Semblançay;1041;28348351;1410474;683;24108678;358;4239673;27232;28146
60675;Vignemont;214;5827703;279483;140;5028134;74;799569;27232;28147
52354;Noidant-Chatenoy;46;1252712;51013;31;1081815;15;170897;27233;28148
34140;Lignan-sur-Orb;1662;45266332;2206768;939;36557828;723;8708504;27236;28149
07070;Cornas;1171;31893870;1401388;768;26923251;403;4970619;27236;28150
76089;Betteville;278;7571766;370408;180;6540849;98;1030917;27237;28151
64540;Urcuit;1135;30913972;1240530;741;25897918;394;5016054;27237;28152
38091;Châteauvilain;333;9069983;410452;206;7544222;127;1525761;27237;28153
28369;Saulnières;307;8361833;371255;204;7080085;103;1281748;27237;28154
67142;Fort-Louis;165;4494265;263299;104;3706837;61;787428;27238;28155
66063;Les Cluses;145;3949729;285086;77;3166088;68;783641;27240;28156
46271;Saint-Jean-Lespinasse;233;6346884;309303;154;5522357;79;824527;27240;28157
01249;Miribel;5024;136857741;7771932;3220;116918482;1804;19939259;27241;28158
38292;Paladru;594;16181076;737308;397;13757853;197;2423223;27241;28159
80059;Bazentin;47;1280365;122762;26;1059448;21;220917;27242;28160
38485;Seyssinet-Pariset;6919;188486438;10870924;4738;165296214;2181;23190224;27242;28161
10169;Gumery;127;3459787;197004;85;2977215;42;482572;27242;28162
68065;Chavannes-sur-l'Étang;309;8418196;349156;198;7032197;111;1385999;27243;28163
39199;Domblans;489;13322208;729690;294;10974690;195;2347518;27244;28164
84058;Lacoste;243;6620359;511974;132;5455666;111;1164693;27244;28165
76198;Criquetot-sur-Ouville;345;9399659;400426;215;7736770;130;1662889;27245;28166
53014;Azé;1669;45472572;1538058;1003;37004778;666;8467794;27245;28167
35126;Guichen;3776;102880260;4295873;2466;87469952;1310;15410308;27246;28168
10205;Longpré-le-Sec;44;1198898;79146;28;998892;16;200006;27248;28169
39405;Parcey;510;13896760;753736;347;11897831;163;1998929;27249;28170
41129;Maslives;362;9864421;579270;246;8668501;116;1195920;27250;28171
68113;Guémar;727;19810902;903877;499;16884877;228;2926025;27250;28172
69273;Corbas;5181;141189431;6430898;3615;121945320;1566;19244111;27251;28173
77355;Paroy;100;2725153;127617;64;2328495;36;396658;27252;28174
73057;Brides-les-Bains;350;9538132;579067;242;8208179;108;1329953;27252;28175
35055;Chantepie;5677;154713458;8250366;3930;135418537;1747;19294921;27253;28176
27262;Fourges;426;11610600;600331;297;10089996;129;1520604;27255;28177
28013;Aunay-sous-Auneau;677;18451796;851573;465;16046577;212;2405219;27255;28178
85288;Talmont-Saint-Hilaire;4149;113082707;6378756;2428;93894944;1721;19187763;27255;28179
80359;Fresnoy-lès-Roye;151;4115578;250805;93;3483353;58;632225;27255;28180
26211;Montségur-sur-Lauzon;684;18643323;1223181;405;15902459;279;2740864;27256;28181
27521;Saint-Christophe-sur-Avre;74;2016969;94681;46;1713370;28;303599;27256;28182
69024;Le Bois-d'Oingt;1204;32817237;1756859;721;27162787;483;5654450;27257;28183
25588;Vaucluse;55;1499131;126075;37;1289040;18;210091;27257;28184
60196;Le Déluge;260;7086850;353088;175;6102454;85;984396;27257;28185
13011;Les Baux-de-Provence;250;6814283;577258;131;5443465;119;1370818;27257;28186
10318;Rigny-la-Nonneuse;85;2316899;140383;55;1918528;30;398371;27258;28187
88371;Raon-aux-Bois;609;16600619;703912;385;13894862;224;2705757;27259;28188
14362;Lessard-et-le-Chêne;94;2562363;233668;51;2149200;43;413163;27259;28189
55377;Nepvant;37;1008594;31142;19;711087;18;297507;27259;28190
02546;La Neuville-en-Beine;92;2507862;128198;55;2016177;37;491685;27259;28191
31203;Frouzins;4502;122728478;6329960;2913;104343942;1589;18384536;27261;28192
2B309;Santa-Maria-di-Lota;1067;29087893;2275487;603;24686198;464;4401695;27261;28193
76227;Ectot-l'Auber;270;7360862;227891;171;5907124;99;1453738;27262;28194
41013;Bauzy;143;3898601;222965;76;3055535;67;843066;27263;28195
38137;Cras;217;5916101;196963;137;4902704;80;1013397;27263;28196
80603;Ochancourt;156;4253115;152294;94;3577155;62;675960;27264;28197
42089;Essertines-en-Châtelneuf;355;9678715;396559;217;8082025;138;1596690;27264;28198
73026;Avrieux;213;5807334;274875;162;5194996;51;612338;27264;28199
64246;Gomer;125;3408062;121238;79;2936308;46;471754;27264;28200
33263;Madirac;112;3053696;143356;74;2654431;38;399265;27265;28201
38070;Le Champ-près-Froges;648;17667867;833088;451;15356559;197;2311308;27265;28202
28426;Ymonville;265;7225380;360337;169;6074538;96;1150842;27266;28203
44032;La Chapelle-Heulin;1453;39616909;1399977;963;33559831;490;6057078;27266;28204
27516;Saint-Aubin-le-Vertueux;498;13578373;773372;295;11055895;203;2522478;27266;28205
08131;Cornay;46;1254415;76012;16;928789;30;325626;27270;28206
27640;Tilleul-Dame-Agnès;95;2590687;134035;61;2151708;34;438979;27270;28207
33084;Cambes;720;19636338;1214938;433;16332782;287;3303556;27273;28208
59539;Saint-Pierre-Brouck;437;11918348;457977;253;9463188;184;2455160;27273;28209
54027;Atton;401;10936547;469951;297;9723600;104;1212947;27273;28210
07344;Vinzieux;187;5100162;185462;126;4369485;61;730677;27274;28211
01024;Attignat;1502;40968952;1772323;1015;34258641;487;6710311;27276;28212
02392;Joncourt;159;4336970;237676;91;3442049;68;894921;27277;28213
80553;Molliens-au-Bois;164;4473388;185425;108;3733359;56;740029;27277;28214
38035;Beauvoir-de-Marc;518;14130016;641923;349;12228417;169;1901599;27278;28215
02382;Holnon;703;19176634;945563;446;16028670;257;3147964;27278;28216
52141;Condes;171;4665046;232548;122;4101330;49;563716;27281;28217
57351;Jury;525;14322745;872271;333;12960746;192;1361999;27281;28218
01008;Ambutrix;389;10612751;478392;293;9410150;96;1202601;27282;28219
64376;Meillon;437;11922554;550137;266;10082311;171;1840243;27283;28220
60678;Villeneuve-les-Sablons;603;16453097;751271;407;14106488;196;2346609;27285;28221
10256;Montsuzain;196;5348218;237162;123;4461268;73;886950;27287;28222
41158;Naveil;1150;31380183;1505259;769;26418105;381;4962078;27287;28223
28336;Saint-Éman;63;1719148;100896;47;1566455;16;152693;27288;28224
59186;Eccles;57;1555428;75401;39;1371780;18;183648;27288;28225
37270;Vernou-sur-Brenne;1429;38996479;1980578;848;31259424;581;7737055;27289;28226
79100;Coulon;1241;33867083;1699720;770;28604099;471;5262984;27290;28227
26088;Chatuzange-le-Goubet;2494;68064162;3316530;1634;57961832;860;10102330;27291;28228
02225;Courchamps;49;1337275;91292;30;1107152;19;230123;27291;28229
57514;Nousseviller-Saint-Nabor;594;16212201;735908;391;13791390;203;2420811;27293;28230
42331;Villemontais;499;13619824;658301;308;11227432;191;2392392;27294;28231
73055;Bozel;1161;31689304;1729084;729;26439567;432;5249737;27295;28232
35058;La Chapelle-Chaussée;519;14166292;626259;330;11736722;189;2429570;27295;28233
25382;Moncey;278;7588257;460567;156;6268809;122;1319448;27296;28234
73186;Notre-Dame-de-Bellecombe;312;8516450;487067;191;7322172;121;1194278;27296;28235
21319;Izeure;360;9826982;426901;255;8588500;105;1238482;27297;28236
61358;Sai;110;3002703;148181;69;2483558;41;519145;27297;28237
54327;Lucey;295;8053537;374278;193;6771615;102;1281922;27300;28238
57550;Porcelette;1338;36527578;1647128;895;31031080;443;5496498;27300;28239
71119;Chaudenay;529;14441795;738672;346;12335325;183;2106470;27300;28240
21702;Villey-sur-Tille;142;3876646;153908;98;3279143;44;597503;27300;28241
60321;Ivry-le-Temple;351;9582565;484228;242;8321578;109;1260987;27301;28242
30294;Saint-Privat-des-Vieux;2737;74724713;4431461;1695;63034568;1042;11690145;27302;28243
57627;Sanry-sur-Nied;163;4450472;179838;113;3814522;50;635950;27304;28244
60229;Le Fayel;122;3331088;168095;87;2928580;35;402508;27304;28245
77083;Champs-sur-Marne;12572;343268788;21935386;8267;299691113;4305;43577675;27304;28246
69045;Charentay;613;16737518;754570;398;14146890;215;2590628;27304;28247
44014;Le Bignon;1620;44233736;1624176;1077;37667845;543;6565891;27305;28248
57584;Rimling;278;7590822;336046;183;6319833;95;1270989;27305;28249
31157;Cugnaux;8982;245258368;14180632;5880;212290307;3102;32968061;27306;28250
54034;Avrainville;121;3304003;156396;79;2798469;42;505534;27306;28251
27150;La Chapelle-Réanville;532;14526844;686519;339;12285847;193;2240997;27306;28252
67432;Salmbach;296;8082630;397638;194;6872087;102;1210543;27306;28253
59443;Ochtezeele;167;4560285;183604;108;3801373;59;758912;27307;28254
25106;Cademène;46;1256129;86479;30;1103197;16;152932;27307;28255
10014;Assencières;85;2321111;97756;60;2015312;25;305799;27307;28256
27637;Thuit-Hébert;152;4150802;191246;103;3641316;49;509486;27308;28257
76473;Notre-Dame-de-Bliquetuit;349;9530717;439299;233;8100785;116;1429932;27309;28258
38162;Faverges-de-la-Tour;662;18078443;883981;451;15680220;211;2398223;27309;28259
50163;Digulleville;139;3796186;180145;92;3270156;47;526030;27311;28260
14694;Le Torquesne;220;6008805;250983;139;4941530;81;1067275;27313;28261
14161;Clarbec;207;5653861;352654;125;4719945;82;933916;27313;28262
25397;Montferrand-le-Château;1173;32039871;1797076;713;27211036;460;4828835;27314;28263
03211;Prémilhat;1340;36602379;2139535;820;31920744;520;4681635;27315;28264
64438;Ouillon;222;6063978;235634;142;5147192;80;916786;27315;28265
67330;Niederroedern;495;13521189;750866;326;11463462;169;2057727;27316;28266
14730;Vaudry;824;22508036;1196127;522;19215188;302;3292848;27316;28267
28205;Lanneray;291;7949498;432136;201;6832750;90;1116748;27318;28268
76109;Bois-Héroult;89;2431321;100219;60;2083681;29;347640;27318;28269
02039;Autremencourt;79;2158253;198779;45;1789981;34;368272;27320;28270
83053;Évenos;1220;33330396;1962246;761;28661516;459;4668880;27320;28271
08218;Les Hautes-Rivières;899;24561404;1387849;458;19691489;441;4869915;27321;28272
39274;Lajoux;146;3988990;197006;84;3239013;62;749977;27322;28273
89480;Vinneuf;711;19426042;925335;464;15634832;247;3791210;27322;28274
68002;Altenach;197;5382494;279082;134;4796854;63;585640;27322;28275
83089;Ollières;311;8497644;465253;189;7095427;122;1402217;27324;28276
55272;Laimont;236;6448553;290517;157;5600910;79;847643;27324;28277
60177;Cressonsacq;222;6066080;367792;158;5399674;64;666406;27325;28278
18251;Sévry;31;847082;57282;13;641251;18;205831;27325;28279
01021;Ars-sur-Formans;670;18308104;875101;427;15709938;243;2598166;27326;28280
90062;Larivière;132;3607097;106465;88;3052493;44;554604;27326;28281
60703;Aux Marais;392;10712128;539140;268;9341025;124;1371103;27327;28282
77158;Diant;125;3416038;342803;73;2914542;52;501496;27328;28283
02271;Dravegny;80;2186272;161600;49;1924436;31;261836;27328;28284
71539;Tintry;44;1202467;67176;29;1008396;15;194071;27329;28285
25084;Boussières;546;14921887;559867;370;12602623;176;2319264;27329;28286
35276;Saint-Gondran;234;6395154;262130;151;5412242;83;982912;27330;28287
78238;Flins-sur-Seine;1344;36731812;1947756;982;32568762;362;4163050;27330;28288
80064;Beaucourt-en-Santerre;87;2377761;89008;59;2029662;28;348099;27331;28289
01104;Chézery-Forens;240;6559438;177222;140;5182333;100;1377105;27331;28290
39561;Villards-d'Héria;233;6368180;320279;149;5367840;84;1000340;27331;28291
76188;Cottévrard;231;6313575;244913;143;5362092;88;951483;27331;28292
68335;Thannenkirch;270;7379631;452823;173;6313757;97;1065874;27332;28293
56084;Le Hézo;404;11042180;524044;258;9418362;146;1623818;27332;28294
02497;Mons-en-Laonnois;573;15661559;835086;343;13148500;230;2513059;27333;28295
28129;Denonville;370;10113152;490800;258;8812929;112;1300223;27333;28296
59566;Sequedin;1995;54531035;2587458;1350;47080110;645;7450925;27334;28297
21053;Beaumont-sur-Vingeanne;111;3034105;111014;65;2123185;46;910920;27334;28298
74301;Villard;406;11097842;402084;225;8191946;181;2905896;27335;28299
36222;Thizay;136;3717507;300697;77;2991127;59;726380;27335;28300
02781;Verdilly;227;6205006;337389;145;5190338;82;1014668;27335;28301
50319;Le Mesnil-Raoult;192;5248763;148349;112;4362365;80;886398;27337;28302
02731;Le Sourd;90;2460494;56888;45;2085500;45;374994;27339;28303
07067;Colombier-le-Cardinal;134;3663406;143070;95;3239866;39;423540;27339;28304
38508;Torchefelon;311;8502484;292175;201;7183222;110;1319262;27339;28305
89310;La Postolle;75;2050499;108699;48;1729139;27;321360;27340;28306
60645;Trie-la-Ville;163;4456444;303235;117;4005212;46;451232;27340;28307
25444;Palise;65;1777123;82958;52;1599183;13;177940;27340;28308
35358;La Ville-ès-Nonais;508;13889490;681544;326;11533550;182;2355940;27342;28309
52297;Luzy-sur-Marne;158;4319982;221812;108;3774670;50;545312;27342;28310
45133;Engenville;265;7245548;246106;178;5956094;87;1289454;27342;28311
02128;Bruyères-et-Montbérault;856;23404715;1436844;530;19736653;326;3668062;27342;28312
28049;Boncé;120;3281049;143573;84;2838583;36;442466;27342;28313
28360;Saint-Sauveur-Marville;442;12086105;559471;289;10173355;153;1912750;27344;28314
60373;Machemont;359;9816715;481798;259;8671619;100;1145096;27345;28315
74170;Massingy;398;10883197;434834;262;9212718;136;1670479;27345;28316
01289;Péronnas;3336;91223207;4690174;2197;77877033;1139;13346174;27345;28317
67048;Bitschhoffen;227;6207591;282111;159;5327657;68;879934;27346;28318
76608;Sainte-Marguerite-sur-Duclair;915;25022239;868882;632;21276877;283;3745362;27347;28319
76717;Val-de-la-Haye;360;9845186;443826;248;8511378;112;1333808;27348;28320
57287;Basse-Ham;1171;32025348;994118;603;22171842;568;9853506;27349;28321
50596;Théville;151;4129675;175950;94;3442132;57;687543;27349;28322
53174;Parigné-sur-Braye;366;10009854;355556;261;8608510;105;1401344;27349;28323
27160;Civières;114;3117839;166661;73;2658992;41;458847;27349;28324
13094;Saint-Étienne-du-Grès;1330;36375126;2402599;778;30579084;552;5796042;27350;28325
68351;Vogelgrun;313;8561155;429182;217;7373089;96;1188066;27352;28326
40258;Sainte-Foy;127;3473725;147366;76;2834933;51;638792;27352;28327
39258;Grande-Rivière;239;6537173;202420;133;5320780;106;1216393;27352;28328
62795;Sibiville;57;1559089;70877;29;1276484;28;282605;27352;28329
50623;Vauville;211;5771368;350650;148;5034244;63;737124;27352;28330
54055;Bayonville-sur-Mad;167;4567893;229370;102;3632888;65;935005;27353;28331
91326;Juvisy-sur-Orge;9245;252881702;18219146;6409;225700477;2836;27181225;27353;28332
40048;Boos;171;4677493;252942;108;3874334;63;803159;27354;28333
51538;Sogny-aux-Moulins;70;1914777;122490;46;1675866;24;238911;27354;28334
14482;Ouézy;111;3036457;131313;80;2621611;31;414846;27355;28335
49123;Distré;778;21282680;959708;510;17887803;268;3394877;27356;28336
67116;Ebersmunster;266;7276667;430619;183;6316297;83;960370;27356;28337
45326;Tournoisis;173;4732622;171363;105;3804691;68;927931;27356;28338
34012;Argelliers;507;13869987;766402;315;11963927;192;1906060;27357;28339
08092;Cauroy;93;2544297;154284;51;2052506;42;491791;27358;28340
76413;Martigny;233;6374592;307412;156;5591698;77;782894;27359;28341
70532;Vellefaux;257;7031319;347430;178;6192557;79;838762;27359;28342
63026;Aydat;1212;33159812;1721160;816;28821868;396;4337944;27360;28343
64304;Lahonce;1098;30041700;1421845;733;25722105;365;4319595;27360;28344
01231;Manziat;968;26486540;1414435;602;22003320;366;4483220;27362;28345
37075;Cigogné;182;4979932;262081;112;4114108;70;865824;27362;28346
25386;Montancy;70;1915380;104561;41;1647650;29;267730;27363;28347
81075;Cuq;267;7305842;292206;124;5914531;143;1391311;27363;28348
38129;Corrençon-en-Vercors;194;5308571;279391;130;4605454;64;703117;27364;28349
10282;Payns;650;17786543;888219;443;15548386;207;2238157;27364;28350
25564;Torpes;478;13080002;536511;335;11123996;143;1956006;27364;28351
71350;Pierreclos;490;13408720;739396;327;11561746;163;1846974;27365;28352
28363;Sainville;484;13244565;555001;325;11351865;159;1892700;27365;28353
37182;Pernay;537;14695594;547687;366;12685776;171;2009818;27366;28354
26140;Geyssans;313;8565676;340852;204;7180092;109;1385584;27366;28355
72020;Avezé;370;10126888;543819;252;8613105;118;1513783;27370;28356
76600;Saint-Léonard;912;24961673;1260112;596;21353593;316;3608080;27370;28357
01198;Joyeux;122;3339178;154095;76;2745195;46;593983;27370;28358
21176;Civry-en-Montagne;55;1505396;72983;39;1317747;16;187649;27371;28359
80193;Chirmont;66;1806506;102613;49;1615266;17;191240;27371;28360
57136;Chémery-les-Deux;226;6186070;131854;130;4649273;96;1536797;27372;28361
25356;Maîche;2462;67390075;4451150;1535;57625386;927;9764689;27372;28362
77050;Bransles;294;8047855;460420;186;6817999;108;1229856;27374;28363
14045;Basseneville;147;4024034;204616;100;3538402;47;485632;27374;28364
77326;Nandy;2826;77360856;3997205;1882;66750309;944;10610547;27375;28365
06010;Le Bar-sur-Loup;1701;46564864;2910262;1043;39961764;658;6603100;27375;28366
67062;Breitenau;155;4243182;191792;102;3572001;53;671181;27375;28367
76447;Montivilliers;8420;230505159;12868498;5365;196666477;3055;33838682;27376;28368
37091;La Croix-en-Touraine;1185;32441694;1555644;790;27373925;395;5067769;27377;28369
67018;Balbronn;327;8952429;424109;217;7390388;110;1562041;27377;28370
66227;Villeneuve-de-la-Raho;2117;57959049;3372553;1302;49181739;815;8777310;27378;28371
50187;Flottemanville-Hague;449;12292768;438904;297;10491500;152;1801268;27378;28372
89451;Villechétive;117;3203310;214167;77;2742531;40;460779;27379;28373
59670;Don;685;18754712;868813;452;15929103;233;2825609;27379;28374
88483;Uxegney;1132;30993945;1350552;780;26846716;352;4147229;27380;28375
50556;Sainte-Suzanne-sur-Vire;311;8515319;284747;229;7529862;82;985457;27380;28376
54446;Réchicourt-la-Petite;36;985740;57503;19;804137;17;181603;27382;28377
13037;La Fare-les-Oliviers;4093;112073765;5799343;2682;96694635;1411;15379130;27382;28378
58071;Chevannes-Changy;80;2190620;253270;39;1755266;41;435354;27383;28379
60134;Cauffry;1251;34257131;1682109;862;29907826;389;4349305;27384;28380
64237;Gelos;1976;54113008;3313587;1187;45817634;789;8295374;27385;28381
69291;Saint-Symphorien-d'Ozon;2887;79064874;3999248;1973;68514937;914;10549937;27387;28382
21268;Flagey-lès-Auxonne;93;2547013;144262;57;2103028;36;443985;27387;28383
41064;Coulanges;178;4875038;239145;123;4172348;55;702690;27388;28384
74236;Saint-Gervais-les-Bains;3448;94436091;5474743;2142;79518547;1306;14917544;27389;28385
28143;Escorpain;119;3259264;161055;74;2698988;45;560276;27389;28386
76453;Morgny-la-Pommeraye;491;13448482;530444;355;11868339;136;1580143;27390;28387
21413;Millery;210;5751904;287172;153;5015496;57;736408;27390;28388
35093;Dinard;6582;180281212;12885325;3758;149009009;2824;31272203;27390;28389
71189;Épervans;767;21008281;1090942;514;17828219;253;3180062;27390;28390
67312;Mutzenhouse;212;5806730;282919;130;4680406;82;1126324;27390;28391
02383;Homblières;794;21749444;1337692;504;18624730;290;3124714;27392;28392
60315;Hodenc-en-Bray;248;6793399;321285;171;5859357;77;934042;27393;28393
59441;Obies;353;9669656;647687;196;7862848;157;1806808;27393;28394
56094;Kervignac;3176;87001514;3709737;2111;73923724;1065;13077790;27393;28395
71224;Grandvaux;46;1260117;62530;28;1081577;18;178540;27394;28396
68313;Soppe-le-Bas;386;10574426;477384;253;8870465;133;1703961;27395;28397
27297;Grandvilliers;184;5040690;268235;121;4443817;63;596873;27395;28398
30060;Caissargues;2106;57694444;3058394;1357;49118966;749;8575478;27395;28399
39315;Marnoz;205;5616066;283177;124;4571183;81;1044883;27395;28400
02811;Villers-en-Prayères;71;1945081;127258;42;1662651;29;282430;27396;28401
14733;Vaux-sur-Seulles;145;3972367;171020;86;3229618;59;742749;27396;28402
67536;Windstein;103;2821790;144691;67;2299978;36;521812;27396;28403
25196;Dasle;781;21396352;1199101;546;18880597;235;2515755;27396;28404
54591;Voinémont;165;4520376;148780;111;3770627;54;749749;27396;28405
29135;Loctudy;2477;67861460;3631762;1458;56246905;1019;11614555;27397;28406
40292;Saubrigues;719;19698236;1087219;445;16511800;274;3186436;27397;28407
76161;Carville-Pot-de-Fer;61;1671201;101696;28;1318134;33;353067;27397;28408
76221;Drosay;104;2849293;98596;57;2284035;47;565258;27397;28409
77279;Marolles-sur-Seine;813;22273972;1181275;531;19095332;282;3178640;27397;28410
18148;Méreau;1269;34767395;1489845;865;29885110;404;4882285;27397;28411
61438;Saint-Ouen-de-Sécherouvre;92;2520615;174155;55;2112664;37;407951;27398;28412
46180;Lunan;262;7178335;310710;167;6144244;95;1034091;27398;28413
02818;Villiers-Saint-Denis;496;13589755;952605;348;11930769;148;1658986;27399;28414
80607;Oissy;113;3096079;120208;72;2534498;41;561581;27399;28415
68336;Traubach-le-Bas;231;6329384;271280;140;5077899;91;1251485;27400;28416
10281;Le Pavillon-Sainte-Julie;147;4027824;173440;98;3466296;49;561528;27400;28417
60479;Ormoy-Villers;327;8960384;442389;237;7859998;90;1100386;27402;28418
61319;Origny-le-Roux;140;3836352;236931;78;3105188;62;731164;27403;28419
39537;Trenal;213;5836803;255174;144;5101833;69;734970;27403;28420
28409;Vieuvicq;233;6384923;380980;146;5344206;87;1040717;27403;28421
27258;Fort-Moville;218;5974190;334096;139;5040522;79;933668;27405;28422
27361;La Lande-Saint-Léger;164;4494649;305033;96;3647258;68;847391;27406;28423
21168;Chevannay;27;739992;53501;15;605888;12;134104;27407;28424
76557;Saint-Arnoult;626;17157446;815212;396;14509461;230;2647985;27408;28425
38462;Saint-Théoffrey;250;6852018;345690;180;6103524;70;748494;27408;28426
01085;La Chapelle-du-Châtelard;188;5152779;235310;134;4446466;54;706313;27408;28427
28375;Serville;176;4823897;248687;121;4101201;55;722696;27409;28428
78267;Gargenville;3708;101632896;5529174;2552;89845076;1156;11787820;27409;28429
91570;Saint-Michel-sur-Orge;11056;303036638;18902558;7664;267206009;3392;35830629;27409;28430
45123;Darvoy;961;26340454;1123558;644;22429703;317;3910751;27409;28431
80023;Andechy;144;3946986;317667;90;3375956;54;571030;27410;28432
27482;La Pyle;71;1946154;101501;54;1758686;17;187468;27411;28433
21644;Trochères;79;2165517;87614;48;1814421;31;351096;27412;28434
51395;Nesle-la-Reposte;59;1617298;135170;28;1204581;31;412717;27412;28435
55101;Chardogne;162;4440720;225327;110;3817835;52;622885;27412;28436
47297;Sembas;72;1973801;135390;41;1624642;31;349159;27414;28437
80819;Wargnies;42;1151416;49133;26;950902;16;200514;27415;28438
25150;Chevigney-sur-l'Ognon;115;3152718;132331;79;2679427;36;473291;27415;28439
81059;Carlus;357;9787849;502834;242;8485644;115;1302205;27417;28440
57636;Schmittviller;170;4661122;253153;101;3951219;69;709903;27418;28441
77437;Saint-Soupplets;1626;44583950;2286807;1092;38351804;534;6232146;27419;28442
49363;Vauchrétien;744;20401419;817903;453;16780526;291;3620893;27421;28443
16399;Verrières;196;5374651;366734;109;4388214;87;986437;27422;28444
25332;Lavernay;276;7568426;343573;183;6449067;93;1119359;27422;28445
26365;Vaunaveys-la-Rochette;347;9515403;766609;199;7732028;148;1783375;27422;28446
76706;Tourville-les-Ifs;289;7925517;370831;178;6515681;111;1409836;27424;28447
63107;Chavaroux;215;5896219;218859;139;5074501;76;821718;27424;28448
28004;Allonnes;151;4141234;203396;102;3550034;49;591200;27425;28449
65268;Layrisse;89;2440904;170313;58;2085415;31;355489;27426;28450
78586;Sartrouville;27558;755814656;47592152;18085;659202262;9473;96612394;27426;28451
22081;Hillion;2144;58802499;3300208;1366;49952186;778;8850313;27427;28452
25410;Morre;695;19062177;802494;459;15984829;236;3077348;27428;28453
68069;Dessenheim;613;16813767;661753;420;14364883;193;2448884;27429;28454
27290;Goupillières;417;11437790;510427;299;10081848;118;1355942;27429;28455
06118;Saint-Cézaire-sur-Siagne;2127;58343665;3042841;1305;48820290;822;9523375;27430;28456
49332;La Séguinière;1954;53599584;2064252;1292;45490199;662;8109385;27431;28457
74127;Féternes;726;19914985;854441;459;16584583;267;3330402;27431;28458
84073;Ménerbes;625;17144537;1304214;335;13770645;290;3373892;27431;28459
30173;Mons;793;21753070;1096795;479;17722797;314;4030273;27431;28460
62426;Héninel;107;2935196;137822;65;2467982;42;467214;27432;28461
68330;Strueth;169;4636144;208407;114;3945410;55;690734;27433;28462
25555;Taillecourt;631;17310532;1148911;416;14904739;215;2405793;27433;28463
60500;Le Plessis-Belleville;1777;48750308;2594872;1267;43026892;510;5723416;27434;28464
64195;Coublucq;59;1618615;242879;28;1336704;31;281911;27434;28465
70433;Quincey;722;19807644;989594;517;17517608;205;2290036;27434;28466
19246;Saint-Viance;906;24855730;1316270;563;20824831;343;4030899;27435;28467
57307;Hayes;106;2908107;91155;68;2487268;38;420839;27435;28468
25067;Blussans;94;2579042;181686;54;2151129;40;427913;27437;28469
77053;Brie-Comte-Robert;9045;248170710;15672027;6386;220602195;2659;27568515;27437;28470
49011;Artannes-sur-Thouet;207;5679756;315502;138;4842564;69;837192;27438;28471
28367;Santilly;183;5021242;340889;117;4147132;66;874110;27438;28472
27531;Saint-Denis-des-Monts;115;3155544;140004;84;2815453;31;340091;27440;28473
02585;Parcy-et-Tigny;130;3567201;162845;77;2924383;53;642818;27440;28474
24392;Saint-Crépin-et-Carlucet;276;7573709;377672;150;6165810;126;1407899;27441;28475
68177;Lautenbach;820;22502169;1167193;536;19052347;284;3449822;27442;28476
22379;Trévou-Tréguignec;760;20855861;1248887;436;17238133;324;3617728;27442;28477
67078;Crastatt;123;3375498;220413;77;2839496;46;536002;27443;28478
02723;Soize;53;1454488;160615;20;1137406;33;317082;27443;28479
80405;Hailles;220;6037501;296329;158;5338286;62;699215;27443;28480
26381;Jaillans;405;11114645;511861;245;9132815;160;1981830;27444;28481
77454;Sognolles-en-Montois;198;5433915;269239;143;4804411;55;629504;27444;28482
71026;Beaumont-sur-Grosne;168;4610666;187595;109;3866239;59;744427;27444;28483
79335;Vallans;393;10785898;498721;258;9006943;135;1778955;27445;28484
27076;Boisset-les-Prévanches;222;6093016;267817;156;5368732;66;724284;27446;28485
01067;Ceignes;135;3705315;151047;87;3155464;48;549851;27447;28486
14257;Évrecy;848;23274978;917204;564;19778312;284;3496666;27447;28487
31589;Villenouvelle;634;17401377;613274;418;14793689;216;2607688;27447;28488
68277;Riquewihr;646;17730846;1150375;417;15221219;229;2509627;27447;28489
73118;Francin;435;11939728;530681;297;10213383;138;1726345;27448;28490
91080;Boissy-le-Cutté;690;18939124;878705;513;17015749;177;1923375;27448;28491
84076;Mirabeau;621;17046771;979717;380;14521464;241;2525307;27451;28492
60355;Laversines;558;15317839;778530;401;13568306;157;1749533;27451;28493
55079;Brillon-en-Barrois;316;8674709;499413;205;7364002;111;1310707;27452;28494
54007;Aingeray;294;8070825;420252;216;7199434;78;871391;27452;28495
83133;Tanneron;834;22895316;1410177;494;19485661;340;3409655;27452;28496
54272;Jaillon;215;5902413;287344;160;5290979;55;611434;27453;28497
80256;Dreuil-lès-Amiens;693;19025056;1052796;490;16851276;203;2173780;27453;28498
51092;Broyes;208;5710527;398543;120;4700730;88;1009797;27454;28499
31137;Cessales;80;2196365;137171;52;1938174;28;258191;27455;28500
29051;Ergué-Gabéric;4033;110726132;4891358;2727;95329637;1306;15396495;27455;28501
42300;Sevelinges;340;9334794;510026;210;7586765;130;1748029;27455;28502
76174;Cideville;148;4063383;189664;102;3460236;46;603147;27455;28503
17376;Saint-Ouen-d'Aunis;598;16418856;769656;398;13940567;200;2478289;27456;28504
25061;Bief;64;1757240;97022;44;1571107;20;186133;27457;28505
27257;Forêt-la-Folie;227;6232759;328882;144;5277496;83;955263;27457;28506
83120;Saint-Zacharie;2720;74683454;4293102;1672;62860770;1048;11822684;27457;28507
89477;Villy;60;1647440;92855;38;1406560;22;240880;27457;28508
33068;Bourideys;45;1235583;139269;22;976502;23;259081;27457;28509
39360;Montmirey-la-Ville;89;2443732;149306;56;2087444;33;356288;27458;28510
89450;Villebougis;328;9006391;487218;224;7790745;104;1215646;27459;28511
67408;Romanswiller;662;18178152;790665;426;15029167;236;3148985;27459;28512
62130;Bienvillers-au-Bois;341;9363954;669862;182;7564892;159;1799062;27460;28513
25111;Chalèze;209;5739198;258390;146;4970410;63;768788;27460;28514
31546;Seyre;54;1482917;46173;37;1289336;17;193581;27461;28515
02290;Essômes-sur-Marne;1494;41029178;2597357;937;35277196;557;5751982;27463;28516
88522;Vomécourt-sur-Madon;34;933758;36112;20;737691;14;196067;27463;28517
45096;Les Choux;290;7964576;449534;185;6798088;105;1166488;27464;28518
76080;Bermonville;219;6014748;278303;144;5163292;75;851456;27465;28519
67351;Seebach;919;25240970;1164725;582;21170187;337;4070783;27466;28520
03269;Sauvagny;48;1318387;121321;25;1008754;23;309633;27466;28521
68211;Mitzach;220;6042745;391596;131;4978022;89;1064723;27467;28522
24274;Monbazillac;494;13568722;845128;295;11532133;199;2036589;27467;28523
47097;Feugarolles;529;14530481;608269;212;11177254;317;3353227;27468;28524
57439;Manderen;210;5768964;224132;79;3179208;131;2589756;27471;28525
25163;Corcelle-Mieslot;59;1620845;70184;37;1413111;22;207734;27472;28526
17019;Ars-en-Ré;865;23764576;1734214;529;19981671;336;3782905;27473;28527
28392;Trancrainville;94;2582509;129111;62;2159459;32;423050;27474;28528
40294;Saugnac-et-Cambran;825;22665672;1115431;503;18603414;322;4062258;27474;28529
57459;Merschweiller;85;2335341;46409;37;1393535;48;941806;27475;28530
11429;Villemoustaussou;2085;57284607;3151790;1301;48394093;784;8890514;27475;28531
28189;Guilleville;94;2582625;141048;58;2155298;36;427327;27475;28532
68071;Diefmatten;143;3928904;182962;98;3358581;45;570323;27475;28533
50220;Gréville-Hague;391;10742920;509129;264;9322837;127;1420083;27475;28534
01002;L'Abergement-de-Varey;127;3489529;150912;84;2955977;43;533552;27477;28535
80634;Pont-Noyelles;408;11211868;508035;287;9667803;121;1544065;27480;28536
53254;Saint-Sulpice;102;2803018;100749;67;2341790;35;461228;27481;28537
57072;Bettelainville;306;8409122;390506;187;6704448;119;1704674;27481;28538
22224;Ploulec'h;882;24240748;1182548;568;20732405;314;3508343;27484;28539
64007;Agnos;492;13522104;668019;340;11611922;152;1910182;27484;28540
45218;Le Moulinet-sur-Solin;88;2418680;216944;57;2051054;31;367626;27485;28541
28418;Villiers-Saint-Orien;87;2391202;153978;54;2005083;33;386119;27485;28542
73098;Les Déserts;430;11818804;690031;280;9822906;150;1995898;27486;28543
37006;Artannes-sur-Indre;1289;35429874;1634959;865;30108020;424;5321854;27486;28544
57298;Harreberg;212;5827194;304663;124;4837133;88;990061;27487;28545
49343;La Tessoualle;1515;41643877;1736201;947;34063369;568;7580508;27488;28546
90077;Petit-Croix;151;4150659;199339;102;3547835;49;602824;27488;28547
55476;Savonnières-devant-Bar;273;7504210;492280;175;6323412;98;1180798;27488;28548
54314;Lexy;1793;49286646;1364973;869;30740793;924;18545853;27488;28549
28224;Lutz-en-Dunois;219;6020232;340405;147;5269816;72;750416;27490;28550
73137;Jacob-Bellecombette;2047;56273787;4265919;1336;49334239;711;6939548;27491;28551
27520;Saint-Benoît-des-Ombres;65;1786934;91888;37;1392081;28;394853;27491;28552
70493;Sorans-lès-Breurey;190;5223494;176379;118;4150507;72;1072987;27492;28553
33443;Saint-Martin-de-Lerm;79;2171893;166774;49;1921666;30;250227;27492;28554
31592;Larra;752;20674512;992202;516;18006071;236;2668441;27493;28555
73302;La Trinité;148;4068939;307606;90;3425511;58;643428;27493;28556
29265;Sainte-Sève;453;12454389;492896;322;10774891;131;1679498;27493;28557
37079;Civray-de-Touraine;946;26008617;1401079;581;21780020;365;4228597;27493;28558
87020;Bonnac-la-Côte;772;21225312;1082795;514;18252597;258;2972715;27494;28559
10043;Bessy;75;2062109;141914;49;1761222;26;300887;27495;28560
25466;Pouilley-Français;401;11025980;413493;298;9733365;103;1292615;27496;28561
56063;Gestel;1307;35938948;1500710;871;30305069;436;5633879;27497;28562
62807;Tatinghem;895;24610367;1172338;553;20304654;342;4305713;27498;28563
59466;Pont-à-Marcq;1383;38030471;1836219;914;32572098;469;5458373;27499;28564
56251;Theix;3528;97023470;4406365;2297;82394248;1231;14629222;27501;28565
27523;Saint-Clair-d'Arcey;177;4867804;243934;115;4103469;62;764335;27502;28566
32247;Maurens;147;4042847;251655;95;3420551;52;622296;27502;28567
61173;Fontenai-sur-Orne;140;3850337;176804;96;3367788;44;482549;27502;28568
29133;Locquirec;885;24339697;1493504;522;19962488;363;4377209;27502;28569
02708;Sequehart;116;3190324;132178;78;2743236;38;447088;27503;28570
62166;Bours;286;7866087;493373;163;6515760;123;1350327;27504;28571
67465;Sessenheim;1152;31684474;1670197;729;26792408;423;4892066;27504;28572
28290;Orrouer;142;3905591;153980;93;3292474;49;613117;27504;28573
47019;Bajamont;533;14660176;799839;355;12605001;178;2055175;27505;28574
31383;Montjoire;614;16888512;725548;412;14578809;202;2309703;27506;28575
25112;Chalezeule;675;18566501;1113808;418;15529896;257;3036605;27506;28576
01092;Châtillon-la-Palud;774;21289607;908195;494;17934255;280;3355352;27506;28577
25532;Saône;1664;45771183;2316451;1091;38708313;573;7062870;27507;28578
71086;Changy;235;6464113;342680;145;5415885;90;1048228;27507;28579
01150;Drom;100;2750763;119047;69;2387913;31;362850;27508;28580
01072;Ceyzériat;1566;43079122;2436776;1049;37158513;517;5920609;27509;28581
2B043;Brando;1009;27756654;2197469;601;23850809;408;3905845;27509;28582
14036;Banneville-la-Campagne;70;1925649;75991;45;1649352;25;276297;27509;28583
38346;Royas;193;5309292;279891;122;4408137;71;901155;27509;28584
58273;Sauvigny-les-Bois;772;21237294;1102307;540;18662359;232;2574935;27509;28585
34276;Saint-Mathieu-de-Tréviers;2306;63438757;3274955;1386;53101624;920;10337133;27510;28586
13035;Eyguières;3872;106522653;6531774;2423;91705681;1449;14816972;27511;28587
36136;Murs;79;2173397;138486;49;1823163;30;350234;27511;28588
27535;Saint-Élier;238;6547852;306806;167;5681408;71;866444;27512;28589
62448;Hesdin-l'Abbé;966;26577012;1460519;584;22236613;382;4340399;27512;28590
84118;Saint-Saturnin-lès-Apt;1636;45011057;3043682;959;37355002;677;7656055;27513;28591
59595;Thun-Saint-Martin;282;7758918;397069;185;6831525;97;927393;27514;28592
27684;Le Vieil-Évreux;395;10868584;545308;288;9597379;107;1271205;27515;28593
02326;Fontenoy;285;7842013;416203;171;6604440;114;1237573;27516;28594
42251;Saint-Laurent-la-Conche;297;8172229;404501;184;6924728;113;1247501;27516;28595
61490;Tournai-sur-Dive;162;4457695;304131;100;3731120;62;726575;27517;28596
42174;Poncins;479;13180760;568711;320;11181234;159;1999526;27517;28597
28092;Châtenay;115;3164583;221033;70;2601587;45;562996;27518;28598
74033;Bernex;678;18657394;938443;473;16118985;205;2538409;27518;28599
31233;Grépiac;488;13428990;653624;318;11487510;170;1941480;27518;28600
41296;Vouzon;765;21051904;1319048;460;16641419;305;4410485;27519;28601
14157;Cheux;606;16676555;711108;410;14267240;196;2409315;27519;28602
27055;Bérengeville-la-Campagne;149;4100495;258005;100;3613540;49;486955;27520;28603
85060;Château-d'Olonne;8333;229326565;13604161;5013;190762899;3320;38563666;27520;28604
68192;Valdieu-Lutran;193;5311447;293125;130;4542164;63;769283;27520;28605
01245;Bohas-Meyriat-Rignat;470;12934958;598582;308;10956922;162;1978036;27521;28606
63135;Davayat;305;8394141;454470;212;7442749;93;951392;27522;28607
80066;Beaucourt-sur-l'Hallue;139;3825540;225857;86;3200274;53;625266;27522;28608
62748;Saint-Folquin;1041;28651421;1314238;666;24273825;375;4377596;27523;28609
21289;Fussey;58;1596481;61916;37;1310573;21;285908;27526;28610
13020;Cadolive;1137;31297223;1658745;730;26470782;407;4826441;27526;28611
21389;Marmagne;143;3936241;256526;102;3550493;41;385748;27526;28612
60330;Laboissière-en-Thelle;645;17754568;895135;430;15073210;215;2681358;27526;28613
60549;Rotangy;100;2752693;94810;55;2157291;45;595402;27527;28614
26312;Saint-Marcel-lès-Sauzet;629;17314612;863949;414;14862972;215;2451640;27527;28615
67164;Goxwiller;423;11644573;539285;299;10070848;124;1573725;27529;28616
41029;Candé-sur-Beuvron;741;20398654;904483;504;17616826;237;2781828;27529;28617
37204;Rouziers-de-Touraine;577;15884206;656231;389;13536853;188;2347353;27529;28618
25227;Étray;103;2835513;118278;68;2479317;35;356196;27529;28619
80431;Hérissart;300;8258776;395663;194;6935099;106;1323677;27529;28620
16050;Bonneuil;152;4184542;364712;83;3551519;69;633023;27530;28621
57318;Hermelange;118;3248620;165101;87;2850174;31;398446;27531;28622
28251;Mézières-en-Drouais;536;14756744;855955;356;13113702;180;1643042;27531;28623
55271;Laheycourt;200;5507196;297136;115;4473665;85;1033531;27536;28624
57502;Neunkirchen-lès-Bouzonville;178;4901515;194578;111;3855412;67;1046103;27537;28625
79003;Aiffres;2890;79582960;4004605;1873;67400604;1017;12182356;27537;28626
61094;La Chapelle-au-Moine;294;8096036;369527;196;6912363;98;1183673;27538;28627
84100;La Roque-Alric;36;991361;109078;19;763924;17;227437;27538;28628
77272;Maison-Rouge;430;11841614;683684;275;10122881;155;1718733;27539;28629
38268;Le Moutaret;122;3359715;132504;88;2908546;34;451169;27539;28630
76118;Bornambusc;122;3359955;131173;77;2843824;45;516131;27541;28631
78531;Rosny-sur-Seine;2809;77363051;3998324;1876;66734907;933;10628144;27541;28632
41104;Huisseau-sur-Cosson;1191;32802468;1596836;805;28306198;386;4496270;27542;28633
14675;Soliers;1012;27872571;1276958;694;24135791;318;3736780;27542;28634
31374;Montesquieu-Lauragais;491;13524206;678163;341;11946743;150;1577463;27544;28635
73162;Montailleur;334;9200216;604691;215;8100722;119;1099494;27546;28636
18157;Morthomiers;383;10550286;515439;274;9319803;109;1230483;27546;28637
26145;Les Granges-Gontardes;340;9365813;458450;238;8156153;102;1209660;27547;28638
28175;La Gaudaine;89;2451673;140339;62;2113274;27;338399;27547;28639
59027;Aubry-du-Hainaut;767;21128763;1177382;469;18149009;298;2979754;27547;28640
51003;Aigny;127;3498545;188737;85;2956588;42;541957;27548;28641
51164;Connantray-Vaurefroy;86;2369105;187492;52;1961700;34;407405;27548;28642
27322;La Haye-Malherbe;810;22314279;1170120;566;19471704;244;2842575;27548;28643
89068;Chablis;1325;36503536;2729490;760;30698884;565;5804652;27550;28644
68200;Manspach;305;8403316;501541;188;7042023;117;1361293;27552;28645
28353;Saint-Maur-sur-le-Loir;209;5759042;293228;136;4991551;73;767491;27555;28646
38189;Heyrieux;2564;70652721;3795946;1794;61933582;770;8719139;27556;28647
62105;Belle-et-Houllefort;292;8046296;428036;166;6503828;126;1542468;27556;28648
36071;Étrechet;493;13585074;780456;331;11842405;162;1742669;27556;28649
60449;Neufvy-sur-Aronde;125;3444529;168460;92;3077918;33;366611;27556;28650
54109;Ceintrey;456;12566087;525300;326;11001661;130;1564426;27557;28651
49154;Grézillé;321;8845881;580606;159;7198767;162;1647114;27557;28652
10324;Roncenay;85;2342613;171382;51;1919699;34;422914;27560;28653
10208;La Louptière-Thénard;149;4106882;220589;87;3377367;62;729515;27563;28654
71160;Curbigny;156;4299845;228196;99;3610668;57;689177;27563;28655
81063;Castelnau-de-Lévis;813;22409255;1141607;473;18301675;340;4107580;27564;28656
25126;Charnay;233;6422645;340883;154;5469488;79;953157;27565;28657
60225;Étouy;415;11439594;549755;300;10301234;115;1138360;27565;28658
18244;Saugy;39;1075052;64237;27;941098;12;133954;27565;28659
59346;Lezennes;1694;46697402;2501768;1152;40816405;542;5880997;27566;28660
41093;Françay;144;3969644;303027;94;3424312;50;545332;27567;28661
59214;Estrées;541;14913955;671908;354;12905263;187;2008692;27567;28662
45320;Thignonville;165;4548939;205885;113;3837976;52;710963;27569;28663
35065;La Chapelle-Thouarault;938;25860852;1074643;650;22357573;288;3503279;27570;28664
25036;Avanne-Aveney;1246;34353189;1924914;739;28669644;507;5683545;27571;28665
38281;Noyarey;1232;33967368;1740293;843;29732038;389;4235330;27571;28666
59656;Wervicq-Sud;2493;68737221;4150250;1453;57168732;1040;11568489;27572;28667
14406;Martragny;174;4797696;183040;115;4179792;59;617904;27573;28668
14055;Beaumont-en-Auge;258;7114083;491653;152;5980475;106;1133608;27574;28669
41276;Villebarou;1271;35046793;1750626;904;30285859;367;4760934;27574;28670
16358;Saint-Yrieix-sur-Charente;3909;107789175;6165227;2525;92433685;1384;15355490;27575;28671
70278;Grattery;95;2619657;105498;69;2284897;26;334760;27575;28672
65021;Arcizans-Avant;202;5570456;286017;131;4855264;71;715192;27577;28673
21057;Beire-le-Fort;145;3998944;154015;99;3427997;46;570947;27579;28674
62578;Monchiet;47;1296272;74471;27;1059294;20;236978;27580;28675
69009;Anse;3321;91597051;4732253;2157;78198781;1164;13398270;27581;28676
38025;Balbins;219;6040290;293968;138;5019500;81;1020790;27581;28677
12273;Soulages-Bonneval;148;4082132;148294;83;3366810;65;715322;27582;28678
41254;Le Temple;101;2785830;159375;65;2309790;36;476040;27582;28679
31588;Villeneuve-Tolosane;4757;131214453;6754052;3141;112272097;1616;18942356;27583;28680
85176;Pissotte;653;18012352;801924;370;14534068;283;3478284;27584;28681
13071;Les Pennes-Mirabeau;11485;316806932;17836776;7458;272942898;4027;43864034;27584;28682
27021;Asnières;159;4386243;217540;93;3693230;66;693013;27586;28683
89463;Villeneuve-Saint-Salves;133;3669253;147814;95;3284325;38;384928;27588;28684
62230;Colembert;354;9766322;252310;206;8011803;148;1754519;27588;28685
57017;Amanvillers;1030;28416458;1108532;648;23257482;382;5158976;27589;28686
27039;Barneville-sur-Seine;248;6842134;467826;156;5823643;92;1018491;27589;28687
14164;Clinchamps-sur-Orne;542;14953458;690860;380;13097560;162;1855898;27589;28688
09128;Gajan;182;5021333;285779;101;4215389;81;805944;27590;28689
71268;Lugny-lès-Charolles;162;4469623;177528;102;3696282;60;773341;27590;28690
64122;Biarritz;17839;492187314;40070932;10204;415240758;7635;76946556;27591;28691
02424;Leury;58;1600262;133668;32;1311082;26;289180;27591;28692
91399;Mespuits;91;2510873;100761;58;2096786;33;414087;27592;28693
78498;Poissy;20944;577914120;39815725;14093;506266238;6851;71647882;27593;28694
80181;Cayeux-en-Santerre;49;1352144;111359;22;1030476;27;321668;27595;28695
31094;Buzet-sur-Tarn;1260;34770442;1830008;771;29092443;489;5677999;27596;28696
60364;Lieuvillers;327;9023981;696296;212;7762729;115;1261252;27596;28697
09273;Saint-Pierre-de-Rivière;347;9575963;495503;228;7952958;119;1623005;27596;28698
45202;Messas;465;12832377;632264;313;10870072;152;1962305;27597;28699
07008;Alissas;726;20035860;1154544;493;17218089;233;2817771;27598;28700
89410;Tharot;61;1683519;84444;35;1441430;26;242089;27599;28701
14393;Maizet;152;4195354;167107;104;3552677;48;642677;27601;28702
45189;Louzouer;151;4168039;258292;98;3590886;53;577153;27603;28703
67383;Rangen;98;2705087;109164;66;2359552;32;345535;27603;28704
51396;Nesle-le-Repons;78;2153122;109941;49;1759049;29;394073;27604;28705
88498;Vecoux;521;14382697;961819;334;12181580;187;2201117;27606;28706
68290;Rustenhart;408;11263533;490049;273;9514438;135;1749095;27607;28707
38310;Poliénas;551;15211923;785749;337;12637049;214;2574874;27608;28708
57114;Brouviller;204;5632004;225198;147;4950219;57;681785;27608;28709
39579;Viry;515;14218102;719795;354;12344291;161;1873811;27608;28710
85300;Venansault;2178;60130913;2498043;1407;50966276;771;9164637;27608;28711
27393;Martainville;196;5411877;210649;111;4317124;85;1094753;27612;28712
65108;Bours;384;10602869;485622;260;9064084;124;1538785;27612;28713
54179;Éply;152;4196975;222268;97;3583550;55;613425;27612;28714
32091;Castin;167;4611178;254682;113;4056218;54;554960;27612;28715
02594;Passy-en-Valois;72;1988053;80718;44;1529086;28;458967;27612;28716
57052;Barst;282;7786803;329077;182;6664998;100;1121805;27613;28717
51271;Gionges;70;1933045;103127;46;1645100;24;287945;27615;28718
68046;Bourbach-le-Haut;220;6075335;290520;159;5290854;61;784481;27615;28719
70060;Beaumotte-lès-Pin;151;4169891;201640;102;3564849;49;605042;27615;28720
60455;La Neuville-Garnier;142;3921513;204698;96;3437634;46;483879;27616;28721
54373;Moncel-lès-Lunéville;272;7511671;234782;190;6493552;82;1018119;27616;28722
38440;Saint-Pierre-de-Bressieux;397;10964001;535748;239;9045378;158;1918623;27617;28723
67325;Niederhaslach;659;18199942;740050;422;15231508;237;2968434;27618;28724
02410;Largny-sur-Automne;121;3342010;121267;82;2900098;39;441912;27620;28725
54576;Villers-le-Rond;49;1353385;54915;22;916963;27;436422;27620;28726
86226;Saint-Julien-l'Ars;1283;35436840;1716028;863;30833648;420;4603192;27620;28727
68318;Soultzmatt;1198;33089673;1483609;793;28396262;405;4693411;27621;28728
27387;Manthelon;169;4667997;314150;111;4091714;58;576283;27621;28729
73213;La Ravoire;4487;123944754;7202599;3012;106068240;1475;17876514;27623;28730
54103;Bruville;107;2955759;155567;67;2524100;40;431659;27624;28731
38010;Annoisin-Chatelans;319;8812146;398599;208;7391125;111;1421021;27624;28732
22168;Perros-Guirec;4815;133018000;8214272;2911;112213106;1904;20804894;27626;28733
83115;Sainte-Maxime;9294;256771230;19317341;5454;217549890;3840;39221340;27628;28734
76482;Offranville;1738;48020113;2741679;1043;40142606;695;7877507;27630;28735
53162;Moulay;539;14892630;807803;355;12508928;184;2383702;27630;28736
45291;Saint-Martin-sur-Ocre;664;18347856;916716;469;16080132;195;2267724;27632;28737
77036;Boisdon;60;1657994;66827;41;1415782;19;242212;27633;28738
41008;Avaray;378;10445656;636958;249;8963341;129;1482315;27634;28739
80582;Namps-Maisnil;549;15171074;889135;363;13220807;186;1950267;27634;28740
94073;Thiais;16304;450551337;31751944;10578;394793124;5726;55758213;27634;28741
62225;Clairmarais;337;9312859;557936;200;7681623;137;1631236;27635;28742
28184;Gouillons;160;4421561;194603;104;3683186;56;738375;27635;28743
80090;Berny-en-Santerre;82;2266078;179603;41;1811660;41;454418;27635;28744
64415;Navailles-Angos;662;18294656;890891;438;15872150;224;2422506;27635;28745
14246;Escoville;333;9202872;358371;234;7992817;99;1210055;27636;28746
49032;La Bohalle;597;16499077;684488;392;14105353;205;2393724;27637;28747
77424;Saint-Martin-du-Boschet;143;3952059;231296;90;3278676;53;673383;27637;28748
14111;Bucéels;187;5168299;130884;118;4347558;69;820741;27638;28749
54287;Lachapelle;121;3344209;122703;83;2878832;38;465377;27638;28750
80782;Vaux-en-Amiénois;218;6025429;310860;145;5089758;73;935671;27640;28751
39014;Archelange;127;3510338;191246;87;3000356;40;509982;27640;28752
11422;Villedubert;175;4837089;272065;113;4219658;62;617431;27641;28753
36121;Meunet-Planches;95;2626063;199523;62;2245289;33;380774;27643;28754
71385;Saint-Amour-Bellevue;283;7822915;427299;176;6620596;107;1202319;27643;28755
02525;Morcourt;322;8901385;479275;216;7675929;106;1225456;27644;28756
77309;Monthyon;827;22863118;1050965;598;20403450;229;2459668;27646;28757
65150;Clarens;262;7243375;375146;161;5842058;101;1401317;27646;28758
80407;Hallivillers;85;2350086;152235;55;2047282;30;302804;27648;28759
41295;Vineuil;4121;113949780;5882822;2697;97248174;1424;16701606;27651;28760
77123;Compans;378;10452269;648070;258;9388861;120;1063408;27652;28761
14517;Poussy-la-Campagne;44;1216690;55171;31;1059227;13;157463;27652;28762
76200;Critot;236;6526101;303079;140;5430381;96;1095720;27653;28763
01320;Replonges;1859;51407024;2499315;1250;44006735;609;7400289;27653;28764
49223;Mûrs-Erigné;2977;82327178;4223030;1811;69068849;1166;13258329;27654;28765
12229;Saint-Jean-d'Alcapiès;122;3373987;118649;68;2731613;54;642374;27656;28766
39182;Crissey;342;9458248;490092;230;8144462;112;1313786;27656;28767
21585;Saulon-la-Chapelle;539;14906648;788253;352;12639463;187;2267185;27656;28768
59619;Villereau;509;14077037;737033;301;11743252;208;2333785;27656;28769
25490;Rigney;202;5586791;326767;125;4674270;77;912521;27657;28770
45244;Ouzouer-sur-Loire;1463;40463463;1909501;988;34883258;475;5580205;27658;28771
71568;Vérissey;31;857409;68774;19;751199;12;106210;27658;28772
02635;Ramicourt;73;2019073;90303;42;1563267;31;455806;27659;28773
31099;Caignac;158;4370077;192994;95;3699688;63;670389;27659;28774
83094;Le Plan-de-la-Tour;1810;50064160;3618129;996;42351206;814;7712954;27660;28775
60130;Catenoy;544;15047022;766539;381;13244108;163;1802914;27660;28776
60185;Crouy-en-Thelle;563;15572969;749255;394;13527958;169;2045011;27661;28777
15268;Le Rouget;554;15324209;492774;224;12026894;330;3297315;27661;28778
37217;Saint-Étienne-de-Chigny;760;21023381;1068079;492;17834709;268;3188672;27662;28779
54589;Vittonville;67;1853389;56769;48;1593660;19;259729;27663;28780
55191;Foameix-Ornel;100;2766257;104975;62;2340630;38;425627;27663;28781
49235;Parnay;243;6722095;269007;139;5435792;104;1286303;27663;28782
21051;Baulme-la-Roche;52;1438496;70316;32;1216458;20;222038;27663;28783
60166;Coudun;527;14578656;806389;351;12796474;176;1782182;27663;28784
27673;Vatteville;93;2572719;118602;65;2211011;28;361708;27664;28785
31453;Rieumajou;63;1742832;99040;33;1373993;30;368839;27664;28786
80390;Grivesnes;185;5117850;279835;113;4321980;72;795870;27664;28787
76407;Manneville-ès-Plains;142;3928330;245195;87;3350403;55;577927;27664;28788
02702;Savy;322;8908080;428723;212;7580542;110;1327538;27665;28789
57610;Saint-François-Lacroix;120;3319786;88650;61;2087955;59;1231831;27665;28790
34342;Viols-en-Laval;117;3237004;198547;76;2792319;41;444685;27667;28791
28098;Cherisy;979;27086427;1424389;668;23823192;311;3263235;27667;28792
27172;Corneuil;248;6861828;430134;159;6009415;89;852413;27669;28793
33494;Salaunes;422;11676490;466148;293;10112463;129;1564027;27669;28794
10129;Dosches;154;4261483;166415;98;3420821;56;840662;27672;28795
62104;Bellebrune;157;4344535;156760;102;3696488;55;648047;27672;28796
68367;Widensolen;631;17461648;895092;436;15257234;195;2204414;27673;28797
71333;Oslon;602;16659593;637380;414;14263405;188;2396188;27674;28798
26272;Rochefort-en-Valdaine;186;5147538;249378;110;4228209;76;919329;27675;28799
21376;Marandeuil;48;1328416;30436;29;1077326;19;251090;27675;28800
10363;Saint-Thibault;279;7721474;456780;189;6715979;90;1005495;27676;28801
27351;Incarville;729;20177228;1051358;512;17623550;217;2553678;27678;28802
11382;Souilhanels;175;4844066;267083;107;4110509;68;733557;27680;28803
39510;Septmoncel;392;10851410;563401;266;9224732;126;1626678;27682;28804
14541;La Roque-Baignard;56;1550218;66134;40;1407842;16;142376;27682;28805
38445;Saint-Pierre-de-Mésage;384;10630245;427644;261;9026207;123;1604038;27683;28806
2B289;Soveria;50;1384190;106922;27;1183714;23;200476;27684;28807
60520;Le Quesnel-Aubry;97;2685378;139802;64;2360168;33;325210;27684;28808
34120;Jacou;3091;85574693;4104176;2061;73719196;1030;11855497;27685;28809
72230;Parigné-le-Pôlin;505;13981002;655153;336;12023473;169;1957529;27685;28810
50305;Le Mesnil-au-Val;312;8637770;319445;204;6994150;108;1643620;27685;28811
77135;Courpalay;700;19379941;883459;478;16854434;222;2525507;27686;28812
25176;Courvières;130;3599154;151061;82;2966738;48;632416;27686;28813
79293;Saint-Rémy;512;14175495;702232;355;12283620;157;1891875;27687;28814
27593;Saint-Pierre-des-Fleurs;704;19493425;862029;508;17072244;196;2421181;27690;28815
57677;Trémery;545;15090876;596192;336;11633183;209;3457693;27690;28816
50345;Monthuchon;322;8916188;390244;213;7447378;109;1468810;27690;28817
91137;Champmotteux;171;4735041;218206;112;4036006;59;699035;27690;28818
30110;Flaux;174;4818150;382407;89;3953545;85;864605;27691;28819
68098;Friesen;325;9000315;542536;201;7512219;124;1488096;27693;28820
35122;La Gouesnière;741;20520735;771949;466;16954688;275;3566047;27693;28821
02490;Monampteuil;79;2187844;127864;55;1979454;24;208390;27694;28822
49299;Saint-Léger-sous-Cholet;1267;35088590;1367973;873;29851603;394;5236987;27694;28823
73003;Aigueblanche;1859;51485069;2722302;1223;43881117;636;7603952;27695;28824
70547;Verlans;83;2298747;78383;54;1965009;29;333738;27696;28825
77470;Tournan-en-Brie;4579;126819010;7177855;3058;111492286;1521;15326724;27696;28826
59401;Méteren;1079;29884045;1291799;664;24980807;415;4903238;27696;28827
80639;Poulainville;649;17975894;924488;441;15810125;208;2165769;27698;28828
73100;Domessin;937;25953692;1469497;597;21929952;340;4023740;27699;28829
27135;Cesseville;214;5928333;266999;141;5091312;73;837021;27702;28830
25073;Bonnay;420;11636066;424515;293;10214920;127;1421146;27705;28831
31060;Bélesta-en-Lauragais;54;1496083;83066;33;1271451;21;224632;27705;28832
33013;Artigues-près-Bordeaux;4031;111686943;5847601;2775;96514839;1256;15172104;27707;28833
03262;Saint-Victor;1088;30145435;1490504;738;26225547;350;3919888;27707;28834
37171;Noizay;636;17621826;871154;418;15041506;218;2580320;27707;28835
60169;Courcelles-lès-Gisors;422;11692583;465766;278;9896448;144;1796135;27708;28836
77371;Pommeuse;1479;40980392;2263798;1011;35986266;468;4994126;27708;28837
71572;Vers;114;3158743;139758;73;2679891;41;478852;27708;28838
76636;Saint-Pierre-de-Varengeville;1155;32003378;1557859;781;27674314;374;4329064;27709;28839
76085;Bertreville-Saint-Ouen;181;5015371;217284;121;4329358;60;686013;27709;28840
67288;Memmelshoffen;170;4710586;260045;103;3886817;67;823769;27709;28841
02279;Épaux-Bézu;310;8590084;466271;210;7452757;100;1137327;27710;28842
32148;Giscaro;41;1136110;50231;21;994952;20;141158;27710;28843
02454;La Malmaison;205;5680935;239044;94;4494444;111;1186491;27712;28844
27607;Saint-Thurien;131;3630454;208140;88;3165809;43;464645;27713;28845
80661;Rainneville;425;11778394;603195;278;10167365;147;1611029;27714;28846
77373;Pontault-Combault;19568;542316349;31266637;13363;473509734;6205;68806615;27714;28847
32357;Sainte-Anne;51;1413439;60933;28;1113898;23;299541;27714;28848
62889;Wierre-Effroy;390;10809516;576956;226;8814870;164;1994646;27717;28849
01183;Guéreins;669;18542569;815012;462;15931605;207;2610964;27717;28850
27422;Muids;489;13553645;801079;337;11892472;152;1661173;27717;28851
51220;Drouilly;73;2023475;128020;45;1572557;28;450918;27719;28852
27250;Fontaine-Heudebourg;401;11116237;636181;267;9461077;134;1655160;27721;28853
25497;Roches-lès-Blamont;331;9176142;444227;219;7734627;112;1441515;27722;28854
67556;Zeinheim;97;2689117;83663;65;2263934;32;425183;27723;28855
62438;Hermaville;267;7402060;388864;191;6528664;76;873396;27723;28856
21623;Tart-le-Haut;575;15941380;452042;416;13834171;159;2107209;27724;28857
54250;Haraucourt;354;9814710;403920;258;8570698;96;1244012;27725;28858
61014;Aunou-le-Faucon;126;3493491;201025;84;3041562;42;451929;27726;28859
38013;Apprieu;1641;45499011;2117882;1113;39340351;528;6158660;27726;28860
67270;Lixhausen;169;4685912;214765;99;3878689;70;807223;27727;28861
71059;Le Breuil;1888;52349741;2884006;1246;44717560;642;7632181;27728;28862
17193;La Jarne;1357;37627534;1898705;893;31921867;464;5705667;27728;28863
59343;Lesquin;3607;100016975;5267767;2428;86228965;1179;13788010;27729;28864
27683;Vézillon;127;3522043;186263;80;3030072;47;491971;27733;28865
86102;Frozes;254;7044179;334138;173;5922018;81;1122161;27733;28866
15074;Giou-de-Mamou;420;11648551;707274;271;9965761;149;1682790;27735;28867
63322;Saint-Beauzire;1105;30648227;1408953;767;26688799;338;3959428;27736;28868
25132;Châtillon-Guyotte;64;1775148;109345;38;1523944;26;251204;27737;28869
28002;Allaines-Mervilliers;176;4881714;275390;103;4034067;73;847647;27737;28870
38313;Ponsonnas;167;4632102;231073;119;4110273;48;521829;27737;28871
62378;Gouves;103;2857018;143445;73;2507806;30;349212;27738;28872
21183;Collonges-lès-Premières;347;9625219;355152;247;8268613;100;1356606;27738;28873
11430;Villeneuve-la-Comptal;655;18168710;939625;390;15299824;265;2868886;27738;28874
38197;Janneyrias;809;22440616;1080741;572;19617264;237;2823352;27739;28875
45062;Cercottes;613;17003935;647695;463;15005482;150;1998453;27739;28876
47234;Saint-Caprais-de-Lerm;301;8350451;419219;201;7146842;100;1203609;27742;28877
10213;Magnant;98;2718756;161701;61;2321670;37;397086;27742;28878
51018;Athis;416;11541043;589831;268;9552111;148;1988932;27743;28879
62472;Inxent;94;2607875;142056;62;2354499;32;253376;27743;28880
67194;Herrlisheim;2527;70107616;3421959;1743;60563587;784;9544029;27743;28881
50143;Coudeville-sur-Mer;438;12152060;556306;278;10091041;160;2061019;27744;28882
42124;Lupé;155;4300560;204664;87;3332605;68;967955;27746;28883
70044;Auxon;229;6353752;378512;148;5332335;81;1021417;27746;28884
14763;Vouilly;87;2413877;189522;39;1917463;48;496414;27746;28885
25152;La Chevillotte;44;1220858;44885;30;1025718;14;195140;27747;28886
83016;Le Beausset;5426;150557317;9186161;3325;128174653;2101;22382664;27747;28887
60597;Saint-Sauveur;823;22836172;1363153;556;19898150;267;2938022;27747;28888
37230;Saint-Ouen-les-Vignes;525;14567750;737948;336;12171468;189;2396282;27748;28889
54150;Custines;1551;43037809;1878648;980;36575054;571;6462755;27748;28890
54336;Maizières;476;13208913;588035;331;11472306;145;1736607;27750;28891
59598;Toufflers;2016;55945110;2612065;1304;47325327;712;8619783;27751;28892
57413;Longeville-lès-Saint-Avold;2124;58942646;2987129;1282;49434901;842;9507745;27751;28893
45183;Lion-en-Beauce;68;1887063;57888;42;1464482;26;422581;27751;28894
65151;Collongues;76;2109125;124558;48;1755914;28;353211;27752;28895
40055;Bretagne-de-Marsan;682;18927564;1013467;446;16215706;236;2711858;27753;28896
71345;Péronne;302;8381469;413942;211;7129018;91;1252451;27753;28897
64488;Saint-Laurent-Bretagne;212;5883742;277756;142;5141275;70;742467;27754;28898
14469;Norrey-en-Auge;44;1221182;74083;26;1007835;18;213347;27754;28899
31248;Labarthe-sur-Lèze;2548;70718955;3692692;1708;61254329;840;9464626;27755;28900
28317;Roinville;238;6605957;307204;164;5602006;74;1003951;27756;28901
45241;Ouvrouer-les-Champs;266;7383211;360829;174;6160770;92;1222441;27756;28902
14380;Loucelles;92;2553641;117256;60;2148415;32;405226;27757;28903
41282;Villeherviers;275;7633209;416687;151;6168914;124;1464295;27757;28904
61229;Loisail;71;1970780;90140;48;1703799;23;266981;27757;28905
60256;Fresneaux-Montchevreuil;373;10353624;490886;250;8951628;123;1401996;27758;28906
77506;Villemer;391;10853543;627824;269;9564183;122;1289360;27758;28907
88002;Ahéville;37;1027121;67068;25;916435;12;110686;27760;28908
80230;Curchy;159;4413886;325393;85;3546600;74;867286;27760;28909
60570;Saint-Crépin-Ibouvillers;640;17766912;741634;419;15054519;221;2712393;27761;28910
31264;Lagrâce-Dieu;255;7079151;315050;173;6163640;82;915511;27761;28911
70160;Coisevaux;158;4386300;161671;112;3785462;46;600838;27761;28912
89245;Marsangy;430;11937439;677613;303;10605699;127;1331740;27761;28913
32262;Monbrun;184;5108237;232525;119;4446861;65;661376;27762;28914
93045;Les Lilas;13161;365389971;28626450;8589;321357149;4572;44032822;27763;28915
77414;Saint-Hilliers;251;6968539;417352;165;5920944;86;1047595;27763;28916
37050;Chambray-lès-Tours;5989;166280788;10171317;3937;143103036;2052;23177752;27764;28917
69206;Saint-Georges-de-Reneins;2204;61193348;3506194;1400;51792943;804;9400405;27765;28918
10130;Dosnon;51;1416033;95944;29;1190507;22;225526;27765;28919
25511;Rurey;156;4331403;216777;102;3738243;54;593160;27765;28920
55073;Bras-sur-Meuse;343;9523681;428106;230;7747863;113;1775818;27766;28921
80077;Béhencourt;177;4914950;273716;114;4241837;63;673113;27768;28922
57548;Pontoy;204;5664719;294304;142;4991893;62;672826;27768;28923
26275;Rochegude;801;22243672;1316342;495;18866748;306;3376924;27770;28924
61510;Vitrai-sous-Laigle;105;2915892;183573;62;2426400;43;489492;27770;28925
54332;Maidières;851;23633943;1336819;555;20168031;296;3465912;27772;28926
01167;Garnerans;329;9136986;398481;214;7770757;115;1366229;27772;28927
90068;Meroux;426;11830913;619999;286;10177237;140;1653676;27772;28928
68374;Wintzenheim;4224;117315639;6863595;2724;100137893;1500;17177746;27774;28929
67242;Kirrwiller;258;7165639;289439;157;5931405;101;1234234;27774;28930
51161;Condé-sur-Marne;349;9693185;460101;228;8238732;121;1454453;27774;28931
28210;Levesville-la-Chenard;111;3082975;207370;63;2468750;48;614225;27775;28932
73318;Villarembert;177;4916351;389192;108;4140227;69;776124;27776;28933
60561;Russy-Bémont;117;3250032;139759;75;2744413;42;505619;27778;28934
72080;Cherré;879;24417807;1152508;592;20987579;287;3430228;27779;28935
95219;Ermont;15364;426866863;28287660;10060;372422575;5304;54444288;27784;28936
62474;Isques;589;16364720;1093574;369;13769168;220;2595552;27784;28937
72106;Courtillers;399;11086335;344145;275;9278490;124;1807845;27785;28938
27188;Criquebeuf-sur-Seine;670;18616227;1022567;452;16145449;218;2470778;27785;28939
70316;Le Magnoray;46;1278130;46925;32;1098485;14;179645;27785;28940
13003;Alleins;1307;36316200;2240421;796;31128309;511;5187891;27786;28941
63103;Châtel-Guyon;3664;101808801;6062927;2332;87112904;1332;14695897;27786;28942
38277;Notre-Dame-de-Commiers;224;6224534;267629;155;5407425;69;817109;27788;28943
01189;Injoux-Génissiat;573;15922675;440737;343;12602086;230;3320589;27788;28944
27309;L'Habit;264;7336104;373439;184;6490129;80;845975;27788;28945
34163;Montarnaud;1367;37988322;2151528;811;31675047;556;6313275;27790;28946
87202;Veyrac;1029;28597884;1437099;692;24914658;337;3683226;27792;28947
49303;Saint-Martin-d'Arcé;378;10505487;344208;230;8627615;148;1877872;27792;28948
54595;Xermaménil;261;7254016;317858;168;6037464;93;1216552;27793;28949
49078;Charcé-Saint-Ellier-sur-Aubance;364;10117207;421157;235;8442958;129;1674249;27795;28950
21353;Longecourt-en-Plaine;605;16816366;786109;406;14279588;199;2536778;27796;28951
65257;Lanne;291;8088688;370956;181;6740442;110;1348246;27796;28952
28025;Barmainville;56;1556591;73653;34;1291847;22;264744;27796;28953
51078;Bouy;252;7004661;270248;170;5739556;82;1265105;27796;28954
06117;Saint-Blaise;513;14259634;728283;338;12290860;175;1968774;27797;28955
14744;Vienne-en-Bessin;141;3919443;186168;91;3347784;50;571659;27797;28956
60106;Breuil-le-Sec;1130;31412514;1576667;814;27578230;316;3834284;27799;28957
02196;Clacy-et-Thierret;174;4837051;321596;113;4172745;61;664306;27799;28958
90095;Suarce;219;6088287;296327;136;5062591;83;1025696;27800;28959
21284;Francheville;121;3364049;166496;80;2840632;41;523417;27802;28960
21473;Ouges;527;14651760;896576;357;12627093;170;2024667;27802;28961
57367;Klang;114;3169531;148234;55;2253641;59;915890;27803;28962
66115;Montesquieu-des-Albères;653;18156150;1132468;366;14746693;287;3409457;27804;28963
29040;Le Conquet;1575;43792150;2555769;963;36544392;612;7247758;27805;28964
13051;Lançon-Provence;4462;124066994;6467723;2856;106208555;1606;17858439;27805;28965
38203;Laffrey;212;5894733;318884;142;5030986;70;863747;27805;28966
88337;Oncourt;86;2391262;99483;56;2077542;30;313720;27805;28967
55111;Chauvoncourt;238;6617708;367735;155;5619369;83;998339;27805;28968
73014;Allondaz;123;3420113;129246;97;3163239;26;256874;27806;28969
31345;Miremont;1041;28946413;1427641;606;23782939;435;5163474;27806;28970
33290;Montagne;809;22495773;1831153;449;18435376;360;4060397;27807;28971
62392;Guémappe;185;5144379;233102;127;4512112;58;632267;27807;28972
65221;Hiis;120;3336938;180531;79;2882679;41;454259;27808;28973
07321;Thorrenc;121;3364747;148945;85;2934167;36;430580;27808;28974
02320;Fontaine-lès-Clercs;141;3920919;207914;92;3329014;49;591905;27808;28975
64137;Bordères;333;9260472;465675;213;7813599;120;1446873;27809;28976
50231;Hauteville-sur-Mer;430;11958312;970082;227;9529083;203;2429229;27810;28977
62704;Renty;295;8204257;766925;144;6447461;151;1756796;27811;28978
14249;Esquay-Notre-Dame;627;17437536;611984;452;15027241;175;2410295;27811;28979
36179;Saint-Aoustrille;104;2892442;134561;64;2471051;40;421391;27812;28980
38179;Gières;3167;88081670;5305516;2226;78299908;941;9781762;27812;28981
42064;Chuyer;377;10485312;555874;249;9065430;128;1419882;27812;28982
77478;Ussy-sur-Marne;515;14323533;841316;340;12210956;175;2112577;27813;28983
62491;Laventie;2495;69392801;3622539;1486;58115942;1009;11276859;27813;28984
76247;Esteville;237;6591918;322681;154;5619648;83;972270;27814;28985
90036;Eguenigue;146;4060852;250599;85;3548107;61;512745;27814;28986
59098;Bousbecque;2297;63889120;3083343;1509;54734980;788;9154140;27814;28987
40334;Yzosse;217;6035736;331711;129;5074183;88;961553;27814;28988
88142;Domèvre-sur-Avière;211;5868877;268099;142;5049232;69;819645;27815;28989
61279;Mieuxcé;318;8845187;395835;213;7637879;105;1207308;27815;28990
67252;Kurtzenhouse;552;15354087;709333;383;13352729;169;2001358;27815;28991
76708;Toussaint;380;10570679;511091;255;9102232;125;1468447;27818;28992
63021;Authezat;334;9291286;535340;215;7934311;119;1356975;27818;28993
73085;Chindrieux;755;21002857;1206594;478;17786370;277;3216487;27818;28994
90093;Sermamagny;461;12825184;718086;300;11029709;161;1795475;27820;28995
49004;Andard;1239;34469701;1462168;812;29179222;427;5290479;27821;28996
77172;Esmans;472;13131359;701598;321;11447231;151;1684128;27821;28997
14212;Cully;80;2225779;110551;52;1925307;28;300472;27822;28998
85163;Noirmoutier-en-l'Île;3064;85249961;6408428;1725;70680039;1339;14569922;27823;28999
70145;Chaux-la-Lotière;191;5314387;235044;143;4710035;48;604352;27824;29000
27241;Feuguerolles;93;2587677;139914;61;2240921;32;346756;27824;29001
14319;Grentheville;398;11074341;440682;288;9750462;110;1323879;27825;29002
39113;Chassal;265;7374019;515483;159;6159152;106;1214867;27826;29003
95566;Saint-Martin-du-Tertre;1342;37346762;1992278;955;33213548;387;4133214;27829;29004
68276;Rimbachzell;109;3033410;151295;71;2516177;38;517233;27829;29005
14158;Chicheboville;233;6484367;220768;152;5295995;81;1188372;27830;29006
01090;Châtenay;193;5371370;304469;127;4689156;66;682214;27831;29007
68280;Rodern;188;5232251;325456;118;4383789;70;848462;27831;29008
22106;Langueux;3942;109711953;6098644;2555;94287669;1387;15424284;27832;29009
02653;Romeny-sur-Marne;269;7486755;561357;179;6587611;90;899144;27832;29010
77320;Mouroux;2626;73092876;3347157;1786;63266761;840;9826115;27834;29011
21638;Til-Châtel;520;14474479;724543;350;12293151;170;2181328;27836;29012
38254;Monteynard;245;6821029;336241;167;5806885;78;1014144;27841;29013
06039;Châteauneuf-Villevieille;464;12918843;726701;311;11268125;153;1650718;27842;29014
51576;Tours-sur-Marne;730;20325417;1259500;491;17651194;239;2674223;27843;29015
67515;Waldolwisheim;284;7907478;381454;197;6995694;87;911784;27843;29016
02524;Mont-Saint-Père;358;9968189;638044;250;8854904;108;1113285;27844;29017
81074;Cunac;791;22024829;897676;545;18830144;246;3194685;27844;29018
81097;Fréjairolles;637;17737215;829839;426;15356754;211;2380461;27845;29019
73200;Planaise;274;7629884;492490;191;6717360;83;912524;27846;29020
77297;Mondreville;181;5040434;257058;126;4436130;55;604304;27848;29021
10017;Aulnay;65;1810355;113657;39;1523970;26;286385;27852;29022
50505;Saint-Loup;314;8745629;334104;215;7523717;99;1221912;27852;29023
50347;Montjoie-Saint-Martin;137;3815778;367773;78;3228967;59;586811;27852;29024
54036;Avril;448;12478153;330717;240;8940564;208;3537589;27853;29025
65063;Barbazan-Dessus;78;2172619;124844;51;1886145;27;286474;27854;29026
51241;Euvy;56;1559892;71607;35;1290560;21;269332;27855;29027
76620;Saint-Martin-l'Hortier;124;3454067;148780;81;2951007;43;503060;27855;29028
73144;Lanslevillard;270;7520998;440505;175;6394829;95;1126169;27856;29029
42280;Saint-Régis-du-Coin;182;5069722;251911;107;4161015;75;908707;27856;29030
39169;Courbouzon;316;8802420;439430;226;7769707;90;1032713;27856;29031
25537;Scey-Maisières;158;4401287;272546;100;3748244;58;653043;27856;29032
67542;Wintzenheim-Kochersberg;168;4679895;220229;104;3818041;64;861854;27857;29033
02523;Mont-Saint-Martin;33;919302;22919;19;680346;14;238956;27858;29034
67058;Bossendorf;186;5181635;262348;121;4475656;65;705979;27858;29035
31377;Montgaillard-Lauragais;306;8524697;347158;193;6909476;113;1615221;27858;29036
35002;Amanlis;761;21201174;813445;495;17877438;266;3323736;27860;29037
39265;Hautecour;102;2841835;116885;72;2434643;30;407192;27861;29038
08457;Tournes;571;15908962;968848;368;13805747;203;2103215;27862;29039
76241;Ermenouville;77;2145516;116334;44;1785052;33;360464;27864;29040
74258;Samoëns;1523;42439509;2583980;959;35316805;564;7122704;27866;29041
41067;Cour-Cheverny;1571;43777459;2682546;1008;37275129;563;6502330;27866;29042
39447;Quintigny;115;3204595;179051;71;2694315;44;510280;27866;29043
78009;Allainville;158;4402917;260083;108;3793686;50;609231;27867;29044
72287;Saint-Gervais-en-Belin;1005;28006591;1064379;676;23991418;329;4015173;27867;29045
02075;Berthenicourt;112;3121223;267792;60;2529229;52;591994;27868;29046
61448;Saint-Pierre-la-Bruyère;235;6549140;374932;170;5820637;65;728503;27869;29047
90078;Petitefontaine;92;2564177;93036;67;2212052;25;352125;27871;29048
89095;Chemilly-sur-Serein;89;2480565;118287;59;2189613;30;290952;27872;29049
10259;La Motte-Tilly;203;5658109;293391;143;5046503;60;611606;27872;29050
36037;La Champenoise;170;4738372;407252;104;3926310;66;812062;27873;29051
61009;Aubry-en-Exmes;152;4236682;175908;95;3427954;57;808728;27873;29052
60097;Boutencourt;128;3567799;219390;81;3117405;47;450394;27873;29053
60034;Avrechy;576;16057450;892969;390;13962875;186;2094575;27878;29054
57543;Pierrevillers;783;21828127;979134;451;17480145;332;4347982;27878;29055
2B030;Barrettali;69;1923714;116406;30;1535621;39;388093;27880;29056
76730;Veauville-lès-Quelles;65;1812198;110058;39;1491756;26;320442;27880;29057
25391;Mont-de-Laval;86;2397771;118196;48;1872187;38;525584;27881;29058
52363;Orbigny-au-Val;55;1533472;87722;33;1281447;22;252025;27881;29059
31013;Ardiège;197;5492662;282739;133;4715336;64;777326;27882;29060
35356;Vignoc;795;22166760;872102;519;18810727;276;3356033;27883;29061
31450;Renneville;239;6664075;223520;160;5660262;79;1003813;27883;29062
68258;Pulversheim;1450;40431210;1945200;1016;35053606;434;5377604;27884;29063
61497;Valframbert;754;21025434;900504;522;18134052;232;2891382;27885;29064
13048;Jouques;2323;64777318;3842568;1398;55256314;925;9521004;27885;29065
38105;Chirens;1160;32348163;1548970;798;27960912;362;4387251;27886;29066
67079;Croettwiller;80;2231031;91981;47;1802096;33;428935;27888;29067
12146;Le Monastère;1098;30620969;1455704;776;26704142;322;3916827;27888;29068
73001;Aiguebelette-le-Lac;147;4099576;280853;103;3628384;44;471192;27888;29069
73078;La Chapelle-Saint-Martin;79;2203250;109725;51;1882300;28;320950;27889;29070
91222;Estouches;112;3123624;159301;77;2716375;35;407249;27890;29071
59283;Hargnies;308;8589972;501667;199;7407212;109;1182760;27890;29072
60359;Lhéraule;86;2398504;93457;66;2157212;20;241292;27890;29073
12174;Olemps;1652;46074188;2994734;1073;40467955;579;5606233;27890;29074
31136;Cépet;881;24572433;1588655;513;21042121;368;3530312;27892;29075
21430;Montigny-Saint-Barthélemy;46;1283054;64060;29;1077984;17;205070;27892;29076
14349;Laize-la-Ville;281;7837881;317438;206;7013944;75;823937;27893;29077
08322;Neuville-lès-This;179;4992966;248394;115;4196476;64;796490;27894;29078
44190;Saint-Sébastien-sur-Loire;13907;387920502;22486018;9346;333728649;4561;54191853;27894;29079
80700;Saint-Blimont;504;14058766;586201;280;11611655;224;2447111;27894;29080
21233;Drambon;76;2119996;84188;49;1743318;27;376678;27895;29081
02613;Pontavert;290;8089643;640268;178;6840151;112;1249492;27895;29082
68257;Pfetterhouse;545;15203796;899223;352;12837314;193;2366482;27897;29083
60285;Grandvillers-aux-Bois;158;4407930;194149;118;3934868;40;473062;27898;29084
14104;Le Brévedent;75;2092376;97495;37;1657889;38;434487;27898;29085
67055;Boofzheim;615;17157907;694457;393;14329600;222;2828307;27899;29086
71448;Saint-Martin-Belle-Roche;717;20004205;983780;506;17318153;211;2686052;27900;29087
60064;Berneuil-sur-Aisne;505;14089515;907911;318;11745449;187;2344066;27900;29088
51235;Les Essarts-lès-Sézanne;145;4045746;219938;92;3393676;53;652070;27902;29089
38081;Charantonnay;937;26144417;1132938;633;22308500;304;3835917;27902;29090
74283;Thusy;519;14481678;543345;348;12132067;171;2349611;27903;29091
27536;Saint-Éloi-de-Fourques;223;6222473;294896;143;5277960;80;944513;27903;29092
63406;Sardon;157;4381012;267558;102;3763124;55;617888;27905;29093
74063;Châtel;740;20650762;1383155;487;17913532;253;2737230;27906;29094
40317;Tosse;1382;38568489;2566668;886;32507338;496;6061151;27908;29095
60512;Pouilly;81;2260540;160322;45;1900953;36;359587;27908;29096
92046;Malakoff;17418;486100836;37880051;11705;431926106;5713;54174730;27908;29097
28041;Blandainville;111;3097957;203426;71;2623960;40;473997;27910;29098
53105;Gesnes;94;2623538;79465;64;2228356;30;395182;27910;29099
60688;Villers-sur-Bonnières;76;2121252;87278;55;1820668;21;300584;27911;29100
67347;Obermodern-Zutzendorf;837;23362069;994505;540;19649256;297;3712813;27912;29101
57464;Metzeresche;385;10746369;310894;214;7696643;171;3049726;27913;29102
76030;Aubermesnil-Beaumais;224;6252538;313680;150;5214439;74;1038099;27913;29103
10020;Avant-lès-Marcilly;266;7425155;517902;159;6194080;107;1231075;27914;29104
50093;Cametours;232;6476831;153601;109;5178237;123;1298594;27917;29105
67473;Soultz-les-Bains;503;14042707;698599;361;12298354;142;1744353;27918;29106
12203;Roquefort-sur-Soulzon;367;10246155;953033;245;8800624;122;1445531;27919;29107
31351;Mondonville;2331;65082849;3417427;1665;57270087;666;7812762;27921;29108
67499;Urbeis;166;4634824;240832;106;3914232;60;720592;27921;29109
55384;Nicey-sur-Aire;64;1786982;104080;42;1524258;22;262724;27922;29110
49263;Roussay;600;16753182;998346;343;13710659;257;3042523;27922;29111
2B182;Occhiatana;131;3657822;441326;52;3017355;79;640467;27922;29112
74241;Saint-Jeoire;1772;49478398;1408685;1023;37227253;749;12251145;27922;29113
02316;Fleury;77;2150083;112660;54;1873981;23;276102;27923;29114
10239;Mesnil-Sellières;268;7483520;287968;174;6144911;94;1338609;27924;29115
60598;Saint-Sulpice;481;13432677;732388;311;11676102;170;1756575;27927;29116
08187;Gernelle;166;4635836;231641;112;3984160;54;651676;27927;29117
21486;Pluvault;264;7372656;343809;193;6511407;71;861249;27927;29118
31587;Villeneuve-lès-Bouloc;623;17398539;893216;411;14881539;212;2517000;27927;29119
41124;Marcilly-en-Beauce;169;4720248;281235;121;4155390;48;564858;27930;29120
87038;Chaptelat;1026;28657062;1434557;723;25388539;303;3268523;27931;29121
38498;Succieu;356;9943441;367028;241;8568012;115;1375429;27931;29122
69197;Saint-Étienne-des-Oullières;933;26059664;1126985;620;22168209;313;3891455;27931;29123
01334;Saint-André-d'Huiriat;273;7625321;314748;191;6485475;82;1139846;27932;29124
41009;Averdon;368;10278862;471139;279;9327111;89;951751;27932;29125
50647;Yquelon;567;15837377;700958;363;13145017;204;2692360;27932;29126
59005;Allennes-les-Marais;1673;46733168;2162346;1146;40301847;527;6431321;27934;29127
89200;Hauterive;224;6257485;345395;157;5527356;67;730129;27935;29128
01099;Chazey-sur-Ain;785;21930905;1142646;536;18954468;249;2976437;27937;29129
59189;Eecke;549;15338486;698609;338;12791160;211;2547326;27939;29130
77298;Mons-en-Montois;249;6956972;486746;155;5838916;94;1118056;27940;29131
10329;Rouilly-Saint-Loup;299;8354409;493298;215;7280462;84;1073947;27941;29132
60386;Marquéglise;223;6231214;279449;154;5466465;69;764749;27943;29133
38402;Saint-Jean-de-Vaulx;258;7209294;316000;177;6227405;81;981889;27943;29134
56240;Sarzeau;4804;134238487;8370281;3007;113374107;1797;20864380;27943;29135
34311;Tourbes;810;22634666;1449758;459;18849982;351;3784684;27944;29136
28298;Pierres;1504;42028784;2143573;1077;37073966;427;4954818;27945;29137
84146;Villedieu;289;8076651;586307;158;6976134;131;1100517;27947;29138
57603;Russange;534;14924357;205893;136;5753988;398;9170369;27948;29139
77370;Poligny;483;13499141;901598;333;11978091;150;1521050;27949;29140
33381;Saint-Caprais-de-Bordeaux;1497;41839239;2104640;980;35805843;517;6033396;27949;29141
85005;Antigny;593;16573763;656359;286;13322804;307;3250959;27949;29142
36065;Diou;147;4108531;246132;85;3362368;62;746163;27949;29143
77081;Champdeuil;360;10062552;528977;257;8982965;103;1079587;27952;29144
62428;Hénin-sur-Cojeul;228;6373009;218956;153;5430873;75;942136;27952;29145
44070;La Haie-Fouassière;2119;59230401;2556695;1429;50706429;690;8523972;27952;29146
91549;Sainte-Geneviève-des-Bois;18644;521146380;34859292;12312;455869540;6332;65276840;27952;29147
26271;La Roche-de-Glun;1662;46457339;2454529;1062;39206658;600;7250681;27953;29148
62568;Mercatel;324;9056740;505240;197;7723778;127;1332962;27953;29149
55100;Champougny;55;1537478;87521;36;1312197;19;225281;27954;29150
27015;Andé;596;16661701;898187;400;14413451;196;2248250;27956;29151
60203;Duvy;238;6653534;446792;162;5849067;76;804467;27956;29152
95157;Chérence;93;2599952;212409;55;2367445;38;232507;27956;29153
62252;La Couture;1297;36259730;1958949;807;30496741;490;5762989;27957;29154
02489;Molinchart;163;4557037;188043;111;3964235;52;592802;27957;29155
54196;Flavigny-sur-Moselle;812;22701422;1353158;573;20127168;239;2574254;27957;29156
71468;Saint-Pierre-de-Varennes;458;12805014;720107;314;11174255;144;1630759;27959;29157
67123;Engwiller;255;7129478;372353;171;6117635;84;1011843;27959;29158
06075;Levens;2592;72475351;4167833;1705;62879446;887;9595905;27961;29159
71154;Crissey;1226;34281485;1579065;818;28829948;408;5451537;27962;29160
46137;Labastide-Marnhac;623;17420428;960353;401;15011754;222;2408674;27962;29161
38148;Dolomieu;1521;42530972;2201911;990;36244181;531;6286791;27963;29162
60307;Heilles;320;8948002;658234;216;7770722;104;1177280;27963;29163
89438;Venoy;899;25139723;1239546;645;22120399;254;3019324;27964;29164
73292;Thénésol;142;3970962;252893;94;3337098;48;633864;27965;29165
76177;Claville-Motteville;134;3747430;163894;96;3363957;38;383473;27966;29166
67360;Ohnenheim;458;12808396;575693;311;10811594;147;1996802;27966;29167
57720;Villing;300;8389859;629893;199;7133127;101;1256732;27966;29168
51008;Ambrières;121;3383965;172498;84;2956621;37;427344;27967;29169
18050;La Chapelle-Saint-Ursin;1742;48718573;2505961;1249;42533489;493;6185084;27967;29170
60052;Beaugies-sous-Bois;43;1202592;63501;30;1071081;13;131511;27967;29171
21187;Commarin;73;2041675;146822;36;1594513;37;447162;27968;29172
39050;Besain;86;2405483;108579;51;2019040;35;386443;27971;29173
54090;Bouxières-aux-Dames;2220;62096341;3127319;1551;54210536;669;7885805;27971;29174
28107;Corancez;216;6042247;259623;149;5213942;67;828305;27973;29175
70429;Pusy-et-Épenoux;282;7888715;481434;190;6766435;92;1122280;27974;29176
49362;Varrains;638;17847868;944623;407;15225453;231;2622415;27975;29177
95582;Sannois;14104;394561578;25838311;9333;347903447;4771;46658131;27975;29178
02821;Vivaise;356;9959281;485910;243;8549800;113;1409481;27976;29179
14574;Saint-Désir;942;26354138;1592668;551;21814447;391;4539691;27977;29180
52120;Chauffourt;109;3049758;233375;55;2455912;54;593846;27979;29181
07298;Saint-Symphorien-sous-Chomérac;378;10577118;642378;234;8792939;144;1784179;27982;29182
16169;Javrezac;362;10129464;637672;227;8464829;135;1664635;27982;29183
08458;Tourteron;92;2574576;258484;42;2067238;50;507338;27985;29184
27604;Saint-Sulpice-de-Grimbouville;89;2490679;145389;62;2188766;27;301913;27985;29185
60055;Beaurains-lès-Noyon;141;3945984;188103;100;3418192;41;527792;27986;29186
21120;La Bussière-sur-Ouche;91;2546846;233576;48;2159857;43;386989;27987;29187
71038;Les Bizots;230;6437355;281258;145;5534526;85;902829;27989;29188
37159;Monts;3700;103558590;4385651;2559;89608961;1141;13949629;27989;29189
14759;Villy-lez-Falaise;145;4058600;223440;92;3480006;53;578594;27990;29190
57328;Holacourt;33;923683;46525;18;719243;15;204440;27990;29191
27239;Ferrières-Saint-Hilaire;220;6158363;363278;162;5520916;58;637447;27993;29192
76253;Étoutteville;332;9293555;472673;218;7827563;114;1465992;27993;29193
54596;Xeuilley;394;11029244;484136;267;9554243;127;1475001;27993;29194
77405;Saint-Cyr-sur-Morin;1046;29280929;1639087;707;25626773;339;3654156;27993;29195
64521;Serres-Sainte-Marie;270;7558573;377614;186;6609237;84;949336;27995;29196
80386;Gratibus;96;2687689;175756;64;2365667;32;322022;27997;29197
60156;Clairoix;1125;31496458;1944131;762;27531492;363;3964966;27997;29198
18201;Saint-Caprais;351;9827221;418333;259;8751358;92;1075863;27998;29199
27474;Poses;650;18199012;1012068;424;15883424;226;2315588;27998;29200
49117;La Daguenière;626;17527577;826556;420;15108284;206;2419293;27999;29201
31126;Caubiac;153;4284030;266170;100;3748424;53;535606;28000;29202
77220;Guercheville;146;4088159;208993;97;3556302;49;531857;28001;29203
87063;Eyjeaux;603;16885433;828279;432;14862527;171;2022906;28002;29204
59640;Wargnies-le-Petit;382;10697102;608832;227;8807114;155;1889988;28003;29205
38158;Eybens;5291;148168129;8271803;3655;130453960;1636;17714169;28004;29206
59471;Préseau;987;27640009;1563205;611;23507680;376;4132329;28004;29207
57305;Havange;204;5713226;194192;74;3080657;130;2632569;28006;29208
67500;Urmatt;753;21088619;985833;507;17854151;246;3234468;28006;29209
35264;Saint-Didier;845;23665360;886927;557;19625382;288;4039978;28006;29210
01263;Montmerle-sur-Saône;1948;54556464;2801908;1249;46193246;699;8363218;28006;29211
73259;Saint-Martin-sur-la-Chambre;286;8009872;451728;193;6910321;93;1099551;28007;29212
38075;Chapareillan;1484;41561953;2192357;971;35469297;513;6092656;28007;29213
25394;Montenois;699;19578013;772122;478;16642797;221;2935216;28009;29214
51167;Coole;99;2772906;215857;53;2311684;46;461222;28009;29215
61212;Juvigny-sur-Orne;59;1652564;115171;34;1401670;25;250894;28010;29216
39313;Marigny;106;2969140;186254;64;2454784;42;514356;28011;29217
26146;Grignan;974;27282803;2089167;532;22854474;442;4428329;28011;29218
30225;Sabran;939;26303354;1372072;573;22437372;366;3865982;28012;29219
64125;Bidart;4095;114711752;7959166;2522;96760439;1573;17951313;28013;29220
39548;Vaux-sur-Poligny;43;1204601;51813;23;1004087;20;200514;28014;29221
86016;Avanton;917;25690332;1187521;661;22593707;256;3096625;28016;29222
41138;Meslay;172;4819026;254079;118;4157979;54;661047;28018;29223
29149;Milizac;1561;43738118;1858219;1021;37593735;540;6144383;28019;29224
65251;Laloubère;986;27628016;1505314;631;23221611;355;4406405;28020;29225
07089;Félines;752;21071311;1151835;501;17909531;251;3161780;28020;29226
60438;Moulin-sous-Touvent;89;2493827;163320;47;2010391;42;483436;28021;29227
54565;Vigneulles;126;3530630;165703;80;2873598;46;657032;28021;29228
53007;Argentré;1277;35782750;1613928;844;30327882;433;5454868;28021;29229
71502;Sassenay;768;21520223;1019792;536;18724511;232;2795712;28021;29230
02186;Chézy-sur-Marne;797;22334496;1617895;483;18843994;314;3490502;28023;29231
51603;Vélye;82;2297918;85396;58;2014816;24;283102;28023;29232
50246;Hiesville;36;1008847;57264;18;806167;18;202680;28024;29233
28400;Varize;113;3166685;224428;72;2674886;41;491799;28024;29234
14747;Vieux;359;10060792;414224;244;8766086;115;1294706;28024;29235
60003;Abbeville-Saint-Lucien;271;7594786;353981;190;6522770;81;1072016;28025;29236
62317;Étaing;210;5885431;313044;131;5007156;79;878275;28026;29237
62373;Givenchy-lès-la-Bassée;468;13116112;957727;284;11007553;184;2108559;28026;29238
77200;Garentreville;52;1457349;93177;39;1322419;13;134930;28026;29239
63120;Corent;378;10594708;487388;279;9387964;99;1206744;28028;29240
24013;Atur;957;26824194;1476053;626;23078982;331;3745212;28029;29241
69218;Saint-Lager;474;13286279;547965;274;10687332;200;2598947;28030;29242
51573;Tinqueux;5528;154954503;8665366;3736;133526966;1792;21427537;28031;29243
13046;Gréasque;2333;65396412;3656634;1456;55396169;877;10000243;28031;29244
54116;Chanteheux;996;27919014;1361512;645;23514256;351;4404758;28031;29245
25415;Mouthier-Haute-Pierre;179;5017744;502187;97;4172780;82;844964;28032;29246
76099;Blacqueville;300;8409649;339497;202;7119550;98;1290099;28032;29247
67292;Mietesheim;331;9278721;421650;224;7950297;107;1328424;28032;29248
27495;La Roquette;128;3588247;233082;87;3164166;41;424081;28033;29249
39030;Authume;425;11914418;600688;288;10245819;137;1668599;28034;29250
56252;Le Tour-du-Parc;669;18755401;1087971;417;15824979;252;2930422;28035;29251
90070;Montbouton;220;6167726;306335;155;5492664;65;675062;28035;29252
71277;Marcilly-lès-Buxy;332;9308083;404654;201;7704520;131;1603563;28036;29253
60239;Fleury;256;7177330;427903;172;6302066;84;875264;28036;29254
30312;Sauveterre;980;27476821;1809492;613;23589336;367;3887485;28038;29255
51386;Morsains;70;1962644;96625;44;1624161;26;338483;28038;29256
60310;Herchies;313;8775984;452795;220;7503188;93;1272796;28038;29257
67310;Mussig;581;16291133;854913;389;13830968;192;2460165;28040;29258
03271;Serbannes;427;11973190;718002;287;10363166;140;1610024;28040;29259
10046;Blaincourt-sur-Aube;56;1570269;132054;34;1259942;22;310327;28041;29260
35032;Bourgbarré;1657;46463474;1858118;1152;40587892;505;5875582;28041;29261
14270;Firfol;215;6028887;297323;152;5295342;63;733545;28041;29262
54352;Maron;446;12506601;610332;300;10914316;146;1592285;28042;29263
15056;Crandelles;378;10600081;614728;247;9282324;131;1317757;28043;29264
32057;Blaziert;75;2103346;126910;41;1829706;34;273640;28045;29265
27366;Letteguives;105;2944901;125651;73;2474043;32;470858;28047;29266
02407;Laniscourt;95;2664441;139006;55;2169855;40;494586;28047;29267
80025;Argoules;150;4207058;165295;79;3488702;71;718356;28047;29268
17064;Breuillet;1594;44707227;2922009;937;37265658;657;7441569;28047;29269
28246;Meslay-le-Vidame;231;6478945;246650;157;5560863;74;918082;28047;29270
02815;Villers-Saint-Christophe;226;6339002;381399;158;5639613;68;699389;28049;29271
30249;Saint-Dionisy;447;12537799;597420;299;10730377;148;1807422;28049;29272
48103;Montrodat;587;16464806;783675;345;13991219;242;2473587;28049;29273
77143;Crégy-lès-Meaux;2084;58455177;2848459;1496;51917623;588;6537554;28050;29274
01434;Versailleux;179;5020911;262491;124;4431527;55;589384;28050;29275
74202;Nonglard;273;7657643;371315;196;6851571;77;806072;28050;29276
27119;Bueil;771;21626960;1053264;519;18602394;252;3024566;28051;29277
14032;Les Authieux-sur-Calonne;152;4263836;237932;85;3498642;67;765194;28052;29278
51647;Vitry-en-Perthois;474;13296493;851160;298;11340478;176;1956015;28052;29279
14606;Saint-Léger-Dubosq;76;2132053;115819;48;1789512;28;342541;28053;29280
28040;Billancelles;155;4348381;276022;103;3706830;52;641551;28054;29281
54569;Ville-au-Val;87;2440723;126418;51;1960572;36;480151;28054;29282
68241;Oberentzen;304;8528579;420993;204;7363168;100;1165411;28055;29283
50087;Brix;1069;29991220;1272856;680;25320582;389;4670638;28055;29284
31282;Launaguet;3864;108409139;6048602;2617;93632403;1247;14776736;28056;29285
55247;Horville-en-Ornois;37;1038135;40610;16;851254;21;186881;28058;29286
60499;Plessis-de-Roye;102;2862043;149014;68;2425993;34;436050;28059;29287
80337;Fouencamps;110;3086642;190911;75;2670980;35;415662;28060;29288
11088;Cazilhac;875;24553299;1300126;581;20830015;294;3723284;28061;29289
60582;Saint-Léger-aux-Bois;419;11757870;585978;285;10232919;134;1524951;28062;29290
51530;Sept-Saulx;276;7745795;262263;193;6495443;83;1250352;28064;29291
76044;Auzouville-Auberbosc;136;3816971;154931;89;3243290;47;573681;28066;29292
63446;Vensat;247;6932343;434381;145;5775193;102;1157150;28066;29293
26208;Montoison;916;25709079;1220920;586;21696383;330;4012696;28067;29294
63265;Orléat;1091;30621180;1539099;687;25857367;404;4763813;28067;29295
25371;Mazerolles-le-Salin;101;2834776;94123;60;2207719;41;627057;28067;29296
29270;Saint-Urbain;732;20546611;728683;512;17847260;220;2699351;28069;29297
84041;Crillon-le-Brave;251;7045371;431028;151;5910854;100;1134517;28069;29298
53141;Louvigné;452;12687709;311563;315;10667923;137;2019786;28070;29299
37085;Courçay;432;12126865;635162;297;10411925;135;1714940;28071;29300
13085;Roquefort-la-Bédoule;2925;82109683;4954371;1772;69022816;1153;13086867;28072;29301
76684;Tancarville;590;16562360;695621;400;14123663;190;2438697;28072;29302
90081;Réchésy;430;12071174;750144;282;10462151;148;1609023;28072;29303
46240;Rocamadour;416;11679331;1283658;206;9731605;210;1947726;28075;29304
27244;Flancourt-Catelon;220;6176851;215390;144;5222205;76;954646;28077;29305
14638;Saint-Ouen-le-Houx;41;1151170;75310;22;890659;19;260511;28077;29306
57428;Macheren;1508;42340627;2600303;909;35475843;599;6864784;28077;29307
73143;Lanslebourg-Mont-Cenis;365;10248500;736675;247;8846707;118;1401793;28078;29308
31420;Pinsaguel;1491;41864655;2542229;973;35731119;518;6133536;28078;29309
02102;Bouconville-Vauclair;106;2976473;247327;49;2288968;57;687505;28080;29310
64238;Ger;977;27434498;1555584;631;23652367;346;3782131;28080;29311
69299;Colombier-Saugnieu;1216;34146139;1619779;827;29294369;389;4851770;28081;29312
62577;Monchel-sur-Canche;40;1123230;65853;21;918955;19;204275;28081;29313
02082;Beugneux;56;1572551;109819;33;1289571;23;282980;28081;29314
41109;Landes-le-Gaulois;362;10165440;476331;241;8766500;121;1398940;28081;29315
33292;Montignac;75;2106163;199190;36;1722309;39;383854;28082;29316
80376;Gentelles;287;8059765;286212;198;7071470;89;988295;28083;29317
41170;Ouchamps;400;11233999;498642;285;9782883;115;1451116;28085;29318
45166;Huêtre;137;3847888;173886;89;3166820;48;681068;28087;29319
31069;Blagnac;12730;357547850;24964258;8382;313443688;4348;44104162;28087;29320
27626;Theillement;189;5308451;232561;123;4438434;66;870017;28087;29321
80813;Vraignes-lès-Hornoy;49;1376279;104588;27;1136717;22;239562;28087;29322
05100;Pelleautier;338;9493786;546305;205;7874858;133;1618928;28088;29323
76726;Vattetot-sur-Mer;153;4297608;205472;102;3752422;51;545186;28089;29324
14500;Pierrefitte-en-Auge;74;2078649;127934;43;1757140;31;321509;28090;29325
31361;Montaut;248;6966307;302806;164;5900478;84;1065829;28090;29326
71557;Varenne-Saint-Germain;332;9326697;549500;192;7778672;140;1548025;28092;29327
29031;Clohars-Carnoët;2560;71918890;4575364;1474;59518787;1086;12400103;28093;29328
77163;Douy-la-Ramée;153;4298547;221556;108;3746791;45;551756;28095;29329
27408;Mézières-en-Vexin;330;9271436;529319;229;8175380;101;1096056;28095;29330
67479;Steinseltz;321;9018700;450764;196;7394924;125;1623776;28096;29331
67156;Geudertheim;1271;35710683;1884291;894;31308105;377;4402578;28097;29332
07323;Toulaud;859;24137172;1320033;529;20542045;330;3595127;28099;29333
33049;Beychac-et-Caillau;1041;29251653;1558341;691;24948867;350;4302786;28100;29334
44135;Le Pouliguen;3269;91862252;6240013;1927;76536636;1342;15325616;28101;29335
68229;Murbach;78;2191885;124114;46;1794607;32;397278;28101;29336
37043;Cangey;535;15034261;871765;360;13136858;175;1897403;28101;29337
14034;Avenay;244;6856760;236573;168;5971074;76;885686;28101;29338
68009;Artzenheim;398;11184834;546960;262;9654404;136;1530430;28103;29339
68086;Falkwiller;97;2725994;113419;64;2334018;33;391976;28103;29340
74215;Praz-sur-Arly;806;22651466;1573623;571;20081120;235;2570346;28104;29341
31252;Labastide-Saint-Sernin;892;25069694;1088455;625;21723818;267;3345876;28105;29342
43190;Saint-Germain-Laprade;1777;49943022;1991732;1200;43301286;577;6641736;28105;29343
38288;Oytier-Saint-Oblas;797;22399934;1049279;557;19649526;240;2750408;28105;29344
67067;Brumath;5225;146850562;8940018;3447;127579473;1778;19271089;28105;29345
60361;Liancourt-Saint-Pierre;293;8234880;424776;192;6995470;101;1239410;28105;29346
95011;Ambleville;204;5733751;285348;141;5094371;63;639380;28107;29347
88231;Haréville;258;7252008;366539;183;6331811;75;920197;28109;29348
42051;La Chapelle-Villars;240;6746111;285851;153;5561389;87;1184722;28109;29349
25458;Les Plains-et-Grands-Essarts;106;2979633;124957;70;2475784;36;503849;28110;29350
88155;Domvallier;62;1742814;141980;39;1478748;23;264066;28110;29351
61067;Bures;82;2305062;99193;47;1844404;35;460658;28111;29352
47218;Puysserampion;127;3570256;154021;80;3006564;47;563692;28112;29353
26224;Ourches;117;3289254;206722;73;2722453;44;566801;28113;29354
26344;Soyans;183;5144867;237674;103;4144854;80;1000013;28114;29355
68123;Hattstatt;448;12595254;633372;298;10808808;150;1786446;28114;29356
86028;Bignoux;564;15856667;812314;417;14264263;147;1592404;28115;29357
27295;Grand-Camp;247;6944446;405991;154;5834764;93;1109682;28115;29358
25492;Rillans;33;927809;19721;19;697090;14;230719;28115;29359
35209;Ossé;539;15154519;624135;389;13427346;150;1727173;28116;29360
25452;Pierrefontaine-lès-Blamont;227;6382350;369415;157;5587280;70;795070;28116;29361
40296;Seignosse;2323;65317373;4542994;1426;55494632;897;9822741;28118;29362
28250;Mézières-au-Perche;72;2024488;171355;42;1680933;30;343555;28118;29363
51148;Cheppes-la-Prairie;92;2586912;159199;58;2128213;34;458699;28119;29364
69231;Saint-Pierre-la-Palud;1307;36757250;1661808;925;32086312;382;4670938;28123;29365
80132;Braches;101;2840526;117748;70;2413099;31;427427;28124;29366
54377;Montigny;78;2193826;211996;44;1758537;34;435289;28126;29367
51524;Saron-sur-Aube;178;5006491;374213;118;4337653;60;668838;28126;29368
14553;Saint-Agnan-le-Malherbe;56;1575193;83276;30;1275652;26;299541;28128;29369
73043;La Biolle;1081;30410654;1416153;727;25881045;354;4529609;28132;29370
70479;Sauvigney-lès-Gray;61;1716055;22932;35;1401778;26;314277;28132;29371
27189;La Croisille;234;6583057;381019;169;5833425;65;749632;28133;29372
62873;Wancourt;306;8609045;371885;199;7269948;107;1339097;28134;29373
60347;Lannoy-Cuillère;117;3291834;98214;67;2740863;50;550971;28135;29374
51198;Crugny;288;8103170;374983;186;6754151;102;1349019;28136;29375
13079;Puyloubier;988;27798758;1960326;550;23653762;438;4144996;28136;29376
68008;Appenwihr;313;8806839;509248;227;7784146;86;1022693;28137;29377
13050;Lambesc;5176;145641560;8989286;3192;124625725;1984;21015835;28138;29378
21612;Souhey;58;1632012;115454;40;1411479;18;220533;28138;29379
25456;Plaimbois-du-Miroir;115;3236026;171250;71;2620183;44;615843;28139;29380
71377;Royer;65;1829154;91027;38;1493888;27;335266;28141;29381
54338;Malleloy;459;12917612;570963;305;11071547;154;1846065;28143;29382
38144;Diémoz;1344;37826557;1829713;900;32023811;444;5802746;28145;29383
42053;Châteauneuf;779;21925069;983353;523;18638074;256;3286995;28145;29384
38546;Vignieu;465;13087548;628809;284;10764759;181;2322789;28145;29385
29069;Guilers;3591;101073110;4398810;2431;87181768;1160;13891342;28146;29386
67304;Morschwiller;275;7740273;366490;186;6796553;89;943720;28146;29387
41209;Saint-Firmin-des-Prés;423;11906122;519228;283;9938456;140;1967666;28147;29388
14256;Étréham;152;4278325;225570;97;3529167;55;749158;28147;29389
25193;Damprichard;1004;28259812;1790140;681;24476537;323;3783275;28147;29390
41058;Concriers;92;2589601;250560;57;2208898;35;380703;28148;29391
40314;Tercis-les-Bains;635;17873998;928940;402;15186293;233;2687705;28148;29392
77122;Combs-la-Ville;11474;322973816;19035044;7922;286656757;3552;36317059;28148;29393
01205;Lancrans;557;15679240;609650;308;11620533;249;4058707;28149;29394
15175;Saint-Cernin;663;18663274;1847435;260;14689762;403;3973512;28150;29395
84025;Cabrières-d'Avignon;979;27559445;1604668;579;23129893;400;4429552;28151;29396
77421;Saint-Mars-Vieux-Maisons;136;3828510;197750;97;3296395;39;532115;28151;29397
77364;Le Plessis-aux-Bois;128;3603325;206205;86;3081506;42;521819;28151;29398
77393;Rozay-en-Brie;1510;42508034;2572785;980;36391819;530;6116215;28151;29399
69280;Jons;692;19481878;1010444;459;16724265;233;2757613;28153;29400
73122;Gerbaix;198;5574338;228676;138;4770697;60;803641;28153;29401
39048;Belmont;133;3744478;199111;86;3222523;47;521955;28154;29402
14286;Fourneville;230;6475752;343378;146;5478654;84;997098;28155;29403
27642;Le Tilleul-Othon;193;5434067;324150;119;4614841;74;819226;28156;29404
82098;Léojac;577;16246272;883005;372;13815923;205;2430349;28156;29405
95218;Éragny;8426;237261391;14079804;5706;208426448;2720;28834943;28158;29406
69123;Lyon;283075;7971099828;644960767;179527;6992904624;103548;978195204;28159;29407
44027;Casson;934;26300547;956351;622;22235514;312;4065033;28159;29408
74239;Saint-Jean-de-Sixt;799;22499101;1394794;541;19495846;258;3003255;28159;29409
32016;Auradé;319;8982766;483166;204;7847106;115;1135660;28159;29410
14676;Sommervieu;494;13911155;582176;339;11727718;155;2183437;28160;29411
91602;Souzy-la-Briche;194;5463136;390053;127;4812533;67;650603;28160;29412
86158;Migné-Auxances;3138;88371529;4980126;2101;76858685;1037;11512844;28162;29413
27276;Gamaches-en-Vexin;175;4928638;327381;108;4121586;67;807052;28164;29414
14033;Auvillars;127;3576880;289586;80;3039349;47;537531;28164;29415
62433;Héricourt;47;1323832;52567;25;1028003;22;295829;28167;29416
77097;Chartronges;146;4112636;212140;99;3489866;47;622770;28169;29417
06090;Pégomas;4005;112822466;6487598;2675;97969359;1330;14853107;28170;29418
54508;Sivry;121;3408713;149714;86;2957410;35;451303;28171;29419
77402;Saint-Barthélemy;177;4986359;298641;111;4253918;66;732441;28172;29420
82064;Gariès;59;1662202;119919;33;1410204;26;251998;28173;29421
34090;Le Crès;4496;126675520;6903538;2897;108429084;1599;18246436;28175;29422
45139;Estouy;282;7945397;450460;183;6829900;99;1115497;28175;29423
89442;Vernoy;123;3466065;257320;80;2917940;43;548125;28179;29424
64306;Lahourcade;362;10201553;426879;246;8588370;116;1613183;28181;29425
58254;Saint-Martin-d'Heuille;319;8989865;516197;215;7953147;104;1036718;28181;29426
64317;Larressore;869;24490382;1250580;573;21090430;296;3399952;28182;29427
85307;La Faute-sur-Mer;517;14570511;1089104;311;12223451;206;2347060;28183;29428
67523;Weitbruch;1413;39822395;1962084;987;34725496;426;5096899;28183;29429
22343;Trébeurden;2267;63891025;3941586;1415;54389594;852;9501431;28183;29430
72280;Saint-Georges-du-Bois;957;26971390;1102746;704;23914159;253;3057231;28183;29431
67098;Dinsheim-sur-Bruche;724;20405102;832962;488;17474349;236;2930753;28184;29432
61170;Fleuré;117;3297515;143956;79;2830127;38;467388;28184;29433
60086;Boran-sur-Oise;1200;33821109;2155210;809;29733627;391;4087482;28184;29434
33015;Arveyres;1057;29791465;2062112;643;25372548;414;4418917;28185;29435
24132;Conne-de-Labarde;136;3833349;187239;78;3228561;58;604788;28186;29436
77429;Saint-Ouen-sur-Morin;274;7723087;407736;187;6652573;87;1070514;28186;29437
21578;Saint-Victor-sur-Ouche;143;4030711;170996;98;3590070;45;440641;28187;29438
38210;Leyrieu;401;11303150;544169;270;9765339;131;1537811;28187;29439
14348;Juvigny-sur-Seulles;33;930276;25959;20;641710;13;288566;28190;29440
70531;Velleclaire;46;1296767;53555;27;1067343;19;229424;28191;29441
77282;Mauregard;156;4397827;218117;110;3851194;46;546633;28191;29442
73238;Saint-Germain-la-Chambotte;228;6427944;327453;144;5316534;84;1111410;28193;29443
38250;Montcarra;229;6456199;237739;161;5584774;68;871425;28193;29444
59006;Amfroipret;98;2763140;103004;66;2434110;32;329030;28195;29445
90046;Florimont;227;6400419;341500;154;5673299;73;727120;28196;29446
60638;Thury-sous-Clermont;343;9671622;443883;245;8458899;98;1212723;28197;29447
90019;Bretagne;129;3637535;151806;93;3174217;36;463318;28198;29448
77510;Villeneuve-Saint-Denis;438;12351246;866616;279;11032276;159;1318970;28199;29449
45233;Ondreville-sur-Essonne;215;6063165;330622;150;5193480;65;869685;28201;29450
01295;Peyzieux-sur-Saône;274;7727031;422954;194;6779223;80;947808;28201;29451
27647;Tosny;394;11111339;732689;214;8804960;180;2306379;28201;29452
89440;Verlin;217;6119893;343077;146;5310375;71;809518;28202;29453
67074;Cleebourg;337;9504209;456205;203;7691366;134;1812843;28202;29454
60358;Lévignen;460;12973476;740386;316;11317056;144;1656420;28203;29455
06019;Blausasc;773;21802270;1353464;510;18873231;263;2929039;28205;29456
59277;Gussignies;173;4879525;234801;107;3914925;66;964600;28205;29457
62042;Athies;510;14385239;1100836;322;12227204;188;2158035;28206;29458
51464;Romain;152;4287513;155842;92;3565594;60;721919;28207;29459
41047;La Chaussée-Saint-Victor;2596;73226755;4345360;1810;62828984;786;10397771;28208;29460
10361;Saint-Remy-sous-Barbuise;97;2736315;136490;72;2442389;25;293926;28209;29461
88136;Dogneville;810;22850875;1221643;567;19981066;243;2869809;28211;29462
45144;Férolles;581;16391152;729566;420;14558853;161;1832299;28212;29463
21240;Échevannes;125;3526516;162407;94;3208790;31;317726;28212;29464
62761;Saint-Martin-sur-Cojeul;102;2877980;122435;73;2554472;29;323508;28215;29465
62821;Tingry;150;4232464;258737;92;3554603;58;677861;28216;29466
54478;Saint-Marcel;79;2229284;148869;45;1788146;34;441138;28219;29467
31325;Mascarville;83;2342227;109788;57;2066039;26;276188;28220;29468
45036;Boismorand;436;12304472;543085;311;10708489;125;1595983;28221;29469
50538;Saint-Pierre-de-Semilly;221;6237172;240986;155;5296115;66;941057;28222;29470
42307;Tartaras;343;9680400;397261;227;8118577;116;1561823;28223;29471
80458;Lahoussoye;222;6265450;266133;167;5563043;55;702407;28223;29472
63288;Prompsat;231;6519484;331625;156;5697526;75;821958;28223;29473
89375;Santigny;53;1495866;79195;30;1216950;23;278916;28224;29474
77436;Saint-Siméon;458;12926772;850179;312;11121397;146;1805375;28224;29475
70378;Navenne;910;25684219;1457919;646;22470195;264;3214024;28224;29476
40114;Gourbera;200;5645076;400361;130;4859101;70;785975;28225;29477
77338;Noisy-Rudignon;288;8129271;388798;204;7105570;84;1023701;28227;29478
39494;Saint-Pierre;174;4911529;198801;112;4077286;62;834243;28227;29479
57040;Aulnois-sur-Seille;120;3387380;146589;71;2755689;49;631691;28228;29480
88499;Velotte-et-Tatignécourt;90;2540536;203175;60;2183840;30;356696;28228;29481
38160;Eyzin-Pinet;1074;30322799;1418116;738;26412814;336;3909985;28234;29482
77439;Salins;489;13806287;713665;311;11335969;178;2470318;28234;29483
62820;Tincques;428;12084058;879145;238;9737193;190;2346865;28234;29484
62355;Fresnes-lès-Montauban;288;8131563;453076;193;7047342;95;1084221;28235;29485
67139;Flexbourg;241;6804924;257557;162;5832229;79;972695;28236;29486
26232;Peyrus;347;9797973;531635;234;8454160;113;1343813;28236;29487
21682;Viévigne;108;3049678;144733;71;2597801;37;451877;28238;29488
68202;Mertzen;119;3360428;235958;76;2777161;43;583267;28239;29489
88502;Vervezelle;67;1892156;92813;43;1545072;24;347084;28241;29490
59252;Frelinghien;1271;35895250;1829068;835;30902161;436;4993089;28242;29491
06113;Sainte-Agnès;697;19685740;1225365;477;17609756;220;2075984;28244;29492
25054;Berche;222;6270154;236315;162;5470412;60;799742;28244;29493
54108;Burthecourt-aux-Chênes;54;1525336;92614;37;1344626;17;180710;28247;29494
34259;Saint-Georges-d'Orques;2983;84260882;5393265;1884;72789327;1099;11471555;28247;29495
27383;Mandres;192;5423653;268429;130;4675257;62;748396;28248;29496
91374;Marolles-en-Beauce;107;3022559;158461;71;2568344;36;454215;28248;29497
27104;Bourg-Beaudouin;348;9830489;389711;254;8554558;94;1275931;28249;29498
44043;Clisson;3614;102098811;5894841;2213;86274385;1401;15824426;28251;29499
72146;Guécélard;1370;38707312;1642334;955;33325059;415;5382253;28254;29500
28291;Ouarville;265;7487765;365269;168;6337389;97;1150376;28256;29501
80752;Thézy-Glimont;241;6810074;337153;162;5866721;79;943353;28258;29502
14524;Putot-en-Auge;171;4832361;179644;102;4023816;69;808545;28259;29503
08134;Coulommes-et-Marqueny;49;1384752;48848;36;1197275;13;187477;28260;29504
02628;Puiseux-en-Retz;121;3419586;207160;78;2948461;43;471125;28261;29505
08229;Houdilcourt;76;2147884;126566;54;1884307;22;263577;28262;29506
90074;Novillard;124;3504956;139556;87;3035483;37;469473;28266;29507
51660;Warmeriville;1058;29905337;1448721;715;25699526;343;4205811;28266;29508
18258;Sury-en-Vaux;419;11843642;1001789;245;10046727;174;1796915;28266;29509
57155;Courcelles-Chaussy;1430;40421168;1992882;921;33905614;509;6515554;28267;29510
01442;Vieu;214;6049080;362963;132;5039010;82;1010070;28267;29511
62503;Leubringhen;133;3759530;137804;82;3168097;51;591433;28267;29512
39436;Pont-d'Héry;99;2798455;121351;57;2303253;42;495202;28267;29513
93077;Villemomble;16064;454097200;32745465;10330;397362256;5734;56734944;28268;29514
01038;Bény;350;9893947;431051;227;7912402;123;1981545;28268;29515
60681;Villers-Saint-Barthélemy;243;6869299;319089;162;6009810;81;859489;28269;29516
72335;Sillé-le-Philippe;522;14756297;983399;348;12594324;174;2161973;28269;29517
87065;Feytiat;3219;90997395;4821914;2166;78743972;1053;12253423;28269;29518
27553;Saint-Julien-de-la-Liègue;213;6021674;373491;152;5400201;61;621473;28271;29519
49231;Nuaillé;691;19536454;722425;488;16955625;203;2580829;28273;29520
51274;Gizaucourt;65;1837914;173735;33;1476677;32;361237;28276;29521
28289;Ormoy;127;3591076;196401;93;3152354;34;438722;28276;29522
64073;Aubin;111;3138845;98336;74;2569730;37;569115;28278;29523
25147;Chemaudin;720;20360102;843537;505;17660076;215;2700026;28278;29524
89009;Annay-la-Côte;190;5372846;341055;131;4550895;59;821951;28278;29525
38545;Vif;4117;116432009;5818265;2856;101867323;1261;14564686;28281;29526
07343;Vinezac;699;19768391;1001023;374;16419742;325;3348649;28281;29527
21431;Montigny-sur-Armançon;87;2460565;113833;60;2156160;27;304405;28282;29528
21295;Gevrey-Chambertin;1737;49127744;3408220;1083;41893582;654;7234162;28283;29529
28215;Louville-la-Chenard;151;4270839;288607;98;3702084;53;568755;28284;29530
60641;Tracy-le-Mont;905;25599442;1523222;619;22123024;286;3476418;28287;29531
60094;Boursonne;157;4441009;248420;100;3695149;57;745860;28287;29532
76365;Houdetot;82;2319510;155838;45;1900689;37;418821;28287;29533
16026;Balzac;697;19718026;1091952;470;17037733;227;2680293;28290;29534
02047;Barenton-Cel;70;1980313;197849;33;1575347;37;404966;28290;29535
43058;La Chapelle-d'Aurec;411;11628286;577596;266;9723319;145;1904967;28293;29536
28053;Le Boullay-les-Deux-Églises;148;4187481;301582;103;3710607;45;476874;28294;29537
42323;Veauche;4461;126238808;6734857;3061;109072441;1400;17166367;28298;29538
64312;Lanneplaà;153;4329711;246479;106;3800452;47;529259;28299;29539
01239;Massignieu-de-Rives;325;9197116;438495;219;7813137;106;1383979;28299;29540
03121;Gennetines;323;9140796;735199;203;7759674;120;1381122;28300;29541
27446;Ormes;235;6650543;352912;155;5653664;80;996879;28300;29542
61496;Urou-et-Crennes;417;11801394;581110;287;10171973;130;1629421;28301;29543
27316;Hauville;647;18310622;913935;433;15936862;214;2373760;28301;29544
84130;Suzette;66;1867950;142662;33;1520624;33;347326;28302;29545
80344;Francières;86;2434000;104034;50;1978304;36;455696;28302;29546
49107;Cornillé-les-Caves;209;5915411;246123;136;4930421;73;984990;28303;29547
45296;Saint-Péravy-la-Colombe;349;9878255;467589;249;8622573;100;1255682;28304;29548
69228;Saint-Maurice-sur-Dargoire;1109;31390547;1636898;744;26844074;365;4546473;28305;29549
14677;Soulangy;124;3510084;149771;84;2981478;40;528606;28307;29550
54367;Mexy;1165;32977918;1082797;508;19825003;657;13152915;28307;29551
67103;Dossenheim-sur-Zinsel;585;16559917;715332;381;13735209;204;2824708;28308;29552
77071;Chaintreaux;493;13955726;837636;325;12024694;168;1931032;28308;29553
92025;Colombes;46612;1319539178;100769599;28433;1149471128;18179;170068050;28309;29554
10396;Vauchassis;283;8011467;500174;186;6882772;97;1128695;28309;29555
78057;Bennecourt;963;27261752;1582198;693;24294343;270;2967409;28309;29556
59016;Armbouts-Cappel;1166;33008675;1364957;798;28226461;368;4782214;28309;29557
25254;Les Fourgs;698;19759921;1228403;472;17121332;226;2638589;28309;29558
24135;Cornille;349;9880238;647933;240;8537391;109;1342847;28310;29559
68146;Houssen;968;27406888;1458857;704;24318611;264;3088277;28313;29560
72034;Bérus;222;6285604;281330;149;5433398;73;852206;28314;29561
24193;Gageac-et-Rouillac;249;7050824;538016;131;5876814;118;1174010;28317;29562
85069;Les Clouzeaux;1264;35797345;1724683;830;30561081;434;5236264;28321;29563
39442;Prénovel;141;3993307;205160;87;3321290;54;672017;28321;29564
27240;La Ferrière-sur-Risle;153;4333215;259199;74;3507066;79;826149;28322;29565
68020;Bantzenheim;882;24980725;1349352;575;21288912;307;3691813;28323;29566
21017;Arcenant;257;7279298;337541;179;6462124;78;817174;28324;29567
73257;Saint-Martin-de-Belleville;1694;47981237;3583956;1159;41446813;535;6534424;28324;29568
76252;Étalondes;572;16201933;951997;371;13765157;201;2436776;28325;29569
54281;Jolivet;455;12888322;654816;319;11355429;136;1532893;28326;29570
51346;Mareuil-le-Port;688;19488674;1765435;403;16413443;285;3075231;28327;29571
68379;Wolfgantzen;549;15551480;842454;385;13437242;164;2114238;28327;29572
60436;Mory-Montcrux;52;1473074;92155;28;1215584;24;257490;28328;29573
13101;Saint-Savournin;1712;48498769;2504773;1137;41885236;575;6613533;28329;29574
77319;Mortery;85;2408009;177717;59;2116177;26;291832;28330;29575
02540;Nesles-la-Montagne;580;16431131;783569;429;14640821;151;1790310;28330;29576
41185;Pruniers-en-Sologne;1265;35837766;2083413;840;30767178;425;5070588;28330;29577
14220;Deauville;2854;80860195;7082060;1634;68789402;1220;12070793;28332;29578
27281;Gaudreville-la-Rivière;115;3258227;209860;73;2810778;42;447449;28332;29579
57256;Gravelotte;389;11021458;619646;253;9128156;136;1893302;28333;29580
51232;Époye;211;5978868;287584;135;4992918;76;985950;28336;29581
67176;Gundershoffen;1895;53696563;2532367;1188;45261719;707;8434844;28336;29582
76014;Angerville-l'Orcher;678;19211837;938125;428;16168124;250;3043713;28336;29583
95229;Ézanville;5216;147802905;9386331;3592;131039021;1624;16763884;28336;29584
14005;Airan;333;9436103;586850;208;7996357;125;1439746;28337;29585
25248;Les Fontenelles;290;8217840;469537;191;7277512;99;940328;28337;29586
42234;Saint-Héand;1874;53104605;2790678;1147;43886888;727;9217717;28338;29587
83097;Pourrières;2479;70248981;3939372;1541;60106710;938;10142271;28338;29588
60553;Rouvillers;139;3939220;187401;94;3417142;45;522078;28340;29589
10162;Fresnoy-le-Château;131;3712510;204117;81;3148269;50;564241;28340;29590
59584;Taisnières-sur-Hon;519;14708601;985397;306;12179216;213;2529385;28340;29591
28397;Umpeau;198;5611391;300553;138;4814223;60;797168;28340;29592
31271;Lanta;915;25933065;1409106;608;22497530;307;3435535;28342;29593
47206;Pinel-Hauterive;259;7340625;353363;137;6035403;122;1305222;28342;29594
77469;Touquin;580;16439207;1023073;371;14233860;209;2205347;28343;29595
45032;Le Bignon-Mirabeau;175;4960280;244801;108;4117844;67;842436;28344;29596
51508;Saint-Ouen-Domprot;113;3202980;206624;65;2599597;48;603383;28345;29597
25485;Rémondans-Vaivre;107;3032933;124636;72;2643558;35;389375;28345;29598
54380;Mont-le-Vignoble;189;5357238;208022;121;4533162;68;824076;28345;29599
58228;Saint-Andelain;306;8673671;714846;183;7464644;123;1209027;28345;29600
25418;Nancray;602;17064246;883156;398;14485733;204;2578513;28346;29601
47288;Sauvagnas;253;7171943;243381;160;6110583;93;1061360;28348;29602
21182;Collonges-lès-Bévy;50;1417548;73619;31;1222726;19;194822;28351;29603
47154;Lusignan-Petit;178;5046527;352531;103;4350349;75;696178;28351;29604
21330;Labergement-Foigney;192;5443546;231488;135;4593507;57;850039;28352;29605
60038;Bachivillers;217;6152373;287868;147;5215897;70;936476;28352;29606
17418;Salignac-sur-Charente;330;9356448;497802;219;8091924;111;1264524;28353;29607
57055;Bazoncourt;252;7144975;286874;171;6175552;81;969423;28353;29608
91479;Paray-Vieille-Poste;4251;120529441;7934797;2988;108079002;1263;12450439;28353;29609
91613;Congerville-Thionville;107;3033796;125485;66;2510398;41;523398;28353;29610
25575;Vaire-Arcier;283;8024235;360582;213;7139995;70;884240;28354;29611
06079;Mandelieu-la-Napoule;15298;433772463;34021672;9780;375834871;5518;57937592;28355;29612
76463;Neuf-Marché;352;9981327;474085;214;8327976;138;1653351;28356;29613
08154;Estrebay;46;1304454;50139;27;1122417;19;182037;28358;29614
28148;Le Favril;183;5189471;273047;125;4492935;58;696536;28358;29615
68110;Grussenheim;413;11711814;570559;282;10150640;131;1561174;28358;29616
69192;Saint-Cyr-le-Chatoux;61;1729861;66698;40;1459007;21;270854;28358;29617
39560;Villard-Saint-Sauveur;356;10095595;533859;257;8969410;99;1126185;28358;29618
57665;Tenteling;557;15795833;873616;359;13470486;198;2325347;28359;29619
28319;Rouvray-Saint-Denis;220;6239234;321654;146;5281216;74;958018;28360;29620
68306;Seppois-le-Haut;237;6721455;418989;148;5600365;89;1121090;28361;29621
43184;Saint-Ferréol-d'Auroure;1198;33978591;1469837;857;29738154;341;4240437;28363;29622
35207;Noyal-sur-Vilaine;2730;77431525;3594967;1862;66766974;868;10664551;28363;29623
65083;Bernac-Debat;349;9898929;554848;240;8559919;109;1339010;28364;29624
21589;Saussy;44;1248017;53992;31;1124333;13;123684;28364;29625
14024;Auberville;232;6580490;293905;157;5667209;75;913281;28364;29626
31210;Gardouch;681;19316340;953095;435;16397681;246;2918659;28365;29627
38475;Satolas-et-Bonce;1105;31344111;1584610;775;27482957;330;3861154;28366;29628
49219;Montsoreau;271;7687312;575746;147;6442222;124;1245090;28366;29629
44169;Saint-Julien-de-Concelles;3421;97041908;4181744;2221;83412358;1200;13629550;28367;29630
35076;Chavagne;1795;50919222;2333513;1301;45234139;494;5685083;28367;29631
01332;Saint-André-de-Bâgé;326;9248305;465183;217;7953692;109;1294613;28369;29632
31113;Castanet-Tolosan;6604;187358136;11799647;4402;163949327;2202;23408809;28370;29633
26358;Upie;761;21590069;1083612;469;18102216;292;3487853;28371;29634
60464;Nointel;532;15094145;688227;390;13412250;142;1681895;28372;29635
14545;Roullours;431;12228982;436850;288;10548477;143;1680505;28374;29636
32380;Saint-Griède;65;1844316;167053;35;1555912;30;288404;28374;29637
77191;Fontenailles;527;14953194;683682;386;13256414;141;1696780;28374;29638
69166;Riverie;131;3717193;168451;85;3259590;46;457603;28376;29639
71112;Château;129;3660581;199993;75;3168390;54;492191;28377;29640
72283;Saint-Germain-d'Arcé;180;5108271;216873;90;4127459;90;980812;28379;29641
91390;Méréville;1727;49011143;2856777;1164;42386127;563;6625016;28379;29642
35152;Liffré;3493;99129949;4685609;2296;84544836;1197;14585113;28380;29643
79081;Chauray;3491;99074948;5261985;2496;87524397;995;11550551;28380;29644
25428;Nommay;870;24690893;1272874;598;21514961;272;3175932;28380;29645
60398;Le Mesnil-en-Thelle;1200;34056766;1814898;883;30578514;317;3478252;28381;29646
86135;Liniers;286;8117116;458305;197;7015309;89;1101807;28382;29647
77246;Léchelle;286;8117223;520660;186;7104845;100;1012378;28382;29648
54340;Mamey;161;4569503;189250;117;4020904;44;548599;28382;29649
51295;Huiron;169;4796783;348475;109;4010758;60;786025;28383;29650
64405;Morlaàs;2232;63356315;3538982;1409;54163334;823;9192981;28385;29651
25440;Ouhans;177;5024550;172743;109;4207186;68;817364;28387;29652
68139;Hirtzbach;752;21348171;1245807;497;18487924;255;2860247;28389;29653
16425;Yvrac-et-Malleyrand;314;8914057;193949;154;7173141;160;1740916;28389;29654
65313;Momères;364;10334217;572294;228;8901058;136;1433159;28391;29655
61203;Héloup;496;14082333;644025;348;12094514;148;1987819;28392;29656
44037;Château-Thébaud;1405;39892234;1623145;939;34174673;466;5717561;28393;29657
72076;Chenay;96;2725823;117799;68;2349321;28;376502;28394;29658
28170;Garancières-en-Drouais;143;4060353;195975;103;3585241;40;475112;28394;29659
21553;Saint-Jean-de-Boeuf;60;1703681;166873;35;1412322;25;291359;28395;29660
67433;Sand;592;16810522;828074;426;14979255;166;1831267;28396;29661
10090;Chauchigny;144;4089120;343216;90;3437494;54;651626;28397;29662
51343;Marcilly-sur-Seine;362;10280331;675406;226;8718268;136;1562063;28399;29663
71412;Saint-Eusèbe;583;16556920;652650;405;14296291;178;2260629;28400;29664
42083;Dargoire;257;7298971;294311;183;6488169;74;810802;28401;29665
14268;Fierville-Bray;231;6561146;303812;155;5587259;76;973887;28403;29666
51428;Les Petites-Loges;205;5822706;236411;150;5174677;55;648029;28403;29667
26064;Chabeuil;3574;101532482;5438439;2205;84704518;1369;16827964;28409;29668
31160;Daux;1047;29745469;1571973;700;25876322;347;3869147;28410;29669
38296;Le Passage;382;10853093;477822;245;9215991;137;1637102;28411;29670
68130;Heiteren;514;14603572;787109;363;12816878;151;1786694;28412;29671
14339;Hubert-Folie;176;5000456;277994;125;4410243;51;590213;28412;29672
51265;Gaye;310;8807862;467595;188;7391904;122;1415958;28412;29673
17407;Sainte-Soulle;1933;54921634;2662928;1305;47366467;628;7555167;28413;29674
29186;Plouezoc'h;945;26851285;1585564;600;23122278;345;3729007;28414;29675
74221;Le Reposoir;251;7132028;434592;164;6351677;87;780351;28414;29676
91232;La Ferté-Alais;2116;60125652;3583104;1452;53040973;664;7084679;28415;29677
01169;Genouilleux;282;8013016;334382;213;7114328;69;898688;28415;29678
26004;Alixan;1261;35831686;2137913;785;30504043;476;5327643;28415;29679
60369;Longueil-Sainte-Marie;941;26742170;1441905;639;23431141;302;3311029;28419;29680
57360;Kerbach;617;17534791;931659;404;14901704;213;2633087;28419;29681
01276;Niévroz;768;21826573;1088602;511;19094830;257;2731743;28420;29682
76396;Longuerue;142;4035951;216657;95;3524112;47;511839;28422;29683
34039;Bouzigues;937;26631740;2177130;529;22266522;408;4365218;28422;29684
08038;Avançon;141;4007759;176392;84;3314441;57;693318;28424;29685
65265;Laslades;179;5088075;349974;111;4263049;68;825026;28425;29686
33256;Ludon-Médoc;2226;63275639;3145672;1535;55344794;691;7930845;28426;29687
51110;Chaltrait;42;1193892;77209;26;1028877;16;165015;28426;29688
60672;Vez;158;4491527;301550;100;3643084;58;848443;28427;29689
54096;Bréhain-la-Ville;172;4889521;185953;70;2837852;102;2051669;28427;29690
27696;Villiers-en-Désoeuvre;439;12480254;631365;315;10828829;124;1651425;28429;29691
59228;Férin;738;20980521;984411;484;17943910;254;3036611;28429;29692
27655;Tourville-sur-Pont-Audemer;359;10206033;721605;224;8692954;135;1513079;28429;29693
77243;Lagny-sur-Marne;11768;334569155;23518196;7909;295856816;3859;38712339;28430;29694
12264;Sébazac-Concourès;1626;46228981;2227513;1125;40351317;501;5877664;28431;29695
62115;Berneville;243;6908872;325419;176;6178852;67;730020;28432;29696
95323;Jouy-le-Moutier;7836;222791586;12013980;5249;194903932;2587;27887654;28432;29697
10053;Bouranton;267;7591380;320071;202;6810143;65;781237;28432;29698
63327;Saint-Bonnet-près-Riom;1038;29512681;1457650;744;26135544;294;3377137;28432;29699
65390;Saint-Lézer;227;6454783;411386;146;5566972;81;887811;28435;29700
76626;Saint-Nicolas-de-la-Haie;187;5318121;241929;138;4826093;49;492028;28439;29701
38451;Saint-Romain-de-Jalionas;1620;46075406;2572052;1132;40203236;488;5872170;28442;29702
17065;Breuil-Magné;840;23891175;1269789;557;20794947;283;3096228;28442;29703
72024;La Bazoge;1779;50599349;2317491;1212;43555310;567;7044039;28443;29704
08048;Barby;190;5404346;233900;126;4652058;64;752288;28444;29705
54510;Sornéville;151;4295353;221234;96;3685552;55;609801;28446;29706
08380;Saint-Fergeux;102;2901527;167488;57;2432857;45;468670;28446;29707
21387;Marigny-lès-Reullée;113;3214473;177180;78;2781352;35;433121;28447;29708
39480;Saint-Didier;148;4210248;154221;101;3454538;47;755710;28448;29709
27101;Bouquelon;192;5462202;223321;134;4722882;58;739320;28449;29710
14657;Saint-Samson;170;4836340;262789;124;4319555;46;516785;28449;29711
13075;Plan-de-Cuques;6147;174881112;10834537;4026;150871898;2121;24009214;28450;29712
73096;Cruet;537;15278471;705168;366;12843828;171;2434643;28452;29713
38238;Moidieu-Détourbe;879;25010094;1127079;598;21720624;281;3289470;28453;29714
17162;Fontaine-Chalendray;133;3784295;111997;47;2876746;86;907549;28453;29715
73191;Novalaise;993;28254400;1382174;651;23927798;342;4326602;28454;29716
90018;Brebotte;171;4865836;224359;115;4115061;56;750775;28455;29717
59388;Marquillies;982;27944655;1486322;596;23260958;386;4683697;28457;29718
71525;Sologny;285;8110309;370879;189;6864755;96;1245554;28457;29719
10391;Vailly;155;4410998;221191;115;3945731;40;465267;28458;29720
10177;Javernant;88;2504517;132289;59;2194897;29;309620;28460;29721
03290;Trévol;833;23707543;1242090;586;20781672;247;2925871;28460;29722
27093;Bosnormand;149;4240747;193650;110;3764672;39;476075;28461;29723
60135;Cauvigny;767;21829976;1156907;549;19396445;218;2433531;28462;29724
67096;Dimbsthal;157;4468516;212737;106;3812448;51;656068;28462;29725
44130;Pont-Saint-Martin;2751;78304158;3507121;1871;67382258;880;10921900;28464;29726
80514;Marieux;59;1679379;45697;34;1443224;25;236155;28464;29727
17245;Montroy;325;9250916;399438;230;8112494;95;1138422;28464;29728
76264;Flamanville;184;5237959;206724;119;4320150;65;917809;28467;29729
55367;Muzeray;58;1651215;56974;34;1214871;24;436344;28469;29730
41150;Mont-près-Chambord;1724;49081477;2941140;1174;42690453;550;6391024;28470;29731
71470;Saint-Point;198;5637194;335243;116;4852681;82;784513;28471;29732
68342;Uffholtz;912;25965879;1561336;624;22485113;288;3480766;28471;29733
59482;Quesnoy-sur-Deûle;3441;97971083;5263880;2132;83743857;1309;14227226;28472;29734
18280;Vignoux-sous-les-Aix;345;9822870;439900;238;8669380;107;1153490;28472;29735
27663;Le Troncq;84;2391774;107603;54;2045339;30;346435;28474;29736
10230;Mergey;339;9652774;482299;240;8394239;99;1258535;28474;29737
21520;Remilly-en-Montagne;76;2164130;130193;53;1905362;23;258768;28475;29738
55102;Charny-sur-Meuse;273;7773789;362897;187;6666087;86;1107702;28475;29739
42312;La Tourette;284;8087044;368429;176;6447620;108;1639424;28476;29740
90056;Joncherey;702;19990290;1322740;462;16949919;240;3040371;28476;29741
88495;Vaudéville;84;2392003;140541;64;2176429;20;215574;28476;29742
27187;Criquebeuf-la-Campagne;136;3873071;171240;98;3403605;38;469466;28478;29743
60489;Péroy-les-Gombries;515;14667694;804450;354;12806096;161;1861598;28481;29744
25586;Vandoncourt;448;12759474;562911;311;10859047;137;1900427;28481;29745
53201;Saint-Berthevin;3836;109256372;5030286;2511;93408349;1325;15848023;28482;29746
41040;La Chapelle-Vendômoise;391;11136481;554527;269;9416358;122;1720123;28482;29747
59066;Bérelles;87;2478078;209970;52;2120240;35;357838;28484;29748
38401;Saint-Jean-de-Soudain;742;21135497;1280278;477;17983931;265;3151566;28484;29749
42253;Saint-Léger-sur-Roanne;573;16322261;869436;396;14016385;177;2305876;28486;29750
67038;Bietlenheim;152;4330255;256413;112;3849067;40;481188;28489;29751
02627;Proviseux-et-Plesnoy;47;1339051;44924;31;1144912;16;194139;28490;29752
83098;Le Pradet;6550;186618360;13150018;4173;160765785;2377;25852575;28491;29753
80723;Saisseval;117;3333735;180298;77;2923529;40;410206;28493;29754
31211;Gargas;327;9318281;438705;202;7751700;125;1566581;28496;29755
59091;Borre;275;7837003;345766;176;6637477;99;1199526;28498;29756
28365;Sandarville;203;5785210;356772;144;5142164;59;643046;28499;29757
76501;Pierrefiques;69;1966429;105127;49;1763333;20;203096;28499;29758
74192;Moye;493;14050430;614464;354;12457485;139;1592945;28500;29759
02554;Nogentel;552;15732603;902254;396;13830781;156;1901822;28501;29760
86133;Ligugé;1707;48654769;2847360;1118;41948677;589;6706092;28503;29761
14173;Condé-sur-Ifs;217;6185318;468529;124;5078886;93;1106432;28504;29762
76725;Vattetot-sous-Beaumont;255;7268483;365155;168;6080505;87;1187978;28504;29763
73145;Lépin-le-Lac;226;6441899;321303;138;5362973;88;1078926;28504;29764
10231;Le Mériot;297;8465882;458270;195;7163117;102;1302765;28505;29765
57119;Buhl-Lorraine;622;17730697;1254328;392;15089521;230;2641176;28506;29766
77115;Chevry-en-Sereine;252;7183790;333143;176;6273126;76;910664;28507;29767
74174;Mégevette;268;7640042;199416;176;6158813;92;1481229;28508;29768
90067;Menoncourt;207;5901131;294388;141;5101834;66;799297;28508;29769
57234;Frauenberg;307;8752320;571551;190;7273310;117;1479010;28509;29770
80713;Saint-Quentin-en-Tourmont;183;5217254;567554;96;4391940;87;825314;28510;29771
16120;Dirac;790;22522773;1209170;535;19566849;255;2955924;28510;29772
16152;Gimeux;397;11319079;552029;264;9904297;133;1414782;28512;29773
33274;Martillac;1395;39773933;2036087;948;34896076;447;4877857;28512;29774
06157;Vence;11166;318388550;23649990;6710;274472220;4456;43916330;28514;29775
57743;Waltembourg;114;3250787;97826;76;2709660;38;541127;28516;29776
77060;Buthiers;434;12376243;756165;302;11113863;132;1262380;28517;29777
30217;Rochefort-du-Gard;3714;105911856;5215598;2342;90113111;1372;15798745;28517;29778
41032;Chailles;1264;36045485;1851723;855;31052997;409;4992488;28517;29779
02287;Essigny-le-Grand;559;15941511;754944;385;13728602;174;2212909;28518;29780
29090;Kerlaz;429;12234418;603031;285;10486758;144;1747660;28518;29781
34102;Fontanès;176;5019434;239795;115;4405263;61;614171;28520;29782
52360;Occey;86;2452793;176745;55;2078462;31;374331;28521;29783
27215;Ecquetot;182;5190991;278356;127;4436246;55;754745;28522;29784
18206;Saint-Éloy-de-Gy;786;22418384;1187489;521;19294893;265;3123491;28522;29785
22123;Léhon;1647;46978669;3209441;971;40759457;676;6219212;28524;29786
54505;Sexey-aux-Forges;329;9384699;452742;234;8319349;95;1065350;28525;29787
60090;Bouconvillers;184;5248593;307558;133;4760465;51;488128;28525;29788
02549;Neuville-Saint-Amand;454;12950371;859878;286;10917611;168;2032760;28525;29789
35206;Noyal-Châtillon-sur-Seiche;3420;97556257;5173452;2294;84917360;1126;12638897;28525;29790
59080;Beuvry-la-Forêt;1405;40079234;2163974;862;33571342;543;6507892;28526;29791
51098;Bussy-le-Repos;65;1854330;130402;37;1517010;28;337320;28528;29792
59407;Monchaux-sur-Écaillon;302;8616023;477298;201;7690510;101;925513;28530;29793
71062;Brion;176;5021334;294491;116;4246945;60;774389;28530;29794
77448;Sept-Sorts;229;6533520;392860;180;6076065;49;457455;28531;29795
80403;Guyencourt-sur-Noye;96;2739065;150052;64;2354382;32;384683;28532;29796
47225;Roquefort;932;26591928;1424367;611;22492703;321;4099225;28532;29797
27456;Pinterville;433;12354645;609564;310;10996376;123;1358269;28533;29798
67186;Hegeney;188;5364284;197880;138;4783741;50;580543;28533;29799
52383;Perrancey-les-Vieux-Moulins;176;5021952;324610;120;4514183;56;507769;28534;29800
14177;Coquainvilliers;439;12526853;845166;286;10777141;153;1749712;28535;29801
06147;Tourrette-Levens;2534;72308609;4359926;1580;61721924;954;10586685;28535;29802
67526;Westhouse;752;21458615;938491;543;19028438;209;2430177;28535;29803
45165;Gy-les-Nonains;366;10444020;676983;243;9112913;123;1331107;28536;29804
32121;Endoufielle;284;8104255;506374;175;6877962;109;1226293;28536;29805
25611;La Vèze;263;7505052;452085;181;6383341;82;1121711;28536;29806
32173;Labrihe;123;3510085;76632;63;2868296;60;641789;28537;29807
35275;Saint-Gilles;1935;55220957;2795208;1342;48656965;593;6563992;28538;29808
57317;Hérange;67;1912044;168326;37;1585560;30;326484;28538;29809
72006;Arçonnay;892;25456068;1358448;598;21918201;294;3537867;28538;29810
28337;Saint-Georges-sur-Eure;1314;37500860;2028227;939;33107138;375;4393722;28539;29811
74268;Seynod;10379;296232734;14918629;6951;254621485;3428;41611249;28542;29812
73141;Laissaud;334;9532891;385223;237;8349254;97;1183637;28542;29813
14198;Cresseveuille;144;4110037;293423;87;3467631;57;642406;28542;29814
28120;Crucey-Villages;250;7135487;449473;164;6110088;86;1025399;28542;29815
60260;Fresnoy-la-Rivière;323;9219099;475250;227;8156745;96;1062354;28542;29816
63160;Flat;249;7107156;329188;182;6220992;67;886164;28543;29817
38450;Saint-Quentin-sur-Isère;664;18952751;981501;419;15998477;245;2954274;28543;29818
76507;Ponts-et-Marais;435;12417415;770952;267;10446499;168;1970916;28546;29819
88437;Saint-Vallier;48;1370198;102634;21;1033481;27;336717;28546;29820
61111;Colombiers;197;5623522;369250;132;4966378;65;657144;28546;29821
21390;Marsannay-la-Côte;2721;77673392;4111404;1867;66744758;854;10928634;28546;29822
19041;Chanac-les-Mines;281;8021948;418976;188;7025912;93;996036;28548;29823
59187;Éclaibes;151;4310851;272527;87;3608420;64;702431;28549;29824
52254;Lachapelle-en-Blaisy;50;1427456;162489;37;1293803;13;133653;28549;29825
46214;Parnac;217;6195685;247710;117;5190506;100;1005179;28552;29826
60568;Saint-Aubin-sous-Erquery;168;4796680;256621;124;4261395;44;535285;28552;29827
83019;Bormes-les-Mimosas;5096;145505898;10865373;3058;125060203;2038;20445695;28553;29828
28139;Épeautrolles;90;2569909;116566;59;2119325;31;450584;28555;29829
77472;La Trétoire;227;6481947;402743;151;5609261;76;872686;28555;29830
60010;Amblainville;892;25472534;1328238;615;22083884;277;3388650;28557;29831
67153;Geiswiller;101;2884471;137662;58;2242686;43;641785;28559;29832
67132;Eschbach;481;13737230;675015;346;11956946;135;1780284;28560;29833
16330;Saint-Laurent-de-Cognac;531;15166106;950991;338;13057698;193;2108408;28561;29834
10435;Villy-le-Maréchal;95;2713341;130637;68;2388063;27;325278;28561;29835
40277;Saint-Pandelon;386;11024800;732347;251;9501649;135;1523151;28562;29836
25364;Mamirolle;795;22706947;1044394;511;19194451;284;3512496;28562;29837
49339;Soulaire-et-Bourg;683;19508051;781903;466;16692680;217;2815371;28562;29838
27563;Saint-Mards-de-Blacarville;418;11939184;686865;269;10274133;149;1665051;28563;29839
47088;Escassefort;329;9397579;353000;167;7775807;162;1621772;28564;29840
01300;Le Poizat;211;6027044;231412;135;4857435;76;1169609;28564;29841
33200;Le Haillan;5237;149591671;8945646;3571;130834769;1666;18756902;28564;29842
88026;Aydoilles;533;15225598;721724;364;13326849;169;1898749;28566;29843
68091;Fessenheim;1199;34250531;1662635;864;30090342;335;4160189;28566;29844
31187;Fonsorbes;5704;162953232;8509379;3790;140911585;1914;22041647;28568;29845
27451;Parville;171;4885273;343243;124;4382511;47;502762;28569;29846
77127;Coubert;855;24426762;1503548;594;21484757;261;2942005;28569;29847
28241;Le Mée;146;4171683;473623;86;3374505;60;797178;28573;29848
28160;Francourville;392;11201391;569782;274;9863232;118;1338159;28575;29849
54439;Pulnoy;2329;66552366;3623085;1585;57871846;744;8680520;28576;29850
91136;Champlan;1408;40235209;2489773;1006;35997500;402;4237709;28576;29851
77357;Pécy;419;11973523;548519;274;10130560;145;1842963;28576;29852
80758;Thory;84;2400516;173654;59;2128673;25;271843;28578;29853
41240;Seillac;52;1486049;92386;35;1268949;17;217100;28578;29854
27376;Louye;125;3572384;228836;92;3219568;33;352816;28579;29855
37025;Berthenay;352;10060224;469271;253;8866149;99;1194075;28580;29856
18271;Vasselay;659;18834712;946334;458;16498104;201;2336608;28581;29857
84119;Saint-Saturnin-lès-Avignon;2636;75342437;4726575;1676;64242674;960;11099763;28582;29858
10051;Bouilly;547;15634442;1035173;364;13616744;183;2017698;28582;29859
49306;Saint-Martin-du-Fouilloux;783;22382860;859211;539;19418496;244;2964364;28586;29860
16058;Boutiers-Saint-Trojan;784;22416139;1343881;516;19495322;268;2920817;28592;29861
59072;Bersillies;141;4031534;235675;92;3307092;49;724442;28592;29862
27560;Saint-Luc;140;4002992;202601;101;3594523;39;408469;28593;29863
67348;Obernai;6058;173216804;11420088;3877;148343536;2181;24873268;28593;29864
11404;Ventenac-Cabardès;446;12754473;862339;271;10990463;175;1764010;28597;29865
47032;Bon-Encontre;3375;96516812;5394049;2078;82152593;1297;14364219;28598;29866
72127;Étival-lès-le-Mans;945;27025204;1109375;684;23609602;261;3415602;28598;29867
74114;Essert-Romand;232;6635168;358530;154;5592246;78;1042922;28600;29868
60548;Rosoy-en-Multien;218;6234934;306589;154;5468292;64;766642;28601;29869
76563;Saint-Aubin-Routot;658;18819593;1074223;415;16637259;243;2182334;28601;29870
60651;Ully-Saint-Georges;958;27401252;1612063;660;23869468;298;3531784;28603;29871
16139;Fleurac;145;4147416;618277;63;3420119;82;727297;28603;29872
27483;Quatremare;196;5606453;314720;135;4927369;61;679084;28604;29873
59416;Morbecque;1332;38101711;1997051;772;31807329;560;6294382;28605;29874
76304;Gonfreville-Caillot;157;4491135;144317;107;3765243;50;725892;28606;29875
77250;Leudon-en-Brie;81;2317124;175240;56;2069048;25;248076;28606;29876
26005;Allan;898;25689788;1633522;567;21949369;331;3740419;28608;29877
73095;La Croix-de-la-Rochette;153;4377156;179282;115;3878334;38;498822;28609;29878
87192;Solignac;814;23289495;1274765;548;20222458;266;3067037;28611;29879
02104;Bouffignereux;52;1487885;86180;34;1295541;18;192344;28613;29880
14551;Russy;92;2632543;112923;64;2360082;28;272461;28615;29881
54469;Saint-Ail;193;5522793;191747;117;4461137;76;1061656;28616;29882
59657;West-Cappel;258;7383060;351888;164;6254713;94;1128347;28617;29883
03195;Néris-les-Bains;1570;44928350;3154441;897;37137265;673;7791085;28617;29884
73041;Betton-Bettonet;156;4464237;183227;103;3786374;53;677863;28617;29885
62263;Dainville;3064;87683200;5308374;1948;74753064;1116;12930136;28617;29886
60264;Frocourt;264;7555027;368918;209;7017368;55;537659;28618;29887
31334;Mauzac;588;16827121;954659;369;14474198;219;2352923;28618;29888
14062;Bény-sur-Mer;185;5294396;240456;130;4705382;55;589014;28618;29889
25362;Malpas;121;3462857;187134;79;2994324;42;468533;28619;29890
77451;Signy-Signets;300;8586536;447326;216;7563136;84;1023400;28622;29891
13049;Lamanon;996;28507821;1629959;657;24732926;339;3774895;28622;29892
64198;Denguin;831;23785712;1078169;568;20351755;263;3433957;28623;29893
65010;Angos;127;3635368;257115;81;3112583;46;522785;28625;29894
27602;Saint-Sébastien-de-Morsent;2358;67510546;3291908;1665;58752547;693;8757999;28630;29895
51051;Berméricourt;83;2376345;110773;61;2171860;22;204485;28631;29896
60162;Corbeil-Cerf;158;4523742;247720;104;3870718;54;653024;28631;29897
51074;Boult-sur-Suippe;776;22217889;986814;532;19207049;244;3010840;28631;29898
27296;Granchain;101;2891820;157535;63;2403099;38;488721;28632;29899
10009;Arrelles;44;1259850;82762;28;1092723;16;167127;28633;29900
78076;Boissets;147;4209090;252544;99;3631508;48;577582;28633;29901
67140;Forstfeld;391;11195697;795602;251;9540638;140;1655059;28633;29902
52251;Jonchery;487;13944562;759107;337;11972598;150;1971964;28634;29903
51293;Heutrégiville;200;5726867;317149;132;4868085;68;858782;28634;29904
73247;Saint-Jean-de-la-Porte;454;13000287;815441;310;11212955;144;1787332;28635;29905
51552;Songy;152;4352599;262354;105;3782233;47;570366;28636;29906
42259;Saint-Martin-la-Plaine;1829;52375283;2544319;1221;44729370;608;7645913;28636;29907
95205;Écouen;3931;112576084;6596388;2837;100774765;1094;11801319;28638;29908
57139;Chérisey;144;4123927;192167;99;3498470;45;625457;28638;29909
51299;Isles-sur-Suippe;422;12085807;610286;291;10540385;131;1545422;28639;29910
68017;Ballersdorf;436;12487665;645566;312;10949003;124;1538662;28641;29911
28393;Tremblay-les-Villages;1090;31219442;1509019;729;26958647;361;4260795;28642;29912
51160;Compertrix;701;20079173;1049956;479;16991911;222;3087262;28644;29913
14109;Brouay;217;6215891;281936;149;5338415;68;877476;28645;29914
80399;Guignemicourt;132;3781214;231550;86;3276980;46;504234;28646;29915
21409;Meuilley;247;7075772;405354;175;6350806;72;724966;28647;29916
02734;Taillefontaine;142;4067871;285351;87;3400814;55;667057;28647;29917
62801;Souchez;1365;39103500;2072612;817;33102441;548;6001059;28647;29918
01286;Parves;188;5385989;216488;126;4437510;62;948479;28649;29919
68153;Illhaeusern;371;10628999;587259;255;9190819;116;1438180;28650;29920
32372;Saint-Cricq;126;3609967;143667;93;3178590;33;431377;28651;29921
47056;Castelnau-sur-Gupie;437;12520979;895691;261;10392461;176;2128518;28652;29922
62205;Campagne-lès-Wardrecques;559;16016680;768413;380;13735201;179;2281479;28652;29923
05005;Antonaves;92;2636084;89946;46;2114944;46;521140;28653;29924
64467;Rontignon;436;12493179;788255;292;10962171;144;1531008;28654;29925
12180;Peyreleau;34;974266;13600;16;803176;18;171090;28655;29926
26169;Malataverne;979;28053707;1482088;659;24082143;320;3971564;28655;29927
27026;Authevernes;186;5329920;256339;130;4644877;56;685043;28655;29928
62073;Bailleul-Sir-Berthoult;640;18340064;926446;430;15880666;210;2459398;28656;29929
40210;Onesse-et-Laharie;578;16564354;973159;302;13488636;276;3075718;28658;29930
01165;Francheleins;678;19430800;805866;488;17042966;190;2387834;28659;29931
77169;Émerainville;3901;111799781;6937023;2744;99935102;1157;11864679;28659;29932
67541;Wintzenbach;289;8282650;509974;187;7130550;102;1152100;28660;29933
42232;Saint-Haon-le-Châtel;310;8884607;423101;186;7153088;124;1731519;28660;29934
57289;Hambach;1508;43220630;3049828;870;35801659;638;7418971;28661;29935
89056;Brion;315;9028395;417698;211;7698267;104;1330128;28662;29936
68060;Burnhaupt-le-Haut;861;24677860;1156079;597;21455378;264;3222482;28662;29937
10274;Orvilliers-Saint-Julien;171;4901259;348063;112;4227650;59;673609;28662;29938
69023;Blacé;732;20982447;1126518;454;17667798;278;3314649;28665;29939
37139;Luynes;2656;76133065;4251209;1721;64665966;935;11467099;28665;29940
73076;La Chapelle-du-Mont-du-Chat;125;3583137;201073;86;3138074;39;445063;28665;29941
49352;Toutlemonde;531;15221535;524564;352;12764515;179;2457020;28666;29942
02441;Louâtre;109;3124833;161512;66;2482216;43;642617;28668;29943
14376;Longraye;131;3755916;223436;62;2995831;69;760085;28671;29944
57708;Verny;902;25861555;1133061;626;22466537;276;3395018;28671;29945
56087;Île-aux-Moines;328;9404212;605014;190;7919410;138;1484802;28671;29946
28006;Amilly;1000;28672489;1586530;728;25708721;272;2963768;28672;29947
80073;Bécordel-Bécourt;82;2351167;170758;58;2076092;24;275075;28673;29948
35327;Servon-sur-Vilaine;1718;49259952;2077449;1208;42633313;510;6626639;28673;29949
14648;Saint-Pierre-des-Ifs;215;6165164;325524;136;5264477;79;900687;28675;29950
01451;Viriat;3113;89268279;4453211;2173;77765306;940;11502973;28676;29951
45342;Villereau;189;5420024;215287;142;4708714;47;711310;28677;29952
77162;Doue;530;15199210;857790;373;13362424;157;1836786;28678;29953
37104;Esvres;2598;74505960;3818161;1757;64657651;841;9848309;28678;29954
28227;Maintenon;2442;70034741;4047716;1664;61403021;778;8631720;28679;29955
59660;Willems;1551;44483199;2602337;961;37807245;590;6675954;28680;29956
80681;Rouvrel;143;4101688;298178;95;3636179;48;465509;28683;29957
27397;Ménilles;825;23664625;1407418;578;20848729;247;2815896;28684;29958
38474;Sassenage;6183;177357237;10244147;4355;156295548;1828;21061689;28685;29959
61359;Saint-Agnan-sur-Erre;91;2610474;175321;63;2252341;28;358133;28687;29960
45195;Mareau-aux-Bois;294;8434197;415012;184;7026875;110;1407322;28688;29961
25579;Val-de-Roulans;79;2266343;125196;55;1970893;24;295450;28688;29962
25033;Autechaux-Roide;298;8549603;382010;217;7568997;81;980606;28690;29963
60656;Varinfroy;125;3586518;160249;88;3018606;37;567912;28692;29964
49155;Grez-Neuville;699;20056166;912553;461;17269905;238;2786261;28693;29965
67092;Dieffenbach-au-Val;309;8866103;382039;197;7320790;112;1545313;28693;29966
63239;Montmorin;350;10044238;693950;212;8429535;138;1614703;28698;29967
67282;Marlenheim;2104;60381455;3518059;1381;52184109;723;8197346;28698;29968
03182;Monteignet-sur-l'Andelot;140;4017779;176990;78;3388947;62;628832;28698;29969
21587;Saulx-le-Duc;131;3759553;235336;89;3331694;42;427859;28699;29970
70327;Malans;74;2123736;90749;48;1634349;26;489387;28699;29971
31254;Labège;1838;52753512;2916476;1132;44963815;706;7789697;28702;29972
80722;Saint-Vaast-en-Chaussée;254;7290343;369191;186;6520058;68;770285;28702;29973
77133;Courcelles-en-Bassée;129;3702649;233666;86;3214148;43;488501;28703;29974
38341;Rochetoirin;514;14753307;716233;350;12802533;164;1950774;28703;29975
18138;Marmagne;1102;31630799;1680703;781;27441936;321;4188863;28703;29976
45348;Yèvre-la-Ville;406;11653545;697101;269;10188151;137;1465394;28703;29977
17318;Saint-Clément-des-Baleines;465;13347602;1097189;306;11712199;159;1635403;28705;29978
71031;Berzé-le-Châtel;34;976003;106523;22;876694;12;99309;28706;29979
57341;Hunting;357;10248451;252337;179;6513024;178;3735427;28707;29980
41165;Oigny;45;1291896;77305;30;1131505;15;160391;28709;29981
33005;Andernos-les-Bains;7088;203488530;13422297;4458;173713771;2630;29774759;28709;29982
84010;La Bastidonne;405;11627225;730181;234;9670428;171;1956797;28709;29983
21540;Saint-Apollinaire;3759;107923144;6112169;2682;94790625;1077;13132519;28711;29984
10307;Prugny;199;5713453;286476;138;5012415;61;701038;28711;29985
29045;Dirinon;1161;33333983;1724159;749;28521484;412;4812499;28711;29986
54559;Velle-sur-Moselle;158;4536436;210276;110;4011763;48;524673;28712;29987
57125;Chailly-lès-Ennery;156;4479056;124138;97;3543494;59;935562;28712;29988
77149;Cucharmoy;132;3790043;309664;92;3436913;40;353130;28712;29989
45011;Attray;111;3187323;159601;71;2801394;40;385929;28715;29990
03304;Vendat;1204;34573778;1627533;788;29685096;416;4888682;28716;29991
14459;Les Moutiers-Hubert;28;804048;24423;17;662282;11;141766;28716;29992
42081;Cuzieu;690;19815993;988721;474;17125932;216;2690061;28719;29993
08393;Saint-Pierre-à-Arnes;39;1120038;67760;24;972623;15;147415;28719;29994
14294;Garcelles-Secqueville;366;10511272;547240;264;9266475;102;1244797;28719;29995
02770;Vauxbuin;418;12005127;805931;277;10415358;141;1589769;28720;29996
10115;Creney-près-Troyes;917;26337111;1372924;662;23251332;255;3085779;28721;29997
14205;Cristot;100;2872108;124088;65;2371029;35;501079;28721;29998
42176;Pouilly-les-Nonains;934;26825966;1349493;628;22829206;306;3996760;28722;29999
76494;Parc-d'Anxtot;262;7525282;280007;180;6307109;82;1218173;28722;30000
52449;Saints-Geosmes;496;14247343;713297;323;12044823;173;2202520;28724;30001
87050;Couzeix;4550;130708703;7588415;3067;114805211;1483;15903492;28727;30002
55331;Méligny-le-Petit;39;1120449;40588;26;936447;13;184002;28729;30003
51037;Baslieux-lès-Fismes;149;4280769;143616;96;3613582;53;667187;28730;30004
85081;Dompierre-sur-Yon;1989;57146035;2424159;1389;49996511;600;7149524;28731;30005
02177;Chérêt;68;1953721;96906;46;1693675;22;260046;28731;30006
01302;Pollieu;89;2557205;173442;63;2291973;26;265232;28733;30007
76533;Rogerville;644;18505900;960962;416;15587836;228;2918064;28736;30008
76508;La Poterie-Cap-d'Antifer;211;6063283;270376;148;5251989;63;811294;28736;30009
54139;Courbesseaux;127;3649603;114188;96;3231711;31;417892;28737;30010
62627;Noyelles-sous-Bellonne;375;10776561;432721;237;9173291;138;1603270;28737;30011
62547;Marant;48;1379463;65717;27;1145234;21;234229;28739;30012
69155;Pomeys;525;15088477;857322;345;12848677;180;2239800;28740;30013
71439;Saint-Léger-lès-Paray;330;9484391;448092;231;8272774;99;1211617;28741;30014
27623;Surtauville;223;6409216;254891;166;5691475;57;717741;28741;30015
28324;Saint-Arnoult-des-Bois;423;12157677;569034;311;10783659;112;1374018;28742;30016
56046;Crach;1828;52539602;2875433;1119;43831140;709;8708462;28742;30017
02510;Monthurel;68;1954440;108286;46;1635284;22;319156;28742;30018
68136;Hettenschlag;174;5001176;303421;121;4471893;53;529283;28742;30019
25303;Hauterive-la-Fresse;100;2874417;130981;65;2487823;35;386594;28744;30020
27537;Saint-Étienne-du-Vauvray;403;11584124;622575;275;10190608;128;1393516;28745;30021
21456;Nogent-lès-Montbard;93;2673313;258075;59;2288293;34;385020;28745;30022
10049;Les Bordes-Aumont;259;7445197;447257;186;6562481;73;882716;28746;30023
05109;Puy-Saint-Pierre;300;8624120;484314;195;7435306;105;1188814;28747;30024
68128;Heimersdorf;327;9400701;577018;204;8251201;123;1149500;28748;30025
22198;Pleumeur-Bodou;2243;64482572;3793041;1457;55362893;786;9119679;28748;30026
60069;Betz;554;15928128;959783;382;14033780;172;1894348;28751;30027
38076;La Chapelle-de-la-Tour;830;23864896;1179602;577;20744155;253;3120741;28753;30028
34322;Valflaunès;394;11328698;728421;249;9927382;145;1401316;28753;30029
57727;Viviers;59;1696460;77388;39;1470526;20;225934;28754;30030
72081;Cherreau;451;12968062;629429;339;11821531;112;1146531;28754;30031
27261;Fouqueville;238;6843872;399506;174;5959019;64;884853;28756;30032
27003;Acquigny;851;24472361;1684826;552;21399417;299;3072944;28757;30033
40216;Ozourt;117;3364650;234316;58;2671005;59;693645;28758;30034
57179;Distroff;821;23611599;712420;445;16209224;376;7402375;28760;30035
45114;Courtempierre;130;3738765;253154;87;3179923;43;558842;28760;30036
29212;Plouzané;5708;164162195;7861895;3842;142294790;1866;21867405;28760;30037
34058;Castries;3045;87574969;5221428;1931;74904104;1114;12670865;28760;30038
83035;Le Castellet;2843;81769206;5619201;1705;68515934;1138;13253272;28762;30039
27122;Cahaignes;167;4803364;225052;110;4181930;57;621434;28763;30040
38504;Theys;1044;30029092;1623597;713;26397207;331;3631885;28763;30041
38118;Colombe;762;21918461;1119991;517;19073138;245;2845323;28764;30042
27644;Tilly;274;7881538;514576;182;7004583;92;876955;28765;30043
45303;Sceaux-du-Gâtinais;320;9204831;516510;197;7811936;123;1392895;28765;30044
59585;Templemars;1816;52237612;2986817;1245;45862158;571;6375454;28765;30045
64009;Ahetze;1043;30002667;1700685;703;25775680;340;4226987;28766;30046
59535;Saint-Jans-Cappel;853;24537543;1303203;549;20975999;304;3561544;28766;30047
21286;Frénois;47;1352021;85286;33;1187320;14;164701;28766;30048
80751;Thennes;225;6472487;329411;163;5792285;62;680202;28767;30049
57271;Guenviller;361;10384895;624225;237;8974329;124;1410566;28767;30050
61234;Lonrai;512;14728969;584020;381;13111254;131;1617715;28768;30051
27695;Villez-sur-le-Neubourg;134;3854890;276713;84;3319180;50;535710;28768;30052
95555;Saint-Gratien;11510;331128794;24597230;7447;290226027;4063;40902767;28769;30053
14548;Rucqueville;62;1783727;104844;44;1609656;18;174071;28770;30054
35274;Saint-Germain-sur-Ille;412;11854423;508288;277;10088302;135;1766121;28773;30055
80577;Moyencourt-lès-Poix;80;2301848;126831;53;1950777;27;351071;28773;30056
62223;Chérisy;140;4028627;188393;96;3470568;44;558059;28776;30057
54102;Bruley;295;8488893;387387;203;7334893;92;1154000;28776;30058
77274;Marcilly;223;6417086;310019;166;5699070;57;718016;28776;30059
35181;Le Minihic-sur-Rance;811;23338012;1361244;463;19190124;348;4147888;28777;30060
80385;Grand-Laviers;204;5870582;367513;127;5043530;77;827052;28777;30061
02812;Villers-Hélon;100;2877774;123132;66;2438235;34;439539;28778;30062
71108;Chasselas;90;2590331;149013;64;2298960;26;291371;28781;30063
73128;Grésy-sur-Aix;2156;62053399;3205321;1491;53660124;665;8393275;28782;30064
14093;Branville;105;3022115;234439;63;2558525;42;463590;28782;30065
01001;L'Abergement-Clémenciat;385;11081134;572810;256;9317567;129;1763567;28782;30066
64117;Bésingrand;62;1784525;89587;47;1585179;15;199346;28783;30067
32279;Montaut-les-Créneaux;372;10707153;460123;235;9059106;137;1648047;28783;30068
90047;Fontaine;290;8347285;417875;179;6863496;111;1483789;28784;30069
69056;Chessy;867;24956146;1068618;597;21608724;270;3347422;28784;30070
51662;Witry-lès-Reims;2408;69316210;3770183;1646;60321702;762;8994508;28786;30071
80807;Ville-sur-Ancre;133;3828762;243079;86;3247157;47;581605;28788;30072
56231;Saint-Nolff;1867;53746922;2629695;1243;46207249;624;7539673;28788;30073
60583;Saint-Léger-en-Bray;186;5354673;255005;131;4679401;55;675272;28789;30074
71194;Farges-lès-Chalon;357;10277698;481109;252;9008568;105;1269130;28789;30075
52453;Saint-Maurice;70;2015331;126093;50;1804954;20;210377;28790;30076
28309;Prunay-le-Gillon;534;15374223;739585;368;13316614;166;2057609;28791;30077
25258;Franois;1036;29827837;1586420;684;25490867;352;4336970;28791;30078
51398;La Neuville-aux-Larris;90;2591303;208004;55;2187864;35;403439;28792;30079
68345;Urschenheim;352;10135985;444544;258;8984340;94;1151645;28795;30080
03094;Creuzier-le-Vieux;1822;52465247;3368612;1239;46317233;583;6148014;28795;30081
21686;Villaines-les-Prévôtes;83;2390033;197308;50;2030271;33;359762;28796;30082
84131;Taillades;1084;31214731;1987101;674;26829892;410;4384839;28796;30083
73265;Saint-Ours;282;8120699;343101;197;7235804;85;884895;28797;30084
31401;Noueilles;173;4982052;200594;110;4132741;63;849311;28798;30085
88273;Longchamp;209;6018978;261199;145;5272615;64;746363;28799;30086
76063;Beauval-en-Caux;236;6796603;385248;141;5788679;95;1007924;28799;30087
10338;Saint-Étienne-sous-Barbuise;74;2131174;127015;51;1828177;23;302997;28800;30088
14275;Fontaine-Henry;241;6940783;523068;155;6109649;86;831134;28800;30089
87021;Bosmie-l'Aiguille;1192;34331721;1615568;852;30118237;340;4213484;28802;30090
89180;Fouchères;213;6134800;273094;147;5293401;66;841399;28802;30091
77078;Chamigny;636;18318163;1026315;454;16385384;182;1932779;28802;30092
82005;Aucamville;558;16071821;844164;333;13573920;225;2497901;28803;30093
54301;Lanfroicourt;66;1901049;138647;42;1604267;24;296782;28804;30094
67546;Wittersheim;290;8353511;366640;191;7078050;99;1275461;28805;30095
54376;Montenoy;190;5472990;260315;132;4705157;58;767833;28805;30096
77524;Vimpelles;255;7345442;368070;176;6363277;79;982165;28806;30097
68246;Obersaasheim;512;14748807;867494;349;12598312;163;2150495;28806;30098
39179;Crenans;128;3687247;142043;78;3158238;50;529009;28807;30099
76180;Cleuville;82;2362175;97968;47;1895959;35;466216;28807;30100
54269;Hudiviller;167;4810824;234050;114;4180318;53;630506;28807;30101
26212;Montvendre;530;15268669;942636;330;12870346;200;2398323;28809;30102
27118;Brosville;347;9996673;619848;230;8673865;117;1322808;28809;30103
60272;Gilocourt;283;8152957;442613;205;7223516;78;929441;28809;30104
01258;Montceaux;554;15960258;702750;373;13965614;181;1994644;28809;30105
14721;Vacognes-Neuilly;227;6539813;251838;156;5528773;71;1011040;28810;30106
87156;Saint-Just-le-Martel;1274;36705655;2116923;841;32334581;433;4371074;28811;30107
64288;Labastide-Cézéracq;266;7663855;404118;176;6612935;90;1050920;28811;30108
25219;Épenoy;284;8182583;452305;172;6789869;112;1392714;28812;30109
27327;Hectomare;116;3342235;135444;79;2855791;37;486444;28812;30110
74084;Cons-Sainte-Colombe;172;4955758;226441;123;4332512;49;623246;28813;30111
70107;Bussières;178;5128733;280075;118;4521726;60;607007;28813;30112
02114;Brasles;795;22906724;1367850;475;19191175;320;3715549;28813;30113
34288;Saint-Sériès;428;12332230;712555;262;10646851;166;1685379;28814;30114
03306;Le Vernet;1037;29880245;1830617;650;25244573;387;4635672;28814;30115
71574;Verzé;387;11151126;684862;262;9661153;125;1489973;28814;30116
64023;Angaïs;419;12073634;579470;284;10526613;135;1547021;28815;30117
21606;Ladoix-Serrigny;922;26567865;1502208;633;23097573;289;3470292;28815;30118
25075;Bonnevaux;178;5129553;320571;114;4447163;64;682390;28818;30119
76002;Alvimare;267;7694402;377834;167;6346995;100;1347407;28818;30120
50287;La Mancellière-sur-Vire;259;7463935;373861;169;6346862;90;1117073;28818;30121
59442;Obrechies;136;3919375;268223;78;3330051;58;589324;28819;30122
62380;Gouy-Servins;172;4957239;268237;112;4195211;60;762028;28821;30123
51313;Lachy;182;5245498;246689;120;4355910;62;889588;28821;30124
88028;La Baffe;289;8329454;427662;182;7116888;107;1212566;28822;30125
57202;Etzling;634;18276525;1102123;376;14742515;258;3534010;28827;30126
77388;Reuil-en-Brie;417;12021894;740048;283;10450182;134;1571712;28829;30127
68076;Durrenentzen;435;12541293;503587;307;10557534;128;1983759;28831;30128
54355;Martincourt;45;1297408;84169;32;1142422;13;154986;28831;30129
33474;Saint-Selve;1108;31948370;1489715;755;28147017;353;3801353;28834;30130
31446;Ramonville-Saint-Agne;7329;211330662;15149073;4881;185843118;2448;25487544;28835;30131
33496;Salleboeuf;1188;34256423;1726076;764;29230910;424;5025513;28835;30132
71236;Igé;449;12947249;608316;306;11216423;143;1730826;28836;30133
67352;Obersoultzbach;204;5882573;474003;123;4947027;81;935546;28836;30134
10255;Montreuil-sur-Barse;150;4325637;280984;100;3732946;50;592691;28838;30135
01356;Saint-Georges-sur-Renon;92;2653171;94319;63;2257889;29;395282;28839;30136
76311;Goupillières;191;5508286;283506;134;4777576;57;730710;28839;30137
90094;Sevenans;252;7267673;441689;176;6599300;76;668373;28840;30138
07072;Coux;884;25494601;1350587;631;22485395;253;3009206;28840;30139
51455;Reims-la-Brûlée;112;3230121;127481;78;2789534;34;440587;28840;30140
71080;Champagny-sous-Uxelles;39;1124804;54260;25;951022;14;173782;28841;30141
87189;Les Salles-Lavauguyon;104;2999534;54177;33;2387529;71;612005;28842;30142
69121;Lozanne;1291;37234935;1986404;903;32289179;388;4945756;28842;30143
80584;Naours;553;15950126;865427;361;13440907;192;2509219;28843;30144
61141;Cuissai;220;6346465;304016;157;5595800;63;750665;28848;30145
59432;Niergnies;279;8048923;409798;189;7139846;90;909077;28849;30146
33174;Fronsac;573;16530810;1311426;317;13843923;256;2686887;28850;30147
46273;Saint-Laurent-les-Tours;523;15088716;984894;361;13234001;162;1854715;28850;30148
54390;Mousson;60;1731029;81130;41;1468612;19;262417;28850;30149
54456;Réméréville;242;6981907;285621;165;6020033;77;961874;28851;30150
85167;L'Orbrie;404;11655847;579326;283;10198618;121;1457229;28851;30151
02108;Bourguignon-sous-Montbavin;76;2192786;146829;46;1922372;30;270414;28852;30152
14421;Le Mesnil-Guillaume;296;8540869;430952;182;7228903;114;1311966;28854;30153
57015;Altviller;278;8021527;392831;178;6766726;100;1254801;28854;30154
59256;Fretin;1709;49313994;2330487;1157;42820339;552;6493655;28855;30155
81102;Garrigues;149;4300256;293545;91;3745242;58;555014;28861;30156
45101;Combreux;136;3925424;217624;90;3458134;46;467290;28863;30157
60484;Oudeuil;132;3810029;181694;101;3379850;31;430179;28864;30158
51407;La Noue;176;5080070;179505;100;4109654;76;970416;28864;30159
43152;Polignac;1513;43671724;2823357;974;37302395;539;6369329;28864;30160
79109;Échiré;1759;50773948;2783560;1207;44094679;552;6679269;28865;30161
94001;Ablon-sur-Seine;3017;87093871;6184913;2111;77473302;906;9620569;28868;30162
59278;Hallennes-lez-Haubourdin;1966;56754600;3240830;1325;49033461;641;7721139;28868;30163
68100;Fulleren;181;5225603;303190;121;4522644;60;702959;28871;30164
38114;Clonas-sur-Varèze;701;20238415;899791;473;17220198;228;3018217;28871;30165
39106;Charchilla;164;4735230;334897;113;4200418;51;534812;28873;30166
77332;Nantouillet;136;3926861;294093;87;3389666;49;537195;28874;30167
74089;Cordon;561;16199204;1076932;362;13847272;199;2351932;28876;30168
73031;Bassens;2247;64884526;4909069;1517;57559466;730;7325060;28876;30169
95199;Domont;8149;235320232;14928467;5728;209990217;2421;25330015;28877;30170
85217;Saint-Georges-de-Montaigu;1917;55358339;2800412;1265;47054846;652;8303493;28878;30171
59641;Warhem;1029;29715222;1563601;658;25345495;371;4369727;28878;30172
45266;Ruan;114;3292195;218152;73;2741854;41;550341;28879;30173
62490;Lattre-Saint-Quentin;124;3581000;191088;84;3111214;40;469786;28879;30174
59082;Bierne;786;22698982;1023573;534;19599018;252;3099964;28879;30175
73329;Voglans;901;26020971;1555497;637;23023304;264;2997667;28880;30176
33165;Fargues-Saint-Hilaire;1561;45083841;2996082;1037;38456689;524;6627152;28881;30177
45217;Morville-en-Beauce;97;2801530;147904;67;2465075;30;336455;28882;30178
27332;Heudebouville;428;12361935;775042;298;10880051;130;1481884;28883;30179
83112;Saint-Cyr-sur-Mer;7499;216597552;16066612;4654;186190307;2845;30407245;28884;30180
51596;Vauchamps;183;5285931;340144;120;4510117;63;775814;28885;30181
51154;Clamanges;117;3379564;181154;75;2819948;42;559616;28885;30182
68314;Soppe-le-Haut;285;8232404;349854;197;7009406;88;1222998;28886;30183
41072;Crucheray;221;6383823;391984;146;5634087;75;749736;28886;30184
76715;Trouville;303;8752539;419826;206;7393474;97;1359065;28886;30185
45181;Léouville;38;1097691;50798;26;945078;12;152613;28887;30186
31341;Merville;2489;71900452;4421607;1655;62674642;834;9225810;28887;30187
27630;Thibouville;157;4535494;411309;89;3741709;68;793785;28888;30188
89274;Nailly;647;18691117;819176;451;16370165;196;2320952;28889;30189
27277;Garencières;277;8002306;395372;195;7010546;82;991760;28889;30190
73297;Tournon;290;8379138;373035;186;7063729;104;1315409;28894;30191
67101;Dorlisheim;1326;38313273;2190541;856;32837239;470;5476034;28894;30192
60356;Lavilletertre;284;8206253;493781;168;7237278;116;968975;28895;30193
74107;Droisy;61;1762623;27300;31;1314720;30;447903;28895;30194
57156;Courcelles-sur-Nied;571;16499857;780827;408;14705444;163;1794413;28896;30195
77395;Rumont;74;2138460;173431;55;1925448;19;213012;28898;30196
63108;Le Cheix;314;9074472;437158;234;8074615;80;999857;28900;30197
63245;Mozac;2080;60112461;3480695;1402;53034133;678;7078328;28900;30198
80785;Vecquemont;264;7630022;378138;197;6824821;67;805201;28902;30199
77043;Boitron;192;5549117;318317;133;4953721;59;595396;28902;30200
70280;Gray-la-Ville;557;16098231;1124449;336;13605415;221;2492816;28902;30201
26185;Mirmande;337;9740138;655534;198;8176870;139;1563268;28902;30202
27154;Chavigny-Bailleul;291;8410951;446666;206;7440809;85;970142;28904;30203
27315;Harquency;132;3815334;168655;96;3404899;36;410435;28904;30204
19093;Jugeals-Nazareth;440;12719337;558546;302;11065566;138;1653771;28908;30205
68270;Richwiller;1933;55878541;3312155;1335;48704914;598;7173627;28908;30206
13073;Peypin;2950;85280858;5054972;1966;74312417;984;10968441;28909;30207
77387;Remauville;243;7024879;397391;161;6035047;82;989832;28909;30208
49323;Saint-Sylvain-d'Anjou;2200;63601291;3210024;1431;53967346;769;9633945;28910;30209
38459;Saint-Sorlin-de-Vienne;410;11853454;636553;296;10573742;114;1279712;28911;30210
27092;Bosguérard-de-Marcouville;284;8210927;404673;198;7254125;86;956802;28912;30211
68145;Horbourg-Wihr;2906;84021064;4857788;2062;73751036;844;10270028;28913;30212
59133;Carnin;498;14399144;834890;321;12357053;177;2042091;28914;30213
62330;Festubert;648;18736456;1024488;388;15721055;260;3015401;28914;30214
80319;Fluy;168;4857619;344299;99;4101578;69;756041;28914;30215
34242;Saint-Bauzille-de-Montmel;493;14255409;770161;312;12479464;181;1775945;28916;30216
38530;Vaulx-Milieu;1240;35856287;2035810;858;31331270;382;4525017;28916;30217
30107;Estézargues;229;6621929;410307;161;5926304;68;695625;28917;30218
76586;Saint-Gilles-de-la-Neuville;301;8704515;357517;214;7547397;87;1157118;28919;30219
76090;Beuzeville-la-Grenier;525;15182429;688270;361;13193770;164;1988659;28919;30220
67051;Blienschwiller;176;5090144;284339;113;4342979;63;747165;28921;30221
14487;Ouilly-le-Vicomte;433;12523040;726916;283;10685182;150;1837858;28922;30222
62016;Airon-Saint-Vaast;85;2458355;151752;50;1943074;35;515281;28922;30223
54369;Millery;317;9168338;457790;223;8083023;94;1085315;28922;30224
81187;Moulayrès;101;2921160;77965;52;2409138;49;512022;28922;30225
51473;Saint-Bon;57;1648584;132119;39;1480887;18;167697;28923;30226
87114;Panazol;5479;158468148;8924102;3685;137348128;1794;21120020;28923;30227
51474;Saint-Brice-Courcelles;1709;49429589;2828077;1172;42732916;537;6696673;28923;30228
01252;Mogneneins;399;11540442;713507;270;9859216;129;1681226;28923;30229
13119;Carnoux-en-Provence;3773;109128928;6736042;2440;94985942;1333;14142986;28924;30230
81229;Roquevidal;62;1793281;82286;39;1585423;23;207858;28924;30231
02807;Villequier-Aumont;312;9024278;481052;191;7698004;121;1326274;28924;30232
35266;Saint-Erblon;1233;35663332;1741515;846;31114706;387;4548626;28924;30233
73179;La Motte-Servolex;6476;187316082;11004776;4532;163560374;1944;23755708;28925;30234
67560;Zoebersdorf;94;2718941;159447;52;2190465;42;528476;28925;30235
32399;Saint-Orens;32;925644;51737;21;784007;11;141637;28926;30236
83081;Montauroux;3262;94358558;5835148;1970;80287700;1292;14070858;28927;30237
37092;Crotelles;314;9083385;361244;206;7731391;108;1351994;28928;30238
14009;Amfreville;621;17965197;873682;440;15823938;181;2141259;28929;30239
67068;Buswiller;104;3008925;138422;66;2450242;38;558683;28932;30240
49329;Savennières;708;20484174;1226566;429;17030361;279;3453813;28932;30241
35203;La Nouaye;128;3703507;74932;90;3251954;38;451553;28934;30242
69100;Irigny;4344;125691088;7522060;2862;109464593;1482;16226495;28934;30243
32183;Lahitte;132;3819343;269169;87;3296264;45;523079;28934;30244
73202;Plancherine;219;6336982;457882;147;5860280;72;476702;28936;30245
78490;Plaisir;16557;479163438;31619700;11163;425906759;5394;53256679;28940;30246
83009;Bandol;6561;189885382;15679962;3964;163666342;2597;26219040;28942;30247
27491;Roman;143;4138978;297916;91;3442414;52;696564;28944;30248
16272;Puyréaux;262;7583554;330594;150;6325976;112;1257578;28945;30249
21161;Chaumont-le-Bois;44;1273622;84847;33;1139376;11;134246;28946;30250
57124;Cattenom;1396;40408985;1709535;642;25686028;754;14722957;28946;30251
14106;Bréville-les-Monts;345;9986675;439868;241;8627507;104;1359168;28947;30252
64315;Laroin;486;14068309;652337;327;12134717;159;1933592;28947;30253
76443;Mont-Cauvaire;300;8684322;487543;207;7733253;93;951069;28948;30254
89399;Soucy;798;23100746;1386728;548;20007447;250;3093299;28948;30255
22334;Saint-Igeaux;68;1968509;177149;37;1681648;31;286861;28949;30256
27664;Le Tronquay;300;8684709;1491993;193;7103214;107;1581495;28949;30257
50008;Anctoville-sur-Boscq;231;6687886;292406;159;5640754;72;1047132;28952;30258
89002;Aigremont;36;1042268;41496;21;850056;15;192212;28952;30259
65149;Clarac;93;2692626;104817;46;2194382;47;498244;28953;30260
67445;Scherwiller;1591;46065459;2527723;1056;39879179;535;6186280;28954;30261
26218;Mours-Saint-Eusèbe;1394;40361796;2136676;943;34910703;451;5451093;28954;30262
59642;Warlaing;243;7035919;283141;155;5953140;88;1082779;28954;30263
60338;Lacroix-Saint-Ouen;2414;69897203;4116659;1646;61502548;768;8394655;28955;30264
27416;Buis-sur-Damville;459;13291224;742180;315;11508043;144;1783181;28957;30265
63099;Châteaugay;1715;49663004;2679971;1169;43567329;546;6095675;28958;30266
60030;Auteuil;264;7645165;343041;180;6579798;84;1065367;28959;30267
14707;Tourville-sur-Odon;491;14219666;631570;335;12168991;156;2050675;28961;30268
10409;Villacerf;281;8137985;385499;200;7151707;81;986278;28961;30269
76634;Saint-Pierre-de-Manneville;400;11585152;608374;287;10333141;113;1252011;28963;30270
51517;Saint-Souplet-sur-Py;73;2114361;138940;43;1719059;30;395302;28964;30271
61336;Pouvrai;64;1853688;103243;41;1546343;23;307345;28964;30272
62323;Fampoux;583;16886847;949721;363;14448344;220;2438503;28965;30273
10336;Saint-Benoît-sur-Seine;215;6228015;320999;163;5489794;52;738221;28968;30274
88219;Greux;72;2085661;159402;37;1706667;35;378994;28968;30275
31580;Villate;413;11964311;606998;281;10404648;132;1559663;28969;30276
28329;Saint-Christophe;76;2201773;114870;62;2063712;14;138061;28971;30277
28209;Lèves;2986;86507939;5732504;2010;77559185;976;8948754;28971;30278
60171;Courtieux;93;2694341;181696;64;2387440;29;306901;28971;30279
80805;Villers-Tournelle;76;2202204;131482;44;1828649;32;373555;28976;30280
38051;Bougé-Chambalud;647;18748651;1077046;384;15806311;263;2942340;28978;30281
02138;Buzancy;90;2608010;126649;60;2325932;30;282078;28978;30282
59048;Bantigny;226;6549167;311143;151;5578382;75;970785;28979;30283
63112;Clerlande;246;7128761;309873;179;6359086;67;769675;28979;30284
54581;Ville-sur-Yron;153;4433772;273898;101;3823071;52;610701;28979;30285
51259;Francheville;98;2840125;87058;66;2272412;32;567713;28981;30286
01422;Tossiat;696;20171276;1079020;490;17675628;206;2495648;28982;30287
80583;Nampty;133;3854570;179287;98;3387697;35;466873;28982;30288
25582;Valleroy;66;1912796;76961;41;1632241;25;280555;28982;30289
25151;Chevigney-lès-Vercel;52;1507116;65921;33;1281331;19;225785;28983;30290
66189;Saleilles;2666;77269496;4798553;1609;65049813;1057;12219683;28983;30291
02084;Bézu-le-Guéry;129;3738961;207164;88;3236413;41;502548;28984;30292
54224;Germonville;57;1652104;65152;31;1284649;26;367455;28984;30293
73091;Conjux;112;3246338;247758;74;2833008;38;413330;28985;30294
73249;Saint-Jeoire-Prieuré;612;17739049;952076;418;15035020;194;2704029;28985;30295
67301;Mommenheim;963;27913096;1504362;668;24292938;295;3620158;28986;30296
49251;Pruillé;322;9333431;404351;225;8053961;97;1279470;28986;30297
77150;Cuisy;227;6579928;372341;162;5869499;65;710429;28986;30298
70268;Gézier-et-Fontenelay;89;2579978;123373;55;2227216;34;352762;28989;30299
84124;Saumane-de-Vaucluse;489;14175584;1090924;268;12170629;221;2004955;28989;30300
16348;Saint-Saturnin;691;20033052;1050867;460;17608610;231;2424442;28991;30301
81152;Mailhoc;141;4088263;397874;81;3430840;60;657423;28995;30302
37153;Monnaie;1996;57873619;2761156;1373;50109902;623;7763717;28995;30303
08497;Warcq;704;20413706;1333733;436;17494054;268;2919652;28997;30304
02042;Azy-sur-Marne;221;6408822;551796;136;5547172;85;861650;28999;30305
17164;Fontcouverte;1287;37322153;2036049;825;31985383;462;5336770;28999;30306
01152;Échallon;419;12151486;510300;273;9970368;146;2181118;29001;30307
27340;Honguemare-Guenouville;298;8642372;421223;213;7621065;85;1021307;29001;30308
21556;Saint-Léger-Triey;102;2958129;137120;76;2634070;26;324059;29001;30309
60352;Lattainville;79;2291198;106393;57;2054168;22;237030;29003;30310
50219;Gratot;344;9977488;676035;222;8647378;122;1330110;29004;30311
62106;Bellonne;128;3712832;251484;80;3225360;48;487472;29007;30312
62796;Simencourt;277;8035078;409590;177;6802603;100;1232475;29008;30313
67529;Weyersheim;1739;50444446;2878767;1233;44275872;506;6168574;29008;30314
64041;Aressy;324;9398654;511810;224;8329970;100;1068684;29008;30315
77433;Saints;706;20480085;1420300;466;18097901;240;2382184;29009;30316
45135;Erceville;155;4496337;349358;89;3696764;66;799573;29009;30317
62170;Bouvigny-Boyeffles;1254;36376930;2319363;727;30425561;527;5951369;29009;30318
77116;Choisy-en-Brie;681;19755455;1035467;445;16805360;236;2950095;29009;30319
76532;Rocquemont;350;10153525;563316;228;8548395;122;1605130;29010;30320
67073;Châtenois;2106;61098421;3978710;1336;52584856;770;8513565;29012;30321
68037;Biltzheim;191;5541316;273297;133;4870264;58;671052;29012;30322
74104;Doussard;2035;59039798;3214913;1360;50315314;675;8724484;29012;30323
01081;Champfromier;363;10531607;455443;215;8337845;148;2193762;29013;30324
34227;Restinclières;799;23181220;1303279;508;20020580;291;3160640;29013;30325
60699;Wambez;80;2321049;145423;52;2029753;28;291296;29013;30326
39271;Lac-des-Rouges-Truites;191;5541505;255662;127;4757095;64;784410;29013;30327
35067;Chasné-sur-Illet;645;18713566;633753;463;16255885;182;2457681;29013;30328
67333;Niedersoultzbach;120;3481656;225062;85;3044206;35;437450;29014;30329
50009;Angey;103;2988519;141434;69;2618636;34;369883;29015;30330
16359;Salles-d'Angles;567;16451544;1139003;345;13907490;222;2544054;29015;30331
62436;Herlin-le-Sec;86;2495323;124132;44;2098270;42;397053;29015;30332
76016;Anglesqueville-la-Bras-Long;59;1711922;87918;38;1406386;21;305536;29016;30333
28169;Garancières-en-Beauce;118;3424114;206047;85;3019991;33;404123;29018;30334
69013;Arnas;1698;49273311;2530649;1182;42913670;516;6359641;29018;30335
14562;Saint-Aubin-sur-Mer;1390;40338255;2474232;893;34647001;497;5691254;29020;30336
69165;Régnié-Durette;504;14626295;607952;296;12140386;208;2485909;29020;30337
67166;Grassendorf;110;3192517;112120;77;2757762;33;434755;29023;30338
70206;Échenans-sous-Mont-Vaudois;228;6617237;332219;156;5673630;72;943607;29023;30339
45051;Bray-en-Val;702;20374178;1168481;457;17362676;245;3011502;29023;30340
66033;Camélas;246;7139749;714195;130;6055651;116;1084098;29023;30341
14228;Douvres-la-Délivrande;2712;78713412;4667122;1679;67147454;1033;11565958;29024;30342
14079;Blonville-sur-Mer;1007;29228320;2064399;626;25043986;381;4184334;29025;30343
14430;Meuvaines;80;2322012;158880;48;1955096;32;366916;29025;30344
39081;Buvilly;189;5485814;300923;133;4880489;56;605325;29025;30345
80094;Berteaucourt-lès-Thennes;232;6733934;341286;167;5931091;65;802843;29026;30346
77044;Bombon;452;13119732;776858;322;11589614;130;1530118;29026;30347
52045;Bettancourt-la-Ferrée;977;28358678;1614004;688;24673298;289;3685380;29026;30348
77164;Échouboulains;282;8185536;458832;205;7307971;77;877565;29027;30349
60322;Jaméricourt;151;4383062;236905;110;3825927;41;557135;29027;30350
62039;Arleux-en-Gohelle;411;11930457;753390;275;10354946;136;1575511;29028;30351
77457;Solers;661;19187571;1150758;500;17470426;161;1717145;29028;30352
80137;Breilly;234;6792696;264537;163;5781937;71;1010759;29029;30353
67317;Neubois;338;9811799;438371;235;8552911;103;1258888;29029;30354
39200;Dompierre-sur-Mont;113;3280417;38436;64;2626242;49;654175;29030;30355
28342;Saint-Jean-Pierre-Fixte;148;4296487;238743;96;3661276;52;635211;29030;30356
39073;Brainans;88;2554767;70078;47;2112856;41;441911;29031;30357
66028;Cabestany;5173;150184512;10640299;3053;126720557;2120;23463955;29032;30358
71590;Volesvres;295;8564612;387442;203;7313541;92;1251071;29033;30359
27329;Hennezis;386;11207252;576924;274;9924770;112;1282482;29034;30360
57116;Buchy;53;1538892;111056;32;1277935;21;260957;29036;30361
90002;Angeot;170;4936220;230433;118;4281445;52;654775;29037;30362
21397;Mavilly-Mandelot;88;2555330;128149;59;2148806;29;406524;29038;30363
81001;Aguts;118;3426578;234370;72;2926235;46;500343;29039;30364
78314;Issou;2015;58513847;2661748;1525;52564199;490;5949648;29039;30365
02328;Fossoy;312;9060210;589437;218;8030027;94;1030183;29039;30366
76664;Sasseville;128;3717056;177199;86;3159210;42;557846;29040;30367
18034;Bouzais;173;5024379;314286;122;4410785;51;613594;29043;30368
54069;Beuvillers;180;5228048;137816;84;3202767;96;2025281;29045;30369
13031;La Destrousse;1697;49289291;3006281;1105;42644177;592;6645114;29045;30370
28207;Léthuin;102;2962607;132609;74;2549088;28;413519;29045;30371
14098;Bretteville-l'Orgueilleuse;1226;35609822;1541293;837;31100224;389;4509598;29046;30372
80704;Saint-Gratien;187;5431600;257887;134;4749378;53;682222;29046;30373
89172;Fontaine-la-Gaillarde;264;7668376;490593;210;7074763;54;593613;29047;30374
91045;Ballancourt-sur-Essonne;3934;114281720;6277996;2793;101456216;1141;12825504;29050;30375
45169;Ingré;4137;120187991;6321075;2847;105556629;1290;14631362;29052;30376
27546;Saint-Germain-des-Angles;100;2905273;127929;68;2573453;32;331820;29053;30377
77012;Augers-en-Brie;157;4561342;392809;91;3850853;66;710489;29053;30378
78320;Jeufosse;213;6189009;353454;141;5327346;72;861663;29056;30379
25422;Neuchâtel-Urtière;80;2324626;98989;55;2035210;25;289416;29058;30380
67356;Offendorf;1135;32980865;1725557;805;29451163;330;3529702;29058;30381
42306;Tarentaise;225;6538504;292558;157;5586813;68;951691;29060;30382
36116;Ménétréols-sous-Vatan;75;2179589;197937;44;1817781;31;361808;29061;30383
77100;Le Châtelet-en-Brie;2394;69572697;3831566;1703;61854997;691;7717700;29061;30384
38115;Saint-Martin-de-la-Cluze;342;9939731;503196;241;8812796;101;1126935;29064;30385
51100;La Caure;44;1278831;86229;32;1113347;12;165484;29064;30386
71444;Saint-Loup-de-Varennes;574;16683913;628060;392;14012328;182;2671585;29066;30387
10334;Saint-Aubin;294;8545600;354984;192;7251101;102;1294499;29067;30388
81177;Montfa;197;5726748;209321;106;4618996;91;1107752;29070;30389
62502;Lestrem;2086;60639746;3018430;1320;51677721;766;8962025;29070;30390
37054;Chanceaux-sur-Choisille;1644;47792195;2186035;1202;42157928;442;5634267;29071;30391
57749;Voelfling-lès-Bouzonville;97;2819947;187097;62;2364020;35;455927;29072;30392
27213;Écos;508;14768510;1007878;330;12862815;178;1905695;29072;30393
50277;Longueville;325;9448576;424041;212;7854523;113;1594053;29073;30394
60694;Villotran;145;4215994;227031;100;3632630;45;583364;29076;30395
16150;Gensac-la-Pallue;882;25645319;1587350;597;22267484;285;3377835;29076;30396
51325;Lisse-en-Champagne;59;1715512;126341;37;1455948;22;259564;29076;30397
81298;Teulat;234;6803935;383121;157;5957803;77;846132;29077;30398
81208;Peyrole;236;6862462;405600;144;5726086;92;1136376;29078;30399
13058;Maussane-les-Alpilles;1498;43559597;3143457;789;36261982;709;7297615;29079;30400
76349;Hautot-sur-Mer;1146;33324556;2325727;708;28430295;438;4894261;29079;30401
76189;Crasville-la-Mallet;73;2122832;101118;45;1760944;28;361888;29080;30402
70261;Frotey-lès-Vesoul;752;21868366;1376039;501;19165864;251;2702502;29080;30403
73116;Fontcouverte-la-Toussuire;326;9480412;620557;224;8133285;102;1347127;29081;30404
60642;Tracy-le-Val;521;15151550;729795;367;13261641;154;1889909;29082;30405
89127;Courtois-sur-Yonne;369;10731578;725131;254;9498271;115;1233307;29083;30406
10191;Lavau;442;12854914;779714;303;11404610;139;1450304;29084;30407
88098;Chaumousey;477;13873534;747783;310;11768583;167;2104951;29085;30408
54091;Bouxières-sous-Froidmont;155;4508353;208003;97;3750864;58;757489;29086;30409
26156;Larnage;476;13846391;698781;309;11814578;167;2031813;29089;30410
87205;Le Vigen;1034;30079778;1576904;712;26186408;322;3893370;29091;30411
90027;Courcelles;71;2065510;121075;52;1866396;19;199114;29092;30412
63280;Pignols;162;4712951;323583;102;4079525;60;633426;29092;30413
37060;Chargé;613;17834940;882698;428;15638119;185;2196821;29095;30414
51495;Saint-Loup;47;1367656;91567;33;1223541;14;144115;29099;30415
59316;Houplin-Ancoisne;1768;51451270;2835467;1173;44549159;595;6902111;29101;30416
61462;Sarceaux;496;14435025;557168;340;12718117;156;1716908;29103;30417
28124;Dampierre-sur-Avre;362;10535448;624331;248;9068838;114;1466610;29103;30418
45024;Baule;1026;29860194;1470382;748;26359673;278;3500521;29104;30419
02195;Ciry-Salsogne;417;12136534;586656;272;10332318;145;1804216;29104;30420
41262;Tour-en-Sologne;542;15774655;810254;382;13645028;160;2129627;29105;30421
60367;Loconville;165;4802387;302504;112;4167088;53;635299;29105;30422
70428;Pusey;729;21219749;1164068;513;18509232;216;2710517;29108;30423
35193;Montreuil-le-Gast;859;25003852;998911;595;21643104;264;3360748;29108;30424
60165;Le Coudray-sur-Thelle;267;7771988;435984;181;6830078;86;941910;29109;30425
13016;La Bouilladisse;3155;91839336;5516595;2013;79105319;1142;12734017;29109;30426
21320;Izier;368;10713506;448806;264;9304388;104;1409118;29113;30427
31576;Vieillevigne;143;4163413;224861;97;3708662;46;454751;29115;30428
71107;Charrecey;153;4454592;239730;109;3843385;44;611207;29115;30429
27090;Le Bosc-Roger-en-Roumois;1575;45857184;2291341;1139;40421869;436;5435315;29116;30430
27569;Saint-Martin-du-Tilleul;118;3435872;190213;75;2945502;43;490370;29118;30431
65284;Louey;520;15142089;774709;360;13032358;160;2109731;29119;30432
38392;Saint-Hilaire-de-Brens;288;8387208;510863;194;7238733;94;1148475;29122;30433
29043;Daoulas;911;26530655;1541060;573;22142590;338;4388065;29123;30434
62654;Peuplingues;342;9960073;412652;216;8322438;126;1637635;29123;30435
72113;Degré;366;10659141;373739;262;9272526;104;1386615;29123;30436
25558;Tarcenay;437;12728250;516037;297;10735800;140;1992450;29126;30437
57456;Meisenthal;419;12204016;1093687;235;9960110;184;2243906;29127;30438
42075;Craintilleux;568;16544598;980409;387;14493972;181;2050626;29128;30439
10349;Saint-Lyé;1503;43781597;2551856;1023;38243490;480;5538107;29129;30440
08298;Montcy-Notre-Dame;894;26043241;1552062;607;23042417;287;3000824;29131;30441
10135;Éclance;69;2010092;141252;45;1754214;24;255878;29132;30442
68244;Obermorschwihr;196;5709897;322738;143;5116889;53;593008;29132;30443
38494;Soleymieu;346;10080054;564792;224;8649001;122;1431053;29133;30444
51039;Bassu;63;1835502;102901;44;1657626;19;177876;29135;30445
67025;Beinheim;1086;31640622;2347495;741;27665443;345;3975179;29135;30446
57013;Alsting;1469;42800051;3153323;908;35799981;561;7000070;29136;30447
54507;Sionviller;58;1689871;82801;38;1440946;20;248925;29136;30448
14389;Maisoncelles-Pelvey;123;3583758;206682;78;3055762;45;527996;29136;30449
39446;Pupillin;128;3729697;227405;94;3359972;34;369725;29138;30450
71413;Saint-Firmin;413;12034291;689918;271;10159863;142;1874428;29139;30451
72329;Savigné-l'Évêque;1962;57170916;2698737;1332;49442008;630;7728908;29139;30452
57437;Malling;291;8479596;259744;144;5492442;147;2987154;29140;30453
74035;Bloye;269;7838625;328162;182;6567037;87;1271588;29140;30454
78337;Limetz-Villez;1003;29227520;1822208;721;26409018;282;2818502;29140;30455
02012;Ambrief;41;1194758;94587;26;1063877;15;130881;29140;30456
77267;La Madeleine-sur-Loing;184;5361892;294871;134;4739659;50;622233;29141;30457
51135;Châtillon-sur-Broué;40;1165632;75434;26;988626;14;177006;29141;30458
46209;Nadaillac-de-Rouge;96;2797583;192783;52;2253739;44;543844;29141;30459
32105;Clermont-Savès;111;3234794;170921;71;2807839;40;426955;29142;30460
01282;Outriaz;135;3934264;149539;94;3471962;41;462302;29143;30461
27600;Saint-Quentin-des-Isles;127;3701210;255909;91;3356115;36;345095;29143;30462
40291;Saubion;714;20808596;1100996;455;17625266;259;3183330;29144;30463
60630;Thibivillers;106;3089296;237767;68;2793787;38;295509;29144;30464
77080;Champcenest;86;2506557;204442;47;2059156;39;447401;29146;30465
08096;Chalandry-Elaire;317;9239529;440952;225;8235179;92;1004350;29147;30466
33518;Tabanac;561;16352271;1213282;349;13768084;212;2584187;29148;30467
84036;Châteauneuf-de-Gadagne;1845;53780916;3390400;1173;45931614;672;7849302;29150;30468
31291;Léguevin;4415;128702463;7032440;3036;113302863;1379;15399600;29151;30469
45105;Cortrat;47;1370138;77155;31;1180354;16;189784;29152;30470
68041;Blodelsheim;922;26879044;1446661;651;23697550;271;3181494;29153;30471
60541;Roberval;204;5947215;366888;142;5135004;62;812211;29153;30472
39553;Le Vernois;135;3936185;203945;96;3501730;39;434455;29157;30473
67440;Schaffhouse-près-Seltz;300;8747668;482995;195;7379917;105;1367751;29159;30474
60334;Lachapelle-Saint-Pierre;450;13121504;676732;326;11748370;124;1373134;29159;30475
51624;Ville-en-Tardenois;306;8923193;364538;205;7561012;101;1362181;29161;30476
33531;Tizac-de-Curton;167;4869885;382968;100;4007304;67;862581;29161;30477
33279;Mazères;347;10118944;824729;208;8399965;139;1718979;29161;30478
77473;Treuzy-Levelay;263;7669857;471827;198;6926732;65;743125;29163;30479
65401;Salles-Adour;266;7757363;452416;166;6786424;100;970939;29163;30480
76518;Raffetot;238;6940976;292572;163;5999481;75;941495;29164;30481
02249;Cuiry-Housse;57;1662357;119356;33;1412548;24;249809;29164;30482
25521;Saint-Julien-lès-Montbéliard;92;2683141;150992;60;2259021;32;424120;29165;30483
62363;Frévin-Capelle;193;5628796;291533;137;4952045;56;676751;29165;30484
32295;Nizas;75;2187595;129865;45;1850747;30;336848;29168;30485
62657;Pihen-lès-Guînes;226;6592011;423073;151;5689761;75;902250;29168;30486
95409;Moisselles;658;19192700;1222337;474;17680683;184;1512017;29168;30487
76316;Grainville-sur-Ry;208;6067632;344973;143;5216688;65;850944;29171;30488
14578;Saint-Gatien-des-Bois;740;21587332;1462196;442;18118622;298;3468710;29172;30489
51176;Corroy;80;2333900;162804;41;1896908;39;436992;29174;30490
59476;Proville;1752;51112443;2968361;1051;43435460;701;7676983;29174;30491
76017;Anglesqueville-l'Esneval;255;7439852;334148;184;6493914;71;945938;29176;30492
41288;Villerbon;423;12341443;708673;305;10816090;118;1525353;29176;30493
14737;Versainville;203;5922857;307454;132;5069346;71;853511;29177;30494
28074;La Chapelle-d'Aunainville;141;4114016;203135;106;3695054;35;418962;29177;30495
33357;Roaillan;721;21037689;990288;473;18198027;248;2839662;29178;30496
60042;Bailleval;762;22234103;1279704;569;20109355;193;2124748;29179;30497
57617;Saint-Jure;150;4376814;168549;104;3501559;46;875255;29179;30498
02661;Royaucourt-et-Chailvet;129;3764139;191911;85;3333085;44;431054;29179;30499
73018;Arbin;432;12606429;705477;308;11136311;124;1470118;29182;30500
62125;Beuvrequen;186;5427955;365713;101;4495672;85;932283;29183;30501
51413;Oiry;476;13891572;1052712;345;12544590;131;1346982;29184;30502
21405;Merceuil;410;11966526;739343;275;10345105;135;1621421;29187;30503
27078;La Boissière;148;4319702;281886;97;3742247;51;577455;29187;30504
27398;Menneval;762;22241518;1340639;514;19542583;248;2698935;29188;30505
57431;Maizeroy;162;4728734;212752;105;4070673;57;658061;29190;30506
66038;Canohès;2664;77766187;5017983;1636;66497108;1028;11269079;29192;30507
25136;Chaucenne;244;7122981;295506;166;6164238;78;958743;29193;30508
62399;Habarcq;342;9983927;542368;221;8667852;121;1316075;29193;30509
63227;Mirefleurs;1222;35676199;2112780;813;30945514;409;4730685;29195;30510
76281;La Frénaye;996;29079137;1478396;651;24713824;345;4365313;29196;30511
44198;Les Sorinières;3772;110128256;5426406;2618;95392438;1154;14735818;29196;30512
54192;Ferrières;151;4408809;213362;100;3755323;51;653486;29197;30513
55504;Tannois;205;5985550;311311;135;5178212;70;807338;29198;30514
41204;Saint-Claude-de-Diray;879;25665629;1419783;607;22464705;272;3200924;29199;30515
31249;Labastide-Beauvoir;508;14833207;953430;349;12932684;159;1900523;29199;30516
54137;Cons-la-Grandville;288;8409428;266673;145;5579505;143;2829923;29199;30517
41156;Mulsans;236;6891296;332226;176;6216959;60;674337;29200;30518
45046;Boulay-les-Barres;279;8147083;396076;202;7109594;77;1037489;29201;30519
60660;Le Vaumain;167;4876879;272620;115;4294168;52;582711;29203;30520
22094;Lancieux;880;25698611;1570820;538;21474103;342;4224508;29203;30521
28236;Margon;703;20530153;1288902;457;17726835;246;2803318;29204;30522
35314;Saint-Suliac;528;15419942;969234;330;12847033;198;2572909;29204;30523
95241;Fontenay-en-Parisis;993;29000630;1621414;731;25901985;262;3098645;29205;30524
65271;Lézignan;210;6133154;413044;134;5228904;76;904250;29205;30525
71447;Saint-Mard-de-Vaux;132;3855262;209219;94;3465723;38;389539;29207;30526
53229;Saint-Jean-sur-Mayenne;692;20211236;848547;502;17743908;190;2467328;29207;30527
88099;Chavelot;808;23599562;1138757;551;20639719;257;2959843;29207;30528
61220;La Lande-sur-Eure;101;2950036;158160;58;2399472;43;550564;29208;30529
42170;Perreux;1077;31457413;1777733;668;26502941;409;4954472;29208;30530
10153;Fontaine-Mâcon;309;9025855;474851;220;7969746;89;1056109;29210;30531
89036;La Belliole;135;3943410;270188;97;3481486;38;461924;29210;30532
60663;Velennes;127;3709861;207841;91;3291676;36;418185;29212;30533
14398;Manerbe;269;7858238;445125;177;6608545;92;1249693;29213;30534
64395;Monségur;72;2103342;126584;38;1738966;34;364376;29213;30535
83031;Le Cannet-des-Maures;2322;67833752;3296085;1323;56960130;999;10873622;29214;30536
27476;Les Préaux;211;6164163;400596;135;5212158;76;952005;29214;30537
67203;Hochstett;160;4674400;208738;111;4052299;49;622101;29215;30538
51486;Saint-Hilaire-le-Grand;181;5288345;321686;103;4275043;78;1013302;29217;30539
27662;Triqueville;189;5522132;373197;121;4852007;68;670125;29218;30540
54151;Cutry;514;15017950;474913;257;9989458;257;5028492;29218;30541
54167;Dommartin-lès-Toul;951;27786308;1321756;647;24104196;304;3682112;29218;30542
76347;Hautot-le-Vatois;147;4295165;198560;92;3621049;55;674116;29219;30543
47016;Aubiac;527;15398659;718488;370;13730034;157;1668625;29219;30544
80045;Authuille;89;2600848;140482;48;2027377;41;573471;29223;30545
83107;Roquebrune-sur-Argens;8776;256466357;16590765;5283;218964082;3493;37502275;29224;30546
27567;Sainte-Marie-de-Vatimesnil;117;3419784;179464;73;2981898;44;437886;29229;30547
59240;Floursies;73;2133715;113546;46;1881211;27;252504;29229;30548
76585;Saint-Gilles-de-Crétot;186;5436916;239050;126;4518497;60;918419;29231;30549
74284;La Tour;650;19001037;754839;372;14985961;278;4015076;29232;30550
76111;Bois-l'Évêque;241;7045391;339319;155;5928337;86;1117054;29234;30551
25251;Fourbanne;76;2221863;124991;55;1964217;21;257646;29235;30552
68316;Soultzbach-les-Bains;368;10758999;582023;253;9268464;115;1490535;29236;30553
35208;Orgères;1886;55142033;2780275;1309;47873809;577;7268224;29238;30554
69088;Fontaines-sur-Saône;3598;105197273;7268716;2427;91856314;1171;13340959;29238;30555
45246;Pannecières;62;1812780;108887;48;1692855;14;119925;29238;30556
69080;Échalas;758;22162938;1158408;531;19474817;227;2688121;29239;30557
69283;Mions;5920;173095235;8820660;4107;150831861;1813;22263374;29239;30558
68203;Merxheim;629;18391511;888596;447;16043381;182;2348130;29239;30559
62012;Agnières;115;3362641;157771;64;2750032;51;612609;29240;30560
14702;Tournay-sur-Odon;177;5175590;232847;113;3771837;64;1403753;29241;30561
51638;Villeseneux;105;3070394;191078;68;2502334;37;568060;29242;30562
59073;Berthen;255;7456921;442958;150;6121846;105;1335075;29243;30563
64290;Labastide-Monréjeau;251;7340140;298816;171;6238149;80;1101991;29244;30564
06095;Peymeinade;4621;135135319;8961648;2965;116475471;1656;18659848;29244;30565
35240;Le Rheu;3902;114114775;6670504;2654;99895774;1248;14219001;29245;30566
87005;Aureil;482;14096863;629064;346;12485096;136;1611767;29247;30567
76245;Eslettes;684;20006204;951369;481;17490335;203;2515869;29249;30568
77330;Nanteuil-lès-Meaux;2905;84974023;5060342;2103;75777545;802;9196478;29251;30569
50475;Saint-Georges-Montcocq;462;13513945;677968;295;11504596;167;2009349;29251;30570
34035;La Boissière;483;14128837;917502;288;12047190;195;2081647;29252;30571
30071;Cassagnoles;204;5967524;480320;112;4957331;92;1010193;29253;30572
59381;Maresches;447;13075927;832899;281;11424054;166;1651873;29253;30573
95607;Taverny;14042;410776640;26133584;9811;365689124;4231;45087516;29253;30574
51212;Dommartin-Lettrée;84;2457298;158475;53;2071753;31;385545;29254;30575
69267;Villié-Morgon;1003;29341697;1414297;591;24871626;412;4470071;29254;30576
17461;Vaux-sur-Mer;2683;78490140;5589977;1656;66993488;1027;11496652;29255;30577
86088;Croutelle;407;11907044;674096;289;10461625;118;1445419;29256;30578
91340;Lisses;3899;114069627;6491535;2857;103046862;1042;11022765;29256;30579
78474;Orvilliers;352;10298282;544252;242;9138897;110;1159385;29256;30580
67337;Nothalten;234;6846112;323221;153;5856827;81;989285;29257;30581
45196;Mareau-aux-Prés;685;20041154;1196587;494;18131685;191;1909469;29257;30582
51055;Bétheny;3345;97878350;5372847;2389;86380935;956;11497415;29261;30583
52221;Gillancourt;55;1609368;88744;35;1360263;20;249105;29261;30584
31061;Bellegarde-Sainte-Marie;104;3043204;211653;60;2746303;44;296901;29262;30585
77383;Rampillon;385;11266271;681151;275;9853185;110;1413086;29263;30586
59639;Wargnies-le-Grand;529;15480666;938305;344;13568244;185;1912422;29264;30587
69175;Savigny;982;28737645;1418882;628;24328115;354;4409530;29264;30588
26037;Beaumont-lès-Valence;1993;58324355;2936082;1339;50484030;654;7840325;29265;30589
67405;Roeschwoog;1188;34768369;1873599;805;29756256;383;5012113;29266;30590
49346;Le Thoureil;247;7229441;403373;148;6103353;99;1126088;29269;30591
02250;Cuiry-lès-Chaudardes;33;965931;39870;21;758938;12;206993;29271;30592
77475;Trilport;2531;74086129;3795587;1813;65927738;718;8158391;29271;30593
38136;Crachier;234;6849927;361589;170;6039701;64;810226;29273;30594
50001;Acqueville;300;8782051;339814;220;7794197;80;987854;29274;30595
43045;Ceyssac;224;6557795;282175;137;5654836;87;902959;29276;30596
14237;Émiéville;273;7992733;355367;203;7092594;70;900139;29277;30597
26191;Montboucher-sur-Jabron;1173;34343491;2076242;743;29324085;430;5019406;29278;30598
94016;Cachan;15263;446880986;34775005;9904;397046572;5359;49834414;29279;30599
51436;Pogny;431;12619617;737794;301;11011307;130;1608310;29280;30600
60031;Autheuil-en-Valois;152;4450931;327845;93;3761785;59;689146;29282;30601
38565;Voreppe;5072;148543886;8621705;3435;130121450;1637;18422436;29287;30602
45327;Traînou;1545;45248847;2119396;1091;39518642;454;5730205;29287;30603
28313;Réclainville;88;2577476;126844;61;2270135;27;307341;29290;30604
14299;Genneville;376;11013062;598917;243;9434607;133;1578455;29290;30605
74119;Évian-les-Bains;5319;155796334;11436265;3383;132773368;1936;23022966;29291;30606
77170;Épisy;268;7850486;402545;202;7186981;66;663505;29293;30607
60490;Pierrefitte-en-Beauvaisis;190;5565691;328073;143;5039338;47;526353;29293;30608
60587;Saint-Martin-Longueau;736;21561299;1257636;516;18994596;220;2566703;29295;30609
60383;Margny-sur-Matz;251;7353131;406452;173;6294942;78;1058189;29295;30610
77417;Saint-Léger;123;3603335;207277;88;3199412;35;403923;29295;30611
67077;Cosswiller;301;8817967;458103;217;7791815;84;1026152;29296;30612
01228;Maillat;321;9404194;448220;209;7939708;112;1464486;29297;30613
67127;Ergersheim;665;19483214;956297;480;17434708;185;2048506;29298;30614
31496;Sainte-Livrade;161;4717023;365326;102;4088609;59;628414;29298;30615
31038;Azas;286;8379468;459605;195;7472646;91;906822;29299;30616
77126;Congis-sur-Thérouanne;867;25402879;1584922;629;22726419;238;2676460;29300;30617
51443;Potangis;63;1845947;150760;41;1652956;22;192991;29301;30618
16146;Garat;1004;29418229;1823886;670;25789960;334;3628269;29301;30619
68119;Hagenbach;337;9874455;413643;217;8239731;120;1634724;29301;30620
61341;Radon;544;15940144;729871;367;13819940;177;2120204;29302;30621
30011;Les Angles;5172;151552663;11195401;3345;130842337;1827;20710326;29303;30622
76298;Ganzeville;246;7208946;365949;169;6180272;77;1028674;29305;30623
14682;Surville;236;6916864;396365;157;5860891;79;1055973;29309;30624
31179;Le Faget;192;5627390;797873;97;4635868;95;991522;29309;30625
94046;Maisons-Alfort;32162;942681405;72166716;22920;852614659;9242;90066746;29310;30626
77140;Coutençon;140;4103515;225221;103;3701747;37;401768;29311;30627
77171;Esbly;3377;98991936;5835905;2487;90095582;890;8896354;29314;30628
25413;Mouthe;565;16562806;1154884;367;14417170;198;2145636;29315;30629
10404;Verpillières-sur-Ource;64;1876259;160430;35;1580126;29;296133;29317;30630
76554;Saint-Aignan-sur-Ry;146;4280341;274945;89;3651089;57;629252;29317;30631
25566;La Tour-de-Sçay;141;4134013;334568;83;3490219;58;643794;29319;30632
77494;Vernou-la-Celle-sur-Seine;1340;39289659;1991956;964;35134009;376;4155650;29321;30633
2A098;Coti-Chiavari;448;13136556;1114542;250;11156072;198;1980484;29323;30634
02192;Chouy;176;5160981;343849;108;4285411;68;875570;29324;30635
68045;Bourbach-le-Bas;321;9412973;503425;203;7807675;118;1605298;29324;30636
67364;Osthouse;489;14340185;828595;344;12614713;145;1725472;29326;30637
08427;Sorbon;109;3196518;191144;67;2686530;42;509988;29326;30638
28274;Moutiers;141;4135046;291517;83;3448209;58;686837;29327;30639
21067;Bessey-lès-Cîteaux;307;9003299;399178;211;7756162;96;1247137;29327;30640
87125;Rilhac-Rancon;2207;64724107;3228515;1569;57025900;638;7698207;29327;30641
45167;Huisseau-sur-Mauves;853;25016916;1315923;585;21350848;268;3666068;29328;30642
25383;Moncley;161;4722087;267037;111;4161809;50;560278;29330;30643
17463;Vergeroux;527;15457202;917742;349;13504194;178;1953008;29331;30644
34022;Baillargues;3415;100166705;6199856;2115;84520455;1300;15646250;29331;30645
21561;Saint-Martin-du-Mont;226;6628940;448276;138;5651267;88;977673;29332;30646
08216;Haudrecy;141;4135789;252015;92;3495340;49;640449;29332;30647
10076;Champignol-lez-Mondeville;182;5338583;581426;92;4331587;90;1006996;29333;30648
54468;Saffais;63;1848058;101478;43;1589884;20;258174;29334;30649
95008;Aincourt;430;12614226;750922;330;11468555;100;1145671;29335;30650
76094;Bierville;141;4136333;204754;101;3631445;40;504888;29336;30651
68016;Balgau;479;14052287;680623;336;12341717;143;1710570;29337;30652
25469;Présentevillers;234;6864843;349899;168;6028641;66;836202;29337;30653
77329;Nanteau-sur-Lunain;298;8744418;641158;196;7917387;102;827031;29344;30654
06034;Castagniers;879;25794459;2038370;565;22551065;314;3243394;29345;30655
68159;Jungholtz;468;13733759;809090;332;12058717;136;1675042;29346;30656
76300;Gerville;176;5164963;228926;135;4717564;41;447399;29346;30657
59123;Camphin-en-Carembault;849;24915092;1483960;586;22189134;263;2725958;29346;30658
50447;Saint-Aubin-des-Préaux;225;6603016;421871;147;5716801;78;886215;29347;30659
62103;Béhagnies;61;1790177;114631;41;1539070;20;251107;29347;30660
10198;Lirey;59;1731583;117641;37;1465450;22;266133;29349;30661
27062;Berville-en-Roumois;405;11887175;575788;289;10433635;116;1453540;29351;30662
60079;Boissy-Fresnoy;465;13649318;684553;320;12088407;145;1560911;29353;30663
56233;Saint-Philibert;995;29208435;2009047;606;24809560;389;4398875;29355;30664
77461;Thénisy;159;4667635;295777;115;4128489;44;539146;29356;30665
17161;La Flotte;1809;53106199;4124061;1137;45438123;672;7668076;29357;30666
68115;Guewenheim;667;19580901;891473;473;17050065;194;2530836;29357;30667
67080;Dachstein;860;25246897;1295775;592;21769907;268;3476990;29357;30668
21625;Ternant;54;1585297;99086;40;1458315;14;126982;29357;30669
25464;Les Pontets;57;1673467;98042;32;1423597;25;249870;29359;30670
52547;Vouécourt;122;3581824;237237;71;2939500;51;642324;29359;30671
12090;Druelle;1000;29359459;1419377;701;25671836;299;3687623;29359;30672
59319;Hoymille;1564;45918466;2078114;1073;39279914;491;6638552;29360;30673
25085;Bouverans;161;4727061;250414;112;4182069;49;544992;29361;30674
85155;Mouilleron-le-Captif;2306;67705933;2813226;1657;59613257;649;8092676;29361;30675
77266;Machault;391;11481229;662522;289;10324603;102;1156626;29364;30676
17380;Saint-Palais-sur-Mer;2615;76800352;5268928;1621;65409569;994;11390783;29369;30677
62320;Étrun;175;5139741;321131;103;4353074;72;786667;29370;30678
80683;Rouy-le-Grand;62;1820942;141532;35;1496171;27;324771;29370;30679
28104;Coltainville;441;12952706;769592;314;11776964;127;1175742;29371;30680
31585;Villeneuve-de-Rivière;873;25642771;1253724;562;22104463;311;3538308;29373;30681
68191;Luemschwiller;378;11103247;606125;254;9428189;124;1675058;29374;30682
15140;Naucelles;988;29022587;1536948;653;24714078;335;4308509;29375;30683
38420;Saint-Martin-de-Vaulserre;125;3671957;167458;85;3223706;40;448251;29376;30684
57406;Liocourt;78;2291346;127423;43;2011272;35;280074;29376;30685
76589;Saint-Honoré;86;2526375;146293;60;2218965;26;307410;29376;30686
79129;Fressines;733;21535535;914816;539;19028176;194;2507359;29380;30687
01259;Montcet;306;8990347;467219;218;7818928;88;1171419;29380;30688
25071;Bondeval;259;7609522;357554;188;6692723;71;916799;29380;30689
89282;Ormoy;406;11928786;674662;280;10381248;126;1547538;29381;30690
68267;Reiningue;1011;29705736;1717363;709;25944588;302;3761148;29383;30691
39427;Plénise;32;940253;70188;18;829461;14;110792;29383;30692
49129;Écouflant;1930;56710731;2527321;1295;48945692;635;7765039;29384;30693
14449;Monts-en-Bessin;231;6787745;301001;144;5799789;87;987956;29384;30694
57092;Blies-Ébersing;320;9403435;606599;210;8065619;110;1337816;29386;30695
27013;Amfreville-sous-les-Monts;250;7346782;431320;158;6280811;92;1065971;29387;30696
26338;Sauzet;1049;30828327;1804429;678;26451843;371;4376484;29388;30697
62612;Neuvireuil;267;7846684;386025;189;6856592;78;990092;29388;30698
67033;Bernolsheim;310;9110956;504685;224;8119687;86;991269;29390;30699
62390;Groffliers;781;22954041;1398979;523;20017868;258;2936173;29391;30700
60378;Marest-sur-Matz;209;6143140;313367;145;5403180;64;739960;29393;30701
64348;Lons;6541;192261763;11907510;4338;167034130;2203;25227633;29393;30702
77307;Montévrain;5065;148902134;11112430;3781;135917453;1284;12984681;29398;30703
67129;Ernolsheim-lès-Saverne;300;8819709;345013;207;7696453;93;1123256;29399;30704
89319;Quenne;234;6879397;421583;167;5944280;67;935117;29399;30705
08314;Neuflize;353;10378277;443272;209;8504575;144;1873702;29400;30706
08101;La Chapelle;82;2411109;118549;60;2186039;22;225070;29404;30707
30043;Boissières;275;8087074;556462;162;6969841;113;1117233;29408;30708
87015;Beynac;314;9233988;507279;223;8156482;91;1077506;29408;30709
28339;Saint-Germain-le-Gaillard;153;4499416;170015;116;4093426;37;405990;29408;30710
01170;Béard-Géovreissiat;434;12763452;749095;294;10955904;140;1807548;29409;30711
60002;Abbecourt;391;11498884;737684;283;10296529;108;1202355;29409;30712
76022;Anquetierville;155;4558396;192345;110;4045824;45;512572;29409;30713
38303;La Pierre;217;6382305;322483;153;5549680;64;832625;29412;30714
74147;Lathuile;522;15352859;994366;377;13603125;145;1749734;29412;30715
76741;Villainville;140;4117732;130240;99;3526247;41;591485;29412;30716
14634;Saint-Michel-de-Livet;90;2647497;120770;56;2158694;34;488803;29417;30717
95024;Arthies;136;4000663;180817;97;3543400;39;457263;29417;30718
61259;Le Ménil-Bérard;36;1059002;86572;22;897938;14;161064;29417;30719
70312;Luze;386;11355004;613915;262;9781878;124;1573126;29417;30720
10339;Saint-Flavy;148;4353852;272258;100;3789779;48;564073;29418;30721
67406;Rohr;129;3794930;219272;79;3134463;50;660467;29418;30722
53119;L'Huisserie;2085;61339938;2829376;1450;53356027;635;7983911;29420;30723
28351;Saint-Maixme-Hauterive;210;6178128;313629;146;5456272;64;721856;29420;30724
53021;La Bazoge-Montpinçon;402;11826839;389738;300;10502048;102;1324791;29420;30725
77042;Boissy-le-Châtel;1613;47456624;2586500;1120;41273411;493;6183213;29421;30726
28082;Charpont;280;8238109;428513;211;7478343;69;759766;29422;30727
48042;Chastel-Nouvel;387;11386365;694667;269;10015780;118;1370585;29422;30728
05124;La Rochette;260;7649909;614279;148;6571584;112;1078325;29423;30729
50294;Martinvast;628;18477520;1167597;409;16151136;219;2326384;29423;30730
74279;Thollon-les-Mémises;418;12299392;714967;264;10535776;154;1763616;29424;30731
14400;Le Manoir;94;2766054;136219;63;2457849;31;308205;29426;30732
25028;Athose;87;2560101;112377;56;2164497;31;395604;29426;30733
91547;Saint-Escobille;243;7150861;435252;165;6152584;78;998277;29427;30734
27301;Grossoeuvre;549;16156241;885612;399;14444579;150;1711662;29428;30735
68302;Schweighouse-Thann;363;10682816;491148;250;9247237;113;1435579;29429;30736
01333;Saint-André-de-Corcy;1518;44674473;2393178;1038;38435898;480;6238575;29430;30737
60448;Neufchelles;182;5356575;302889;125;4618278;57;738297;29432;30738
68255;Pfaffenheim;734;21603637;1219018;544;19505256;190;2098381;29433;30739
77173;Étrépilly;453;13333101;799938;322;11924334;131;1408767;29433;30740
60085;Bonvillers;106;3119998;185271;77;2811556;29;308442;29434;30741
59001;Abancourt;214;6299279;334609;151;5559057;63;740222;29436;30742
60391;Maysel;129;3797301;197306;99;3404680;30;392621;29436;30743
51547;Somme-Tourbe;78;2296064;125148;53;1945491;25;350573;29437;30744
21590;Savigny-lès-Beaune;766;22548562;1434003;526;20077476;240;2471086;29437;30745
57648;Servigny-lès-Raville;179;5269325;257553;121;4541493;58;727832;29438;30746
80414;Hangard;63;1854582;99363;49;1664447;14;190135;29438;30747
86007;Antran;596;17546207;992682;407;15145447;189;2400760;29440;30748
45076;La Chapelle-Saint-Sépulcre;146;4298652;259202;106;3882349;40;416303;29443;30749
89102;Chevannes;1207;35537619;1906215;840;31300540;367;4237079;29443;30750
76007;Anceaumeville;323;9510586;463962;234;8409392;89;1101194;29445;30751
73328;Viviers-du-Lac;1164;34274795;2159291;799;30163650;365;4111145;29446;30752
08003;Aiglemont;849;25000358;1377211;585;21718073;264;3282285;29447;30753
67149;Furchhausen;190;5594949;265684;120;4580850;70;1014099;29447;30754
68059;Burnhaupt-le-Bas;906;26679680;1305314;661;23574821;245;3104859;29448;30755
02415;Laversine;66;1943610;91465;42;1599824;24;343786;29449;30756
62772;Salperwick;223;6567284;295106;145;5530803;78;1036481;29450;30757
71135;Clessé;421;12398607;664710;305;10907466;116;1491141;29450;30758
26110;Crozes-Hermitage;273;8040056;346257;194;7052948;79;987108;29451;30759
14569;Sainte-Croix-sur-Mer;116;3416894;144809;82;3059950;34;356944;29456;30760
01027;Balan;710;20914687;983878;519;18526461;191;2388226;29457;30761
70363;Montigny-lès-Vesoul;344;10133622;620405;241;8959811;103;1173811;29458;30762
35254;Saint-Aubin-du-Pavail;338;9958292;367075;235;8625928;103;1332364;29462;30763
57576;Rettel;351;10341566;430968;159;6229862;192;4111704;29463;30764
60101;Brégy;299;8809520;614803;196;7616385;103;1193135;29463;30765
68343;Ungersheim;1000;29463398;1595477;717;26088929;283;3374469;29463;30766
39306;Macornay;542;15970504;855111;365;13949254;177;2021250;29466;30767
54311;Lenoncourt;296;8722019;445374;210;7738525;86;983494;29466;30768
80637;Port-le-Grand;150;4420008;414008;81;3597753;69;822255;29467;30769
45269;Saint-Ay;1658;48857113;2714717;1186;43118006;472;5739107;29467;30770
2A008;Albitreccia;818;24105510;2029163;523;21180700;295;2924810;29469;30771
42115;Jonzieux;641;18889709;1428202;379;15866785;262;3022924;29469;30772
60054;Beaumont-les-Nonains;178;5245943;253788;122;4592000;56;653943;29472;30773
29112;Lanildut;527;15532046;907559;341;13435745;186;2096301;29473;30774
45137;Escrennes;381;11229062;476369;238;9265359;143;1963703;29473;30775
28380;Sours;864;25465119;1202727;637;22783844;227;2681275;29474;30776
33192;Gradignan;12789;376946644;25683130;8489;332078747;4300;44867897;29474;30777
76670;Senneville-sur-Fécamp;403;11878406;702089;289;10513859;114;1364547;29475;30778
26196;Montéléger;908;26764338;1809649;525;23181966;383;3582372;29476;30779
59668;Zuydcoote;772;22755671;1207327;526;19889890;246;2865781;29476;30780
77460;Tancrou;178;5246928;299784;120;4599857;58;647071;29477;30781
25024;Arçon;391;11525591;615150;273;10235981;118;1289610;29477;30782
76206;Cuverville;160;4716617;182249;116;4206442;44;510175;29479;30783
67112;Duttlenheim;1461;43074332;2398357;1054;38360153;407;4714179;29483;30784
01271;Nattages;283;8343701;453892;199;7458992;84;884709;29483;30785
25041;Bannans;162;4776378;210313;115;4305988;47;470390;29484;30786
12131;La Loubière;724;21346455;1011224;506;18685827;218;2660628;29484;30787
51485;Saint-Hilaire-au-Temple;148;4363715;255630;103;3785827;45;577888;29485;30788
29058;Fouesnant;5512;162532668;10041652;3517;139439956;1995;23092712;29487;30789
76229;Elbeuf-en-Bray;207;6103894;346107;127;5156415;80;947479;29487;30790
59408;Moncheaux;724;21349729;1092388;487;18716128;237;2633601;29489;30791
25186;Cussey-sur-l'Ognon;453;13358470;611829;324;11834329;129;1524141;29489;30792
28312;Puiseux;67;1975785;140659;49;1781858;18;193927;29489;30793
50641;Villiers-Fossard;278;8198627;442189;186;7043179;92;1155448;29491;30794
73196;Pallud;386;11384636;647739;271;9962911;115;1421725;29494;30795
14522;Prêtreville;219;6459416;410505;140;5520853;79;938563;29495;30796
56243;Séné;4916;145021894;8824499;3237;125598998;1679;19422896;29500;30797
29075;Guipavas;6784;200131070;10879712;4503;172077182;2281;28053888;29500;30798
38157;Estrablin;1696;50033589;2736721;1205;44170605;491;5862984;29501;30799
77082;Champeaux;432;12745409;731189;294;10945941;138;1799468;29503;30800
42074;Coutouvre;583;17200677;719789;338;14566968;245;2633709;29504;30801
05012;Baratier;290;8556103;453728;163;7082678;127;1473425;29504;30802
60107;Breuil-le-Vert;1524;44965299;2609126;1148;40826263;376;4139036;29505;30803
56262;Bono;1230;36291786;2311639;782;31103849;448;5187937;29506;30804
10341;Saint-Hilaire-sous-Romilly;194;5724540;348903;126;4903591;68;820949;29508;30805
37175;Nouzilly;636;18769695;1029745;444;16416199;192;2353496;29512;30806
60649;Troussures;100;2951231;207770;62;2605545;38;345686;29512;30807
60145;Chelles;249;7348810;377653;175;6422927;74;925883;29513;30808
64197;Cuqueron;97;2862834;182319;57;2352128;40;510706;29514;30809
77380;Puisieux;161;4751752;295580;117;4240967;44;510785;29514;30810
10066;Bucey-en-Othe;225;6640707;361912;158;5928257;67;712450;29514;30811
49196;La Meignanne;1048;30931601;1307056;683;26442744;365;4488857;29515;30812
59144;Château-l'Abbaye;411;12131222;585704;269;10518488;142;1612734;29516;30813
90015;Botans;144;4250522;241475;98;3676924;46;573598;29518;30814
45188;Loury;1217;35923045;1769471;874;31682279;343;4240766;29518;30815
89373;Saligny;364;10744540;738289;267;9626194;97;1118346;29518;30816
62350;Fouquières-lès-Béthune;576;17003359;1173962;368;14842213;208;2161146;29520;30817
67189;Heiligenstein;508;14996236;923423;331;12921172;177;2075064;29520;30818
51150;Cherville;48;1416973;69719;32;1226801;16;190172;29520;30819
62175;Brévillers;77;2273132;242627;39;1851064;38;422068;29521;30820
69007;Ampuis;1447;42717487;2979943;941;37110030;506;5607457;29521;30821
56164;Ploeren;3195;94320985;5376633;2144;82058620;1051;12262365;29521;30822
63051;Brenat;298;8797598;551389;197;7597627;101;1199971;29522;30823
67169;Gries;1452;42867989;2335843;998;37318750;454;5549239;29523;30824
71402;Saint-Cyr;360;10629020;655115;243;9257501;117;1371519;29525;30825
51169;Corbeil;54;1594462;123472;32;1292595;22;301867;29527;30826
76623;Saint-Michel-d'Halescourt;55;1624043;123176;35;1385497;20;238546;29528;30827
14184;Cottun;92;2716728;120831;64;2362634;28;354094;29530;30828
64558;Villefranque;1213;35819707;2047644;796;30819578;417;5000129;29530;30829
33083;Camarsac;491;14500203;909066;324;12531268;167;1968935;29532;30830
10086;Charny-le-Bachot;100;2953306;193366;61;2460352;39;492954;29533;30831
40207;Oeyreluy;676;19964826;1144223;466;17177251;210;2787575;29534;30832
49042;Brain-sur-l'Authion;1562;46132196;1944122;1100;40281482;462;5850714;29534;30833
60318;Houdancourt;323;9539821;553803;241;8589591;82;950230;29535;30834
59259;Ghissignies;232;6852544;277453;153;5790378;79;1062166;29537;30835
58137;Lamenay-sur-Loire;32;945200;106089;18;788723;14;156477;29538;30836
27045;Bazincourt-sur-Epte;356;10515362;561040;240;9113276;116;1402086;29538;30837
05018;La Bâtie-Vieille;162;4785204;295279;104;4157771;58;627433;29538;30838
70559;Villeparois;105;3101530;154841;73;2671848;32;429682;29538;30839
23186;Saint-Christophe;70;2067715;127854;38;1751930;32;315785;29539;30840
69021;Bessenay;1148;33911125;1580100;684;28123517;464;5787608;29539;30841
62747;Saint-Floris;229;6764506;290152;161;5957659;68;806847;29539;30842
27504;Sacquenville;506;14946913;626583;355;12990692;151;1956221;29539;30843
87143;Saint-Gence;1016;30014511;1771501;699;26606562;317;3407949;29542;30844
68106;Goldbach-Altenbach;152;4490463;304609;98;3781183;54;709280;29543;30845
59608;Vendegies-sur-Écaillon;543;16042013;829727;338;13594804;205;2447209;29543;30846
76135;Bouville;480;14180833;796149;341;12368916;139;1811917;29543;30847
90087;Roppe;454;13413204;799724;317;11869597;137;1543607;29545;30848
14160;Cintheaux;101;2984177;138086;68;2553831;33;430346;29546;30849
76627;Saint-Nicolas-de-la-Taille;641;18939213;921824;450;16442604;191;2496609;29546;30850
71430;Saint-Jean-de-Vaux;197;5820649;383217;131;4988550;66;832099;29546;30851
31568;Varennes;131;3870841;185688;96;3449506;35;421335;29548;30852
45311;Sigloy;329;9721548;395575;230;8388622;99;1332926;29549;30853
07310;Savas;400;11819732;671639;277;10360597;123;1459135;29549;30854
76682;Sotteville-sous-le-Val;337;9958184;505665;234;8606597;103;1351587;29550;30855
25522;Saint-Julien-lès-Russey;65;1920748;76717;42;1580750;23;339998;29550;30856
33231;Laroque;137;4048386;272069;92;3535963;45;512423;29550;30857
51487;Saint-Hilaire-le-Petit;155;4580451;277562;101;3978064;54;602387;29551;30858
28003;Allainville;72;2127966;119789;48;1851673;24;276293;29555;30859
77376;Précy-sur-Marne;368;10876664;682864;255;9670020;113;1206644;29556;30860
78118;Buchelay;1249;36919138;2115399;909;32945536;340;3973602;29559;30861
68140;Hirtzfelden;592;17499355;931707;421;15406358;171;2092997;29560;30862
45014;Aulnay-la-Rivière;291;8602552;602796;187;7366843;104;1235709;29562;30863
80461;Lamotte-Brebière;117;3458774;172920;78;2972929;39;485845;29562;30864
15215;Saint-Simon;630;18625025;1445817;383;15855925;247;2769100;29564;30865
02327;Foreste;88;2601627;132468;40;2088333;48;513294;29564;30866
06031;Cantaron;768;22705702;1414650;508;20004062;260;2701640;29565;30867
29170;Plomelin;2192;64816782;3508839;1389;56007930;803;8808852;29570;30868
77474;Trilbardou;349;10320499;619160;262;9457611;87;862888;29572;30869
21605;Sennecey-lès-Dijon;1034;30577863;1352831;745;26919765;289;3658098;29572;30870
76522;La Remuée;615;18188758;879080;429;15836023;186;2352735;29575;30871
01069;Certines;719;21265120;996425;516;18733852;203;2531268;29576;30872
76568;Saint-Clair-sur-les-Monts;300;8873149;455562;197;7523842;103;1349307;29577;30873
60209;Énencourt-le-Sec;99;2928375;168209;70;2574023;29;354352;29580;30874
28064;Bû;952;28160510;1916219;645;24527209;307;3633301;29580;30875
67551;Wolfisheim;2218;65610171;4180901;1567;57906153;651;7704018;29581;30876
38556;Ville-sous-Anjou;598;17689556;1017309;403;15428158;195;2261398;29581;30877
64560;Viven;87;2573604;151468;49;2095306;38;478298;29582;30878
81232;Rouffiac;310;9170359;599278;195;7658056;115;1512303;29582;30879
17142;Dompierre-sur-Mer;2768;81885167;4224379;1895;70804438;873;11080729;29583;30880
39503;Sapois;168;4969959;252634;110;4240369;58;729590;29583;30881
18097;Fussy;1053;31151340;1679927;757;27644450;296;3506890;29583;30882
54498;Seichamps;2474;73198620;3870283;1729;63975314;745;9223306;29587;30883
76737;Vibeuf;285;8432552;490082;175;7159791;110;1272761;29588;30884
31458;Roques;2045;60508276;3504549;1325;52585422;720;7922854;29588;30885
60430;Morienval;523;15474754;1034005;341;13241927;182;2232827;29588;30886
51199;Cuchery;243;7190160;563672;160;6303577;83;886583;29589;30887
2A001;Afa;1564;46277733;3523277;1015;40810813;549;5466920;29589;30888
44172;Sainte-Luce-sur-Loire;6535;193375802;9638417;4638;170076319;1897;23299483;29591;30889
14074;Billy;179;5296986;494985;105;4325601;74;971385;29592;30890
27677;Venon;174;5149201;223790;115;4307195;59;842006;29593;30891
62712;Rivière;605;17904114;1118558;378;15481570;227;2422544;29594;30892
49278;Sainte-Gemmes-sur-Loire;1953;57797277;4080042;1235;50697025;718;7100252;29594;30893
27582;Saint-Ouen-du-Tilleul;765;22640047;1219613;546;19957095;219;2682952;29595;30894
10421;La Villeneuve-au-Châtelot;77;2278855;187344;38;1785586;39;493269;29596;30895
67329;Niedernai;612;18112571;928624;433;15866442;179;2246129;29596;30896
33364;Saillans;205;6067188;675083;116;5135956;89;931232;29596;30897
60120;Cambronne-lès-Clermont;550;16278167;877792;402;14415940;148;1862227;29597;30898
45243;Ouzouer-sous-Bellegarde;170;5031440;208734;92;4101249;78;930191;29597;30899
09227;Péreille;105;3107701;203990;59;2583170;46;524531;29597;30900
01301;Polliat;1225;36256744;2030676;876;31879117;349;4377627;29597;30901
27489;Reuilly;275;8139593;487406;181;7070797;94;1068796;29599;30902
40069;Castaignos-Souslens;194;5742153;241254;104;4746956;90;995197;29599;30903
02420;Lesdins;427;12639396;817843;277;10892554;150;1746842;29600;30904
60325;Jaux;1131;33479226;2132497;739;29868471;392;3610755;29601;30905
77344;Oissery;977;28922202;1441283;723;25811675;254;3110527;29603;30906
28179;Germignonville;132;3907626;403510;72;3236193;60;671433;29603;30907
26206;Montmeyran;1517;44910837;2355159;955;38154541;562;6756296;29605;30908
33312;Parempuyre;4160;123166337;6013472;2719;106716588;1441;16449749;29607;30909
27006;Aizier;62;1835687;108791;39;1603931;23;231756;29608;30910
77428;Saint-Ouen-en-Brie;405;11991187;555292;309;10880184;96;1111003;29608;30911
42332;Villerest;2412;71418848;3836106;1590;61646136;822;9772712;29610;30912
51499;Saint-Mard-lès-Rouffy;74;2191182;104218;53;1924805;21;266377;29611;30913
74131;Frangy;1090;32278232;1081027;586;23781442;504;8496790;29613;30914
38235;Miribel-Lanchâtre;176;5212469;204697;129;4571768;47;640701;29616;30915
51326;Livry-Louvercy;485;14364079;637507;342;12586989;143;1777090;29617;30916
01061;Brens;515;15252729;590815;356;13299056;159;1953673;29617;30917
13098;Saint-Mitre-les-Remparts;3343;99017665;6673074;2207;86943089;1136;12074576;29619;30918
64407;Mouguerre;2403;71179840;3902309;1636;61318544;767;9861296;29621;30919
60572;Saint-Étienne-Roilaye;172;5095075;316242;127;4601583;45;493492;29623;30920
34152;Mas-de-Londres;289;8560912;470306;171;7367577;118;1193335;29623;30921
94019;Chennevières-sur-Marne;10352;306672304;24241788;6748;270782090;3604;35890214;29624;30922
67190;Hengwiller;93;2755153;172843;68;2362803;25;392350;29625;30923
41187;Renay;90;2666286;191768;55;2295722;35;370564;29625;30924
29056;La Forest-Landerneau;889;26340000;1282879;648;23452183;241;2887817;29629;30925
77107;Chaumes-en-Brie;1587;47021276;2749719;1097;41903330;490;5117946;29629;30926
44094;Mauves-sur-Loire;1499;44418072;2001580;989;37757623;510;6660449;29632;30927
13086;Roquevaire;5045;149503133;12533272;3140;130090139;1905;19412994;29634;30928
41230;Saint-Sulpice-de-Pommeray;914;27087597;1345803;691;24372720;223;2714877;29636;30929
27636;Le Thuit-Anger;305;9039315;429896;222;7877802;83;1161513;29637;30930
31438;Pradère-les-Bourguets;113;3349005;229878;70;2884983;43;464022;29637;30931
60424;Montmartin;107;3171182;150965;77;2852101;30;319081;29637;30932
27249;Fontaine-Bellenger;480;14225944;647621;355;12681379;125;1544565;29637;30933
16018;Ars;375;11114302;711856;249;9704128;126;1410174;29638;30934
77318;Mortcerf;738;21873151;1378084;528;19639304;210;2233847;29638;30935
62680;Quiéry-la-Motte;374;11085050;679798;255;9756471;119;1328579;29639;30936
14089;Bougy;173;5128217;189957;118;4420120;55;708097;29643;30937
51404;Noirlieu;55;1630470;81950;30;1298757;25;331713;29645;30938
77245;Laval-en-Brie;227;6729744;346568;166;6044393;61;685351;29646;30939
60411;Monneville;409;12125501;694431;275;10650242;134;1475259;29647;30940
74135;Giez;298;8835318;558438;194;7543678;104;1291640;29649;30941
31171;Espanès;155;4595776;292963;105;4016049;50;579727;29650;30942
68225;Munchhouse;809;23988005;1266690;589;21438949;220;2549056;29651;30943
76531;Rocquefort;148;4388560;240119;94;3821420;54;567140;29652;30944
21060;Belleneuve;782;23188350;1096574;561;20344784;221;2843566;29653;30945
27161;Claville;534;15835279;907271;383;14299958;151;1535321;29654;30946
38430;Saint-Mury-Monteymond;174;5160196;300049;120;4614381;54;545815;29656;30947
95462;Omerville;163;4834090;332424;115;4380703;48;453387;29657;30948
71019;Barizey;69;2046401;114062;45;1717145;24;329256;29658;30949
57075;Beux;124;3677845;158654;83;3140788;41;537057;29660;30950
50077;Bretteville;573;16995445;882470;395;14895683;178;2099762;29660;30951
51463;Les Rivières-Henruel;91;2699124;180261;67;2430776;24;268348;29661;30952
29245;Saint-Divy;654;19398247;744196;452;16848413;202;2549834;29661;30953
93049;Neuilly-Plaisance;11148;330674216;23091270;7669;295905116;3479;34769100;29662;30954
42315;Unias;182;5398560;288410;119;4456158;63;942402;29662;30955
54204;Forcelles-sous-Gugney;51;1512796;161759;30;1291610;21;221186;29663;30956
57024;Antilly;71;2106083;79588;50;1803968;21;302115;29663;30957
10346;Saint-Léger-sous-Margerie;33;978929;109444;16;828846;17;150083;29665;30958
27181;Courdemanche;286;8484814;588672;199;7408020;87;1076794;29667;30959
55366;Val-d'Ornain;479;14210606;774162;342;12352532;137;1858074;29667;30960
08126;Condé-lès-Herpy;115;3411755;254937;60;2816658;55;595097;29667;30961
27390;Marcilly-la-Campagne;520;15427171;658434;345;13183852;175;2243319;29668;30962
59480;Quérénaing;456;13528834;757114;300;11762662;156;1766172;29668;30963
62799;Sorrus;324;9613183;447506;207;8273922;117;1339261;29670;30964
39388;Nevy-sur-Seille;128;3797851;449370;76;3232756;52;565095;29671;30965
60013;Angicourt;774;22965163;1482164;537;20681301;237;2283862;29671;30966
38002;Les Adrets;510;15132207;816780;353;13137253;157;1994954;29671;30967
59508;Roncq;6767;200784471;10861353;4432;172745106;2335;28039365;29671;30968
76502;Pierreval;211;6260736;279875;153;5430793;58;829943;29672;30969
33090;Canéjan;2666;79106036;4338931;1868;70063880;798;9042156;29672;30970
61115;Condeau;204;6053323;413256;128;5195726;76;857597;29673;30971
61198;Guerquesalles;64;1899283;118181;41;1697639;23;201644;29676;30972
14082;La Boissière;84;2492817;84964;59;2226698;25;266119;29676;30973
21708;Villy-le-Moutier;171;5074760;302357;110;4408247;61;666513;29677;30974
51369;Moeurs-Verdey;169;5015446;235943;101;4260518;68;754928;29677;30975
10146;Fay-lès-Marcilly;42;1246490;88062;28;1067078;14;179412;29678;30976
72157;Lavardin;353;10476845;552235;243;9029961;110;1446884;29679;30977
38172;Four;601;17837926;843073;435;15875589;166;1962337;29680;30978
73239;Saint-Girod;289;8577847;450273;199;7541760;90;1036087;29681;30979
49241;Le Plessis-Grammoire;1042;30928187;1349228;716;27115631;326;3812556;29682;30980
27534;Saint-Didier-des-Bois;428;12704111;704276;309;11252764;119;1451347;29683;30981
14461;Mutrécy;171;5076512;250409;126;4472816;45;603696;29687;30982
10373;Souligny;220;6531432;334969;150;5545705;70;985727;29688;30983
76471;Norville;444;13181716;858280;296;11420236;148;1761480;29689;30984
74178;Menthonnex-sous-Clermont;320;9500337;389246;212;7753453;108;1746884;29689;30985
44066;Grandchamps-des-Fontaines;2202;65376578;2591106;1468;55724726;734;9651852;29690;30986
10347;Saint-Loup-de-Buffigny;112;3325272;221361;77;2834109;35;491163;29690;30987
76368;Houquetot;145;4305119;171261;106;3834336;39;470783;29690;30988
21290;Gemeaux;421;12499916;579314;275;10713608;146;1786308;29691;30989
59451;Orsinval;286;8492091;484294;201;7597861;85;894230;29693;30990
91421;Montgeron;13230;392837648;28662268;8696;346073970;4534;46763678;29693;30991
22251;Pordic;3099;92023784;4779139;2042;79530239;1057;12493545;29695;30992
57343;Illange;1021;30319208;1095427;577;21500531;444;8818677;29696;30993
74164;Marignier;3482;103403036;4944708;2349;87115393;1133;16287643;29696;30994
38524;Varces-Allières-et-Risset;3378;100332977;5761605;2489;89982597;889;10350380;29702;30995
10418;Villemorien;112;3326715;349300;68;2816316;44;510399;29703;30996
44150;Saint-Aignan-Grandlieu;1792;53230717;2484522;1215;46058361;577;7172356;29705;30997
41052;Chitenay;521;15477873;872474;365;13667126;156;1810747;29708;30998
91589;Savigny-sur-Orge;20462;607906673;42556172;14358;544678677;6104;63227996;29709;30999
50432;Réthoville;71;2109370;119328;42;1668114;29;441256;29709;31000
62639;Oppy;205;6090452;370572;134;5304585;71;785867;29710;31001
80686;Rubempré;358;10636079;595837;244;9254824;114;1381255;29710;31002
80836;Yonval;120;3565235;199566;89;3102636;31;462599;29710;31003
80198;Clairy-Saulchoix;195;5793593;294264;140;5169234;55;624359;29711;31004
87075;Isle;4284;127281605;8888586;2829;111820025;1455;15461580;29711;31005
70130;Charcenne;168;4991700;293746;105;4272800;63;718900;29713;31006
54506;Sexey-les-Bois;182;5407790;250578;146;4875605;36;532185;29713;31007
31460;Roquettes;2134;63408970;3737912;1524;55862211;610;7546759;29714;31008
95301;Haute-Isle;183;5437741;435504;126;4761345;57;676396;29714;31009
55263;Koeur-la-Grande;77;2288020;108065;55;2089649;22;198371;29715;31010
28325;Saint-Aubin-des-Bois;480;14263609;745522;361;12923797;119;1339812;29716;31011
80315;Flers-sur-Noye;205;6091782;292341;138;5203395;67;888387;29716;31012
77147;La Croix-en-Brie;358;10638745;648823;238;9171932;120;1466813;29717;31013
91393;Mérobert;294;8737310;474883;205;7629901;89;1107409;29719;31014
02598;Pernant;332;9866646;534349;240;8690670;92;1175976;29719;31015
44115;Oudon;1783;52992630;2336202;1129;44836418;654;8156212;29721;31016
34116;Grabels;3684;109493704;7709183;2295;96247570;1389;13246134;29721;31017
18179;Pigny;407;12096931;559571;293;10351699;114;1745232;29722;31018
54247;Hammeville;90;2675285;128789;57;2199775;33;475510;29725;31019
69068;Couzon-au-Mont-d'Or;1443;42894143;3092120;903;37598474;540;5295669;29726;31020
69163;Quincieux;1574;46791472;2528785;1104;41209601;470;5581871;29728;31021
73222;Saint-Alban-Leysse;3271;97242053;6551362;2258;85763487;1013;11478566;29729;31022
32207;Leboulin;165;4905682;271861;115;4301424;50;604258;29731;31023
21106;Bretenière;358;10644650;439639;253;9207811;105;1436839;29734;31024
51410;OEuilly;334;9931157;744630;213;8570301;121;1360856;29734;31025
51430;Pierre-Morains;50;1486743;102642;36;1336126;14;150617;29735;31026
59586;Templeuve;3092;91940714;5486330;2001;79551965;1091;12388749;29735;31027
29109;Landunvez;869;25841793;1945894;527;22131138;342;3710655;29737;31028
25559;Thiébouhans;108;3211804;192099;71;2771512;37;440292;29739;31029
31032;Aussonne;3406;101291177;5919023;2396;89502594;1010;11788583;29739;31030
71105;Charnay-lès-Mâcon;4069;121013576;8662493;2763;106003839;1306;15009737;29740;31031
64072;Aubertin;335;9963161;550580;230;8702621;105;1260540;29741;31032
27488;Renneville;104;3093522;159879;70;2585130;34;508392;29745;31033
84037;Châteauneuf-du-Pape;1261;37509039;3834397;707;31527657;554;5981382;29745;31034
80676;Roiglise;100;2974551;383962;54;2576737;46;397814;29746;31035
27385;Manneville-sur-Risle;785;23352252;1394330;494;20311977;291;3040275;29748;31036
25117;Champoux;43;1279248;53414;30;1088641;13;190607;29750;31037
14454;Mouen;683;20319317;1191298;497;18169893;186;2149424;29750;31038
68300;Sausheim;2900;86280063;5110310;1914;73808837;986;12471226;29752;31039
14499;Petiville;252;7497499;302065;192;6644182;60;853317;29752;31040
44125;Piriac-sur-Mer;1424;42367227;2466081;892;35380425;532;6986802;29752;31041
32282;Montégut;257;7646929;470783;168;6661490;89;985439;29755;31042
51616;Vésigneul-sur-Marne;120;3570710;189843;93;3245213;27;325497;29756;31043
01446;Villeneuve;633;18835733;840421;452;16418475;181;2417258;29756;31044
14436;Monceaux-en-Bessin;258;7677401;307828;180;6727495;78;949906;29757;31045
38043;Bilieu;677;20146233;1023319;444;17198924;233;2947309;29758;31046
27657;Touville;73;2172386;101085;46;1846274;27;326112;29759;31047
77415;Saint-Jean-les-Deux-Jumeaux;606;18033780;1133488;435;16183782;171;1849998;29759;31048
74133;Gaillard;6342;188738224;4573656;2737;114904533;3605;73833691;29760;31049
69249;Thurins;1479;44018455;2269783;966;37943830;513;6074625;29762;31050
14620;Saint-Martin-aux-Chartrains;230;6845825;500855;157;6000582;73;845243;29764;31051
41050;Cheverny;497;14794193;865119;332;12738368;165;2055825;29767;31052
08201;Gruyères;38;1131169;34352;27;1007221;11;123948;29768;31053
44028;Le Cellier;1871;55696805;2838218;1244;48066648;627;7630157;29768;31054
21407;Messanges;107;3185236;123833;78;2812263;29;372973;29769;31055
06138;Théoule-sur-Mer;1049;31228947;3053727;653;27308350;396;3920597;29770;31056
34164;Montaud;445;13248299;763795;283;11297074;162;1951225;29771;31057
10125;Dierrey-Saint-Pierre;130;3870346;226600;87;3316976;43;553370;29772;31058
28254;Mittainvilliers;248;7383580;403018;173;6518194;75;865386;29773;31059
01398;Savigneux;602;17923565;982482;394;15552953;208;2370612;29773;31060
41246;Seur;234;6967074;380471;158;6144031;76;823043;29774;31061
14399;Manneville-la-Pipard;175;5210594;348273;113;4509058;62;701536;29775;31062
34125;Lagamas;58;1726980;162959;34;1482239;24;244741;29776;31063
34027;Beaulieu;815;24267270;1454379;509;20766773;306;3500497;29776;31064
28136;Écluzelles;98;2918072;195201;71;2621090;27;296982;29776;31065
45325;Tivernon;136;4049770;302126;82;3358729;54;691041;29778;31066
89453;Villefargeau;541;16110199;1138454;377;14338228;164;1771971;29779;31067
10352;Sainte-Maure;754;22454242;1250956;551;20006209;203;2448033;29780;31068
27335;Heudreville-sur-Eure;534;15903171;1116969;361;14097474;173;1805697;29781;31069
86297;Vouneuil-sous-Biard;2713;80806478;4755471;1905;71225201;808;9581277;29785;31070
51151;Chichey;87;2591289;173442;64;2345697;23;245592;29785;31071
78217;Épône;3482;103716509;6539132;2437;92411956;1045;11304553;29786;31072
90104;Vézelois;491;14625162;887614;356;13041664;135;1583498;29786;31073
41203;Saint-Bohaire;244;7268209;384832;185;6534379;59;733830;29788;31074
73284;Salins-les-Thermes;545;16234327;1251750;350;13909486;195;2324841;29788;31075
77223;Gurcy-le-Châtel;264;7864055;437788;186;6800540;78;1063515;29788;31076
01392;Samognat;325;9681174;454533;230;8482271;95;1198903;29788;31077
59110;Brouckerque;603;17962884;832011;403;15546374;200;2416510;29789;31078
27033;Bacquepuis;154;4587741;257619;109;4096152;45;491589;29791;31079
02659;Rouvroy;260;7745822;395799;179;6725839;81;1019983;29792;31080
64419;Nousty;710;21152891;1004439;480;18359502;230;2793389;29793;31081
07281;Saint-Péray;3897;116106245;7340882;2429;99217676;1468;16888569;29794;31082
62307;Escalles;146;4350131;386103;91;3774751;55;575380;29795;31083
37154;Montbazon;2042;60846532;3396224;1441;53759898;601;7086634;29798;31084
31105;Caragoudes;106;3158833;166114;59;2454036;47;704797;29800;31085
51337;Magneux;122;3635683;175283;80;3144999;42;490684;29801;31086
95388;Menucourt;2499;74474561;3725382;1911;67779043;588;6695518;29802;31087
25600;Vennes;80;2384148;171133;59;2189111;21;195037;29802;31088
95371;Marly-la-Ville;2843;84727535;4839201;2099;76373664;744;8353871;29802;31089
06104;Roquebrune-Cap-Martin;8173;243581948;21280375;5569;216410172;2604;27171776;29803;31090
90105;Villars-le-Sec;73;2175724;137987;51;1920893;22;254831;29804;31091
02477;Mercin-et-Vaux;498;14842696;865015;344;13095054;154;1747642;29805;31092
15267;Ytrac;2022;60266139;3383142;1356;52974114;666;7292025;29805;31093
10067;Buchères;774;23071784;1423142;549;20298467;225;2773317;29809;31094
62206;Campigneulles-les-Grandes;148;4411824;281032;89;3789040;59;622784;29810;31095
76499;Petiville;523;15591431;966656;357;13498198;166;2093233;29812;31096
34129;Lattes;9352;278797534;19457142;6289;242901614;3063;35895920;29812;31097
49029;Blaison-Gohier;557;16605750;1082253;337;14051876;220;2553874;29813;31098
61088;Champ-Haut;25;745387;88713;13;603307;12;142080;29815;31099
69221;Saint-Laurent-de-Vaux;113;3369278;123563;82;2944010;31;425268;29817;31100
29076;Guipronvel;365;10883103;480620;248;9251071;117;1632032;29817;31101
38192;Hurtières;90;2683643;147197;63;2388070;27;295573;29818;31102
77023;Barcy;128;3817053;221176;87;3336521;41;480532;29821;31103
38538;Le Versoud;2399;71540988;4140278;1737;63505586;662;8035402;29821;31104
27144;Champigny-la-Futelaye;127;3787399;239136;80;3254481;47;532918;29822;31105
54104;Buissoncourt;121;3608553;167123;88;3216750;33;391803;29823;31106
17371;Saint-Maurice-de-Tavernole;65;1938482;88434;35;1316928;30;621554;29823;31107
88132;Deyvillers;770;22965424;1105032;525;20261711;245;2703713;29825;31108
62706;Richebourg;1300;38774450;2130208;822;33368097;478;5406353;29827;31109
60215;Erquery;303;9037530;490091;193;8275543;110;761987;29827;31110
95637;Vauréal;7612;227055937;13434720;5180;200976603;2432;26079334;29829;31111
76573;Saint-Denis-le-Thiboult;244;7278324;385888;173;6494353;71;783971;29829;31112
51527;Savigny-sur-Ardres;134;3997187;291378;78;3404296;56;592891;29830;31113
67030;Bergbieten;335;9993048;445350;245;8805589;90;1187459;29830;31114
59308;Hondeghem;472;14079824;807270;295;12030246;177;2049578;29830;31115
01101;Chevillard;90;2684964;81737;66;2408646;24;276318;29833;31116
14383;Louvigny;1431;42692166;2524271;1032;38203727;399;4488439;29834;31117
78172;Conflans-Sainte-Honorine;19529;582653383;38534545;13487;522456775;6042;60196608;29835;31118
77349;Othis;3162;94340869;4875376;2417;85794306;745;8546563;29836;31119
95476;Osny;7984;238220419;15055383;5401;213123136;2583;25097283;29837;31120
38141;Culin;323;9637468;487024;226;8379361;97;1258107;29837;31121
57565;Rédange;394;11755965;141786;90;3980428;304;7775537;29837;31122
83118;Saint-Raphaël;23463;700099033;53683258;14348;598483687;9115;101615346;29838;31123
39323;Menotey;151;4505681;258341;109;3984030;42;521651;29839;31124
77361;Pierre-Levée;227;6773768;358478;163;6035691;64;738077;29840;31125
95197;Deuil-la-Barre;12629;376860842;26973714;8706;336071291;3923;40789551;29841;31126
60530;Rémérangles;114;3402284;209862;82;3057497;32;344787;29845;31127
27678;Les Ventes;537;16027893;940163;407;14484527;130;1543366;29847;31128
40051;Bougue;335;9999416;478595;233;8753368;102;1246048;29849;31129
54587;Vitrey;100;2984916;176712;64;2564607;36;420309;29849;31130
39345;Monnières;226;6745937;332437;162;5977690;64;768247;29849;31131
73240;Sainte-Hélène-du-Lac;355;10597412;464683;235;8738796;120;1858616;29852;31132
27411;Moisville;110;3283795;219581;70;2851840;40;431955;29853;31133
68214;Montreux-Jeune;163;4866153;223846;109;4274540;54;591613;29854;31134
68005;Ammerschwihr;1031;30779695;1927277;694;26761984;337;4017711;29854;31135
29268;Saint-Thonan;666;19885576;779846;457;17282229;209;2603347;29858;31136
51064;Bisseuil;346;10331055;681157;250;9271299;96;1059756;29859;31137
02076;Bertricourt;69;2060304;53100;54;1893791;15;166513;29859;31138
77130;Coulommes;207;6180918;339707;150;5483120;57;697798;29860;31139
69005;Ambérieux;266;7943059;386669;188;7083788;78;859271;29861;31140
69004;Alix;367;10960236;562016;231;9251316;136;1708920;29864;31141
08078;Bourg-Fidèle;421;12572942;1146003;182;9908934;239;2664008;29864;31142
56186;Quiberon;3424;102260074;5985762;2019;86247634;1405;16012440;29866;31143
74224;La Roche-sur-Foron;6020;179817369;6608881;3591;142320568;2429;37496801;29870;31144
06032;Cap-d'Ail;2825;84384765;8100922;1930;76128209;895;8256556;29871;31145
54121;Charmois;93;2778017;156760;74;2603631;19;174386;29871;31146
60284;Grandfresnoy;801;23927016;1340511;559;21100440;242;2826576;29871;31147
25201;Dommartin;333;9947572;539362;234;8571164;99;1376408;29873;31148
51268;Germinon;79;2359958;163873;49;2047205;30;312753;29873;31149
31424;Plaisance-du-Touch;8760;261689350;15054743;5986;231092667;2774;30596683;29873;31150
29037;Combrit;2150;64229070;4233331;1357;54668480;793;9560590;29874;31151
13044;Grans;2563;76568316;5062219;1677;67035449;886;9532867;29874;31152
56116;Locmariaquer;936;27963550;1750613;576;23656103;360;4307447;29876;31153
38496;Sonnay;644;19242962;1028900;380;15949176;264;3293786;29880;31154
28102;Clévilliers;331;9890957;475328;228;8649507;103;1241450;29882;31155
28217;Louvilliers-lès-Perche;80;2390601;152138;50;1981289;30;409312;29883;31156
42065;Civens;645;19274381;963072;455;16894457;190;2379924;29883;31157
34256;Saint-Geniès-des-Mourgues;977;29197952;1780765;615;25308357;362;3889595;29885;31158
71526;Solutré-Pouilly;216;6455530;401371;149;5772353;67;683177;29887;31159
28257;Mondonville-Saint-Jean;43;1285313;90151;27;1103281;16;182032;29891;31160
59473;Preux-au-Sart;150;4483938;279008;96;3872985;54;610953;29893;31161
67327;Niederlauterbach;505;15096723;962609;346;12977994;159;2118729;29895;31162
95119;Buhy;150;4484265;231317;110;3973275;40;510990;29895;31163
21558;Sainte-Marie-la-Blanche;406;12137568;556346;287;10515838;119;1621730;29895;31164
67389;Reichstett;2416;72228124;4282122;1691;62970046;725;9258078;29896;31165
27423;Muzy;424;12676012;800747;307;11332268;117;1343744;29896;31166
42279;Saint-Just-Saint-Rambert;7716;230686447;14416368;4797;197664979;2919;33021468;29897;31167
60508;Pontpoint;1672;49996224;3041192;1186;44233315;486;5762909;29902;31168
61142;Dame-Marie;84;2511794;137768;56;2204969;28;306825;29902;31169
57219;Flévy;288;8611892;567031;175;7022791;113;1589101;29902;31170
54495;Saulxures-lès-Nancy;2021;60432943;3452224;1429;53318303;592;7114640;29902;31171
63038;Besse-et-Saint-Anastaise;960;28708095;2508521;516;24133227;444;4574868;29904;31172
77505;Villemareuil;191;5711999;285916;142;5238826;49;473173;29906;31173
02280;Épieds;194;5801780;308845;129;5094954;65;706826;29906;31174
27472;Portes;128;3828037;197888;92;3519823;36;308214;29907;31175
60453;La Neuville-d'Aumont;150;4485985;295850;100;3895011;50;590974;29907;31176
62557;Maroeuil;1321;39506636;2452301;893;34709997;428;4796639;29907;31177
27382;Mandeville;149;4456171;217044;113;4038508;36;417663;29907;31178
39498;Salans;295;8822708;493801;203;7784655;92;1038053;29907;31179
79281;Saint-Maxire;603;18034415;1069186;418;15866464;185;2167951;29908;31180
68235;Niederhergheim;535;16001026;797567;380;13950707;155;2050319;29908;31181
14533;Repentigny;47;1405706;88072;29;1181611;18;224095;29909;31182
28415;Villemeux-sur-Eure;853;25513565;1422983;581;22324443;272;3189122;29910;31183
76421;Mélamare;387;11576200;571191;276;10290282;111;1285918;29913;31184
51356;Matignicourt-Goncourt;65;1944346;77152;50;1762491;15;181855;29913;31185
35197;Mouazé;524;15674984;653692;384;13837112;140;1837872;29914;31186
50002;Agneaux;2313;69191690;3976399;1494;59478532;819;9713158;29914;31187
62861;Vimy;2345;70152436;4901198;1455;59587243;890;10565193;29916;31188
02748;Trélou-sur-Marne;560;16753128;1443281;344;14504002;216;2249126;29916;31189
91273;Gironville-sur-Essonne;381;11398472;595872;263;9796958;118;1601514;29917;31190
28072;Champrond-en-Perchet;201;6013374;327695;155;5462051;46;551323;29917;31191
70248;Frahier-et-Chatebier;648;19386417;1129291;451;17104959;197;2281458;29917;31192
54592;Vroncourt;127;3799627;131691;88;3288692;39;510935;29918;31193
77366;Le Plessis-l'Évêque;137;4098811;276306;99;3741265;38;357546;29918;31194
81195;Navès;373;11160820;560255;247;9495493;126;1665327;29922;31195
52104;Chancenay;559;16727368;909542;397;14720915;162;2006453;29924;31196
59232;La Flamengrie;190;5685607;256125;129;4977087;61;708520;29924;31197
77500;Villebéon;224;6703447;360375;150;5887815;74;815632;29926;31198
38017;Assieu;618;18494643;997219;431;16280386;187;2214257;29927;31199
77340;Nonville;317;9487006;502378;228;8546900;89;940106;29927;31200
74014;Arâches-la-Frasse;1095;32771967;2069211;737;27959538;358;4812429;29929;31201
49337;Soucelles;1206;36095099;1720463;815;30808791;391;5286308;29930;31202
68029;Bergholtz;558;16700958;894503;423;14860732;135;1840226;29930;31203
50599;Tollevast;619;18526758;799743;458;16714500;161;1812258;29930;31204
30342;Vénéjan;652;19514637;1210761;437;17117082;215;2397555;29930;31205
69053;Chénas;251;7513130;377712;152;6403843;99;1109287;29933;31206
78165;Les Clayes-sous-Bois;9284;277896665;17622588;6666;248723762;2618;29172903;29933;31207
68297;Saint-Louis;10856;324951420;28238856;6599;280383219;4257;44568201;29933;31208
60095;Boury-en-Vexin;204;6106470;424091;148;5619681;56;486789;29934;31209
17414;Saint-Xandre;2252;67411291;3860739;1615;59328119;637;8083172;29934;31210
87048;Condat-sur-Vienne;2558;76573596;4329549;1790;67541105;768;9032491;29935;31211
56205;Saint-Armel;501;14997464;1055938;339;13205670;162;1791794;29935;31212
79162;Magné;1549;46372268;2696571;1101;41374379;448;4997889;29937;31213
36098;Lizeray;50;1496939;105760;31;1296338;19;200601;29939;31214
27654;Tourville-la-Campagne;466;13951579;676058;331;12123474;135;1828105;29939;31215
69213;Saint-Jean-de-Touslas;414;12394752;641587;303;10988602;111;1406150;29939;31216
57361;Kerling-lès-Sierck;249;7454864;239265;128;4888955;121;2565909;29939;31217
09252;Rouze;38;1137792;126230;18;912360;20;225432;29942;31218
71258;Leynes;249;7455601;544070;154;6369602;95;1085999;29942;31219
64119;Beuste;271;8114369;443418;187;7031948;84;1082421;29942;31220
27641;Le Tilleul-Lambert;97;2904473;131696;71;2597857;26;306616;29943;31221
59163;Croix;11566;346325340;27844825;6869;297261333;4697;49064007;29943;31222
27287;Glisolles;441;13205150;878578;311;11728641;130;1476509;29944;31223
90030;Croix;83;2485544;160715;55;2163602;28;321942;29946;31224
57021;Ancy-sur-Moselle;778;23299109;1423100;515;19879213;263;3419896;29947;31225
76194;Criquebeuf-en-Caux;188;5630263;334812;130;4943609;58;686654;29948;31226
01241;Meillonnas;664;19885627;1299443;465;17665363;199;2220264;29948;31227
67212;Holtzheim;1856;55588613;3402295;1325;48875415;531;6713198;29951;31228
55197;Fresnes-au-Mont;77;2306348;109656;55;2058935;22;247413;29953;31229
21175;Cirey-lès-Pontailler;73;2186675;88239;52;1902516;21;284159;29954;31230
77504;Villemaréchal;446;13359874;832121;314;11645043;132;1714831;29955;31231
69285;Pusignan;1858;55657810;3229606;1307;49293087;551;6364723;29956;31232
62199;Camblain-l'Abbé;325;9736432;617580;217;8484570;108;1251862;29958;31233
39341;Les Molunes;79;2366711;92083;45;2003655;34;363056;29958;31234
73151;Les Marches;1303;39036190;2406253;883;34118977;420;4917213;29959;31235
27464;Le Plessis-Grohan;414;12403373;598064;296;10997184;118;1406189;29960;31236
21659;Vaux-Saules;83;2486760;187798;46;2027483;37;459277;29961;31237
17207;Loix;434;13003074;940175;289;11218021;145;1785053;29961;31238
68234;Niederentzen;252;7550906;319526;187;6716335;65;834571;29964;31239
77020;Bannost-Villegagnon;319;9558541;500691;209;8011988;110;1546553;29964;31240
65107;Bourréac;45;1348389;62189;27;1136595;18;211794;29964;31241
91659;Villabé;2472;74074298;4232769;1847;67033671;625;7040627;29965;31242
27666;La Vacherie;266;7971235;499658;185;7191495;81;779740;29967;31243
10045;Beurey;100;2996817;243548;67;2705379;33;291438;29968;31244
67532;Willgottheim;537;16093275;650350;322;13414365;215;2678910;29969;31245
64184;Cescau;238;7132702;343047;164;6252174;74;880528;29969;31246
91097;Boussy-Saint-Antoine;3484;104421682;6825729;2559;93916299;925;10505383;29972;31247
51023;Aulnay-sur-Marne;127;3806421;249224;88;3412854;39;393567;29972;31248
71278;Marigny;84;2517686;154887;56;2236385;28;281301;29972;31249
77495;Vert-Saint-Denis;3591;107632233;6162089;2569;96380155;1022;11252078;29973;31250
67503;Uttwiller;88;2637613;119775;55;2203502;33;434111;29973;31251
91495;Plessis-Saint-Benoist;152;4556090;233168;105;3989566;47;566524;29974;31252
36236;Vicq-Exemplet;197;5905207;311038;88;4732740;109;1172467;29976;31253
68026;Bennwihr;662;19845826;1174108;433;16706206;229;3139620;29979;31254
70517;Vallerois-Lorioz;158;4737140;183611;105;3980302;53;756838;29982;31255
59468;Potelle;188;5636613;365536;122;4871451;66;765162;29982;31256
34240;Saint-Aunès;1659;49740385;3570014;1095;43775870;564;5964515;29982;31257
74160;Manigod;538;16132098;950169;339;13984218;199;2147880;29985;31258
28122;Dammarie;766;22969129;1211399;549;20323159;217;2645970;29986;31259
67441;Schalkendorf;146;4377938;194735;98;3782416;48;595522;29986;31260
59221;Famars;1220;36586046;2820521;736;31818580;484;4767466;29989;31261
77316;Moret-sur-Loing;2441;73203845;4713664;1655;64263336;786;8940509;29989;31262
76224;Écrainville;494;14815856;633770;333;12767086;161;2048770;29992;31263
77199;Fublaines;565;16945811;1095711;404;15291693;161;1654118;29993;31264
67285;Matzenheim;717;21506615;1164514;516;19171345;201;2335270;29995;31265
02411;Latilly;94;2819560;154596;61;2322426;33;497134;29995;31266
2A130;Grosseto-Prugna;1816;54472192;4509900;1120;47297997;696;7174195;29996;31267
14019;Arganchy;115;3449764;177522;82;2995229;33;454535;29998;31268
68360;Weckolsheim;279;8369624;438072;195;7159239;84;1210385;29999;31269
76699;Le Torp-Mesnil;179;5370316;186031;106;4493172;73;877144;30002;31270
25523;Sainte-Marie;384;11521305;623048;280;10240480;104;1280825;30003;31271
25119;Champvans-les-Moulins;162;4860811;233076;109;4162273;53;698538;30005;31272
57373;Lachambre;415;12452275;742127;290;10935863;125;1516412;30005;31273
49289;Saint-Jean-de-Linières;817;24514645;1124444;559;21691297;258;2823348;30006;31274
79298;Saint-Symphorien;934;28025986;1531558;664;24612659;270;3413327;30006;31275
76151;Cailleville;111;3330820;219492;58;2663104;53;667716;30007;31276
21632;Thorey-en-Plaine;464;13923800;553418;352;12275228;112;1648572;30008;31277
01044;Billiat;282;8462331;251321;177;6832410;105;1629921;30008;31278
25515;Sainte-Colombe;183;5491568;280414;137;5077536;46;414032;30009;31279
60317;Hondainville;334;10022879;702109;223;8823730;111;1199149;30009;31280
50066;Jullouville;1356;40692019;2596981;828;34120261;528;6571758;30009;31281
38566;Vourey;887;26620275;1698333;592;23386564;295;3233711;30012;31282
89347;Saint-Germain-des-Champs;234;7022753;828516;109;5744813;125;1277940;30012;31283
14185;Coudray-Rabut;183;5492212;281458;107;4748154;76;744058;30012;31284
94060;La Queue-en-Brie;5813;174460789;11589820;4048;156723761;1765;17737028;30012;31285
67366;Ottersthal;387;11616784;666634;274;10155773;113;1461011;30018;31286
76565;Saint-Aubin-sur-Scie;601;18041105;1117672;377;15540804;224;2500301;30018;31287
44171;Saint-Léger-les-Vignes;740;22213722;906739;519;19294759;221;2918963;30019;31288
51339;Mairy-sur-Marne;274;8225225;453234;200;7336735;74;888490;30019;31289
76729;Veauville-lès-Baons;350;10507015;549805;223;8964180;127;1542835;30020;31290
67235;Kesseldorf;232;6965449;513492;175;6356487;57;608962;30023;31291
81297;Terssac;574;17233667;1133984;400;15063418;174;2170249;30024;31292
76055;Baons-le-Comte;171;5134097;266511;111;4345858;60;788239;30024;31293
18267;Trouy;1890;56758362;2759853;1411;50355994;479;6402368;30031;31294
26285;Rousset-les-Vignes;172;5165413;316015;82;4282905;90;882508;30031;31295
54312;Lesménils;255;7658255;429872;167;6476508;88;1181747;30032;31296
60413;Montagny-Sainte-Félicité;231;6937560;442438;159;6171680;72;765880;30033;31297
33554;Yvrac;1521;45680494;3026098;1013;39963429;508;5717065;30033;31298
62892;Willerval;318;9550853;505142;201;8042812;117;1508041;30034;31299
60218;Esches;618;18561110;924964;418;15795123;200;2765987;30034;31300
51609;Verneuil;460;13815896;1113331;288;11963314;172;1852582;30035;31301
67205;Hoerdt;2309;69355080;4349483;1552;60360442;757;8994638;30037;31302
76226;Écretteville-sur-Mer;71;2132631;168441;50;1917503;21;215128;30037;31303
22186;Pléneuf-Val-André;2646;79488528;4807778;1562;67401049;1084;12087479;30041;31304
42010;Aveizieux;751;22561130;1243817;499;19670370;252;2890760;30041;31305
67315;Neewiller-près-Lauterbourg;353;10605206;717039;235;9099153;118;1506053;30043;31306
02644;Retheuil;183;5497901;486824;116;4728096;67;769805;30043;31307
29060;Gouesnach;1393;41850166;2395810;909;36008385;484;5841781;30043;31308
80171;Caours;313;9403846;580686;214;8242521;99;1161325;30044;31309
13034;Eygalières;1144;34370785;2357181;590;28616727;554;5754058;30044;31310
57039;Augny;969;29114790;1616169;683;25359026;286;3755764;30046;31311
10325;Rosières-près-Troyes;1516;45550476;2496160;1089;40279362;427;5271114;30046;31312
27171;Le Cormier;218;6550481;485239;140;5708725;78;841756;30048;31313
77354;Pamfou;442;13281702;621449;323;12056693;119;1225009;30049;31314
76238;Épouville;1368;41107747;2069701;971;36136080;397;4971667;30050;31315
74254;Saint-Sylvestre;324;9736353;435903;230;8584223;94;1152130;30050;31316
60619;Silly-le-Long;635;19082204;1143545;486;17459288;149;1622916;30051;31317
77420;Saint-Mard;1874;56317620;3179840;1388;50758829;486;5558791;30052;31318
97309;Remire-Montjoly;9910;297829850;14861349;4941;230666075;4969;67163775;30053;31319
28062;Broué;439;13193623;720715;325;11830313;114;1363310;30054;31320
27572;Saint-Meslin-du-Bosc;98;2945302;100459;71;2627872;27;317430;30054;31321
57049;Le Ban-Saint-Martin;2344;70450415;4643104;1456;59371513;888;11078902;30056;31322
51447;Prosnes;237;7123242;338698;164;6201422;73;921820;30056;31323
35173;Melesse;2805;84311632;4665882;1839;72451943;966;11859689;30058;31324
43061;Chaspinhac;368;11061606;645282;251;9427608;117;1633998;30059;31325
62452;Heuringhem;642;19298017;963820;443;16684296;199;2613721;30059;31326
35081;Clayes;299;8987725;440296;210;7829325;89;1158400;30059;31327
19151;Noailles;442;13286872;756955;288;11458537;154;1828335;30061;31328
02658;Roupy;123;3697480;247448;76;3132288;47;565192;30061;31329
67054;Bolsenheim;227;6824451;320960;163;5946313;64;878138;30064;31330
68377;Wittersdorf;441;13258811;784556;290;11543740;151;1715071;30065;31331
80467;Laucourt;105;3156904;432876;72;2715981;33;440923;30066;31332
90021;Charmois;150;4509878;259418;106;3968109;44;541769;30066;31333
54433;Port-sur-Seille;116;3487818;178828;79;3015039;37;472779;30067;31334
27201;Daubeuf-la-Campagne;115;3457847;222744;78;3095286;37;362561;30068;31335
27410;Miserey;277;8329073;441625;202;7471838;75;857235;30069;31336
52380;Peigney;194;5833878;262217;146;5115632;48;718246;30072;31337
27004;Aigleville;153;4601051;207151;107;4072667;46;528384;30072;31338
57509;Nitting;260;7819093;284027;163;6634920;97;1184173;30073;31339
31091;Bruguières;2612;78556839;4525021;1716;68680416;896;9876423;30075;31340
76712;La Trinité-du-Mont;344;10346200;442210;255;9268661;89;1077539;30076;31341
25560;Thise;1640;49325242;2743672;1166;43091459;474;6233783;30076;31342
90043;Faverois;281;8451541;463235;202;7527761;79;923780;30077;31343
54358;Mazerulles;127;3819747;181174;92;3303374;35;516373;30077;31344
60277;Goincourt;706;21234744;1333409;512;18917237;194;2317507;30078;31345
02259;Dampleux;197;5925788;365481;147;5309300;50;616488;30080;31346
67223;Innenheim;585;17596982;874172;410;15152233;175;2444749;30080;31347
35363;Pont-Péan;1791;53875558;2682682;1239;47498730;552;6376828;30081;31348
59213;Estourmel;218;6558032;308227;149;5737666;69;820366;30083;31349
21135;Champagne-sur-Vingeanne;158;4753431;291194;100;4076532;58;676899;30085;31350
69172;Salles-Arbuissonnas-en-Beaujolais;359;10800824;514089;241;9242584;118;1558240;30086;31351
63417;Sayat;1222;36767060;2294393;865;33029477;357;3737583;30088;31352
31294;Lespiteau;39;1173462;88924;25;1003740;14;169722;30089;31353
09013;Arabaux;40;1203560;94910;24;1083424;16;120136;30089;31354
25477;Rancenay;149;4483372;242624;107;3987854;42;495518;30090;31355
80650;Querrieu;335;10081202;578670;224;8879693;111;1201509;30093;31356
14325;Hermanville-sur-Mer;1535;46194250;2623279;1064;40603678;471;5590572;30094;31357
59180;Le Doulieu;629;18929930;870093;420;16330637;209;2599293;30095;31358
54212;Fresnois-la-Montagne;194;5838702;282034;84;3582143;110;2256559;30096;31359
25512;Le Russey;1218;36658210;2306237;824;32173263;394;4484947;30097;31360
10210;Luyères;218;6561217;388273;145;5604042;73;957175;30097;31361
17264;Nieul-sur-Mer;3162;95170389;5766259;2129;82309211;1033;12861178;30098;31362
21614;Spoy;135;4063369;200517;92;3525106;43;538263;30099;31363
27478;Prey;476;14328208;777134;350;12791357;126;1536851;30101;31364
77302;Montcourt-Fromonville;1046;31486575;1710139;765;28138340;281;3348235;30102;31365
77236;Jaulnes;188;5659289;447868;128;4959280;60;700009;30103;31366
67053;Boesenbiesen;147;4425110;170305;106;3931774;41;493336;30103;31367
78290;Guernes;545;16408489;920174;415;14881244;130;1527245;30107;31368
27336;La Heunière;147;4426009;314537;98;3871102;49;554907;30109;31369
49318;Saint-Saturnin-sur-Loire;633;19058970;917744;421;16439050;212;2619920;30109;31370
77233;Iverny;294;8852473;593977;216;7891995;78;960478;30110;31371
07059;Châteaubourg;118;3553277;283767;79;3152683;39;400594;30113;31372
67081;Dahlenheim;373;11232880;546020;246;9771109;127;1461771;30115;31373
90028;Courtelevant;197;5932717;313441;147;5224494;50;708223;30115;31374
33075;Bruges;8877;267336602;19451946;6130;237245693;2747;30090909;30116;31375
32117;Duran;417;12559167;664514;294;11037277;123;1521890;30118;31376
35099;Domloup;1326;39936521;1728763;948;35322249;378;4614272;30118;31377
41005;Arville;53;1596340;149124;35;1449239;18;147101;30120;31378
57372;Kuntzig;642;19337190;733068;351;13789178;291;5548012;30120;31379
76641;Saint-Pierre-le-Vieux;112;3373564;279692;67;2884375;45;489189;30121;31380
68134;Herrlisheim-près-Colmar;980;29519198;1749035;723;26469038;257;3050160;30122;31381
14630;Saint-Martin-des-Entrées;309;9307748;520637;195;7771004;114;1536744;30122;31382
38011;Anthon;479;14429282;774396;319;12499599;160;1929683;30124;31383
13001;Aix-en-Provence;80486;2424542211;210480101;49228;2119968417;31258;304573794;30124;31384
77336;Neufmoutiers-en-Brie;455;13707207;749113;342;12413690;113;1293517;30126;31385
50578;Sortosville;51;1536452;93004;33;1342218;18;194234;30127;31386
02729;Soucy;44;1325577;84125;27;1123066;17;202511;30127;31387
76716;Turretot;673;20276573;1138182;479;17954801;194;2321772;30129;31388
39294;Lézat;93;2802040;168420;62;2329081;31;472959;30129;31389
60243;Fontaine-Saint-Lucien;78;2350309;179946;54;2090179;24;260130;30132;31390
89295;Perrigny;699;21062785;1268034;500;18620506;199;2442279;30133;31391
90050;Frais;116;3495422;161654;85;3173827;31;321595;30133;31392
67168;Gresswiller;795;23957227;1222783;571;21197690;224;2759537;30135;31393
60154;Cinqueux;871;26247708;1833529;627;23602849;244;2644859;30135;31394
61118;Corbon;66;1989002;102835;45;1690006;21;298996;30136;31395
57731;Volmerange-les-Mines;986;29715486;343315;289;11735267;697;17980219;30137;31396
25142;Chaux-Neuve;135;4068740;220866;84;3484791;51;583949;30139;31397
69222;Saint-Laurent-d'Oingt;410;12357543;722584;239;10332183;171;2025360;30140;31398
03314;Villebret;646;19470892;1113784;468;17524847;178;1946045;30141;31399
76675;Sierville;465;14015497;592807;325;12304557;140;1710940;30141;31400
62874;Wanquetin;355;10700060;648641;217;9028927;138;1671133;30141;31401
62332;Ficheux;248;7475610;463411;186;6756376;62;719234;30144;31402
51324;Linthes;57;1718203;116552;41;1496549;16;221654;30144;31403
27595;Saint-Pierre-du-Bosguérard;474;14288301;639000;308;11940647;166;2347654;30144;31404
78437;Mousseaux-sur-Seine;347;10460419;647734;247;9468054;100;992365;30145;31405
21076;Binges;363;10942854;563679;256;9827975;107;1114879;30146;31406
29288;Trégarantec;260;7838494;258779;173;6547022;87;1291472;30148;31407
91191;Crosne;4811;145048314;9767663;3517;130810435;1294;14237879;30149;31408
68164;Kientzheim;414;12482158;756087;289;10833363;125;1648795;30150;31409
72260;Ruaudin;1634;49269804;2641275;1163;43775436;471;5494368;30153;31410
76116;Boos;1570;47340868;2401816;1147;42063284;423;5277584;30153;31411
09316;Troye-d'Ariège;56;1688721;158421;35;1427595;21;261126;30156;31412
38336;Reventin-Vaugris;857;25844548;1413325;570;22407455;287;3437093;30157;31413
68111;Gueberschwihr;462;13933669;941565;288;12212777;174;1720892;30159;31414
21088;Boncourt-le-Bois;124;3739976;153842;91;3330178;33;409798;30161;31415
27447;Orvaux;228;6876767;385945;152;5911747;76;965020;30161;31416
77323;Moussy-le-Vieux;542;16347796;1122911;433;15268965;109;1078831;30162;31417
56078;Guidel;5777;174258345;9517802;3898;152139121;1879;22119224;30164;31418
77464;Thorigny-sur-Marne;4980;150218556;10251923;3591;135196368;1389;15022188;30164;31419
31331;Maureville;137;4132700;298708;86;3497311;51;635389;30166;31420
78239;Follainville-Dennemont;928;27993835;1745746;664;25265929;264;2727906;30166;31421
27123;Caillouet-Orgeville;216;6515948;430746;132;5722406;84;793542;30166;31422
81150;Lugan;195;5882637;310757;128;5239117;67;643520;30167;31423
78503;Port-Villez;116;3499481;205376;86;3135998;30;363483;30168;31424
14163;Cléville;166;5007919;279023;107;4291114;59;716805;30168;31425
76296;Gainneville;1274;38434643;2032929;908;34049324;366;4385319;30168;31426
52062;Bourg;78;2353142;116002;53;1991824;25;361318;30168;31427
28293;Oulins;574;17317351;863766;406;14879039;168;2438312;30170;31428
69115;Limas;2282;68849496;4063926;1507;60095550;775;8753946;30171;31429
68062;Carspach;1082;32645945;2019732;722;28652107;360;3993838;30172;31430
21617;Talant;6483;195608314;14701382;4044;169590613;2439;26017701;30172;31431
35353;Vezin-le-Coquet;2294;69216184;4519353;1491;61394246;803;7821938;30173;31432
14592;Sainte-Honorine-du-Fay;639;19280375;923702;445;16884933;194;2395442;30173;31433
62383;Gouy-sous-Bellonne;621;18738967;1201927;431;16661787;190;2077180;30175;31434
57102;Bousse;1524;45989488;1734321;967;34713524;557;11275964;30177;31435
26284;Roussas;189;5703662;316119;117;4819833;72;883829;30178;31436
34131;Lauret;276;8331226;460988;176;7347889;100;983337;30186;31437
54515;Thélod;130;3924169;158442;92;3422713;38;501456;30186;31438
25103;Busy;281;8482264;431435;201;7389388;80;1092876;30186;31439
27102;Bouquetot;516;15577061;920979;363;13651007;153;1926054;30188;31440
28350;Saint-Luperce;458;13826196;770570;339;12361000;119;1465196;30188;31441
77440;Sammeron;537;16211390;1176096;370;14666583;167;1544807;30189;31442
31407;Paulhac;560;16906317;792736;397;14982302;163;1924015;30190;31443
77153;Dammartin-en-Goële;4394;132655760;8154768;3219;120136508;1175;12519252;30190;31444
38382;Saint-Égrève;8492;256383437;16495350;5868;227636507;2624;28746930;30191;31445
07340;Veyras;852;25723086;1472660;601;22819822;251;2903264;30191;31446
69026;Le Breuil;219;6612045;334575;153;5854200;66;757845;30192;31447
51202;Cumières;458;13828121;1225410;294;11945261;164;1882860;30192;31448
08483;Ville-sur-Lumes;237;7156099;414012;165;6233542;72;922557;30195;31449
54232;Gondreville;1370;41369321;1998952;984;36204635;386;5164686;30197;31450
65411;Sassis;42;1268261;80552;23;1006168;19;262093;30197;31451
25195;Dannemarie-sur-Crète;550;16608832;820695;387;14558473;163;2050359;30198;31452
73210;Puygros;197;5948993;236143;133;5160152;64;788841;30198;31453
68373;Winkel;184;5556423;356236;115;4774360;69;782063;30198;31454
38056;Bressieux;46;1389148;71532;31;1066656;15;322492;30199;31455
82087;Lafrançaise;1572;47472972;4674483;736;39268988;836;8203984;30199;31456
59211;Esquerchin;418;12623459;907849;250;10743865;168;1879594;30200;31457
39251;Gevingey;237;7157345;387303;158;6263006;79;894339;30200;31458
70020;Andelarrot;104;3140836;131724;82;2893376;22;247460;30200;31459
77063;La Celle-sur-Morin;670;20234935;1288556;474;18020924;196;2214011;30201;31460
67295;Mittelbergheim;342;10329197;578413;239;8985048;103;1344149;30202;31461
19117;Lissac-sur-Couze;379;11447496;416779;242;8967304;137;2480192;30204;31462
68368;Wihr-au-Val;646;19513443;1018050;454;16940817;192;2572626;30207;31463
28171;Garnay;480;14500066;961527;337;12917189;143;1582877;30208;31464
42290;Saint-Thomas-la-Garde;283;8549106;350002;211;7680218;72;868888;30209;31465
38146;Dizimieu;371;11207699;475711;275;10023107;96;1184592;30209;31466
57152;Contz-les-Bains;221;6676473;103083;68;2882707;153;3793766;30210;31467
45012;Audeville;86;2598289;165400;56;2250968;30;347321;30213;31468
77155;Dampmart;1679;50734523;3370263;1206;45572347;473;5162176;30217;31469
35194;Montreuil-sous-Pérouse;495;14958293;722831;349;12978607;146;1979686;30219;31470
72236;Pincé;98;2961476;130544;71;2619109;27;342367;30219;31471
04001;Aiglun;697;21064083;1125393;434;17969430;263;3094653;30221;31472
81310;Veilhes;62;1873777;123135;36;1569106;26;304671;30222;31473
10013;Assenay;71;2145979;208038;41;1795061;30;350918;30225;31474
68209;Mittelwihr;471;14236876;909078;331;12476733;140;1760143;30227;31475
30299;Saint-Siffret;520;15718770;950873;336;13575379;184;2143391;30228;31476
28299;Les Pinthières;83;2508986;127909;65;2299545;18;209441;30229;31477
42296;Salt-en-Donzy;262;7919998;404920;167;6801968;95;1118030;30229;31478
21247;Époisses;431;13029140;463326;200;9714224;231;3314916;30230;31479
27005;Ailly;546;16506336;980375;392;14884021;154;1622315;30231;31480
01195;Jasseron;811;24518258;1259783;544;21183398;267;3334860;30232;31481
57214;Fixem;199;6016209;64802;78;2906546;121;3109663;30232;31482
51099;Bussy-Lettrée;133;4020918;237492;84;3297306;49;723612;30232;31483
88087;Chantraine;1808;54661360;3729578;1235;48211071;573;6450289;30233;31484
56162;Ploemeur;10057;304055933;19167690;6509;261779587;3548;42276346;30233;31485
77486;Vaudoy-en-Brie;391;11821338;722736;264;10386210;127;1435128;30234;31486
31056;Beauzelle;2869;86747679;5464979;2004;76947318;865;9800361;30236;31487
90029;Cravanche;1002;30298433;2045515;673;26273567;329;4024866;30238;31488
33009;Arcachon;8354;252622737;23153575;4863;213698065;3491;38924672;30240;31489
76604;Saint-Mards;111;3356652;270810;75;3027458;36;329194;30240;31490
62281;Echinghen;196;5928495;437029;108;5069974;88;858521;30247;31491
67266;Limersheim;352;10647460;589140;246;9327148;106;1320312;30248;31492
89226;Lignorelles;111;3357581;217508;74;2924623;37;432958;30248;31493
69147;Les Olmes;393;11887895;607484;268;10242806;125;1645089;30249;31494
26179;Mercurol;1055;31913854;1964540;669;27136273;386;4777581;30250;31495
25563;Thurey-le-Mont;59;1784771;109468;41;1526228;18;258543;30250;31496
30075;Caveirac;2104;63648679;3931053;1416;56142720;688;7505959;30251;31497
21217;Curley;66;1996743;120422;45;1723755;21;272988;30254;31498
69027;Brignais;5910;178827979;11435564;3941;156557032;1969;22270947;30259;31499
28035;Berchères-les-Pierres;504;15250517;1018023;367;13687349;137;1563168;30259;31500
42222;Saint-Galmier;2951;89300232;6013432;1862;76319360;1089;12980872;30261;31501
02452;Maissemy;122;3691975;211228;79;3197220;43;494755;30262;31502
70117;Châlonvillars;643;19458709;1107186;453;17156762;190;2301947;30262;31503
76172;La Chapelle-sur-Dun;105;3177575;302027;60;2748664;45;428911;30263;31504
25115;Champagney;139;4206640;294588;99;3773608;40;433032;30264;31505
89326;Rosoy;539;16312986;1029944;375;14460122;164;1852864;30265;31506
78297;Guyancourt;14197;429697027;29495369;10127;386524871;4070;43172156;30267;31507
63032;Beaumont;6340;191892633;13580814;4335;169129034;2005;22763599;30267;31508
78545;Saint-Cyr-l'École;9118;275977381;18771232;6601;248196554;2517;27780827;30267;31509
77407;Saint-Fargeau-Ponthierry;7078;214244707;15084883;5017;190377371;2061;23867336;30269;31510
60528;Reilly;76;2300755;163257;52;2042240;24;258515;30273;31511
51516;Saint-Saturnin;37;1120185;106621;24;988561;13;131624;30275;31512
45044;Bougy-lez-Neuville;103;3118605;183138;72;2789921;31;328684;30278;31513
50003;Agon-Coutainville;1867;56535579;4176287;1068;47303407;799;9232172;30282;31514
38554;Villemoirieu;843;25528972;1265761;579;22167872;264;3361100;30283;31515
76412;Martainville-Épreville;343;10387734;603345;248;9201932;95;1185802;30285;31516
59403;Millonfosse;327;9903658;732566;217;8570922;110;1332736;30286;31517
27694;Villez-sous-Bailleul;165;4997936;289123;120;4513883;45;484053;30291;31518
59352;Linselles;4165;126160694;7030948;2565;107544214;1600;18616480;30291;31519
10398;Vaucogne;37;1120823;66347;22;908985;15;211838;30293;31520
76718;Valliquerville;642;19447818;1099350;440;16714001;202;2733817;30293;31521
95429;Montreuil-sur-Epte;196;5937351;339338;128;4964425;68;972926;30293;31522
68038;Bischwihr;468;14177755;726358;345;12711793;123;1465962;30294;31523
42223;Saint-Genest-Lerpt;3125;94674507;6500523;2007;81065678;1118;13608829;30296;31524
80423;Havernas;195;5908020;248305;149;5336874;46;571146;30298;31525
68173;Labaroche;1217;36872386;2334234;839;32326556;378;4545830;30298;31526
77532;Vulaines-lès-Provins;42;1272528;118510;28;1119717;14;152811;30298;31527
27337;Heuqueville;185;5605513;392886;119;4715934;66;889579;30300;31528
10374;Spoy;85;2575524;243724;51;2180672;34;394852;30300;31529
68383;Zellenberg;207;6272393;324056;142;5490879;65;781514;30301;31530
14266;Feuguerolles-Bully;663;20089845;1158391;483;18061436;180;2028409;30301;31531
45286;Saint-Jean-le-Blanc;4604;139508254;9802250;3135;124283351;1469;15224903;30302;31532
28377;Sorel-Moussel;926;28059946;1682872;631;24630674;295;3429272;30302;31533
19114;Lignareix;82;2484862;127594;61;2154636;21;330226;30303;31534
67338;Obenheim;700;21214079;1067616;443;17990786;257;3223293;30306;31535
68291;Rumersheim-le-Haut;540;16365480;876324;390;14270009;150;2095471;30306;31536
21513;Quemigny-Poisot;101;3060973;198215;64;2561756;37;499217;30307;31537
67113;Eberbach-Seltz;211;6395881;386784;147;5591290;64;804591;30312;31538
31058;Belbèze-de-Lauragais;53;1606592;95105;37;1427319;16;179273;30313;31539
31055;Beauville;76;2303857;169636;50;2003147;26;300710;30314;31540
27426;Neaufles-Saint-Martin;650;19704651;1328694;443;17062131;207;2642520;30315;31541
28180;Gilles;265;8033589;494067;178;7061836;87;971753;30315;31542
70162;Colombe-lès-Vesoul;251;7609197;437477;183;6792677;68;816520;30316;31543
77026;Beauchery-Saint-Martin;196;5942128;366801;124;5116775;72;825353;30317;31544
60089;Boubiers;218;6609226;331212;159;5872005;59;737221;30318;31545
68023;Beblenheim;551;16705490;1274654;353;14458193;198;2247297;30318;31546
76408;Manneville-la-Goupil;465;14098896;713445;309;12121499;156;1977397;30320;31547
49015;Avrillé;6881;208637693;12665403;4559;181172958;2322;27464735;30321;31548
74138;Gruffy;776;23530426;1103581;522;20270202;254;3260224;30323;31549
51585;Troissy;465;14100602;1310992;285;12137997;180;1962605;30324;31550
57499;Neufgrange;779;23623430;1412070;503;19987446;276;3635984;30325;31551
78202;Drocourt;276;8370078;603565;189;7446467;87;923611;30326;31552
53200;Saint-Baudelle;504;15286328;624949;369;13423837;135;1862491;30330;31553
17010;Angoulins;2095;63543727;4351127;1341;54775691;754;8768036;30331;31554
73138;Jarrier;294;8917656;639557;188;7677152;106;1240504;30332;31555
67469;Singrist;180;5459874;308084;119;4752404;61;707470;30333;31556
51025;Auménancourt;445;13498496;592562;315;11881393;130;1617103;30334;31557
38166;La Flachère;228;6916272;370673;166;6166193;62;750079;30335;31558
38513;Treffort;112;3397745;208620;75;2852639;37;545106;30337;31559
71443;Saint-Loup-Géanges;735;22299309;1268828;498;19265113;237;3034196;30339;31560
27503;Le Sacq;149;4520695;277536;103;3969372;46;551323;30340;31561
10236;Mesnil-Lettre;31;940630;55260;16;748495;15;192135;30343;31562
54345;Manoncourt-en-Vermois;146;4430427;187915;105;3887571;41;542856;30345;31563
68250;Orschwihr;570;17298726;1160267;415;15525380;155;1773346;30349;31564
08230;Houldizy;181;5493152;283858;128;4775180;53;717972;30349;31565
27273;Gadencourt;196;5948483;353933;139;5307988;57;640495;30349;31566
69278;Genay;2684;81457965;5135697;1825;71082814;859;10375151;30349;31567
18129;Lissay-Lochy;106;3217372;223023;70;2727142;36;490230;30353;31568
21523;Reulle-Vergy;57;1730145;120377;38;1510838;19;219307;30353;31569
25096;Brey-et-Maison-du-Bois;55;1669447;111505;36;1380984;19;288463;30354;31570
64132;Bizanos;2697;81863818;5402089;1719;70947991;978;10915827;30354;31571
33535;Tresses;2160;65565905;3567177;1524;57961488;636;7604417;30355;31572
76701;Touffreville-la-Cable;184;5585246;271903;142;5175627;42;409619;30355;31573
62867;Wacquinghen;117;3552133;187531;73;3066558;44;485575;30360;31574
38480;Septème;952;28902829;1633458;638;25294422;314;3608407;30360;31575
71487;Saint-Vérand;105;3187956;305750;65;2772712;40;415244;30361;31576
25139;La Chaux;214;6498437;332349;146;5725155;68;773282;30367;31577
38532;Vénérieu;316;9596649;529013;229;8480293;87;1116356;30369;31578
02582;Paissy;46;1397047;76620;22;996055;24;400992;30371;31579
31216;Gémil;130;3948299;192092;92;3527018;38;421281;30372;31580
51113;Champaubert;75;2277989;192146;49;2005056;26;272933;30373;31581
51106;Cernon;71;2156751;129784;54;1955996;17;200755;30377;31582
02329;Fourdrain;218;6622237;465059;145;5746065;73;876172;30377;31583
77070;Chailly-en-Brie;709;21538716;1344418;500;19269031;209;2269685;30379;31584
61100;La Chapelle-Viel;140;4253552;279442;98;3861936;42;391616;30383;31585
62324;Farbus;301;9145343;633158;189;7807914;112;1337429;30383;31586
08022;Arreux;177;5377960;224610;126;4827789;51;550171;30384;31587
27480;Puchay;288;8750631;482310;177;7456082;111;1294549;30384;31588
74282;Thorens-Glières;1596;48493903;2132297;1035;40068039;561;8425864;30385;31589
16078;Champniers;2836;86174414;5801698;1922;75863523;914;10310891;30386;31590
38205;Lans-en-Vercors;1385;42086012;2413989;978;37529813;407;4556199;30387;31591
60290;Guignecourt;205;6229450;403701;149;5710950;56;518500;30388;31592
79308;Sciecq;322;9784824;556222;222;8598665;100;1186159;30388;31593
91115;Bruyères-le-Châtel;1976;60047043;3879286;1536;55221288;440;4825755;30388;31594
77479;Vaires-sur-Marne;6866;208648386;14668425;4843;186791993;2023;21856393;30389;31595
47215;Pujols;1989;60443283;3663273;1153;51070082;836;9373201;30389;31596
45335;Vienne-en-Val;919;27927364;1557009;665;24576451;254;3350913;30389;31597
44136;Préfailles;792;24068190;1716460;500;20626580;292;3441610;30389;31598
35263;Saint-Coulomb;1356;41208349;2646962;861;34976283;495;6232066;30390;31599
08137;Damouzy;226;6868334;421859;167;6235485;59;632849;30391;31600
26339;Savasse;723;21973119;1456227;478;19273792;245;2699327;30392;31601
28343;Saint-Laurent-la-Gâtine;249;7568267;477902;185;6766627;64;801640;30395;31602
01374;Saint-Martin-du-Mont;870;26443352;1338113;610;23253872;260;3189480;30395;31603
74038;Bogève;565;17174888;569048;333;13197091;232;3977797;30398;31604
76693;Le Tilleul;333;10122592;466065;229;8749438;104;1373154;30398;31605
28243;Mérouville;117;3556589;202744;74;3079176;43;477413;30398;31606
59109;Brillon;350;10639801;546386;203;8943832;147;1695969;30399;31607
27638;Le Thuit-Signol;1063;32316697;1600989;761;28566282;302;3750415;30401;31608
86076;Cissé;1270;38610361;2079942;940;34399439;330;4210922;30402;31609
69207;Saint-Germain-au-Mont-d'Or;1480;44995366;2655433;1006;39090161;474;5905205;30402;31610
68272;Riedwihr;203;6172422;440266;138;5334724;65;837698;30406;31611
68052;Bretten;86;2615008;147611;61;2267264;25;347744;30407;31612
67308;Munchhausen;387;11768780;621860;259;10031888;128;1736892;30410;31613
74289;Vallières;771;23448158;1147431;550;20123077;221;3325081;30413;31614
27331;Heubécourt-Haricourt;226;6873651;368534;166;5972279;60;901372;30414;31615
33449;Saint-Médard-en-Jalles;15024;456957159;26477164;10606;405459166;4418;51497993;30415;31616
68284;Roppentzwiller;375;11406099;854310;244;10138976;131;1267123;30416;31617
94038;L'Haÿ-les-Roses;16926;514828844;41208997;11226;458640442;5700;56188402;30416;31618
51581;Treslon;101;3072080;155853;76;2724145;25;347935;30417;31619
89011;Annéot;63;1916310;74209;50;1709903;13;206407;30418;31620
38339;Roche;944;28714364;1464480;655;25157535;289;3556829;30418;31621
10402;La Vendue-Mignot;130;3954531;229154;82;3381177;48;573354;30419;31622
59162;Crochte;317;9643163;440215;220;8346977;97;1296186;30420;31623
46197;Le Montat;509;15484438;933879;357;13655362;152;1829076;30421;31624
59105;Bouvignies;766;23303634;1412723;471;19912547;295;3391087;30422;31625
27243;Fiquefleur-Équainville;347;10557091;698568;209;8817851;138;1739240;30424;31626
44018;Bouaye;3029;92158512;4375014;2087;79830711;942;12327801;30425;31627
07172;Peaugres;990;30121521;1742506;683;26625481;307;3496040;30426;31628
64282;Jatxou;525;15974222;818723;369;14145630;156;1828592;30427;31629
14603;Saint-Laurent-de-Condel;234;7120599;441038;153;6164962;81;955637;30430;31630
73053;Bourgneuf;300;9129069;187443;185;7598743;115;1530326;30430;31631
69179;Saint-Andéol-le-Château;824;25074663;1470512;596;22245392;228;2829271;30430;31632
72344;Spay;1415;43066523;2421433;1036;38339401;379;4727122;30436;31633
77416;Saint-Just-en-Brie;122;3713812;215632;88;3346713;34;367099;30441;31634
67124;Entzheim;1070;32574184;1946590;736;28789619;334;3784565;30443;31635
25390;Montbenoît;204;6210427;430217;144;5679044;60;531383;30443;31636
76673;Servaville-Salmonville;467;14218792;552187;346;12714857;121;1503935;30447;31637
14609;Saint-Loup-Hors;186;5663681;344399;122;4974583;64;689098;30450;31638
95395;Le Mesnil-Aubry;459;13977482;847226;340;12712092;119;1265390;30452;31639
27017;Angerville-la-Campagne;551;16779414;878040;402;14946152;149;1833262;30453;31640
59247;Forest-sur-Marque;703;21409824;1101631;495;18957163;208;2452661;30455;31641
73312;Verrens-Arvey;431;13126854;920136;301;11507608;130;1619246;30457;31642
72001;Aigné;735;22385963;1042523;532;19959551;203;2426412;30457;31643
44078;Juigné-des-Moutiers;195;5939146;211517;88;4842393;107;1096753;30457;31644
83123;Sanary-sur-Mer;11429;348099830;27314347;6968;299837361;4461;48262469;30458;31645
77378;Pringy;1408;42884569;2646197;1075;39401553;333;3483016;30458;31646
01156;Faramans;361;10995741;589775;261;9884747;100;1110994;30459;31647
57695;Varize;258;7859009;644816;156;6621161;102;1237848;30461;31648
26081;Châteaudouble;289;8803493;448815;177;7461614;112;1341879;30462;31649
76622;Saint-Maurice-d'Ételan;148;4508645;252955;100;3846543;48;662102;30464;31650
77411;Saint-Germain-sous-Doue;229;6976833;343463;155;5992401;74;984432;30467;31651
77483;Varreddes;1002;30527763;2027591;704;26856925;298;3670838;30467;31652
69114;Liergues;913;27816405;1550725;641;24412694;272;3403711;30467;31653
69057;Chevinay;268;8165167;444818;193;7179692;75;985475;30467;31654
91248;La Forêt-Sainte-Croix;77;2346251;116386;53;2052822;24;293429;30471;31655
07240;Saint-Georges-les-Bains;1064;32421820;1971548;711;28073734;353;4348086;30472;31656
95370;Marines;1781;54270008;3803824;1226;48592107;555;5677901;30472;31657
69294;Sérézin-du-Rhône;1367;41658782;2669250;994;37279857;373;4378925;30475;31658
02572;Orainville;237;7222553;357361;177;6465646;60;756907;30475;31659
54131;Clémery;233;7100687;366692;156;6164215;77;936472;30475;31660
14713;Trois-Monts;187;5699052;273786;125;4838969;62;860083;30476;31661
27142;Champenard;104;3169629;165915;77;2852214;27;317415;30477;31662
38271;Murianette;430;13105211;710438;306;11765089;124;1340122;30477;31663
67346;Oberlauterbach;280;8533886;567306;191;7594790;89;939096;30478;31664
41205;Saint-Cyr-du-Gault;111;3383094;322686;67;2904296;44;478798;30478;31665
35352;Vern-sur-Seiche;3989;121579662;6414704;2774;107191037;1215;14388625;30479;31666
38407;Saint-Julien-de-Raz;234;7132058;451822;160;6209895;74;922163;30479;31667
32405;Sainte-Radegonde;98;2986946;91523;55;2535958;43;450988;30479;31668
68064;Chalampé;510;15545803;947847;383;13835522;127;1710281;30482;31669
25510;Ruffey-le-Château;172;5243091;270977;121;4471147;51;771944;30483;31670
65410;Sarrouilles;284;8657231;458165;187;7476945;97;1180286;30483;31671
27528;Le Vaudreuil;2039;62156510;4025719;1361;54601077;678;7555433;30484;31672
68278;Rixheim;7359;224334150;15595307;5043;197489866;2316;26844284;30484;31673
14145;Cauvicourt;232;7072593;289030;148;6005062;84;1067531;30485;31674
28239;Marville-Moutiers-Brûlé;456;13902291;817535;332;12590614;124;1311677;30487;31675
59323;Jenlain;564;17195809;1118481;377;15092143;187;2103666;30489;31676
02656;Roucy;199;6067580;426125;125;5192370;74;875210;30490;31677
69288;Saint-Laurent-de-Mure;2766;84339120;4740156;2026;74960328;740;9378792;30491;31678
67378;Plobsheim;2081;63452566;3418567;1508;56276896;573;7175670;30491;31679
60441;Moyvillers;304;9269666;523899;219;8201073;85;1068593;30492;31680
60690;Villers-sur-Trie;163;4970310;256699;118;4405920;45;564390;30493;31681
14535;Reviers;298;9086913;597314;210;8100979;88;985934;30493;31682
59044;Baisieux;2239;68278311;3841976;1531;60013890;708;8264421;30495;31683
27692;Villettes;87;2653156;174292;63;2417426;24;235730;30496;31684
28267;Montreuil;269;8204005;619368;190;7430904;79;773101;30498;31685
11327;Roullens;262;7992183;326861;148;6827754;114;1164429;30505;31686
77142;Crécy-la-Chapelle;2437;74355503;4910378;1722;65923834;715;8431669;30511;31687
61498;Vaunoise;60;1830763;274681;32;1572041;28;258722;30513;31688
38367;Saint-Bernard;300;9154115;460571;198;7863799;102;1290316;30514;31689
21273;Fleurey-sur-Ouche;655;19987188;1214496;472;17891234;183;2095954;30515;31690
68251;Osenbach;461;14067770;773850;336;12291682;125;1776088;30516;31691
49322;Saint-Sulpice;108;3295966;275743;65;2716246;43;579720;30518;31692
10219;Maisons-lès-Soulaines;38;1159731;71344;23;988740;15;170991;30519;31693
10136;Éguilly-sous-Bois;63;1922816;131048;46;1711942;17;210874;30521;31694
62714;Roclincourt;406;12391532;671644;274;10780074;132;1611458;30521;31695
39275;Lamoura;314;9584110;560931;231;8551001;83;1033109;30523;31696
51194;Courville;211;6441121;334345;141;5648048;70;793073;30527;31697
76439;Mirville;153;4671540;246749;104;3798360;49;873180;30533;31698
67231;Kauffenheim;118;3602890;247914;90;3269563;28;333327;30533;31699
71585;Virey-le-Grand;642;19603220;1137794;466;17556361;176;2046859;30535;31700
64181;Castillon (Canton d'Arthez-de-Béarn);132;4030592;153297;74;3414749;58;615843;30535;31701
21406;Mesmont;117;3572657;273809;83;3153135;34;419522;30536;31702
14344;Janville;210;6412544;426963;145;5657467;65;755077;30536;31703
41069;Cour-sur-Loire;160;4885795;358637;114;4451022;46;434773;30536;31704
77095;Charny;627;19147311;1077809;473;17346826;154;1800485;30538;31705
27676;Venables;396;12094614;701829;297;10887328;99;1207286;30542;31706
51245;Faverolles-et-Coëmy;284;8674031;543000;198;7791300;86;882731;30542;31707
62611;Neuville-Vitasse;265;8094187;591116;168;7061432;97;1032755;30544;31708
14738;Verson;1889;57699510;3714574;1286;50737872;603;6961638;30545;31709
69176;Soucieu-en-Jarrest;1992;60846002;3178370;1446;54097104;546;6748898;30545;31710
51656;Vraux;222;6781814;354537;148;5743560;74;1038254;30549;31711
51491;Saint-Jean-sur-Tourbe;56;1710754;108798;37;1473053;19;237701;30549;31712
64065;Ascain;2345;71638105;3989236;1458;59922450;887;11715655;30549;31713
59469;Pradelles;147;4491063;210104;105;3893184;42;597879;30551;31714
60151;Choisy-au-Bac;1810;55300146;3725815;1253;49478244;557;5821902;30553;31715
28001;Abondant;1125;34371701;1891916;738;29404778;387;4966923;30553;31716
68099;Froeningen;386;11793916;703703;285;10675969;101;1117947;30554;31717
21651;Val-Suzon;115;3513854;220466;77;3069803;38;444051;30555;31718
67501;Uttenheim;280;8555941;445368;196;7525279;84;1030662;30557;31719
38536;Vernioz;589;18000501;864480;413;15459043;176;2541458;30561;31720
57441;Manom;1417;43307597;1988305;803;31663400;614;11644197;30563;31721
77335;Chauconin-Neufmontiers;1003;30654856;1838864;742;28235341;261;2419515;30563;31722
71117;Châtenoy-en-Bresse;501;15312168;898760;348;13584831;153;1727337;30563;31723
44131;Pornic;8657;264593802;16893296;5302;225014421;3355;39579381;30564;31724
59158;Coutiches;1394;42609319;2184522;932;37130183;462;5479136;30566;31725
65206;Goudon;129;3943346;294291;79;3422462;50;520884;30569;31726
01298;Plagne;66;2017645;81784;44;1696942;22;320703;30570;31727
51238;Étoges;212;6481803;488304;130;5577360;82;904443;30575;31728
70579;Vyans-le-Val;236;7215672;429338;165;6300691;71;914981;30575;31729
21190;Corcelles-les-Arts;236;7215677;451257;165;6429879;71;785798;30575;31730
01257;Montanges;176;5381539;327470;116;4490455;60;891084;30577;31731
71034;Bissey-sous-Cruchaud;187;5717938;494653;119;4890135;68;827803;30577;31732
28178;Germainville;142;4342041;221474;107;3951487;35;390554;30578;31733
01325;Rignieux-le-Franc;458;14005693;677039;332;12433620;126;1572073;30580;31734
10371;Sommeval;163;4984575;299506;106;4311282;57;673293;30580;31735
21256;Étevaux;131;4006099;225722;98;3603260;33;402839;30581;31736
27624;Surville;433;13241803;620508;317;11847427;116;1394376;30582;31737
22187;Plérin;7696;235360964;15156284;4920;205094818;2776;30266146;30582;31738
68031;Bernwiller;327;10001626;479667;221;8609186;106;1392440;30586;31739
51183;Courcy;503;15385123;963054;359;13740928;144;1644195;30587;31740
54178;Épiez-sur-Chiers;84;2569325;114135;50;2025956;34;543369;30587;31741
95134;Champagne-sur-Oise;2447;74847864;5036508;1725;67117977;722;7729887;30588;31742
21423;Montagny-lès-Beaune;354;10828366;644511;263;9700388;91;1127978;30589;31743
59579;Steene;638;19515800;980818;408;16791020;230;2724780;30589;31744
69198;Saint-Étienne-la-Varenne;336;10278048;548827;217;8779163;119;1498885;30589;31745
35080;Cintré;925;28297033;1187143;681;25484397;244;2812636;30591;31746
77193;Forfry;121;3701747;262546;82;3308705;39;393042;30593;31747
01009;Andert-et-Condon;177;5414990;326738;110;4667614;67;747376;30593;31748
62144;Boiry-Becquerelle;198;6057626;351160;136;5269309;62;788317;30594;31749
68088;Feldkirch;495;15144065;825928;365;13549049;130;1595016;30594;31750
59636;Wambrechies;5048;154444747;10200210;3312;135135733;1736;19309014;30595;31751
51149;Chepy;215;6578028;422365;158;5781288;57;796740;30595;31752
76477;Notre-Dame-du-Bec;215;6578182;356036;150;5756461;65;821721;30596;31753
49020;Beaucouzé;2298;70311094;3711027;1642;62675915;656;7635179;30597;31754
80735;Seux;86;2631313;181909;59;2252267;27;379046;30597;31755
76103;Bonsecours;3803;116359553;8455359;2542;102126041;1261;14233512;30597;31756
03040;Bressolles;545;16675294;863528;397;14917593;148;1757701;30597;31757
90090;Saint-Dizier-l'Évêque;220;6731694;449333;165;6195675;55;536019;30599;31758
74232;Saint-Eustache;220;6731770;304620;154;5888241;66;843529;30599;31759
34282;Saint-Paul-et-Valmalle;562;17196773;984902;350;14874960;212;2321813;30599;31760
25157;La Cluse-et-Mijoux;659;20165335;1339653;453;17714840;206;2450495;30600;31761
38455;Saint-Savin;1912;58510709;2952359;1294;51025773;618;7484936;30602;31762
34295;Saussan;737;22556379;1423750;493;19970268;244;2586111;30606;31763
25357;Maisons-du-Bois-Lièvremont;308;9427095;394975;191;8099689;117;1327406;30607;31764
56005;Arzon;1548;47381784;3778542;965;41020382;583;6361402;30608;31765
60402;Le Meux;1088;33302249;1990303;765;29913735;323;3388514;30609;31766
77212;Gravon;80;2448757;139534;62;2213976;18;234781;30609;31767
01344;Saint-Denis-lès-Bourg;2905;88920653;4915324;2061;79087583;844;9833070;30610;31768
78208;Élancourt;13639;417537640;27320532;9894;377227662;3745;40309978;30614;31769
70330;Mandrevillars;111;3398488;210192;81;3075466;30;323022;30617;31770
91001;Abbéville-la-Rivière;147;4500839;274675;109;4106886;38;393953;30618;31771
74255;Sales;876;26822821;1258259;637;23556755;239;3266066;30620;31772
54048;Les Baroches;167;5113810;288047;98;4195483;69;918327;30622;31773
62586;Montenescourt;227;6951816;434132;162;6235665;65;716151;30625;31774
39193;Le Deschaux;493;15098264;522365;277;12665281;216;2432983;30625;31775
73193;Ontex;50;1531320;104652;35;1344584;15;186736;30626;31776
57282;Hagen;176;5390418;-21751;34;1485835;142;3904583;30627;31777
14604;Saint-Laurent-du-Mont;93;2848539;166358;65;2518797;28;329742;30629;31778
28055;Le Boullay-Thierry;286;8760100;525184;215;7975710;71;784390;30630;31779
60523;Rainvillers;473;14487860;805868;353;13014075;120;1473785;30630;31780
74026;La Balme-de-Sillingy;2560;78412464;3744681;1768;66969591;792;11442873;30630;31781
77138;Courtomer;286;8760456;605268;209;7946219;77;814237;30631;31782
77184;Flagy;310;9495890;437921;230;8435483;80;1060407;30632;31783
68018;Balschwiller;401;12284254;791377;267;10710522;134;1573732;30634;31784
62636;Offrethun;137;4196899;181283;91;3615078;46;581821;30634;31785
54575;Villers-la-Montagne;755;23131835;762406;386;15197248;369;7934587;30638;31786
38488;Siccieu-Saint-Julien-et-Carisieu;307;9406230;594829;216;8394093;91;1012137;30639;31787
34217;Prades-le-Lez;2434;74579220;4405534;1592;65044536;842;9534684;30641;31788
72123;Dureil;33;1011190;55228;19;870482;14;140708;30642;31789
78410;Moisson;493;15106794;1051886;350;13542544;143;1564250;30643;31790
67152;Geispolsheim;3667;112367447;7466384;2401;97440819;1266;14926628;30643;31791
62239;Coquelles;1179;36128098;2592156;750;31175655;429;4952443;30643;31792
27089;Bosc-Renoult-en-Roumois;212;6496392;353046;151;5784396;61;711996;30643;31793
80107;Blangy-Tronville;271;8304399;444664;196;7490078;75;814321;30644;31794
50516;Saint-Martin-des-Champs;1201;36806993;2263492;819;32381284;382;4425709;30647;31795
26124;Étoile-sur-Rhône;2613;80085148;4850841;1629;69057144;984;11028004;30649;31796
27012;Amfreville-les-Champs;201;6160485;330022;125;5238803;76;921682;30649;31797
10015;Aubeterre;140;4290907;276450;102;3807130;38;483777;30649;31798
10085;Charmoy;39;1195340;90532;27;1050688;12;144652;30650;31799
60620;Silly-Tillard;242;7417330;447151;163;6479000;79;938330;30650;31800
10150;Fontaine;152;4658835;332957;105;4070341;47;588494;30650;31801
76131;La Bouille;445;13639419;1148195;316;12314072;129;1325347;30650;31802
38279;Notre-Dame-de-Mésage;594;18206414;923040;440;16168719;154;2037695;30651;31803
29140;Loperhet;1776;54435806;2886763;1186;47341612;590;7094194;30651;31804
27060;Berthenonville;142;4352780;308657;95;3898603;47;454177;30653;31805
39126;La Chaumusse;199;6100057;316147;139;5331774;60;768283;30654;31806
34124;Lacoste;162;4966223;594372;80;4104636;82;861587;30656;31807
45289;Saint-Lyé-la-Forêt;531;16280000;810715;394;14448139;137;1831861;30659;31808
59434;Nivelle;634;19438762;1219919;401;16800205;233;2638557;30661;31809
76556;Saint-Antoine-la-Forêt;484;14839804;727750;371;13374530;113;1465274;30661;31810
21497;Pont-et-Massène;109;3342098;200392;85;3053559;24;288539;30661;31811
73214;Rochefort;98;3005631;231635;62;2540241;36;465390;30670;31812
2B255;Quercitello;31;950821;180326;13;822491;18;128330;30672;31813
22324;Saint-Quay-Perros;745;22850407;1364995;504;19882994;241;2967413;30672;31814
37236;Saint-Règle;244;7483987;329731;175;6643847;69;840140;30672;31815
06035;Castellar;535;16409714;1025248;344;14205439;191;2204275;30672;31816
61318;Origny-le-Butin;52;1595008;134906;32;1352699;20;242309;30673;31817
38400;Saint-Jean-de-Moirans;1628;49939853;2828681;1082;43478085;546;6461768;30676;31818
67248;Krautergersheim;860;26381511;1435777;648;23771014;212;2610497;30676;31819
37172;Notre-Dame-d'Oé;1943;59604912;3282129;1420;52820867;523;6784045;30677;31820
78082;Boissy-Mauvoisin;311;9541261;669879;225;8605685;86;935576;30679;31821
67492;Traenheim;351;10769154;627399;242;9447255;109;1321899;30681;31822
76595;Saint-Jouin-Bruneval;899;27583726;1513324;635;24304758;264;3278968;30683;31823
77363;Le Pin;731;22429942;1542973;565;20732106;166;1697836;30684;31824
26121;Espeluche;531;16293870;1016544;363;14118209;168;2175661;30685;31825
76350;Hautot-sur-Seine;205;6290812;410919;146;5628324;59;662488;30687;31826
63226;Mezel;922;28293427;1470765;651;25107171;271;3186256;30687;31827
01369;Saint-Just;467;14331026;842423;325;12849657;142;1481369;30687;31828
60246;Fosseuse;357;10955548;542894;254;9498232;103;1457316;30688;31829
28297;Pézy;105;3222250;236348;73;2861483;32;360767;30688;31830
25486;Remoray-Boujeons;195;5984312;346472;125;5242401;70;741911;30689;31831
72130;Fay;286;8777673;421380;214;7851651;72;926022;30691;31832
60700;Warluis;609;18693980;1394517;416;16667476;193;2026504;30696;31833
59551;Saméon;747;22930863;1249504;469;19693926;278;3236937;30697;31834
38101;Cheyssieu;498;15287817;939793;350;13652258;148;1635559;30698;31835
51158;Val-des-Marais;292;8964109;634817;202;7895755;90;1068354;30699;31836
91112;Brouy;69;2118245;127184;46;1855504;23;262741;30699;31837
60488;Passel;144;4420780;374156;95;3853987;49;566793;30700;31838
25432;Orchamps-Vennes;1042;31989306;1861993;704;28193085;338;3796221;30700;31839
21535;Ruffey-lès-Echirey;646;19834579;1100665;481;17940981;165;1893598;30704;31840
68216;Mooslargue;219;6724869;410986;153;5921019;66;803850;30707;31841
67411;Rosheim;2653;81471093;5063720;1801;70690497;852;10780596;30709;31842
51136;Châtillon-sur-Marne;369;11331644;903844;226;9752059;143;1579585;30709;31843
41163;Nourray;61;1873423;98530;42;1538308;19;335115;30712;31844
31563;Vacquiers;642;19717523;1034197;423;17181862;219;2535661;30713;31845
35059;La Chapelle-des-Fougeretz;2234;68612701;3957607;1545;60794520;689;7818181;30713;31846
60197;Dieudonné;413;12684743;727635;318;11668252;95;1016491;30714;31847
76516;Quièvrecourt;244;7494177;412637;165;6372620;79;1121557;30714;31848
10190;Laubressel;240;7371356;372952;178;6556550;62;814806;30714;31849
95387;Menouville;46;1412845;69070;33;1214577;13;198268;30714;31850
68338;Turckheim;2174;66773231;4916248;1445;57620792;729;9152439;30714;31851
56167;Plougoumelen;1200;36858814;1979639;816;32436249;384;4422565;30716;31852
67510;Wahlenheim;196;6020411;297209;142;5259632;54;760779;30716;31853
80602;Occoches;60;1843009;212536;36;1593332;24;249677;30717;31854
41212;Saint-Gervais-la-Forêt;1750;53756869;3450248;1214;46860701;536;6896168;30718;31855
27465;Le Plessis-Hébert;208;6389406;477126;138;5524371;70;865035;30718;31856
80617;Parvillers-le-Quesnoy;112;3440481;228149;62;2895954;50;544527;30719;31857
28188;Le Gué-de-Longroi;425;13055484;565040;320;11733552;105;1321932;30719;31858
37018;Ballan-Miré;4224;129769614;7921886;2920;113861646;1304;15907968;30722;31859
21110;Brochon;363;11152155;703473;261;10017859;102;1134296;30722;31860
51572;Tilloy-et-Bellay;108;3318012;199743;71;2726887;37;591125;30722;31861
14491;Parfouru-sur-Odon;98;3010810;233632;63;2681580;35;329230;30723;31862
41031;Cellettes;1299;39909673;2356831;911;35057665;388;4852008;30723;31863
62698;Recques-sur-Course;136;4178419;187777;84;3450265;52;728154;30724;31864
03286;Toulon-sur-Allier;608;18681699;944307;426;16572365;182;2109334;30726;31865
62145;Boiry-Notre-Dame;231;7097849;292419;150;6125636;81;972213;30727;31866
91507;Prunay-sur-Essonne;169;5192952;384779;119;4598760;50;594192;30728;31867
67035;Berstheim;221;6791808;346005;167;6092555;54;699253;30732;31868
69245;Ternand;358;11003319;607950;234;9204873;124;1798446;30736;31869
67225;Issenhausen;54;1659894;102052;32;1431376;22;228518;30739;31870
51458;Reuves;35;1075885;92299;24;952289;11;123596;30740;31871
29132;Locquénolé;440;13525566;865379;300;12027382;140;1498184;30740;31872
21086;Bligny-lès-Beaune;647;19890598;1219370;439;17563503;208;2327095;30743;31873
54180;Erbéviller-sur-Amezule;37;1137493;64488;26;1007963;11;129530;30743;31874
74029;Bassy;221;6794221;201712;132;5440228;89;1353993;30743;31875
28141;Ermenonville-la-Grande;149;4581215;253036;110;4092270;39;488945;30746;31876
73164;Montcel;453;13929369;908049;297;11998167;156;1931202;30749;31877
13091;Saint-Cannat;2945;90563955;6033989;1860;78492956;1085;12070999;30752;31878
25212;École-Valentin;1180;36287884;2144310;845;32029315;335;4258569;30752;31879
95509;Puiseux-en-France;1694;52094643;3145928;1289;47483681;405;4610962;30752;31880
47110;Gontaud-de-Nogaret;926;28478799;2741587;473;23685244;453;4793555;30755;31881
44159;Saint-Fiacre-sur-Maine;565;17376831;792521;374;15028807;191;2348024;30755;31882
21189;Corberon;201;6182063;309573;128;5262294;73;919769;30757;31883
51197;La Croix-en-Champagne;39;1199566;60143;28;1015814;11;183752;30758;31884
14203;Cricqueville-en-Auge;95;2922058;281548;62;2560491;33;361567;30759;31885
31526;La Salvetat-Saint-Gilles;3757;115565713;6354287;2702;103433371;1055;12132342;30760;31886
91201;Draveil;15309;470925550;33950883;10655;421661974;4654;49263576;30761;31887
27658;Le Tremblay-Omonville;169;5201847;332394;120;4551587;49;650260;30780;31888
07316;Soyons;1080;33245535;1935563;758;29683529;322;3562006;30783;31889
67214;Hurtigheim;318;9789365;603988;242;8682032;76;1107333;30784;31890
77015;Baby;50;1539226;95777;34;1323752;16;215474;30785;31891
60316;Hodenc-l'Évêque;113;3478653;193691;85;3105348;28;373305;30785;31892
81255;Saint-Jean-de-Rives;192;5911005;326487;121;4923612;71;987393;30786;31893
59587;Terdeghem;285;8774213;623300;166;7485679;119;1288534;30787;31894
10354;Saint-Nabord-sur-Aube;73;2247571;247304;44;1907862;29;339709;30789;31895
41055;Chouzy-sur-Cisse;1053;32420647;2170657;731;28884506;322;3536141;30789;31896
14557;Saint-Arnoult;747;23000419;1829583;476;19908090;271;3092329;30790;31897
51627;Villeneuve-Renneville-Chevigny;160;4926496;385159;111;4370339;49;556157;30791;31898
67403;Ringendorf;209;6435490;365811;139;5738520;70;696970;30792;31899
12254;Salles-la-Source;1137;35014260;2413763;756;30613345;381;4400915;30795;31900
17420;Salles-sur-Mer;1081;33290865;1993880;779;29751256;302;3539609;30796;31901
67161;Gottenhouse;204;6282572;368939;150;5632387;54;650185;30797;31902
14723;Valsemé;144;4435139;414402;90;3776909;54;658230;30800;31903
42069;Commelle-Vernay;1398;43059469;2248263;1037;38232270;361;4827199;30801;31904
54012;Amance;163;5020884;284043;114;4513354;49;507530;30803;31905
90007;Banvillars;137;4220301;182995;95;3609132;42;611169;30805;31906
27579;Saint-Ouen-de-Pontcheuil;47;1447894;93696;32;1288201;15;159693;30806;31907
25238;Fessevillers;88;2711133;218677;63;2497572;25;213561;30808;31908
73269;Saint-Paul;318;9797889;688976;220;8541486;98;1256403;30811;31909
21596;Savouges;169;5207571;256337;126;4660337;43;547234;30814;31910
61015;Aunou-sur-Orne;138;4252615;390916;85;3685423;53;567192;30816;31911
95110;Brignancourt;117;3605561;263531;88;3358574;29;246987;30817;31912
52514;Verbiesles;161;4961655;240122;122;4422432;39;539223;30818;31913
67512;La Walck;567;17473826;1751066;355;15048303;212;2425523;30818;31914
11272;Palaja;1045;32206017;1882680;707;28357488;338;3848529;30819;31915
64037;Arbus;550;16951632;919006;372;14762610;178;2189022;30821;31916
37267;Véretz;2028;62508331;3083547;1463;55328352;565;7179979;30823;31917
59446;Oisy;288;8877133;489060;200;7831538;88;1045595;30823;31918
62520;Locon;1155;35605327;2084996;777;31171948;378;4433379;30827;31919
51651;Voipreux;115;3545478;231438;80;3135403;35;410075;30830;31920
77471;Tousson;190;5857978;350699;135;5127270;55;730708;30831;31921
77084;Changis-sur-Marne;573;17666586;1187652;423;15880900;150;1785686;30832;31922
18226;Saint-Michel-de-Volangis;231;7122625;424659;172;6411142;59;711483;30834;31923
62527;Longvilliers;132;4070153;495994;69;3267406;63;802747;30834;31924
89236;Maillot;550;16959661;1036868;381;14988943;169;1970718;30836;31925
64511;Sauvagnon;1443;44500393;2312214;978;38799157;465;5701236;30839;31926
71265;La Loyère;193;5951925;303678;142;5236544;51;715381;30839;31927
83103;Le Revest-les-Eaux;1936;59705018;3838261;1319;52941433;617;6763585;30839;31928
25459;La Planée;127;3916641;226015;89;3446342;38;470299;30840;31929
28383;Theuville;218;6723564;503391;151;5796158;67;927406;30842;31930
67336;Nordhouse;852;26278961;1571176;629;23735977;223;2542984;30844;31931
72336;Solesmes;769;23718929;1281250;449;20469931;320;3248998;30844;31932
18205;Saint-Doulchard;5033;155250189;10178298;3351;137122736;1682;18127453;30846;31933
67031;Bernardswiller;725;22365053;1353219;512;19706846;213;2658207;30848;31934
42088;Épercieux-Saint-Paul;335;10334413;316018;170;8405108;165;1929305;30849;31935
45154;Gidy;813;25080727;1297363;633;22928604;180;2152123;30850;31936
84101;La Roque-sur-Pernes;239;7373560;580825;135;6151431;104;1222129;30852;31937
06064;Gattières;2320;71578982;4998576;1503;62231883;817;9347099;30853;31938
73135;Hermillon;276;8515697;417023;208;7723395;68;792302;30854;31939
91132;Chamarande;600;18513492;1279959;442;16829059;158;1684433;30856;31940
88229;Harchéchamp;55;1697278;75138;35;1505435;20;191843;30860;31941
68081;Saint-Bernard;259;7993013;355851;179;6972724;80;1020289;30861;31942
95523;La Roche-Guyon;238;7345431;551716;154;6548445;84;796986;30863;31943
67539;Wingersheim;563;17376225;942859;405;15365306;158;2010919;30864;31944
60309;Hénonville;441;13611442;738786;312;12281946;129;1329496;30865;31945
74055;Challonges;274;8457695;230301;178;6793633;96;1664062;30868;31946
73015;Les Allues;1082;33399043;3166918;723;28950348;359;4448695;30868;31947
73029;Barberaz;2635;81338499;5551498;1877;71865374;758;9473125;30869;31948
31566;Vallègue;237;7316192;485590;156;6385825;81;930367;30870;31949
78591;Septeuil;1216;37538724;2634801;823;33680031;393;3858693;30871;31950
62695;Rebreuviette;140;4322036;428873;67;3527351;73;794685;30872;31951
73263;Saint-Offenge-Dessous;344;10619878;476706;249;9596334;95;1023544;30872;31952
39373;Les Moussières;107;3303754;108246;60;2813061;47;490693;30876;31953
31004;Ayguesvives;1149;35476950;1701802;810;31246642;339;4230308;30876;31954
60469;Novillers;169;5218206;291887;116;4541410;53;676796;30877;31955
62089;Bazinghen;189;5835871;261674;124;5010765;65;825106;30878;31956
02446;Ly-Fontaine;55;1698416;84780;39;1538528;16;159888;30880;31957
68305;Seppois-le-Bas;549;16953581;1081772;346;14359145;203;2594436;30881;31958
91121;Buno-Bonnevaux;253;7813331;444627;176;6947888;77;865443;30883;31959
27484;Quessigny;56;1729504;105555;39;1529924;17;199580;30884;31960
18158;Moulins-sur-Yèvre;372;11489293;675535;272;10056084;100;1433209;30885;31961
31516;Saint-Sauveur;882;27244086;1929077;592;23770060;290;3474026;30889;31962
31230;Gratentour;1745;53901581;3181126;1243;47989206;502;5912375;30889;31963
76239;Épretot;333;10286826;517357;242;9184352;91;1102474;30891;31964
76713;Triquerville;176;5436886;265540;120;4663838;56;773048;30891;31965
67100;Donnenheim;132;4077844;223448;89;3632739;43;445105;30893;31966
91649;Vert-le-Petit;1380;42632614;2392438;1057;38566136;323;4066478;30893;31967
01136;Cruzilles-lès-Mépillat;398;12295757;589321;268;10564844;130;1730913;30894;31968
71257;Lessard-le-National;292;9021890;551758;218;8149006;74;872884;30897;31969
74278;Thyez;3153;97417992;5837657;2220;84554599;933;12863393;30897;31970
04201;Saumane;68;2101022;219125;35;1711067;33;389955;30897;31971
27282;Gauville-la-Campagne;280;8651294;525722;197;7630921;83;1020373;30897;31972
62606;Neuve-Chapelle;618;19094798;927695;451;16813691;167;2281107;30898;31973
76105;Le Bocasse;346;10691327;615526;239;9322213;107;1369114;30900;31974
25448;Pelousey;650;20085014;989564;451;17622905;199;2462109;30900;31975
01450;Villieu-Loyes-Mollon;1579;48794075;2946591;1116;43240500;463;5553575;30902;31976
14670;Secqueville-en-Bessin;191;5902724;293191;129;5264654;62;638070;30904;31977
60152;Choisy-la-Victoire;112;3461331;148423;82;3163983;30;297348;30905;31978
77273;Marchémoret;245;7571753;408016;184;6783516;61;788237;30905;31979
73075;La Chapelle-Blanche;278;8591652;508625;197;7664621;81;927031;30905;31980
21656;Varanges;351;10847995;489053;253;9556404;98;1291591;30906;31981
27339;Hondouville;397;12269727;670200;299;11055585;98;1214142;30906;31982
28070;Champhol;1738;53724351;2766520;1249;47900652;489;5823699;30912;31983
59563;Semousies;125;3863971;353334;66;3149750;59;714221;30912;31984
80078;Bellancourt;253;7822074;424582;175;6854459;78;967615;30917;31985
77534;Yèbles;337;10420642;668007;263;9540417;74;880225;30922;31986
57716;Vigy;752;23254691;1090038;511;19988097;241;3266594;30924;31987
60650;Trumilly;250;7731070;424959;181;7052033;69;679037;30924;31988
02051;Barzy-sur-Marne;221;6834457;586115;144;6028497;77;805960;30925;31989
95641;Vémars;1177;36399275;2485930;881;33215100;296;3184175;30925;31990
51655;Vouzy;143;4422590;204850;93;3819921;50;602669;30927;31991
41057;Conan;101;3123834;144906;63;2689371;38;434463;30929;31992
08294;La Moncelle;74;2288773;143555;39;1887545;35;401228;30929;31993
26071;Chanos-Curson;544;16826142;1084679;352;14490695;192;2335447;30930;31994
19053;Chaveroche;105;3247960;217683;61;2631439;44;616521;30933;31995
31270;Landorthe;503;15559407;839654;338;13289839;165;2269568;30933;31996
01083;Chaneins;389;12034022;530696;258;10391015;131;1643007;30936;31997
28197;Intréville;75;2320392;210589;54;2085597;21;234795;30939;31998
67540;Wintershouse;397;12282958;634742;287;10779034;110;1503924;30939;31999
57059;Bellange;30;928243;89092;15;781831;15;146412;30941;32000
21411;Meursanges;275;8509180;711247;185;7636827;90;872353;30942;32001
88439;Sanchey;425;13150725;722165;305;11570671;120;1580054;30943;32002
63273;Pérignat-sur-Allier;760;23518889;1484830;532;20803259;228;2715630;30946;32003
44069;Guérande;8713;269643660;16096195;5495;232119380;3218;37524280;30947;32004
67158;Gingsheim;155;4796853;249367;100;4052246;55;744607;30947;32005
14102;Le Breuil-en-Auge;560;17332226;889299;353;14905172;207;2427054;30950;32006
60406;Monceaux;394;12194710;796548;282;10979282;112;1215428;30951;32007
68310;Sigolsheim;635;19654427;1120150;456;17428653;179;2225774;30952;32008
18250;Serruelles;35;1083315;84809;24;987534;11;95781;30952;32009
94033;Fontenay-sous-Bois;29371;909160847;77822773;19076;809576158;10295;99584689;30954;32010
38512;Tramolé;261;8079714;403621;181;6948043;80;1131671;30957;32011
27097;Bouafles;353;10928612;572345;268;9950235;85;978377;30959;32012
67359;Ohlungen;657;20340226;1237187;467;17858850;190;2481376;30959;32013
47100;Foulayronnes;2720;84210745;5963920;1835;74516732;885;9694013;30960;32014
77202;La Genevraye;336;10403033;898134;225;9156244;111;1246789;30961;32015
54394;Murville;120;3715818;190310;58;2469373;62;1246445;30965;32016
27114;Breuilpont;609;18858169;1154807;415;16504611;194;2353558;30966;32017
50611;Urville-Nacqueville;1122;34744224;1928626;793;30987892;329;3756332;30966;32018
26360;Valaurie;328;10157251;885952;190;8751021;138;1406230;30967;32019
79249;Saint-Gelais;918;28428772;1551078;681;25514224;237;2914548;30968;32020
50034;Baudre;271;8392482;437811;193;7482202;78;910280;30969;32021
69215;Saint-Julien;408;12635369;752821;287;11122381;121;1512988;30969;32022
90091;Saint-Germain-le-Châtelet;304;9414795;477230;212;8244971;92;1169824;30970;32023
25170;Courcelles-lès-Montbéliard;576;17838710;1114860;400;15483278;176;2355432;30970;32024
79355;Vouillé;1657;51317414;3215229;1159;45187246;498;6130168;30970;32025
59643;Warneton;102;3159037;179392;63;2684923;39;474114;30971;32026
49326;Sarrigné;347;10747622;413306;268;9568312;79;1179310;30973;32027
38484;Serpaize;742;22983444;1233706;539;20329159;203;2654285;30975;32028
10206;Longsols;70;2168448;231963;42;1879320;28;289128;30978;32029
59303;Herlies;1063;32929491;1946672;703;29095818;360;3833673;30978;32030
21368;Magny-lès-Villers;129;3996356;211429;87;3409195;42;587161;30980;32031
67402;Ringeldorf;50;1549109;97310;32;1317977;18;231132;30982;32032
50052;Beuzeville-la-Bastille;90;2788494;437860;46;2375357;44;413137;30983;32033
28406;Viabon;191;5918097;519397;116;4939564;75;978533;30985;32034
95060;Bessancourt;3591;111266967;7776180;2509;100359690;1082;10907277;30985;32035
76370;Hugleville-en-Caux;191;5918547;487149;133;5230012;58;688535;30987;32036
27691;Villers-sur-le-Roule;354;10970337;590451;265;9889763;89;1080574;30990;32037
78242;Fontenay-le-Fleury;7179;222489427;15957299;5292;202591366;1887;19898061;30992;32038
10284;Périgny-la-Rose;65;2014468;154699;40;1782601;25;231867;30992;32039
51556;Soudron;161;4990317;358610;119;4429674;42;560643;30996;32040
62371;Givenchy-en-Gohelle;1024;31740686;2468680;642;27576493;382;4164193;30997;32041
25571;Trévillers;246;7625330;549337;178;6825747;68;799583;30997;32042
49130;Écuillé;256;7935601;321764;177;6900539;79;1035062;30998;32043
46105;Flaujac-Poujols;390;12089722;790017;268;10519110;122;1570612;30999;32044
60259;Fresnoy-en-Thelle;443;13732741;714313;340;12581653;103;1151088;30999;32045
91434;Morsang-sur-Orge;11226;348006694;24617332;7850;311652129;3376;36354565;31000;32046
73097;Curienne;310;9610812;453838;223;8474154;87;1136658;31003;32047
37015;Azay-sur-Cher;1533;47529583;2767538;1093;42322936;440;5206647;31004;32048
52364;Orcevaux;62;1922295;135602;40;1661593;22;260702;31005;32049
45235;Ormes;1617;50135399;2365512;1200;44444676;417;5690723;31005;32050
68364;Westhalten;495;15347746;870907;376;13912520;119;1435226;31006;32051
25188;Dambenois;364;11286703;468508;280;10097038;84;1189665;31007;32052
34338;Villeneuvette;40;1240318;153250;19;1102811;21;137507;31008;32053
27449;Panilleuse;233;7225049;428160;174;6442997;59;782052;31009;32054
26326;Saint-Restitut;773;23971044;1586015;527;21559084;246;2411960;31010;32055
60009;Allonne;820;25429080;1678997;590;22879634;230;2549446;31011;32056
72198;La Milesse;1138;35290861;1842868;799;31150115;339;4140746;31011;32057
77010;Aubepierre-Ozouer-le-Repos;476;14761558;1060165;332;13092403;144;1669155;31012;32058
19063;Cosnac;1502;46580725;2762785;1054;41071310;448;5509415;31012;32059
60668;Verderel-lès-Sauqueuse;388;12033290;678536;293;10976201;95;1057089;31014;32060
59354;Loffre;372;11537395;606806;257;9945117;115;1592278;31015;32061
41140;Millançay;419;12996078;1416530;234;10510425;185;2485653;31017;32062
31488;Saint-Jean;5559;172426632;10485723;3850;152726294;1709;19700338;31018;32063
14135;Carcagny;142;4404612;234450;89;3638154;53;766458;31018;32064
77121;Collégien;1648;51120300;3090787;1201;46612199;447;4508101;31020;32065
68006;Ammerzwiller;206;6390245;315484;144;5477643;62;912602;31021;32066
95394;Méry-sur-Oise;4651;144279572;8575258;3316;129396062;1335;14883510;31021;32067
67239;Kintzheim;839;26027812;1382681;560;22374382;279;3653430;31022;32068
64335;Lescar;5038;156294929;9394493;3258;135614376;1780;20680553;31023;32069
42265;Saint-Michel-sur-Rhône;404;12533636;717727;280;10991516;124;1542120;31024;32070
91432;Morangis;6540;202913505;14191120;4758;183786846;1782;19126659;31027;32071
74183;Mieussy;1169;36271390;1664420;801;29973140;368;6298250;31028;32072
51357;Matougues;324;10054429;497972;238;8922989;86;1131440;31032;32073
73304;Val-d'Isère;1059;32863599;2826705;758;29434213;301;3429386;31033;32074
73184;Nances;226;7013478;409438;168;6357890;58;655588;31033;32075
95150;Chaussy;339;10520336;852837;219;9023649;120;1496687;31033;32076
28208;Levainville;195;6052060;278855;154;5604334;41;447726;31036;32077
02198;Clamecy;117;3631257;360740;73;3134043;44;497214;31036;32078
62435;Herlincourt;54;1676140;150127;32;1365422;22;310718;31040;32079
74312;Vougy;727;22567208;905486;477;18938314;250;3628894;31042;32080
67367;Otterswiller;688;21357072;1327962;478;18446507;210;2910565;31042;32081
27057;Bernienville;149;4625462;389515;107;4074278;42;551184;31043;32082
27576;Sainte-Opportune-du-Bosc;281;8724051;360920;196;7749473;85;974578;31046;32083
69111;Légny;312;9686628;600790;207;8443226;105;1243402;31047;32084
38426;Saint-Maximin;358;11116686;720816;240;9553278;118;1563408;31052;32085
78003;Ablis;1533;47604917;2968734;1065;41881963;468;5722954;31053;32086
28117;Crécy-Couvé;142;4409914;218193;98;3764468;44;645446;31056;32087
60613;Senots;161;5000469;300834;107;4367917;54;632552;31059;32088
37138;Lussault-sur-Loire;401;12454682;885667;296;11221687;105;1232995;31059;32089
02242;Crouttes-sur-Marne;343;10653358;948053;209;8644052;134;2009306;31059;32090
32379;Saint-Germier;94;2919750;186675;58;2465207;36;454543;31061;32091
61187;Les Genettes;106;3292535;132156;66;2922912;40;369623;31062;32092
51329;Loivre;568;17643312;893786;425;15871368;143;1771944;31062;32093
77403;Saint-Brice;366;11368950;765273;264;10144111;102;1224839;31063;32094
74142;Héry-sur-Alby;409;12705576;601007;276;10982101;133;1723475;31065;32095
27313;La Harengère;267;8294724;588831;198;7526428;69;768296;31066;32096
59166;Curgies;595;18484617;1209766;384;16400096;211;2084521;31067;32097
68077;Eglingen;167;5188671;243136;111;4409641;56;779030;31070;32098
91339;Linas;3323;103246365;7592785;2369;94858503;954;8387862;31070;32099
16224;Montchaude;288;8948478;615908;152;7568472;136;1380006;31071;32100
35069;Châteaugiron;3298;102475925;4973014;2263;89949979;1035;12525946;31072;32101
57412;Longeville-lès-Metz;2283;70957100;5726769;1422;60668042;861;10289058;31081;32102
27384;Manneville-la-Raoult;261;8112349;453635;174;6991342;87;1121007;31082;32103
74196;Nancy-sur-Cluses;209;6496099;327251;154;5759338;55;736761;31082;32104
08160;Évigny;106;3294688;266656;75;2946680;31;348008;31082;32105
57575;Retonfey;672;20889203;1203346;480;18385978;192;2503225;31085;32106
51210;Dizy;892;27729379;2041962;675;25178946;217;2550433;31087;32107
34248;Sainte-Croix-de-Quintillargues;273;8486892;434942;191;7481195;82;1005697;31088;32108
59536;Sainte-Marie-Cappel;377;11720024;532475;255;10099717;122;1620307;31088;32109
68090;Ferrette;447;13896390;1184655;304;12307658;143;1588732;31088;32110
27147;La Chapelle-du-Bois-des-Faulx;249;7741395;358647;177;6960689;72;780706;31090;32111
67128;Ernolsheim-Bruche;955;29692706;1916776;723;26759349;232;2933357;31092;32112
67425;Saint-Jean-Saverne;308;9576306;512995;215;8453973;93;1122333;31092;32113
02347;Gland;266;8270989;712053;178;7336739;88;934250;31094;32114
59435;Nomain;1259;39147604;2409498;838;34320552;421;4827052;31094;32115
01291;Perrex;393;12220145;459410;263;10535052;130;1685093;31095;32116
31560;Trébons-sur-la-Grasse;209;6498819;290489;144;5848893;65;649926;31095;32117
38260;Moras;251;7804838;463664;181;6904416;70;900422;31095;32118
74191;Morzine;1787;55568244;4358413;1183;48758602;604;6809642;31096;32119
86261;Sèvres-Anxaumont;1041;32371375;2151178;740;28967145;301;3404230;31096;32120
02302;Faverolles;152;4726833;375027;95;4061023;57;665810;31098;32121
59553;Santes;2777;86370930;5062275;1900;75910982;877;10459948;31102;32122
27091;Bosgouet;328;10202463;491832;228;9148835;100;1053628;31105;32123
51027;Auve;133;4137003;241205;82;3428737;51;708266;31105;32124
52193;Euffigneix;156;4852900;239088;127;4495440;29;357460;31108;32125
59266;Gondecourt;2047;63687653;4179735;1403;56134612;644;7553041;31113;32126
77244;Larchant;403;12538602;917052;272;10902569;131;1636033;31113;32127
08031;Aure;30;933396;103606;16;754020;14;179376;31113;32128
51453;Recy;542;16863683;1014800;407;15254231;135;1609452;31114;32129
15127;Molompize;187;5818428;630730;81;4557755;106;1260673;31115;32130
77089;La Chapelle-Rablais;449;13971733;835829;328;12549547;121;1422186;31117;32131
51434;Plivot;389;12104985;740578;287;10840874;102;1264111;31118;32132
78206;Ecquevilly;2027;63081412;4177168;1442;56742648;585;6338764;31121;32133
78478;Paray-Douaville;100;3112066;105576;74;2589647;26;522419;31121;32134
76514;Quévreville-la-Poterie;464;14440126;693311;363;13262036;101;1178090;31121;32135
80092;Bertangles;310;9647793;623194;225;8745242;85;902551;31122;32136
38369;Sainte-Blandine;429;13352323;680399;297;11728585;132;1623738;31124;32137
77216;Grez-sur-Loing;741;23063318;1475780;513;20468191;228;2595127;31125;32138
74205;Onnion;624;19425593;610570;402;15793420;222;3632173;31131;32139
68279;Roderen;459;14289131;755907;309;12197012;150;2092119;31131;32140
41206;Saint-Denis-sur-Loire;446;13884728;847813;322;12288020;124;1596708;31132;32141
61245;Maison-Maugis;29;902826;75245;16;734532;13;168294;31132;32142
74292;Vaulx;427;13293448;666224;296;11466629;131;1826819;31132;32143
14484;Ouilly-du-Houley;105;3269043;215855;62;2775447;43;493596;31134;32144
90037;Éloie;481;14975658;854350;350;13252577;131;1723081;31134;32145
37179;Parçay-Meslay;1171;36459876;1815984;827;32129621;344;4330255;31136;32146
60513;Précy-sur-Oise;1769;55079982;3711944;1236;48830125;533;6249857;31136;32147
28425;Ymeray;320;9964394;808213;224;8915021;96;1049373;31139;32148
66170;Sainte-Colombe-de-la-Commanderie;70;2179861;141847;55;2009206;15;170655;31141;32149
70109;Buthiers;156;4858215;251337;117;4301442;39;556773;31142;32150
21339;Lantenay;233;7256812;289759;178;6442381;55;814431;31145;32151
86024;Béruges;642;19995801;1026914;470;17980561;172;2015240;31146;32152
29189;Plougastel-Daoulas;6791;211516627;13546678;4271;183824736;2520;27691891;31147;32153
69159;Pouilly-le-Monial;453;14109599;682904;327;12477064;126;1632535;31147;32154
14565;Saint-Côme-de-Fresné;133;4143084;276073;93;3636195;40;506889;31151;32155
80746;Talmas;562;17507997;870531;381;15504010;181;2003987;31153;32156
74141;Hauteville-sur-Fier;416;12960052;540533;299;11360012;117;1600040;31154;32157
39047;Bellefontaine;277;8630046;496492;176;7280078;101;1349968;31155;32158
27429;Neuilly;79;2461290;176303;51;2060552;28;400738;31156;32159
21241;Échevronne;147;4580026;265135;106;4133073;41;446953;31157;32160
68070;Didenheim;929;28946296;1969783;632;25308264;297;3638032;31159;32161
67016;Avolsheim;372;11591727;586563;285;10578428;87;1013299;31161;32162
01362;Saint-Jean-de-Thurigneux;373;11623167;609282;283;10642077;90;981090;31161;32163
76547;La Rue-Saint-Pierre;325;10127563;488247;234;8896428;91;1231135;31162;32164
51077;Bouvancourt;98;3053871;171582;75;2844298;23;209573;31162;32165
95166;Cléry-en-Vexin;207;6450868;418481;146;5887278;61;563590;31164;32166
25592;Vaux-et-Chantegrue;282;8788148;521105;196;7633721;86;1154427;31164;32167
60066;Béthancourt-en-Valois;127;3958011;264391;90;3617181;37;340830;31165;32168
50446;Saint-André-de-l'Épine;294;9163311;614111;192;7965461;102;1197850;31168;32169
27517;Saint-Aubin-sur-Gaillon;899;28020248;1772000;664;25440938;235;2579310;31168;32170
59568;Sercus;173;5392333;319711;107;4541998;66;850335;31170;32171
63396;Saint-Saturnin;583;18172015;1097434;390;15846181;193;2325834;31170;32172
63278;Pessat-Villeneuve;265;8260399;454275;205;7582826;60;677573;31171;32173
47129;Lagarrigue;145;4519899;345853;88;3995032;57;524867;31172;32174
38528;Vaulnaveys-le-Bas;631;19670798;1225685;462;17809317;169;1861481;31174;32175
14423;Le Mesnil-Patry;122;3803776;180541;84;3311082;38;492694;31178;32176
91226;Étréchy;3477;108408089;7198494;2574;97867310;903;10540779;31179;32177
80050;Bacouel-sur-Selle;255;7951158;590537;162;7220988;93;730170;31181;32178
30209;Pujaut;2167;67577092;4569799;1386;57710456;781;9866636;31185;32179
74188;Montriond;460;14345338;1091566;293;12716624;167;1628714;31186;32180
14724;Varaville;572;17838479;1628513;381;15756663;191;2081816;31186;32181
51617;La Veuve;306;9542980;511998;237;8596837;69;946143;31186;32182
34179;Murviel-lès-Montpellier;904;28195333;1433849;581;23399692;323;4795641;31190;32183
13057;Mas-Blanc-des-Alpilles;254;7922904;419034;151;6811689;103;1111215;31193;32184
89466;Villeroy;181;5645914;311950;143;5152916;38;492998;31193;32185
62810;Thélus;609;18997060;1220485;406;16484886;203;2512174;31194;32186
40181;Messanges;575;17937789;1692392;348;15402663;227;2535126;31196;32187
49338;Soulaines-sur-Aubance;581;18125494;922406;421;16215080;160;1910414;31197;32188
01247;Mijoux;203;6333997;331070;129;5270496;74;1063501;31202;32189
42122;Lézigneux;775;24181870;1272269;517;21135154;258;3046716;31202;32190
27403;Le Mesnil-Jourdain;116;3619515;193856;78;3079423;38;540092;31203;32191
57109;Breistroff-la-Grande;306;9548240;84945;102;3807361;204;5740879;31203;32192
50575;Sideville;277;8643472;358532;208;7781430;69;862042;31204;32193
78291;Guerville;1088;33953422;1961362;833;30825060;255;3128362;31207;32194
80285;Essertaux;123;3838586;311198;84;3328760;39;509826;31208;32195
28022;Bailleau-l'Évêque;568;17727945;994854;447;16270654;121;1457291;31211;32196
73084;Chignin;490;15293540;1102700;344;13542442;146;1751098;31211;32197
26024;Barcelonne;194;6055020;370007;131;5319320;63;735700;31211;32198
68322;Steinbach;772;24095241;1642623;550;21181225;222;2914016;31211;32199
73152;Marcieux;97;3027587;223324;71;2736209;26;291378;31212;32200
28308;Prudemanche;112;3496269;217727;72;3054265;40;442004;31217;32201
68189;Logelheim;383;11956975;584815;276;10491117;107;1465858;31219;32202
34249;Saint-Drézéry;1090;34029106;1936000;708;29659644;382;4369462;31219;32203
60586;Saint-Martin-le-Noeud;535;16703109;1186430;397;15383776;138;1319333;31221;32204
42037;Chalain-d'Uzore;256;7992838;462433;168;6876438;88;1116400;31222;32205
63307;Romagnat;4332;135260073;8891714;2983;119880240;1349;15379833;31223;32206
67257;Lampertsloch;400;12489640;690539;260;10688152;140;1801488;31224;32207
60018;Anserville;247;7712653;454952;169;6917169;78;795484;31225;32208
38048;Bonnefamille;523;16331110;878340;379;14746445;144;1584665;31226;32209
10320;Rilly-Sainte-Syre;121;3778484;236417;82;3201643;39;576841;31227;32210
31514;Saint-Rome;32;999269;96259;18;844911;14;154358;31227;32211
02034;Audignicourt;51;1592594;123143;32;1294455;19;298139;31227;32212
29190;Plougonvelin;2129;66484715;4333298;1441;58121929;688;8362786;31228;32213
42017;Le Bessat;232;7245780;448785;169;6565331;63;680449;31232;32214
76668;Saussay;155;4841106;331419;111;4253615;44;587491;31233;32215
28110;Le Coudray;2111;65932823;4317040;1595;59762239;516;6170584;31233;32216
27129;Caorches-Saint-Nicolas;289;9026597;459970;194;7836733;95;1189864;31234;32217
59237;Flêtre;451;14087731;891530;301;12336038;150;1751693;31237;32218
50382;Nouainville;212;6622489;285144;165;6050373;47;572116;31238;32219
14633;Saint-Martin-du-Mesnil-Oury;53;1655689;43727;31;1407765;22;247924;31239;32220
60046;Bargny;140;4373579;202527;102;3942984;38;430595;31240;32221
28113;Coulombs;733;22899575;1433254;533;20421985;200;2477590;31241;32222
84011;Le Beaucet;193;6029768;435151;100;5238028;93;791740;31242;32223
35177;La Mézière;2057;64273065;3287665;1520;57529017;537;6744048;31246;32224
25622;Villers-Buzon;137;4280709;263749;97;3852210;40;428499;31246;32225
91105;Breuillet;4191;130953874;8342919;2947;117119644;1244;13834230;31246;32226
34198;Pérols;5071;158451219;11839630;3206;137146096;1865;21305123;31247;32227
81022;Bannières;94;2937307;159878;62;2631010;32;306297;31248;32228
57162;Cuvry;405;12655705;649322;276;10822120;129;1833585;31249;32229
14304;Gonneville-sur-Honfleur;443;13844280;1010272;310;12444682;133;1399598;31251;32230
13007;Auriol;6239;194983258;14008690;3888;168923916;2351;26059342;31252;32231
77516;Ville-Saint-Jacques;378;11814021;689056;266;10454064;112;1359957;31254;32232
55031;Baudonvilliers;224;7001218;439074;165;6363218;59;638000;31255;32233
73225;Saint-Baldoph;1556;48637552;2939913;1042;42571378;514;6066174;31258;32234
83106;Rocbaron;2063;64494539;4323808;1280;55032143;783;9462396;31263;32235
13040;Fuveau;4995;156185452;9965512;3308;137075172;1687;19110280;31268;32236
45034;Boigny-sur-Bionne;1106;34586876;2017941;807;30966076;299;3620800;31272;32237
68281;Roggenhouse;233;7287236;377699;173;6444899;60;842337;31276;32238
31079;Bouloc;2020;63178686;3709114;1347;55467578;673;7711108;31277;32239
71497;Sancé;1006;31464871;1893465;754;28483037;252;2981834;31277;32240
63443;Varennes-sur-Morge;190;5942856;305603;137;5243984;53;698872;31278;32241
59338;Ledringhem;282;8821616;409324;183;7442095;99;1379521;31282;32242
57465;Metzervisse;952;29782952;965950;529;21118371;423;8664581;31285;32243
85214;Sainte-Foy;861;26936346;1415973;565;22939805;296;3996541;31285;32244
67045;Bischoffsheim;1749;54721889;3509892;1221;47987255;528;6734634;31288;32245
67209;Hohfrankenheim;138;4317692;192738;94;3296832;44;1020860;31288;32246
29235;Le Relecq-Kerhuon;5833;182516978;12010190;3843;159678712;1990;22838266;31290;32247
91294;Guillerval;400;12516250;738269;296;11261856;104;1254394;31291;32248
21056;Beire-le-Châtel;410;12831450;836647;285;11579263;125;1252187;31296;32249
71378;Rully;817;25571526;1629259;544;22054616;273;3516910;31299;32250
77253;Lissy;106;3317756;193512;87;3147833;19;169923;31300;32251
45182;Ligny-le-Ribault;709;22192843;1468488;472;19562496;237;2630347;31302;32252
01382;Sainte-Olive;152;4757863;240368;106;4149579;46;608284;31302;32253
77430;Saint-Pathus;2709;84796657;4468496;2070;76256099;639;8540558;31302;32254
60412;Montagny-en-Vexin;302;9453164;594316;229;8541525;73;911639;31302;32255
77024;Bassevelle;171;5353070;382948;115;4679091;56;673979;31305;32256
59511;Rosult;913;28582054;1852155;576;24899255;337;3682799;31306;32257
54072;Bezaumont;119;3725602;210088;87;3371704;32;353898;31308;32258
08046;Banogne-Recouvrance;81;2536065;218188;49;2220639;32;315426;31309;32259
02828;Vregny;48;1503177;145357;33;1305952;15;197225;31316;32260
74046;Boussy;235;7360142;379652;163;6471275;72;888867;31320;32261
77286;Meigneux;110;3445265;165477;85;3147294;25;297971;31321;32262
13069;Pélissanne;5142;161056579;10442933;3374;140644162;1768;20412417;31322;32263
35241;La Richardais;1316;41220989;2208494;875;35631100;441;5589889;31323;32264
39407;Passenans;196;6139651;288435;105;5237526;91;902125;31325;32265
95288;Groslay;4337;135866918;10017467;2918;121701572;1419;14165346;31327;32266
90035;Dorans;301;9429739;568582;221;8451013;80;978726;31328;32267
40008;Argelouse;54;1691782;203264;27;1486535;27;205247;31329;32268
80024;Argoeuves;284;8897800;561384;192;7762025;92;1135775;31330;32269
77374;Pontcarré;1081;33868771;2232982;831;31263890;250;2604881;31331;32270
76740;La Vieux-Rue;217;6799180;279985;160;6053333;57;745847;31333;32271
27140;Chambray;220;6893257;455360;159;6226216;61;667041;31333;32272
77408;Saint-Fiacre;209;6548919;342432;165;6039263;44;509656;31335;32273
27400;Merey;201;6298428;486376;143;5696258;58;602170;31335;32274
76409;Mannevillette;363;11375107;488901;290;10601926;73;773181;31336;32275
27020;Arnières-sur-Iton;843;26416990;1997911;576;23645011;267;2771979;31337;32276
38511;Le Touvet;1643;51487267;3198768;1123;45327929;520;6159338;31337;32277
35079;Chevaigné;906;28393348;1542212;641;24977545;265;3415803;31339;32278
45161;Griselles;432;13538585;991931;285;11943876;147;1594709;31339;32279
54341;Mance;325;10185568;705072;196;8213436;129;1972132;31340;32280
60426;Montreuil-sur-Thérain;124;3886585;219325;101;3590634;23;295951;31343;32281
60433;Mortefontaine-en-Thelle;393;12318175;674041;281;10818809;112;1499366;31344;32282
39534;La Tour-du-Meix;120;3761318;115783;74;2979857;46;781461;31344;32283
95054;Le Bellay-en-Vexin;118;3698671;212787;87;3422170;31;276501;31345;32284
68218;Morschwiller-le-Bas;1804;56547643;3723350;1255;50048335;549;6499308;31346;32285
68227;Muntzenheim;532;16676617;971865;348;14318371;184;2358246;31347;32286
77028;Beautheil;338;10595477;649140;240;9297102;98;1298375;31348;32287
60447;Néry;357;11191473;721629;253;9828008;104;1363465;31349;32288
57552;Pouilly;359;11254680;700725;269;9986033;90;1268647;31350;32289
31410;Pechbonnieu;2033;63740959;3690451;1335;56191990;698;7548969;31353;32290
76038;Authieux-Ratiéville;185;5800407;280765;136;5093293;49;707114;31354;32291
68131;Heiwiller;100;3135463;201887;70;2729912;30;405551;31355;32292
57350;Jouy-aux-Arches;862;27028283;1942264;524;23045992;338;3982291;31355;32293
62415;Haute-Avesnes;191;5989799;272380;131;5305239;60;684560;31360;32294
67108;Duppigheim;827;25935303;1611574;581;22970212;246;2965091;31361;32295
76605;Sainte-Marguerite-sur-Mer;261;8185346;551585;166;7325367;95;859979;31361;32296
57426;Luttange;401;12576591;414779;231;9342938;170;3233653;31363;32297
28277;Neuvy-en-Dunois;165;5175408;382601;100;4469580;65;705828;31366;32298
83132;Solliès-Ville;1373;43070338;3123720;867;37190202;506;5880136;31370;32299
89113;Collemiers;309;9693249;622455;222;8595829;87;1097420;31370;32300
27690;Villers-en-Vexin;146;4580193;442212;99;3999003;47;581190;31371;32301
42302;Sorbiers;3895;122200602;6627740;2740;107290008;1155;14910594;31374;32302
26032;La Baume-Cornillane;224;7028172;501424;141;6059410;83;968762;31376;32303
28330;Saint-Cloud-en-Dunois;109;3420012;228010;75;2880383;34;539629;31376;32304
72133;Fillé;667;20929111;956117;500;18639317;167;2289794;31378;32305
38325;Proveysieux;279;8754738;524359;209;7912481;70;842257;31379;32306
10187;Landreville;286;8974423;977876;164;7829361;122;1145062;31379;32307
81324;Viviers-lès-Lavaur;95;2981138;143993;60;2616142;35;364996;31380;32308
91175;Corbreuse;829;26017306;1411052;605;23167363;224;2849943;31384;32309
67297;Mittelhausen;303;9509393;665477;204;8387584;99;1121809;31384;32310
52474;Silvarouvres;25;784879;39391;12;639996;13;144883;31395;32311
54584;Villey-Saint-Étienne;537;16860098;974068;385;14911134;152;1948964;31397;32312
37151;La Membrolle-sur-Choisille;1501;47127129;2916947;1032;41676110;469;5451019;31397;32313
50162;Digosville;729;22889326;1195819;535;20435781;194;2453545;31398;32314
78451;Nézel;540;16955602;1027858;419;15623218;121;1332384;31399;32315
63083;Chanat-la-Mouteyre;452;14196067;837704;339;12751492;113;1444575;31407;32316
77018;Bailly-Romainvilliers;3285;103178820;6290007;2429;93475413;856;9703407;31409;32317
36159;Le Poinçonnet;2965;93130347;5404069;2205;83623591;760;9506756;31410;32318
14302;Glanville;86;2701484;191079;56;2300290;30;401194;31413;32319
58308;Vignol;44;1382224;68579;21;1166167;23;216057;31414;32320
44132;Pornichet;6762;212431634;15158081;4394;185021016;2368;27410618;31416;32321
21661;Velars-sur-Ouche;902;28336877;1679366;668;25479426;234;2857451;31416;32322
01297;Pizay;361;11341648;587195;267;10264979;94;1076669;31417;32323
45153;Germigny-des-Prés;369;11593050;671423;229;9808844;140;1784206;31417;32324
77360;Pézarches;183;5750252;287788;122;5008404;61;741848;31422;32325
60063;Berneuil-en-Bray;426;13386246;842032;312;12271012;114;1115234;31423;32326
27615;Sassey;92;2891081;153153;75;2675360;17;215721;31425;32327
25265;Geneuille;642;20175176;1185528;471;18238211;171;1936965;31426;32328
51387;Moslins;150;4713865;285591;114;4375805;36;338060;31426;32329
21508;Prenois;192;6033866;358617;145;5543958;47;489908;31426;32330
10021;Avant-lès-Ramerupt;74;2325627;187102;43;1979744;31;345883;31427;32331
21684;Vignoles;389;12226435;633318;280;10848880;109;1377555;31430;32332
64370;Maucor;255;8014938;537690;171;7102097;84;912841;31431;32333
27128;Cantiers;112;3520329;265273;70;3028645;42;491684;31432;32334
76282;Freneuse;491;15433063;947886;364;13839096;127;1593967;31432;32335
10240;Messon;233;7323861;391021;164;6382223;69;941638;31433;32336
51172;Cormontreuil;3251;102189244;6229891;2324;90810014;927;11379230;31433;32337
14728;Vaucelles;177;5563808;217759;132;5079388;45;484420;31434;32338
27023;Aulnay-sur-Iton;370;11631456;764747;266;10285644;104;1345812;31436;32339
76112;Le Bois-Robert;161;5061350;351650;115;4547621;46;513729;31437;32340
01456;Vongnes;48;1509177;90841;35;1362072;13;147105;31441;32341
27539;Saint-Étienne-sous-Bailleul;190;5973903;384213;134;5347223;56;626680;31442;32342
68030;Bergholtzzell;225;7074946;382586;157;6252499;68;822447;31444;32343
28100;Cintray;204;6414854;364131;160;5837353;44;577501;31445;32344
60274;Glaignes;184;5786023;330499;138;5333691;46;452332;31446;32345
68116;Gundolsheim;355;11163258;617695;252;9900728;103;1262530;31446;32346
25280;Goumois;109;3427655;358113;76;3112778;33;314877;31446;32347
57534;Peltre;946;29749363;1804132;645;26187703;301;3561660;31448;32348
95177;Cormeilles-en-Vexin;576;18114880;1143381;410;16088973;166;2025907;31449;32349
41287;Villerable;272;8554822;402686;218;7301594;54;1253228;31452;32350
57145;Coincy;153;4813089;308732;106;4302622;47;510467;31458;32351
10084;Charmont-sous-Barbuise;474;14911785;851577;329;12883558;145;2028227;31459;32352
59626;Villers-Pol;656;20637582;1527521;408;17899848;248;2737734;31460;32353
74237;Saint-Gingolph;444;13968150;1154967;306;12607585;138;1360565;31460;32354
69051;Chaussan;450;14156977;864324;299;12378998;151;1777979;31460;32355
34123;Juvignac;4037;127004320;8620956;2618;110052523;1419;16951797;31460;32356
01449;Villette-sur-Ain;341;10728621;667528;238;9328394;103;1400227;31462;32357
28284;Oinville-Saint-Liphard;151;4750934;381360;103;4112916;48;638018;31463;32358
65005;Allier;184;5790050;324725;131;5192162;53;597888;31468;32359
62693;Rebreuve-Ranchicourt;574;18064420;1153586;369;15966796;205;2097624;31471;32360
01197;Journans;172;5413298;313036;128;4816634;44;596664;31473;32361
80449;Ignaucourt;44;1385059;125221;27;1203209;17;181850;31479;32362
57645;Semécourt;451;14196972;721648;285;11379584;166;2817388;31479;32363
68108;Grentzingen;290;9128921;548081;195;7931334;95;1197587;31479;32364
51205;Dampierre-au-Temple;126;3966692;205850;90;3447554;36;519138;31482;32365
63262;Orcet;1456;45837802;3082406;1060;41225193;396;4612609;31482;32366
10241;Metz-Robert;31;976098;73749;19;843766;12;132332;31487;32367
18254;Soye-en-Septaine;289;9099778;488626;206;7997495;83;1102283;31487;32368
54403;Norroy-lès-Pont-à-Mousson;616;19396515;1111215;445;17255997;171;2140518;31488;32369
51002;Saint-Martin-d'Ablois;741;23335443;1642200;507;20498514;234;2836929;31492;32370
68289;Ruelisheim;1193;37570718;2421500;858;33274836;335;4295882;31493;32371
95539;Saint-Brice-sous-Forêt;7070;222653615;15848873;4794;197031064;2276;25622551;31493;32372
25002;Abbans-Dessus;148;4660940;284173;118;4341354;30;319586;31493;32373
39297;Longchaumois;620;19527587;1209312;401;16912728;219;2614859;31496;32374
64067;Assat;831;26173361;1396696;574;23186477;257;2986884;31496;32375
62582;Monchy-le-Preux;306;9637928;652737;199;8449725;107;1188203;31496;32376
67023;Batzendorf;489;15402458;894224;353;13702146;136;1700312;31498;32377
35001;Acigné;3031;95472567;4813193;2184;85080898;847;10391669;31499;32378
38557;Villette-d'Anthon;2251;70906852;4199994;1642;63499592;609;7407260;31500;32379
67233;Kertzfeld;629;19813824;1076805;417;17039209;212;2774615;31501;32380
13104;Sausset-les-Pins;4805;151361228;12109442;3403;136073442;1402;15287786;31501;32381
76163;Catenay;343;10805076;565034;242;9386223;101;1418853;31502;32382
67506;Vendenheim;2942;92686710;5748587;2055;81820198;887;10866512;31505;32383
84013;Beaumettes;123;3875574;257374;73;3354685;50;520889;31509;32384
21178;Clémencey;61;1922057;143290;50;1839173;11;82884;31509;32385
38417;Sainte-Marie-d'Alloix;282;8885842;517464;178;7469905;104;1415937;31510;32386
94059;Le Plessis-Trévise;10258;323240982;24617310;7316;292675246;2942;30565736;31511;32387
35189;Montgermont;1637;51585098;3078463;1175;46127726;462;5457372;31512;32388
45019;Baccon;315;9926321;526060;237;8892469;78;1033852;31512;32389
52494;Treix;127;4002071;235556;96;3682561;31;319510;31512;32390
57626;Sanry-lès-Vigy;238;7500141;329655;159;6367795;79;1132346;31513;32391
67460;Schwindratzheim;833;26255738;1490332;529;22425530;304;3830208;31519;32392
77315;Montry;1760;55474411;3556344;1369;50877119;391;4597292;31520;32393
69141;Mornant;2813;88675356;5247930;1948;78340611;865;10334745;31523;32394
59013;Anstaing;634;19986309;1067252;446;17649562;188;2336747;31524;32395
27533;Saint-Denis-le-Ferment;251;7913383;540691;188;7324666;63;588717;31527;32396
51087;Breuvery-sur-Coole;97;3058246;161508;70;2776722;27;281524;31528;32397
51496;Saint-Lumier-en-Champagne;124;3909567;184971;94;3554407;30;355160;31529;32398
27053;Le Bec-Thomas;111;3499751;209321;78;3065440;33;434311;31529;32399
57452;La Maxe;439;13844206;734176;293;11550882;146;2293324;31536;32400
51626;La Villeneuve-lès-Charleville;65;2049835;155504;42;1806522;23;243313;31536;32401
08099;Champigneul-sur-Vence;56;1766357;61871;41;1469298;15;297059;31542;32402
25210;Échenans;62;1955647;99445;43;1670796;19;284851;31543;32403
60328;Juvignies;137;4321458;246182;103;3824134;34;497324;31543;32404
68295;Sainte-Croix-en-Plaine;1380;43531893;2371562;996;38666354;384;4865539;31545;32405
59335;Lecelles;1394;43974982;2790857;887;38156240;507;5818742;31546;32406
39449;Rainans;124;3911763;178576;86;3499905;38;411858;31546;32407
14306;Gonneville-en-Auge;221;6971919;440660;158;6182886;63;789033;31547;32408
71422;Saint-Germain-lès-Buxy;133;4195856;246613;92;3767726;41;428130;31548;32409
14558;Saint-Aubin-d'Arquenay;389;12272845;703417;293;11219439;96;1053406;31550;32410
34153;Les Matelles;940;29659951;1648928;612;25821929;328;3838022;31553;32411
51345;Mareuil-en-Brie;144;4543720;486480;92;3987360;52;556360;31554;32412
50230;Hardinvast;405;12779435;619446;292;11455844;113;1323591;31554;32413
21521;Remilly-sur-Tille;390;12306269;625303;282;11018651;108;1287618;31555;32414
71294;Mercurey;669;21110006;1683648;424;18321706;245;2788300;31555;32415
57553;Pournoy-la-Chétive;308;9718934;509253;214;8482251;94;1236683;31555;32416
71202;Fontaines;1000;31555346;1754496;684;28049730;316;3505616;31555;32417
91247;La Forêt-le-Roi;240;7573591;492781;184;6902420;56;671171;31557;32418
29156;Pencran;811;25593432;1321233;574;22636007;237;2957425;31558;32419
86100;Fontaine-le-Comte;1897;59866369;3406305;1389;53551238;508;6315131;31558;32420
91412;Mondeville;388;12244713;819510;299;11143358;89;1101355;31559;32421
06007;Auribeau-sur-Siagne;1684;53146880;3548645;1117;46301310;567;6845570;31560;32422
59019;Artres;514;16223758;883591;315;14470715;199;1753043;31564;32423
70019;Andelarre;57;1799230;95457;38;1487841;19;311389;31565;32424
01293;Peyriat;84;2651550;147990;64;2405068;20;246482;31566;32425
01047;Blyes;447;14110486;727154;337;12734302;110;1376184;31567;32426
18028;Berry-Bouy;583;18405530;1003710;419;16404654;164;2000876;31570;32427
59419;Mouchin;702;22162554;1364308;468;19556145;234;2606409;31571;32428
25204;Doubs;1375;43415576;2812017;899;37906209;476;5509367;31575;32429
27555;Saint-Laurent-des-Bois;115;3631147;251364;78;3142408;37;488739;31575;32430
25634;Vuillecin;308;9725199;579562;230;8766729;78;958470;31575;32431
33322;Le Pian-Médoc;3164;99909563;6394541;2193;88764953;971;11144610;31577;32432
21586;Saulon-la-Rue;314;9915184;514102;230;8771801;84;1143383;31577;32433
31384;Montlaur;558;17620525;942904;371;15323345;187;2297180;31578;32434
77491;Veneux-les-Sablons;2710;85584589;6148867;1967;77470955;743;8113634;31581;32435
90102;Vescemont;390;12316738;771220;275;11047656;115;1269082;31581;32436
28247;Le Mesnil-Simon;281;8875589;586722;213;8082413;68;793176;31586;32437
91085;Boissy-sous-Saint-Yon;1931;60996969;3868933;1476;56463051;455;4533918;31588;32438
68010;Aspach;578;18258899;1057457;390;16000558;188;2258341;31590;32439
27341;L'Hosmes;36;1137434;59656;25;996674;11;140760;31595;32440
76536;Roncherolles-sur-le-Vivier;524;16557293;860472;392;14711400;132;1845893;31598;32441
49298;Saint-Léger-des-Bois;672;21234605;952652;470;18673686;202;2560919;31599;32442
62011;Agnez-lès-Duisans;326;10301737;734248;191;8756683;135;1545054;31600;32443
45094;Chevry-sous-le-Bignon;127;4013449;423959;83;3538950;44;474499;31602;32444
21458;Noiron-sous-Gevrey;445;14062927;555878;345;12631366;100;1431561;31602;32445
21691;Villebichot;170;5372809;274709;126;4921162;44;451647;31605;32446
60680;Villeneuve-sur-Verberie;353;11157296;827973;252;10126543;101;1030753;31607;32447
54578;Villers-lès-Nancy;7892;249451623;18090816;5570;223732046;2322;25719577;31608;32448
80797;Villers-aux-Érables;60;1897183;101227;39;1656433;21;240750;31620;32449
31150;Cornebarrieu;2829;89452618;5998918;2000;80163498;829;9289120;31620;32450
27306;Guichainville;1327;41960065;2663614;926;37636482;401;4323583;31620;32451
81052;Cambon;947;29944494;1410978;682;26783832;265;3160662;31620;32452
02187;Chierry;617;19510807;1005974;435;17495251;182;2015556;31622;32453
54346;Manoncourt-en-Woëvre;125;3953298;172675;70;3167090;55;786208;31626;32454
67439;Schaffhouse-sur-Zorn;183;5787828;250993;123;5072920;60;714908;31627;32455
87019;Boisseuil;1359;42983326;2530873;980;38467694;379;4515632;31629;32456
60148;Chèvreville;232;7337960;397081;172;6648537;60;689423;31629;32457
60141;Chantilly;6699;211887291;19382874;4724;190198203;1975;21689088;31630;32458
08432;Sury;49;1550018;77979;30;1267338;19;282680;31633;32459
95091;Bouffémont;2918;92309044;6462481;2062;82309096;856;9999948;31634;32460
33519;Le Taillan-Médoc;4901;155042605;9414402;3545;138941723;1356;16100882;31635;32461
67247;Kolbsheim;413;13065236;756502;283;11525416;130;1539820;31635;32462
91425;Montlhéry;4000;126547364;9320574;2882;114423896;1118;12123468;31637;32463
57345;Inglange;193;6106107;226044;104;4218441;89;1887666;31638;32464
27158;Cierrey;358;11327462;650139;257;10161981;101;1165481;31641;32465
45227;Nevoy;618;19554228;1262980;457;17626282;161;1927946;31641;32466
55105;Châtillon-sous-les-Côtes;92;2911118;271089;54;2387275;38;523843;31643;32467
60551;Rousseloy;147;4651555;264192;103;4085355;44;566200;31643;32468
84002;Ansouis;573;18132510;905828;344;15803676;229;2328834;31645;32469
21213;Crimolois;357;11297255;683673;270;10335336;87;961919;31645;32470
33069;Le Bouscat;13913;440289269;37361689;9124;390397164;4789;49892105;31646;32471
02272;Droizy;40;1266070;132884;21;1060946;19;205124;31652;32472
77353;Paley;250;7914201;678415;167;6963371;83;950830;31657;32473
29057;La Forêt-Fouesnant;1900;60153799;3880062;1201;51222503;699;8931296;31660;32474
25322;Laire;182;5762180;350579;132;5079271;50;682909;31660;32475
57445;Marieulles;346;10954621;556359;251;9839593;95;1115028;31661;32476
59193;Emmerin;1629;51575884;3648370;1138;45877735;491;5698149;31661;32477
10170;Gyé-sur-Seine;275;8707913;889626;160;7518782;115;1189131;31665;32478
72058;Changé;3089;97818837;5890393;2153;86789181;936;11029656;31667;32479
77444;Sancy-lès-Provins;165;5225250;347812;109;4474168;56;751082;31668;32480
10291;Plessis-Barbuise;87;2755255;314250;52;2399835;35;355420;31670;32481
16418;Voeuil-et-Giget;811;25686294;1534485;582;23076432;229;2609862;31672;32482
78559;Saint-Illiers-le-Bois;217;6873084;473646;157;6227817;60;645267;31673;32483
51045;Beaunay;59;1868914;196270;38;1623619;21;245295;31677;32484
60251;Fouquerolles;149;4720191;294413;106;4187402;43;532789;31679;32485
60250;Fouquenies;233;7381847;564994;178;6794924;55;586923;31682;32486
91179;Le Coudray-Montceaux;2476;78444059;5013628;1833;70444747;643;7999312;31682;32487
57364;Kirsch-lès-Sierck;142;4498909;92115;59;2218782;83;2280127;31682;32488
90031;Cunelières;143;4530679;246945;97;4048658;46;482021;31683;32489
54460;Rogéville;80;2534664;83506;49;2124067;31;410597;31683;32490
28185;Goussainville;455;14416038;700538;338;13149776;117;1266262;31684;32491
51409;Nuisement-sur-Coole;176;5576363;335455;138;5161146;38;415217;31684;32492
69260;Vernaison;2241;71009716;4975667;1397;61863544;844;9146172;31687;32493
77118;Claye-Souilly;6186;196017928;13990656;4530;177732977;1656;18284951;31687;32494
67490;Thanvillé;298;9442949;506427;219;8481286;79;961663;31688;32495
01290;Pérouges;652;20661685;1290815;456;18473862;196;2187823;31690;32496
28332;Sainte-Gemme-Moronval;475;15055270;903515;319;13076846;156;1978424;31695;32497
39404;Pannessières;245;7765786;520649;175;6918548;70;847238;31697;32498
62285;Écoust-Saint-Mein;227;7195505;347830;139;6098778;88;1096727;31698;32499
74161;Marcellaz-Albanais;903;28624158;1521181;652;25234457;251;3389701;31699;32500
28194;Houville-la-Branche;244;7735862;587502;184;7114085;60;621777;31704;32501
31466;Saiguède;359;11382274;596995;248;9877217;111;1505057;31705;32502
80668;Remiencourt;90;2853547;224949;61;2550906;29;302641;31706;32503
28154;Fontaine-la-Guyon;739;23431874;1359275;514;20778929;225;2652945;31708;32504
27648;Tostes;221;7007584;434657;164;6383987;57;623597;31709;32505
67249;Krautwiller;98;3107968;308670;69;2789054;29;318914;31714;32506
01054;Bourg-Saint-Christophe;589;18681382;941288;413;16434630;176;2246752;31717;32507
91405;Milly-la-Forêt;2656;84244005;5995644;1809;74517227;847;9726778;31718;32508
38362;Saint-Aupre;549;17414542;1008081;395;15401653;154;2012889;31720;32509
64080;Aussevielle;347;11007036;493476;252;9692136;95;1314900;31721;32510
84068;Lourmarin;726;23030307;2130495;390;19586260;336;3444047;31722;32511
84116;Saint-Romain-en-Viennois;470;14909976;767877;271;12740330;199;2169646;31723;32512
25288;Fournets-Luisans;316;10024711;559293;232;8843040;84;1181671;31724;32513
33012;Arsac;1638;51963703;3016500;1157;45993665;481;5970038;31724;32514
62744;Sainte-Catherine;1811;57453339;4407483;1231;50985979;580;6467360;31725;32515
77052;Bréau;185;5869114;417344;122;5245664;63;623450;31725;32516
60014;Angivillers;96;3045851;156547;68;2731071;28;314780;31728;32517
91639;Vayres-sur-Essonne;450;14277525;958155;337;12808400;113;1469125;31728;32518
60683;Villers-Saint-Genest;190;6028418;389441;129;5305488;61;722930;31729;32519
55041;Behonne;353;11200416;838733;259;10054361;94;1146055;31729;32520
60099;Braisnes;95;3014308;167243;71;2693188;24;321120;31730;32521
13112;Velaux;4596;145829883;8829603;3226;129485932;1370;16343951;31730;32522
77406;Saint-Denis-lès-Rebais;457;14500587;879198;326;12929081;131;1571506;31730;32523
25619;Les Villedieu;95;3014378;211054;65;2647259;30;367119;31730;32524
14534;Reux;198;6282700;513591;129;5404556;69;878144;31731;32525
39261;Graye-et-Charnay;70;2221465;181695;40;1845580;30;375885;31735;32526
54214;Frolois;320;10155514;578152;228;9102351;92;1053163;31736;32527
51445;Pourcy;100;3173804;211406;75;2925883;25;247921;31738;32528
95203;Eaubonne;12938;410645795;30602182;9170;369598515;3768;41047280;31740;32529
22007;Binic;2263;71828239;4479297;1420;62119371;843;9708868;31740;32530
77508;Villeneuve-le-Comte;936;29709094;2067865;709;27260253;227;2448841;31740;32531
45089;Chécy;4185;132834153;7991655;2995;118167702;1190;14666451;31741;32532
78234;Flacourt;81;2571089;207428;56;2291842;25;279247;31742;32533
03200;Neuvy;784;24886823;1559307;567;22363342;217;2523481;31743;32534
01448;Villes;181;5745625;177319;118;4505609;63;1240016;31744;32535
57652;Sillegny;207;6571217;399559;153;5829717;54;741500;31745;32536
69101;Jarnioux;315;9999993;561904;215;8733998;100;1265995;31746;32537
51505;Saint-Masmes;212;6730238;394332;144;5874758;68;855480;31746;32538
38368;Saint-Blaise-du-Buis;491;15588290;762188;322;13422878;169;2165412;31748;32539
95056;Belloy-en-France;1021;32415514;2042905;785;29595340;236;2820174;31749;32540
61397;Saint-Germain-du-Corbéis;2140;67942926;3417475;1366;59051092;774;8891834;31749;32541
78327;Juziers;1961;62264634;4140324;1462;56775306;499;5489328;31751;32542
25594;Velesmes-Essarts;156;4953525;286316;115;4374998;41;578527;31753;32543
31567;Vallesvilles;189;6001813;332600;137;5361872;52;639941;31756;32544
69069;Craponne;5400;171484719;10815592;3880;153404388;1520;18080331;31756;32545
02508;Monthenault;68;2159464;181913;41;1878095;27;281369;31757;32546
27689;Villegats;165;5239951;298848;124;4725023;41;514928;31757;32547
77401;Sainte-Aulde;345;10956787;661022;243;9768493;102;1188294;31759;32548
77515;Villeroy;338;10734731;626632;240;9632102;98;1102629;31760;32549
76182;Cliponville;129;4097299;103967;67;3310769;62;786530;31762;32550
95651;Vétheuil;481;15282153;1264545;313;13296547;168;1985606;31772;32551
59478;Quaëdypre;536;17029775;1107898;355;14616397;181;2413378;31772;32552
54527;Tonnoy;363;11533427;659229;252;10343163;111;1190264;31773;32553
74204;Les Ollières;438;13916418;865615;295;12183598;143;1732820;31773;32554
28084;Chartainvilliers;351;11153552;609032;277;10212286;74;941266;31777;32555
68039;Bisel;296;9406067;561232;179;7844833;117;1561234;31777;32556
69131;Messimy;1641;52148077;2936248;1172;45899218;469;6248859;31778;32557
21246;Épernay-sous-Gevrey;89;2828312;198590;59;2443642;30;384670;31779;32558
08385;Saint-Laurent;517;16429848;956186;370;14609960;147;1819888;31779;32559
08005;Alincourt;60;1906787;111899;39;1660215;21;246572;31780;32560
02506;Montgobert;111;3527826;280164;78;3093292;33;434534;31782;32561
33501;Saucats;1122;35661864;2071700;781;31343537;341;4318327;31784;32562
69241;Taluyers;1155;36712728;2124952;782;32346949;373;4365779;31786;32563
77141;Coutevroult;495;15734110;1044149;374;14614748;121;1119362;31786;32564
60677;Villembray;122;3877976;406539;81;3382104;41;495872;31787;32565
28388;Thivars;528;16783852;1017878;395;15046790;133;1737062;31788;32566
51044;Beaumont-sur-Vesle;349;11094446;569928;251;9998800;98;1095646;31789;32567
62854;Villers-au-Bois;251;7979470;508253;170;7076260;81;903210;31791;32568
38107;Chonas-l'Amballan;772;24543544;1322783;562;21796197;210;2747347;31792;32569
69223;Saint-Loup;479;15228912;789137;336;13434298;143;1794614;31793;32570
51483;Saint-Gibrien;228;7248927;356903;170;6515441;58;733486;31794;32571
60300;Hardivillers-en-Vexin;69;2193767;179555;55;2013066;14;180701;31794;32572
38149;Domarin;716;22765556;1436352;505;20134763;211;2630793;31795;32573
45231;Oison;66;2098716;104574;45;1817779;21;280937;31799;32574
64139;Bosdarros;497;15806082;967663;316;13994116;181;1811966;31803;32575
76734;Vergetot;187;5947417;269028;143;5433584;44;513833;31804;32576
10079;Channes;81;2576166;241670;56;2233089;25;343077;31805;32577
31540;Ségreville;103;3275872;135204;72;2748387;31;527485;31805;32578
28177;Gellainville;273;8682760;545013;203;7837278;70;845482;31805;32579
28323;Saint-Ange-et-Torçay;147;4675496;369008;95;4071131;52;604365;31806;32580
64478;Saint-Faust;394;12531752;938533;260;11068424;134;1463328;31806;32581
80268;Épagne-Épagnette;304;9669223;642929;203;8509002;101;1160221;31807;32582
13013;Belcodène;919;29234061;1954301;620;26121113;299;3112948;31811;32583
76714;Les Trois-Pierres;354;11261305;633374;267;10018670;87;1242635;31812;32584
21173;Chorey-les-Beaune;299;9513032;519601;217;8516668;82;996364;31816;32585
60540;Rivecourt;241;7667710;569556;165;6893449;76;774261;31816;32586
27358;Jouy-sur-Eure;285;9067996;660304;204;8223163;81;844833;31818;32587
01149;Douvres;489;15561138;790325;374;14105440;115;1455698;31822;32588
68125;Hecken;214;6810263;368146;150;5877367;64;932896;31824;32589
62348;Foufflin-Ricametz;65;2068821;213177;35;1622252;30;446569;31828;32590
38084;Charnècles;735;23394132;1347538;513;20661804;222;2732328;31829;32591
86180;Nouaillé-Maupertuis;1378;43863422;2666237;988;39403080;390;4460342;31831;32592
78296;Guitrancourt;327;10409610;700043;255;9566031;72;843579;31834;32593
30206;Poulx;1879;59824314;3410858;1298;52677973;581;7146341;31838;32594
01171;Géovreisset;445;14168160;915073;313;12599769;132;1568391;31839;32595
51523;Sarcy;131;4170944;316859;98;3835555;33;335389;31839;32596
25348;Longevilles-Mont-d'Or;244;7769637;557358;177;7070857;67;698780;31843;32597
51466;Romigny;109;3471198;275175;70;3021989;39;449209;31846;32598
80791;Vers-sur-Selles;386;12294721;841809;273;11066397;113;1228324;31852;32599
76657;Saint-Vigor-d'Ymonville;453;14429286;701001;350;13034631;103;1394655;31853;32600
21191;Corcelles-lès-Cîteaux;377;12008814;558549;292;10933542;85;1075272;31854;32601
64448;Poey-de-Lescar;756;24081723;1269765;533;20922340;223;3159383;31854;32602
71241;Jambles;251;7995782;539226;176;7081885;75;913897;31856;32603
06108;La Roquette-sur-Siagne;2836;90344285;6339212;1911;79691174;925;10653111;31856;32604
77029;Beauvoir;116;3695376;238002;79;3267719;37;427657;31857;32605
76587;Sainte-Hélène-Bondeville;341;10863232;553601;225;9453124;116;1410108;31857;32606
06161;Villeneuve-Loubet;9859;314084819;27343685;6544;280508278;3315;33576541;31858;32607
10197;Lignol-le-Château;97;3090240;178298;65;2715020;32;375220;31858;32608
78402;Mézières-sur-Seine;1841;58661438;3554925;1359;52615582;482;6045856;31864;32609
57764;Zoufftgen;494;15741159;141375;161;6353793;333;9387366;31865;32610
60427;Monts;92;2931652;228269;59;2562380;33;369272;31866;32611
10077;Champigny-sur-Aube;44;1402252;105250;29;1202018;15;200234;31869;32612
17426;Le Seure;129;4111204;334531;77;3619855;52;491349;31870;32613
77443;Sancy;172;5481733;330392;135;5061361;37;420372;31871;32614
62454;Hinges;1108;35314237;2425509;749;31330919;359;3983318;31872;32615
44114;Orvault;12749;406339886;26483913;8674;359537891;4075;46801995;31872;32616
21492;Pommard;288;9179397;688486;195;8043742;93;1135655;31873;32617
78383;Maurepas;10350;329899374;23260908;7741;300249009;2609;29650365;31874;32618
53157;Montigné-le-Brillant;578;18423448;935444;407;16059043;171;2364405;31874;32619
02593;Pasly;519;16542964;893328;361;14487236;158;2055728;31875;32620
21478;Pasques;154;4909095;303788;109;4390995;45;518100;31877;32621
01359;Saint-Germain-sur-Renon;129;4112401;375561;85;3611872;44;500529;31879;32622
68288;Ruederbach;185;5897708;382894;119;5072086;66;825622;31880;32623
31228;Gragnague;873;27831770;1803891;612;24565806;261;3265964;31881;32624
91135;Champcueil;1320;42086442;2718641;904;37392377;416;4694065;31884;32625
02011;Ambleny;588;18747800;1360889;361;15911357;227;2836443;31884;32626
51085;Le Breuil;211;6727661;692575;118;5658798;93;1068863;31885;32627
25494;Rochejean;351;11191560;755910;250;10072948;101;1118612;31885;32628
77322;Moussy-le-Neuf;1411;44990582;2678044;1095;41358122;316;3632460;31886;32629
38388;Saint-Georges-de-Commiers;1050;33480322;2084172;767;30056873;283;3423449;31886;32630
49048;Briollay;1374;43811802;2011466;943;38718578;431;5093224;31886;32631
27099;Le Boulay-Morin;342;10905282;643564;261;9903822;81;1001460;31887;32632
38481;Sérézin-de-la-Tour;436;13903266;825688;315;12310261;121;1593005;31888;32633
51642;Villiers-aux-Corneilles;59;1881724;181097;33;1596938;26;284786;31894;32634
29032;Clohars-Fouesnant;1150;36680182;1957263;761;31822025;389;4858157;31896;32635
60686;Villers-sous-Saint-Leu;1176;37509767;2049290;897;33658351;279;3851416;31896;32636
38312;Pommiers-la-Placette;306;9760960;584958;230;8870127;76;890833;31899;32637
01045;Birieux;129;4115086;229381;95;3661898;34;453188;31900;32638
77021;Barbey;89;2839142;193812;65;2549292;24;289850;31900;32639
02485;Missy-aux-Bois;51;1626993;90274;32;1434410;19;192583;31902;32640
74103;Domancy;1034;32988408;1997583;726;29065333;308;3923075;31904;32641
90057;Lachapelle-sous-Chaux;365;11645230;802529;246;10123516;119;1521714;31905;32642
10330;Rouvres-les-Vignes;75;2392976;261882;54;2186804;21;206172;31906;32643
71225;Granges;234;7466819;420829;180;6844016;54;622803;31909;32644
02330;Francilly-Selency;227;7243981;477776;150;6329028;77;914953;31912;32645
90073;Moval;176;5616559;299376;135;5150201;41;466358;31912;32646
69074;Denicé;674;21509312;1444704;453;18935573;221;2573739;31913;32647
76593;Saint-Jean-de-la-Neuville;241;7691082;386689;173;6804833;68;886249;31913;32648
56214;Saint-Gildas-de-Rhuys;1120;35745589;2677332;759;31440888;361;4304701;31916;32649
21113;Broindon;60;1914961;75449;43;1662427;17;252534;31916;32650
51392;Mutigny;102;3255451;215559;75;2964364;27;291087;31916;32651
51073;Bouleuse;90;2872656;155045;64;2553283;26;319373;31918;32652
95139;La Chapelle-en-Vexin;154;4915668;301533;117;4523011;37;392657;31920;32653
01049;La Boisse;1400;44688593;2356279;1000;39412942;400;5275651;31920;32654
68299;Saint-Ulrich;163;5203426;413944;102;4485110;61;718316;31923;32655
64114;Bernadets;283;9034386;675755;204;8140347;79;894039;31924;32656
25392;Mont-de-Vougney;88;2809339;188293;59;2506070;29;303269;31924;32657
25252;Fourcatier-et-Maison-Neuve;47;1500492;106073;36;1408902;11;91590;31925;32658
77264;Lumigny-Nesles-Ormeaux;792;25285474;1814742;561;22849748;231;2435726;31926;32659
10060;Bréviandes;1282;40930230;2374166;775;35902691;507;5027539;31927;32660
74285;Usinens;193;6162302;171932;100;4291335;93;1870967;31929;32661
47169;Moirax;565;18041215;1063491;414;16169324;151;1871891;31931;32662
13107;Simiane-Collongue;2962;94584738;6425980;2002;84499437;960;10085301;31933;32663
32047;Berrac;53;1692511;110957;34;1505131;19;187380;31934;32664
57547;Pommérieux;349;11145161;593523;239;9748161;110;1397000;31935;32665
51444;Pouillon;228;7281309;520999;151;6641284;77;640025;31936;32666
21517;Quincey;225;7187140;390781;164;6512238;61;674902;31943;32667
91468;Ormoy;883;28206099;1680896;683;26103592;200;2102507;31943;32668
17286;Les Portes-en-Ré;473;15109323;1371142;297;12812561;176;2296762;31944;32669
31049;Bazus;297;9487983;631033;207;8561669;90;926314;31946;32670
54110;Cerville;270;8625556;446350;203;7741568;67;883988;31947;32671
01378;Saint-Maurice-de-Gourdans;1220;38978580;2153092;907;35228305;313;3750275;31950;32672
38448;Saint-Prim;577;18437217;1174484;425;16527289;152;1909928;31954;32673
63345;Saint-Genès-Champanelle;1634;52212549;2878103;1210;47012197;424;5200352;31954;32674
67237;Kilstett;1259;40232546;2432202;966;36766113;293;3466433;31956;32675
51379;Montigny-sur-Vesle;242;7733523;505502;158;6628910;84;1104613;31957;32676
02615;Pontruet;161;5145543;277466;117;4516862;44;628681;31960;32677
69177;Sourcieux-les-Mines;958;30625126;1603557;713;27404916;245;3220210;31968;32678
27264;Fours-en-Vexin;89;2845179;197193;60;2524065;29;321114;31968;32679
74313;Vovray-en-Bornes;183;5850639;154102;108;4531198;75;1319441;31971;32680
27072;Bois-Jérôme-Saint-Ouen;376;12021062;662676;284;10789955;92;1231107;31971;32681
74223;La Rivière-Enverse;242;7739035;572166;163;6560865;79;1178170;31979;32682
60351;Lataule;58;1854949;94367;40;1652313;18;202636;31982;32683
60618;Séry-Magneval;145;4637405;324230;102;4223686;43;413719;31982;32684
77455;Soignolles-en-Brie;1105;35340814;2213671;808;32038677;297;3302137;31983;32685
68174;Landser;799;25554684;1711374;558;22644117;241;2910567;31983;32686
64021;Andoins;296;9467475;561030;212;8400397;84;1067078;31985;32687
22134;Louannec;1624;51946055;2938944;1093;45325491;531;6620564;31986;32688
29130;Locmaria-Plouzané;2297;73475958;3874366;1644;65104071;653;8371887;31988;32689
71069;Bussières;311;9949030;627682;226;8847314;85;1101716;31990;32690
78299;Hardricourt;1160;37112714;2987291;838;33754311;322;3358403;31994;32691
88175;Fontenay;236;7550550;501219;144;6452103;92;1098447;31994;32692
31072;Boissède;40;1279755;163358;21;1064298;19;215457;31994;32693
28357;Saint-Piat;631;20189738;1331472;463;18408198;168;1781540;31996;32694
68340;Ueberstrass;174;5567837;311010;125;4925678;49;642159;31999;32695
60547;Rosoy;301;9632123;560122;246;9024663;55;607460;32000;32696
54257;Heillecourt;2991;95715198;6027237;2132;85545696;859;10169502;32001;32697
78192;Dammartin-en-Serve;522;16705195;968781;394;15103599;128;1601596;32002;32698
59173;Deûlémont;745;23842033;1108080;517;20802477;228;3039556;32003;32699
76250;Étainhus;488;15619210;675284;349;13760002;139;1859208;32007;32700
45072;Chanteau;685;21924573;1233065;554;20461574;131;1462999;32007;32701
28187;Guainville;331;10594353;811808;230;9341551;101;1252802;32007;32702
76550;Sahurs;573;18340500;1004078;403;16180002;170;2160498;32008;32703
42042;Chambles;476;15235939;1050559;308;13139164;168;2096775;32008;32704
54411;Ormes-et-Ville;110;3520957;170491;80;3101727;30;419230;32009;32705
56034;Carnac;2839;90885685;7845386;1703;78424590;1136;12461095;32013;32706
10091;Chaudrey;70;2240932;213780;40;1904875;30;336057;32013;32707
26093;Clansayes;270;8643898;596127;181;7629125;89;1014773;32014;32708
91047;Baulne;724;23180157;1710156;538;21012054;186;2168103;32017;32709
21105;Bressey-sur-Tille;310;9925379;425452;244;9017683;66;907696;32017;32710
25411;Morteau;4017;128616206;11040987;2817;116054249;1200;12561957;32018;32711
74080;La Clusaz;1112;35607778;2736727;745;31172941;367;4434837;32021;32712
78520;Richebourg;703;22511800;1700886;460;20700005;243;1811795;32022;32713
57654;Silly-sur-Nied;329;10535479;522600;242;9346834;87;1188645;32023;32714
76555;Saint-André-sur-Cailly;405;12969563;752070;292;11672199;113;1297364;32024;32715
74068;Chêne-en-Semine;215;6886357;226654;133;5203604;82;1682753;32030;32716
51551;Somsois;108;3459216;295793;69;2953623;39;505593;32030;32717
11419;Villautou;26;832802;93673;12;681952;14;150850;32031;32718
25008;Aibre;242;7751494;616961;157;6649485;85;1102009;32031;32719
91540;Saint-Chéron;2551;81713877;5453469;1875;74142165;676;7571712;32032;32720
80213;Cottenchy;192;6150510;379105;149;5600749;43;549761;32034;32721
51595;Vatry;62;1986162;170353;40;1742235;22;243927;32035;32722
02294;Étouvelles;110;3523870;213525;78;3233870;32;290000;32035;32723
63254;Nohanent;1086;34796436;2291874;771;31320492;315;3475944;32041;32724
83001;Les Adrets-de-l'Estérel;1425;45660267;3479293;878;39602220;547;6058047;32042;32725
67008;Altorf;660;21148745;1344616;496;19040519;164;2108226;32044;32726
34320;Vailhauquès;1197;38358492;1882146;830;33801637;367;4556855;32046;32727
77229;La Houssaye-en-Brie;813;26054842;1774331;594;23564321;219;2490521;32048;32728
38503;La Terrasse;1222;39163581;2366698;851;34716636;371;4446945;32049;32729
73108;Épersy;191;6121572;340819;136;5489052;55;632520;32050;32730
51285;Haussimont;83;2660236;273041;55;2325435;28;334801;32051;32731
77299;Montarlot;127;4070940;267000;97;3720539;30;350401;32055;32732
45065;Césarville-Dossainville;119;3815151;323143;78;3252970;41;562181;32060;32733
91129;Cerny;1761;56459339;3797948;1335;51373701;426;5085638;32061;32734
68180;Leimbach;427;13690096;767634;313;12229886;114;1460210;32061;32735
81237;Saint-Amancet;90;2885545;251245;40;2392249;50;493296;32062;32736
67410;Rosenwiller;358;11478791;708093;259;10095690;99;1383101;32064;32737
60576;Saint-Germain-la-Poterie;215;6894110;441230;164;6210057;51;684053;32066;32738
51050;Bergères-sous-Montmirail;77;2469072;272619;45;2031064;32;438008;32066;32739
68074;Durlinsdorf;277;8882965;560084;191;7852219;86;1030746;32068;32740
63241;Montpeyroux;199;6382795;606235;132;5700791;67;682004;32074;32741
28191;Hanches;1303;41795564;2440778;993;37714471;310;4081093;32076;32742
44158;Saint-Étienne-de-Montluc;3223;103389364;6054734;2218;90206082;1005;13183282;32079;32743
60228;Fay-les-Étangs;213;6832775;427971;151;6073309;62;759466;32079;32744
14042;Baron-sur-Odon;401;12864003;790778;293;11583929;108;1280074;32080;32745
68273;Riespach;343;11004006;779772;208;9491346;135;1512660;32082;32746
37272;Villandry;527;16908363;890647;366;15015914;161;1892449;32084;32747
51526;Saudoy;199;6384783;546841;134;5649259;65;735524;32084;32748
59597;Tilloy-lez-Cambrai;296;9497241;689317;210;8592969;86;904272;32085;32749
08295;Mondigny;93;2984139;173911;62;2593491;31;390648;32088;32750
07225;Saint-Clair;534;17135223;1025686;392;15249596;142;1885627;32088;32751
10173;Isle-Aumont;269;8632114;528723;198;7869410;71;762704;32090;32752
35047;Bruz;7938;254735099;16107814;5333;225174759;2605;29560340;32091;32753
90059;Lacollonge;108;3465959;183976;75;3031092;33;434867;32092;32754
38351;Saint-Agnin-sur-Bion;450;14442236;590149;317;12809582;133;1632654;32094;32755
78668;La Villeneuve-en-Chevrie;322;10334359;811277;230;9342919;92;991440;32094;32756
14044;Basly;505;16209422;762842;376;14556944;129;1652478;32098;32757
35256;Saint-Briac-sur-Mer;1262;40510952;3400436;751;34296179;511;6214773;32101;32758
60670;Verneuil-en-Halatte;2355;75605419;4820710;1730;68446624;625;7158795;32104;32759
38153;Engins;229;7352019;402040;162;6518809;67;833210;32105;32760
95682;Villiers-le-Sec;91;2921665;200676;72;2682927;19;238738;32106;32761
41261;Tourailles;66;2119094;157259;45;1891881;21;227213;32107;32762
21534;Ruffey-lès-Beaune;343;11012992;781365;245;9729229;98;1283763;32108;32763
74139;Habère-Lullin;406;13037445;373813;233;10275833;173;2761612;32112;32764
35139;Laillé;2075;66640230;3227843;1505;59524725;570;7115505;32116;32765
51171;Cormicy;631;20266384;1260655;432;17838367;199;2428017;32118;32766
80741;Soyécourt;86;2762205;138395;45;2256769;41;505436;32119;32767
57323;Hettange-Grande;3896;125171753;3366909;1593;68422046;2303;56749707;32128;32768
21127;Chaignay;257;8257267;519171;179;7356380;78;900887;32129;32769
17059;Bourgneuf;555;17832123;1008616;402;15855916;153;1976207;32130;32770
02080;Besny-et-Loizy;188;6040777;415284;141;5561417;47;479360;32132;32771
51004;Allemanche-Launay-et-Soyer;61;1960111;187226;39;1780755;22;179356;32133;32772
67182;Hangenbieten;820;26351352;2020932;622;24082737;198;2268615;32136;32773
62845;Verlincthun;170;5463758;293263;108;4760377;62;703381;32140;32774
45124;Desmonts;82;2635583;193845;59;2302591;23;332992;32141;32775
62231;Colline-Beaumont;71;2282165;118815;41;1875003;30;407162;32143;32776
74097;Cusy;842;27065736;1382233;606;24161931;236;2903805;32145;32777
14530;Ranville;882;28356900;1530282;595;24728160;287;3628740;32151;32778
56258;La Trinité-sur-Mer;1099;35336010;2848842;638;29663161;461;5672849;32153;32779
27639;Le Thuit-Simer;201;6463319;336507;154;5860877;47;602442;32156;32780
69050;Châtillon;1132;36400930;2350652;782;32070232;350;4330698;32156;32781
28121;Dambron;54;1736486;183172;37;1529840;17;206646;32157;32782
51278;Les Grandes-Loges;124;3987533;202221;96;3601029;28;386504;32158;32783
64121;Beyrie-en-Béarn;92;2958514;180756;66;2628701;26;329813;32158;32784
25012;Les Alliés;54;1736895;104617;36;1519011;18;217884;32165;32785
90034;Denney;358;11515011;632822;248;10162941;110;1352070;32165;32786
67471;Souffelweyersheim;4036;129823218;8717795;2915;116574603;1121;13248615;32166;32787
01207;Lapeyrouse;135;4342917;270012;89;3762234;46;580683;32170;32788
69180;Saint-André-la-Côte;138;4439446;275339;90;3896747;48;542699;32170;32789
78068;Blaru;469;15088616;1260906;313;13536504;156;1552112;32172;32790
25034;Auxon-Dessous;635;20429315;1017957;454;17973262;181;2456053;32172;32791
39349;Montain;259;8333316;447744;165;7064818;94;1268498;32175;32792
49055;Cantenay-Épinard;981;31567038;1748592;682;27815832;299;3751206;32178;32793
72247;Pruillé-le-Chétif;580;18664201;964267;438;17005726;142;1658475;32180;32794
57153;Corny-sur-Moselle;1079;34723188;2207556;731;30161024;348;4562164;32181;32795
80032;Assainvillers;73;2349364;275351;51;2082843;22;266521;32183;32796
25110;Chaffois;455;14643497;886285;340;13166494;115;1477003;32184;32797
45330;Trinay;115;3701212;240096;83;3177834;32;523378;32184;32798
51393;Nanteuil-la-Forêt;118;3797857;178077;88;3291265;30;506592;32185;32799
69297;Ternay;2677;86167385;5267346;1893;76643498;784;9523887;32188;32800
95483;Le Perchay;268;8626923;539503;190;7724551;78;902372;32190;32801
42032;Cellieu;772;24851390;1775122;522;21301225;250;3550165;32191;32802
60036;Avrigny;178;5730728;375676;134;5248103;44;482625;32195;32803
51097;Bussy-le-Château;91;2929843;187503;64;2530616;27;399227;32196;32804
84050;Gordes;1151;37058166;2943007;653;31301501;498;5756665;32196;32805
17121;La Couarde-sur-Mer;879;28301740;2528859;565;25093118;314;3208622;32198;32806
70461;Saint-Broing;72;2318311;91897;44;1991347;28;326964;32199;32807
10416;Villemereuil;118;3799545;209594;85;3309342;33;490203;32200;32808
14166;Colleville-Montgomery;1275;41055315;2436512;890;36281972;385;4773343;32200;32809
01386;Saint-Sorlin-en-Bugey;587;18902901;1470274;409;16747480;178;2155421;32203;32810
19009;Les Angles-sur-Corrèze;57;1835568;104265;43;1652483;14;183085;32203;32811
77277;Marles-en-Brie;702;22611557;1383753;522;20621552;180;1990005;32210;32812
80562;Montigny-sur-l'Hallue;100;3221202;170585;70;2953343;30;267859;32212;32813
29061;Gouesnou;3043;98024005;6504725;2060;86280211;983;11743794;32213;32814
28321;Rouvres;447;14399316;1048989;318;13013403;129;1385913;32213;32815
77178;Faÿ-lès-Nemours;246;7925584;532462;189;7246269;57;679315;32218;32816
31162;Donneville;489;15754876;894432;362;14195047;127;1559829;32219;32817
68152;Illfurth;1288;41501606;2490715;878;36376722;410;5124884;32222;32818
67335;Nordheim;406;13082537;996561;279;11602969;127;1479568;32223;32819
67207;Hohatzenheim;103;3318988;166146;73;2791672;30;527316;32223;32820
80304;Fay;50;1611537;177664;28;1415667;22;195870;32231;32821
01091;Châtillon-en-Michaille;1628;52471828;2193055;1012;42948060;616;9523768;32231;32822
60140;Chambors;190;6123865;513758;133;5530046;57;593819;32231;32823
31561;L'Union;6598;212662233;14210268;4725;190299500;1873;22362733;32231;32824
67511;Walbourg;426;13731561;1128458;307;12274009;119;1457552;32234;32825
28249;Mévoisins;330;10637128;657027;245;9562189;85;1074939;32234;32826
77046;Boulancourt;221;7123881;619076;152;6381470;69;742411;32235;32827
68331;Sundhoffen;1033;33299949;2073626;750;30006900;283;3293049;32236;32828
77476;Trocy-en-Multien;129;4158672;314095;92;3774235;37;384437;32238;32829
67118;Eckbolsheim;3482;112261133;8115945;2503;100384537;979;11876596;32240;32830
14385;Magny-en-Bessin;69;2225186;117353;48;1881309;21;343877;32249;32831
51193;Courtisols;1212;39086879;2203494;868;34476238;344;4610641;32250;32832
34307;Sussargues;1309;42216497;2696167;871;36892341;438;5324156;32251;32833
45298;Saint-Pryvé-Saint-Mesmin;2787;89884992;6360170;1952;80058264;835;9826728;32252;32834
51348;Marfaux;75;2418956;200043;52;2210446;23;208510;32253;32835
25097;Brognard;237;7644234;455750;183;6938099;54;706135;32254;32836
57733;Volstroff;707;22806633;951530;409;16938539;298;5868094;32258;32837
95270;Genainville;288;9291771;498765;209;8484724;79;807047;32263;32838
77254;Liverdy-en-Brie;656;21164961;1385621;484;19258680;172;1906281;32264;32839
76560;Saint-Aubin-Épinay;510;16455845;1015642;380;14788951;130;1666894;32266;32840
80626;Pissy;151;4872226;404108;103;4284568;48;587658;32266;32841
25231;Eysson;49;1581054;121899;27;1322163;22;258891;32266;32842
86204;Quinçay;1030;33234539;1971402;719;29348205;311;3886334;32267;32843
67150;Furdenheim;620;20005877;1105862;450;17920189;170;2085688;32268;32844
25091;Les Bréseux;226;7292871;487851;158;6557855;68;735016;32269;32845
59071;Bersée;1104;35628377;2280383;756;31454394;348;4173983;32272;32846
28023;Bailleau-Armenonville;683;22045904;1539681;494;19801173;189;2244731;32278;32847
51570;Le Thoult-Trosnay;59;1904503;155093;42;1701689;17;202814;32280;32848
51327;Loisy-en-Brie;104;3357625;247265;71;2935487;33;422138;32285;32849
77145;Crisenoy;300;9686048;607398;228;8809023;72;877025;32287;32850
84052;Grambois;663;21406683;1916305;377;18550892;286;2855791;32288;32851
10414;Villeloup;72;2324952;196642;54;2123474;18;201478;32291;32852
10232;Merrey-sur-Arce;193;6233611;519203;142;5643390;51;590221;32299;32853
59646;Wasquehal;10618;342976248;24019746;6912;299441410;3706;43534838;32301;32854
73324;Villaroux;105;3392209;188050;74;3023779;31;368430;32307;32855
81025;Belcastel;103;3327702;159303;65;2750350;38;577352;32308;32856
52072;Brethenay;205;6623103;429239;149;5995087;56;628016;32308;32857
02144;Caulaincourt;61;1970838;105460;39;1697501;22;273337;32309;32858
77498;Vignely;137;4426326;302519;109;4044494;28;381832;32309;32859
51354;Marson;141;4556293;292513;108;4071355;33;484938;32314;32860
62544;Manin;92;2973240;189493;69;2672776;23;300464;32318;32861
33408;Saint-Genès-de-Lombaud;167;5397363;338090;101;4654889;66;742474;32320;32862
29006;Bénodet;2133;68942610;4993036;1356;60344349;777;8598261;32322;32863
74272;Sillingy;2268;73308813;3575383;1670;64689384;598;8619429;32323;32864
53099;Forcé;436;14094329;662126;328;12636867;108;1457462;32326;32865
64472;Saint-Castin;388;12543458;670136;280;11218411;108;1325047;32329;32866
51075;Bourgogne;505;16326299;919308;343;14290331;162;2035968;32329;32867
59039;Awoingt;385;12449295;750467;251;10785181;134;1664114;32336;32868
77300;Montceaux-lès-Meaux;321;10380678;830272;237;9570279;84;810399;32339;32869
31215;Gauré;256;8278720;534625;178;7457308;78;821412;32339;32870
27312;Hardencourt-Cocherel;142;4592404;387326;103;4195346;39;397058;32341;32871
27231;Fains;207;6694608;542823;152;5983656;55;710952;32341;32872
51314;Lagery;99;3201853;270556;65;2895701;34;306152;32342;32873
10186;Laines-aux-Bois;252;8150373;487101;178;7103368;74;1047005;32343;32874
27353;Irreville;211;6824573;369129;156;6253600;55;570973;32344;32875
14435;Les Monceaux;86;2781600;196225;62;2498692;24;282908;32344;32876
60019;Antheuil-Portes;210;6792559;580363;136;5885115;74;907444;32346;32877
73124;Gilly-sur-Isère;1565;50622543;3370190;1104;45519738;461;5102805;32347;32878
51577;Tramery;68;2199728;151123;48;1989192;20;210536;32349;32879
62052;Audembert;198;6405095;494516;127;5585237;71;819858;32349;32880
77139;Courtry;3128;101203832;6493898;2286;92835097;842;8368735;32354;32881
80730;Saveuse;442;14301441;882563;341;13129001;101;1172440;32356;32882
77517;Villevaudé;953;30835499;2392471;611;27600849;342;3234650;32356;32883
13008;Aurons;268;8672263;594961;177;7513503;91;1158760;32359;32884
21132;Chamboeuf;156;5048158;209195;123;4655312;33;392846;32360;32885
01181;Groissiat;550;17798331;894234;405;15993224;145;1805107;32361;32886
31297;Lévignac;985;31875868;2137311;660;27950100;325;3925768;32361;32887
10412;Villechétif;451;14595167;849052;361;13347444;90;1247723;32362;32888
57134;Châtel-Saint-Germain;936;30292141;1672590;653;26275062;283;4017079;32363;32889
59190;Élesmes;505;16345201;1195789;350;14324764;155;2020437;32367;32890
51208;Dampierre-sur-Moivre;52;1683086;114668;38;1532156;14;150930;32367;32891
89168;Fleys;94;3042705;270759;66;2728430;28;314275;32369;32892
21555;Saint-Julien;694;22465334;1210438;503;19955221;191;2510113;32371;32893
54113;Champenoux;599;19390551;1263266;449;17599538;150;1791013;32372;32894
64034;Arbérats-Sillègue;128;4143616;311341;81;3567953;47;575663;32372;32895
91109;Brières-les-Scellés;529;17125437;1026086;397;15403538;132;1721899;32373;32896
91184;Courdimanche-sur-Essonne;139;4500029;293537;104;4114975;35;385054;32374;32897
74134;Les Gets;768;24864239;2033383;535;22003082;233;2861157;32375;32898
13068;Paradou;868;28101914;1982505;581;24956870;287;3145044;32375;32899
76309;Gonzeville;62;2007318;109333;32;1545623;30;461695;32376;32900
45138;Escrignelles;39;1262697;135144;26;1106366;13;156331;32377;32901
68022;Battenheim;770;24931058;1485445;572;22587242;198;2343816;32378;32902
95652;Viarmes;2771;89725065;6080456;1993;81145596;778;8579469;32380;32903
13023;Ceyreste;2404;77846781;5892938;1587;68824779;817;9022002;32382;32904
59462;Phalempin;2453;79442157;5535285;1613;70166094;840;9276063;32386;32905
81173;Montcabrier;126;4081360;244511;76;3323282;50;758078;32392;32906
25098;Buffard;95;3077252;326079;60;2738508;35;338744;32392;32907
38023;Avignonet;111;3595712;254907;80;3275045;31;320667;32394;32908
14605;Saint-Laurent-sur-Mer;145;4697770;482291;102;4193323;43;504447;32398;32909
74210;Perrignier;862;27928334;860945;529;20769174;333;7159160;32399;32910
25296;Les Gras;409;13252862;929947;295;11955213;114;1297649;32403;32911
60421;Mont-l'Évêque;229;7420369;605976;163;6568365;66;852004;32403;32912
67085;Dangolsheim;321;10401855;485535;236;9313763;85;1088092;32405;32913
10430;Villiers-Herbisse;50;1620237;145676;29;1391369;21;228868;32405;32914
64018;Amendeuix-Oneix;219;7097518;533595;123;5961525;96;1135993;32409;32915
67052;Boersch;1291;41842954;2810977;919;37161743;372;4681211;32411;32916
27688;Villalet;55;1782702;148895;40;1663068;15;119634;32413;32917
77290;Méry-sur-Marne;341;11053247;709009;228;9866626;113;1186621;32414;32918
35287;Saint-Lunaire;1327;43014015;3211963;830;36851523;497;6162492;32414;32919
45067;Chaingy;1768;57311820;3450629;1317;52125751;451;5186069;32416;32920
76609;Sainte-Marie-au-Bosc;158;5121826;268861;113;4575951;45;545875;32417;32921
71204;Fragnes;464;15042413;723108;316;13312826;148;1729587;32419;32922
54409;Omelmont;88;2852913;185949;53;2399279;35;453634;32419;32923
27044;Les Baux-Sainte-Croix;480;15562032;1091804;373;14589397;107;972635;32421;32924
28344;Saint-Léger-des-Aubées;133;4312060;267439;94;3870708;39;441352;32422;32925
76314;Graimbouville;279;9045810;461663;191;7968104;88;1077706;32422;32926
68105;Gildwiller;149;4833379;351548;94;4080370;55;753009;32439;32927
33483;Saint-Sulpice-et-Cameyrac;2422;78572996;5793595;1558;69211814;864;9361182;32441;32928
25086;Braillans;72;2335934;93794;52;2056129;20;279805;32444;32929
76169;La Cerlangue;572;18559425;1009301;395;16326723;177;2232702;32447;32930
67065;Breuschwickersheim;668;21677723;1429606;483;19392766;185;2284957;32452;32931
55036;Beauclair;41;1330590;157642;25;1140914;16;189676;32453;32932
01209;Léaz;303;9833963;288519;161;6537429;142;3296534;32455;32933
41033;Chambon-sur-Cisse;401;13014942;873453;295;11924449;106;1090493;32456;32934
59031;Audignies;148;4803620;322242;103;4225050;45;578570;32457;32935
61433;Saint-Nicolas-des-Bois;129;4187030;413402;92;3756969;37;430061;32458;32936
95436;Mours;669;21714154;1283024;520;20255082;149;1459072;32458;32937
69083;Éveux;561;18210842;1064293;385;16200335;176;2010507;32461;32938
31212;Garidech;748;24281885;1361439;524;21585132;224;2696753;32462;32939
77011;Aufferville;276;8960062;571581;187;7947632;89;1012430;32464;32940
51344;Mardeuil;803;26070156;1850785;624;23834796;179;2235360;32466;32941
28146;Faverolles;450;14611496;1051132;307;13031490;143;1580006;32470;32942
42161;Notre-Dame-de-Boisset;253;8215459;462815;175;7164831;78;1050628;32472;32943
72217;Neuville-sur-Sarthe;1190;38641922;2419390;871;34944045;319;3697877;32472;32944
67086;Daubensand;193;6268958;447224;141;5656572;52;612386;32482;32945
73017;Apremont;525;17053230;1096448;372;14596007;153;2457223;32482;32946
95676;Villers-en-Arthies;255;8283728;507647;191;7599000;64;684728;32485;32947
67200;Hipsheim;418;13579097;734865;316;12247951;102;1331146;32486;32948
35024;Betton;5257;170781638;10466945;3807;153844203;1450;16937435;32487;32949
45194;Mardié;1274;41388724;2314314;933;37200601;341;4188123;32487;32950
77255;Livry-sur-Seine;1111;36095754;2547624;791;32506968;320;3588786;32489;32951
33238;Léognan;5090;165376475;10789995;3566;147404387;1524;17972088;32490;32952
17274;Périgny;3985;129486770;8157905;2742;115310644;1243;14176126;32494;32953
51040;Bassuet;155;5036719;524821;99;4367740;56;668979;32495;32954
62213;Carency;366;11893382;741256;265;10797079;101;1096303;32496;32955
68101;Galfingue;409;13291419;893231;296;11899196;113;1392223;32497;32956
14101;Bretteville-sur-Odon;2102;68311347;4956588;1433;60381299;669;7930048;32498;32957
14232;Ducy-Sainte-Marguerite;75;2437495;149371;49;2188693;26;248802;32500;32958
91131;Chalou-Moulineux;218;7085375;382619;162;6516498;56;568877;32502;32959
54316;Limey-Remenauville;117;3802716;195625;85;3388610;32;414106;32502;32960
90098;Urcerey;128;4160516;266752;92;3719338;36;441178;32504;32961
60510;Porcheux;180;5850916;293487;131;5243775;49;607141;32505;32962
27661;La Trinité-de-Thouberville;223;7249049;464296;160;6465182;63;783867;32507;32963
10406;Verrières;894;29068361;1871153;647;25833857;247;3234504;32515;32964
31572;Venerque;1298;42204928;2627099;842;36849549;456;5355379;32515;32965
54127;Chenières;318;10340307;453714;169;6951886;149;3388421;32517;32966
38109;Chozeau;510;16585965;952568;350;14592390;160;1993575;32522;32967
60050;Bazicourt;164;5333582;322041;115;4621269;49;712313;32522;32968
51597;Vauciennes;158;5138504;440988;109;4568083;49;570421;32522;32969
54225;Gézoncourt;84;2732155;159721;65;2481205;19;250950;32526;32970
14326;Hermival-les-Vaux;425;13823476;951318;289;12112436;136;1711040;32526;32971
91095;Bouray-sur-Juine;1082;35195061;2260689;843;32554369;239;2640692;32528;32972
95598;Soisy-sous-Montmorency;9599;312241502;25441053;6625;278895420;2974;33346082;32529;32973
26294;Saint-Bardoux;314;10215932;685587;178;8566278;136;1649654;32535;32974
51504;Saint-Martin-sur-le-Pré;430;13991313;860158;318;12519401;112;1471912;32538;32975
62769;Saint-Tricat;317;10316124;760236;198;9117234;119;1198890;32543;32976
73082;La Chavanne;271;8819149;437149;203;8036631;68;782518;32543;32977
80173;Cardonnette;243;7907957;498800;174;6982905;69;925052;32543;32978
68011;Aspach-le-Bas;632;20567323;1163517;467;18402343;165;2164980;32543;32979
67309;Mundolsheim;2627;85496234;5465723;1918;76452107;709;9044127;32545;32980
38540;Veurey-Voroize;702;22846760;1476233;488;20403769;214;2442991;32545;32981
64060;Artiguelouve;750;24409497;1313283;523;21501794;227;2907703;32546;32982
58160;Marzy;1876;61066731;4128527;1380;55298360;496;5768371;32552;32983
67041;Birkenwald;153;4980924;237818;99;4351453;54;629471;32555;32984
80305;Ferrières;266;8660103;744391;183;7732453;83;927650;32557;32985
76756;Yquebeuf;116;3776683;235793;82;3461150;34;315533;32558;32986
64183;Caubios-Loos;237;7717035;590585;172;7016410;65;700625;32561;32987
21266;Flacey;85;2767736;169911;55;2332168;30;435568;32562;32988
67430;Saint-Pierre-Bois;387;12601497;711612;261;10876548;126;1724949;32562;32989
59004;Aix;557;18138248;1108727;359;15880113;198;2258135;32564;32990
37266;Veigné;2981;97079126;6021167;2134;86553731;847;10525395;32566;32991
41112;Lassay-sur-Croisne;128;4169307;349136;87;3579369;41;589938;32573;32992
91573;Saint-Pierre-du-Perray;4321;140748961;8296892;3233;127305639;1088;13443322;32573;32993
74154;Lugrin;1255;40880048;2740578;842;35846149;413;5033899;32574;32994
21267;Flagey-Echézeaux;251;8176485;682098;189;7523390;62;653095;32576;32995
17190;L'Houmeau;1469;47853883;3425640;1012;42385991;457;5467892;32576;32996
68149;Huningue;3938;128285100;12028065;2593;114052271;1345;14232829;32576;32997
24098;Champcevinel;1494;48672351;3696465;1051;43488171;443;5184180;32579;32998
87201;Verneuil-sur-Vienne;2263;73726198;4910595;1658;66128393;605;7597805;32579;32999
51088;Brimont;233;7591163;518521;176;6750979;57;840184;32580;33000
51013;Aougny;46;1498885;100671;25;1274388;21;224497;32584;33001
02542;Neuflieux;44;1433937;83868;32;1277724;12;156213;32589;33002
91037;Auvernaux;175;5703454;363765;139;5335645;36;367809;32591;33003
55046;Beney-en-Woëvre;82;2672483;217642;42;2198584;40;473899;32591;33004
62653;Pernes-lès-Boulogne;246;8017668;502855;158;7139838;88;877830;32592;33005
91461;Ollainville;2152;70139029;4494983;1605;64501413;547;5637616;32592;33006
08032;Aussonce;91;2965930;187807;57;2541380;34;424550;32593;33007
51038;Baslieux-sous-Châtillon;104;3389821;274351;66;2940934;38;448887;32594;33008
25467;Pouilley-les-Vignes;972;31683658;1758872;678;27475261;294;4208397;32596;33009
77377;Presles-en-Brie;1083;35301899;2392686;840;32440801;243;2861098;32596;33010
86214;Saint-Benoît;3835;125007679;8567465;2584;110368025;1251;14639654;32597;33011
76064;Beaurepaire;244;7953661;588676;174;7238179;70;715482;32597;33012
28242;Méréglise;44;1434392;108805;27;1243148;17;191244;32600;33013
74186;Montagny-les-Lanches;327;10660568;616434;224;9276318;103;1384250;32601;33014
67443;Scheibenhard;420;13694589;961041;305;12240267;115;1454322;32606;33015
28292;Ouerre;353;11510572;619885;235;10091020;118;1419552;32608;33016
01042;Bey;133;4337399;227841;97;3893935;36;443464;32612;33017
08194;Glaire;524;17089309;1011924;296;14745299;228;2344010;32613;33018
73182;Mouxy;1131;36886912;2286591;838;32963544;293;3923368;32614;33019
31497;Saint-Loup-Cammas;882;28766107;1739743;637;25728765;245;3037342;32615;33020
51179;Coupéville;95;3098448;171992;66;2825029;29;273419;32615;33021
59638;Wannehain;517;16863032;1360141;353;14880156;164;1982876;32617;33022
38120;La Combe-de-Lancey;350;11416312;658225;259;10269893;91;1146419;32618;33023
06140;Le Tignet;1769;57701512;4228991;1189;50939347;580;6762165;32618;33024
45308;Semoy;1526;49779574;2882295;1138;44711794;388;5067780;32621;33025
21230;Diénay;165;5382467;385511;119;4902143;46;480324;32621;33026
77525;Vinantes;169;5513333;364538;113;4941945;56;571388;32623;33027
28281;Nogent-sur-Eure;238;7764511;527296;176;6967708;62;796803;32624;33028
63157;Fayet-le-Château;198;6460148;1085434;110;5550483;88;909665;32627;33029
25127;Charquemont;1391;45386016;3521885;1010;41060982;381;4325034;32628;33030
21569;Saint-Romain;123;4013627;284508;86;3614197;37;399430;32631;33031
28361;Bleury - Saint-Symphorien;655;21374422;1320199;486;19439159;169;1935263;32633;33032
61011;Aubusson;191;6233826;322143;144;5611543;47;622283;32638;33033
67226;Ittenheim;1118;36492500;2470500;835;33248458;283;3244042;32641;33034
13002;Allauch;10910;356113479;27545147;7396;316701511;3514;39411968;32641;33035
68260;Raedersheim;572;18670784;1028695;408;16852359;164;1818425;32641;33036
71210;Fuissé;187;6104580;491838;129;5495060;58;609520;32645;33037
91216;Épinay-sur-Orge;5499;179530532;14047007;3947;165120386;1552;14410146;32648;33038
77190;Fontains;152;4962658;438293;106;4436990;46;525668;32649;33039
28034;Berchères-Saint-Germain;380;12407266;660744;296;11414736;84;992530;32651;33040
25271;Gilley;797;26024694;1670725;540;23103295;257;2921399;32653;33041
69295;Simandres;816;26646874;1566935;618;23923511;198;2723363;32655;33042
51117;Champigneul-Champagne;156;5094643;302595;97;4449065;59;645578;32658;33043
84061;Lagarde-Paréol;171;5584672;362606;110;4797108;61;787564;32659;33044
60671;Versigny;196;6401248;509924;143;5872744;53;528504;32659;33045
45333;Vennecy;698;22797646;1266300;544;20649288;154;2148358;32661;33046
84135;Uchaux;776;25349114;1738850;498;22225143;278;3123971;32666;33047
68261;Rammersmatt;108;3528084;193043;78;3136910;30;391174;32667;33048
76558;Saint-Aubin-Celloville;462;15092523;1148059;344;13759926;118;1332597;32668;33049
95183;Courdimanche;3202;104607469;6827491;2357;94826758;845;9780711;32669;33050
25398;Montflovin;44;1437570;62456;26;1267675;18;169895;32672;33051
92049;Montrouge;28507;931392331;87697184;20924;860556501;7583;70835830;32672;33052
59116;Bry;193;6305834;393299;131;5502422;62;803412;32673;33053
78073;Bois-d'Arcy;7004;228848918;15646349;5516;212786791;1488;16062127;32674;33054
69167;Rivolet;276;9018230;632907;171;7798700;105;1219530;32675;33055
44204;Thouaré-sur-Loire;3848;125735770;6386697;2735;111301975;1113;14433795;32676;33056
25562;Thulay;115;3757843;273993;87;3471153;28;286690;32677;33057
13038;Fontvieille;2161;70617278;4776471;1253;61453499;908;9163779;32678;33058
17051;Le Bois-Plage-en-Ré;1571;51338760;4499311;1049;45683438;522;5655322;32679;33059
13072;Peynier;1707;55783655;4174149;1166;49323210;541;6460445;32679;33060
38110;Chuzelles;1029;33629250;1910293;738;29800117;291;3829133;32681;33061
10344;Saint-Léger-près-Troyes;397;12974815;929762;303;11668365;94;1306450;32682;33062
68001;Algolsheim;552;18043109;863098;363;15404786;189;2638323;32687;33063
51515;Saint-Remy-sur-Bussy;147;4805172;351041;82;3981115;65;824057;32688;33064
74099;Demi-Quartier;585;19124414;1545996;404;16953496;181;2170918;32691;33065
25027;Arguel;130;4249908;275472;93;3810851;37;439057;32692;33066
91069;Boigneville;231;7552077;763321;162;6838042;69;714035;32693;33067
69279;Jonage;2740;89583047;5553539;1986;80220480;754;9362567;32695;33068
14243;Équemauville;675;22069053;2032444;450;19718499;225;2350554;32695;33069
95306;Herblay;13695;447772902;33432134;9832;408622878;3863;39150024;32696;33070
91599;Soisy-sur-École;765;25015959;1887118;574;22701326;191;2314633;32701;33071
21200;Couchey;631;20634227;1376829;455;18418025;176;2216202;32701;33072
62878;Warlus;196;6409420;399598;138;5662327;58;747093;32701;33073
74054;Chainaz-les-Frasses;297;9712472;507416;204;8355896;93;1356576;32702;33074
71250;Laizé;506;16548966;979481;375;14789331;131;1759635;32705;33075
34176;Mudaison;1385;45302771;3641185;885;39878690;500;5424081;32710;33076
76489;Oudalle;195;6378770;307181;137;5586011;58;792759;32712;33077
86263;Smarves;1331;43549569;3292789;900;38329643;431;5219926;32719;33078
51254;Fontaine-Denis-Nuisy;143;4679406;451203;100;4158194;43;521212;32723;33079
80231;Curlu;64;2094317;135236;39;1772210;25;322107;32724;33080
09099;Cos;207;6773827;541871;145;6077441;62;696386;32724;33081
91665;La Ville-du-Bois;3579;117133611;7795570;2663;106784926;916;10348685;32728;33082
77365;Le Plessis-Feu-Aussoux;260;8509304;551970;189;7714275;71;795029;32728;33083
74008;Ambilly;3631;118840962;3370471;1729;76596535;1902;42244427;32730;33084
33085;Camblanes-et-Meynac;1407;46053470;3206010;934;40588822;473;5464648;32732;33085
60206;Élincourt-Sainte-Marguerite;461;15089868;1020144;317;13510919;144;1578949;32733;33086
27668;Le Val-David;379;12407530;891510;292;11272216;87;1135314;32738;33087
51244;Faux-Vésigneul;129;4223157;348387;83;3688646;46;534511;32738;33088
74249;Saint-Paul-en-Chablais;1132;37060832;2175512;779;32359841;353;4700991;32739;33089
68144;Hombourg;529;17319496;1113850;364;14998912;165;2320584;32740;33090
80632;Pont-de-Metz;1105;36178288;2528664;757;32627512;348;3550776;32741;33091
10375;Thennelières;160;5240071;299556;114;4665576;46;574495;32750;33092
56150;Noyalo;399;13068010;852843;285;11586013;114;1481997;32752;33093
74006;Allonzier-la-Caille;943;30886703;879093;584;23543612;359;7343091;32754;33094
77438;Saint-Thibault-des-Vignes;3181;104200619;7868670;2263;94521415;918;9679204;32757;33095
60231;Feigneux;226;7405076;525169;171;6738585;55;666491;32766;33096
06122;Saint-Jeannet;2172;71172285;5711105;1435;63740123;737;7432162;32768;33097
91284;Les Granges-le-Roi;524;17170810;1075445;395;15624750;129;1546060;32769;33098
27477;Pressagny-l'Orgueilleux;378;12386944;787623;265;11180669;113;1206275;32770;33099
21601;Semezanges;53;1737009;114875;40;1603977;13;133032;32774;33100
14465;Nonant;229;7505383;433951;163;6549383;66;956000;32775;33101
91315;Itteville;3302;108245408;6524256;2578;100055203;724;8190205;32782;33102
37214;Saint-Cyr-sur-Loire;9455;309981471;24352040;6504;276411020;2951;33570451;32785;33103
77278;Marolles-en-Brie;186;6098371;433309;143;5535245;43;563126;32787;33104
02428;Licy-Clignon;41;1344274;73875;24;1143982;17;200292;32787;33105
33384;Saint-Christophe-des-Bardes;232;7607757;928211;134;6570880;98;1036877;32792;33106
68271;Riedisheim;6760;221677836;17437760;4582;195157638;2178;26520198;32793;33107
77112;Chevrainvilliers;139;4558345;317137;102;4192648;37;365697;32794;33108
32210;Lias;226;7412157;374560;163;6667725;63;744432;32797;33109
78346;Longnes;742;24335998;1529461;532;21308200;210;3027798;32798;33110
25262;Fuans;250;8199706;4883548;178;7299391;72;900315;32799;33111
49290;Saint-Jean-des-Mauvrets;821;26929131;1512526;563;23422756;258;3506375;32800;33112
67217;Ichtratzheim;145;4756096;345849;106;4316322;39;439774;32801;33113
13062;Mimet;2341;76789798;4934620;1575;66800606;766;9989192;32802;33114
14543;Rots;743;24372538;1585943;517;21742752;226;2629786;32803;33115
52340;Montsaugeon;43;1410622;81171;29;1253088;14;157534;32805;33116
33079;Cadarsac;158;5183385;367351;106;4532589;52;650796;32806;33117
76592;Saint-Jean-de-Folleville;389;12762133;656845;269;11225238;120;1536895;32808;33118
51549;Somme-Yèvre;59;1935962;148444;44;1767498;15;168464;32813;33119
60600;Saint-Vaast-de-Longmont;312;10239311;673515;227;9215574;85;1023737;32818;33120
77343;Ocquerre;187;6137476;362437;123;5242679;64;894797;32821;33121
64518;Sendets;427;14015184;896272;295;12537510;132;1477674;32822;33122
60491;Pierrefonds;1023;33580063;2918855;625;29344460;398;4235603;32825;33123
77270;Maisoncelles-en-Brie;410;13458306;820977;292;11870301;118;1588005;32825;33124
69090;Frontenas;395;12967123;824006;282;11721152;113;1245971;32828;33125
45013;Augerville-la-Rivière;124;4070822;259829;92;3767457;32;303365;32829;33126
51292;Herpont;66;2166782;164126;41;1829924;25;336858;32830;33127
69287;Saint-Bonnet-de-Mure;3334;109466527;6911653;2459;98398975;875;11067552;32833;33128
31328;Mauremont;139;4564050;215751;98;3972546;41;591504;32835;33129
57043;Ay-sur-Moselle;778;25546401;1402586;506;21471386;272;4075015;32836;33130
01353;Sainte-Euphémie;721;23675193;1183844;529;21176726;192;2498467;32837;33131
76747;Virville;156;5122764;257542;114;4596031;42;526733;32838;33132
77094;Charmentray;138;4532191;338172;109;4182430;29;349761;32842;33133
51449;Prunay;482;15830166;926386;356;14354503;126;1475663;32843;33134
25200;Devecey;698;22926462;1325862;490;20121444;208;2805018;32846;33135
91333;Leuville-sur-Orge;2075;68159091;4387123;1569;63323179;506;4835912;32848;33136
65479;Visker;178;5847306;501444;116;5206619;62;640687;32850;33137
10316;Rhèges;120;3942288;364757;70;3287421;50;654867;32852;33138
57510;Noisseville;518;17019444;937859;374;15139326;144;1880118;32856;33139
95046;Banthelu;76;2497333;229533;56;2263793;20;233540;32860;33140
02098;Bonneil;209;6867741;667086;130;5929917;79;937824;32860;33141
68118;Habsheim;2633;86530999;6585864;1871;77225449;762;9305550;32864;33142
51571;Val-de-Vesle;407;13375896;838687;283;11842637;124;1533259;32865;33143
73103;Drumettaz-Clarafond;1318;43317010;2816425;961;38593184;357;4723826;32866;33144
21048;Barges;220;7230496;355196;168;6531610;52;698886;32866;33145
10069;Buxières-sur-Arce;71;2333510;218002;40;2024796;31;308714;32866;33146
77367;Le Plessis-Placy;134;4404184;336980;80;3817938;54;586246;32867;33147
60195;Delincourt;266;8742806;589371;198;8055219;68;687587;32868;33148
49294;Saint-Lambert-la-Potherie;1125;36978495;1817494;815;32652943;310;4325552;32870;33149
27580;Saint-Ouen-de-Thouberville;1120;36815845;1954019;778;32470332;342;4345513;32871;33150
78413;Mondreville;193;6344329;546639;138;5708331;55;635998;32872;33151
38515;Trept;961;31591771;1589338;603;27400571;358;4191200;32874;33152
59263;Goeulzin;533;17523421;1306629;340;14988460;193;2534961;32877;33153
68356;Walheim;479;15752555;978025;344;13825701;135;1926854;32886;33154
38526;Vatilieu;195;6413103;437853;130;5659513;65;753590;32888;33155
25124;Charmauvillers;147;4834624;398597;100;4265793;47;568831;32889;33156
68359;Wattwiller;874;28746800;1803519;599;25009175;275;3737625;32891;33157
41113;Lavardin;129;4243200;303734;83;3718637;46;524563;32893;33158
77134;Courchamp;76;2499931;202804;48;2163769;28;336162;32894;33159
51477;Saint-Étienne-sur-Suippe;134;4408176;317911;91;3858190;43;549986;32897;33160
51372;Moncetz-Longevas;266;8750722;476505;204;7950568;62;800154;32897;33161
01321;Revonnas;406;13357343;797535;305;12014467;101;1342876;32900;33162
21532;Rouvres-en-Plaine;490;16121102;942707;360;14528020;130;1593082;32900;33163
77410;Saint-Germain-Laxis;334;10988866;685552;263;10184102;71;804764;32901;33164
74075;Chilly;574;18885355;681212;380;15612936;194;3272419;32901;33165
91240;Fontaine-la-Rivière;124;4079851;290382;93;3566436;31;513415;32902;33166
18180;Plaimpied-Givaudins;861;28329559;1628277;658;25719038;203;2610521;32903;33167
45005;Andonville;104;3422009;234645;76;3010108;28;411901;32904;33168
65392;Saint-Martin;213;7008851;343291;130;6102900;83;905951;32905;33169
95392;Mériel;2476;81475041;5756198;1919;75548819;557;5926222;32906;33170
54132;Clérey-sur-Brenon;35;1151722;81587;24;1025260;11;126462;32906;33171
69146;Oingt;322;10596279;606409;223;9286303;99;1309976;32908;33172
55143;Damloup;63;2073216;117437;45;1840096;18;233120;32908;33173
77413;Saint-Germain-sur-Morin;1719;56570466;3730322;1314;51833796;405;4736670;32909;33174
17297;Rivedoux-Plage;1423;46835070;3872840;966;41646733;457;5188337;32913;33175
31459;Roquesérière;344;11322714;786656;227;9945393;117;1377321;32915;33176
27191;La Croix-Saint-Leufroy;581;19123821;1630992;387;16860385;194;2263436;32915;33177
74037;Boëge;823;27090543;735759;490;21550335;333;5540208;32917;33178
31364;Montberon;1260;41496107;2348510;920;37244322;340;4251785;32933;33179
77269;Maincy;962;31683689;2360356;674;28414393;288;3269296;32935;33180
38184;Grenay;720;23714137;1438006;509;21079033;211;2635104;32936;33181
73064;Challes-les-Eaux;2730;89929192;6560316;1911;80211472;819;9717720;32941;33182
90082;Autrechêne;133;4381239;220773;98;3874787;35;506452;32942;33183
65070;Bartrès;224;7379053;425719;143;6021276;81;1357777;32942;33184
62736;Sailly-sur-la-Lys;1980;65225908;3560142;1295;57016315;685;8209593;32942;33185
91691;Yerres;15468;509561549;37236634;11733;468324722;3735;41236827;32943;33186
13093;Saint-Estève-Janson;183;6028806;496452;126;5355307;57;673499;32944;33187
68078;Eguisheim;964;31758944;2163160;663;28076933;301;3682011;32945;33188
60335;Lachapelle-sous-Gerberoy;88;2899489;177113;61;2572614;27;326875;32949;33189
77392;Rouvres;282;9291822;552066;224;8636512;58;655310;32950;33190
08162;Fagnon;181;5963980;343955;130;5323386;51;640594;32950;33191
60473;Ognes;143;4711900;472880;104;4340996;39;370904;32950;33192
54328;Ludres;3323;109494424;7289200;2423;97965625;900;11528799;32950;33193
53034;Bonchamp-lès-Laval;2724;89757294;4849254;2008;80234057;716;9523237;32951;33194
73140;Jongieux;146;4810934;364834;97;4207056;49;603878;32952;33195
95675;Villeron;401;13215014;926856;313;12320090;88;894924;32955;33196
25004;Abbévillers;556;18324227;1343867;409;16777218;147;1547009;32957;33197
27693;Sylvains-les-Moulins;575;18954445;1221223;417;17211133;158;1743312;32964;33198
64059;Artigueloutan;476;15692008;763724;334;13784129;142;1907879;32966;33199
57678;Tressange;966;31854290;1641868;371;19499544;595;12354746;32975;33200
77085;Chanteloup-en-Brie;1193;39348500;2238486;888;35883699;305;3464801;32983;33201
95055;Bellefontaine;251;8279221;612813;166;7292384;85;986837;32985;33202
42172;Planfoy;484;15964949;897996;340;14270365;144;1694584;32985;33203
05057;Fouillouse;113;3727472;271900;68;3287645;45;439827;32986;33204
13029;Cornillon-Confoux;755;24906959;2298712;487;21962305;268;2944654;32989;33205
73079;Châteauneuf;410;13525767;547518;274;12006246;136;1519521;32990;33206
76509;Préaux;803;26491039;1422081;588;23721415;215;2769624;32990;33207
69204;Saint-Genis-Laval;10808;356569131;26288581;7514;320684314;3294;35884817;32991;33208
38309;Poisat;1086;35830488;2638722;785;32395469;301;3435019;32993;33209
76357;Hermeville;177;5839895;332010;125;5127669;52;712226;32994;33210
74291;Vanzy;154;5081355;131317;98;3983360;56;1097995;32996;33211
37124;Larçay;1222;40323822;2522650;911;36451733;311;3872089;32998;33212
68032;Berrwiller;576;19007293;1018603;421;16874728;155;2132565;32999;33213
17222;Marsilly;1400;46199839;2899418;984;41152643;416;5047196;33000;33214
31339;Mérenvielle;223;7359954;488807;152;6573981;71;785973;33004;33215
51083;Braux-Saint-Remy;43;1419422;89058;30;1231942;13;187480;33010;33216
60666;Ver-sur-Launette;634;20928725;1578441;483;19220294;151;1708431;33011;33217
51140;Chaumuzy;183;6041849;631066;111;5278136;72;763713;33016;33218
41191;Roches;32;1056593;69797;19;874331;13;182262;33019;33219
80798;Villers-Bocage;714;23575431;1558047;493;20774970;221;2800461;33019;33220
51347;Mareuil-sur-Ay;652;21528651;1593137;473;19573511;179;1955140;33019;33221
54537;Ugny;341;11260582;337738;181;7172859;160;4087723;33022;33222
51029;Avize;879;29026952;2711920;596;25728378;283;3298574;33023;33223
74213;Poisy;3638;120136733;6974020;2676;106303191;962;13833542;33023;33224
50102;Carolles;469;15489356;1193201;272;13199612;197;2289744;33026;33225
10149;Feuges;134;4425823;275852;107;4028767;27;397056;33029;33226
14611;Saint-Manvieu-Bocage;264;8720347;320965;140;7301837;124;1418510;33032;33227
25465;Pont-les-Moulins;87;2873803;185270;55;2508262;32;365541;33032;33228
51412;Ognes;33;1090068;85773;21;963015;12;127053;33032;33229
45092;Chevillon-sur-Huillard;722;23850644;1314638;492;21266863;230;2583781;33034;33230
83068;Grimaud;2987;98677933;10381341;1787;86942683;1200;11735250;33036;33231
62908;La Capelle-lès-Boulogne;813;26858883;1822914;533;23752387;280;3106496;33037;33232
69134;Moiré;100;3303949;206037;71;2906096;29;397853;33039;33233
30138;Langlade;1091;36049248;2291945;735;31066844;356;4982404;33042;33234
27326;Hécourt;172;5683521;454388;104;4790318;68;893203;33044;33235
95438;Moussy;59;1949752;106550;42;1739111;17;210641;33047;33236
68366;Wickerschwihr;361;11930233;637691;275;10700013;86;1230220;33048;33237
10332;Ruvigny;214;7074070;378844;164;6424616;50;649454;33056;33238
26170;Malissard;1624;53691244;3077744;1173;47893546;451;5797698;33061;33239
10007;Arconville;68;2248361;272490;39;1930305;29;318056;33064;33240
69289;Saint-Pierre-de-Chandieu;2290;75724734;4830091;1718;68327075;572;7397659;33068;33241
51536;Sillery;843;27876262;1709936;641;25448051;202;2428211;33068;33242
60271;Gerberoy;57;1885011;316987;36;1649062;21;235949;33070;33243
73267;Saint-Pancrace;148;4894433;289380;118;4505457;30;388976;33070;33244
95452;Nointel;445;14717923;1060267;358;13854169;87;863754;33074;33245
02048;Barenton-sur-Serre;66;2183463;156165;45;1960838;21;222625;33083;33246
69017;Bagnols;386;12770973;737910;253;11188230;133;1582743;33085;33247
27439;Normanville;580;19189926;1292130;423;17140679;157;2049247;33086;33248
21245;Épagny;142;4698243;200650;104;4105725;38;592518;33086;33249
30186;Nages-et-Solorgues;797;26370240;1774258;543;23363056;254;3007184;33087;33250
28050;Boncourt;159;5261117;492879;106;4737555;53;523562;33089;33251
57148;Colligny;173;5724601;258396;132;5022046;41;702555;33090;33252
63075;Chamalières;11291;373801035;34541204;7868;337970536;3423;35830499;33106;33253
46155;Larnagol;72;2383864;212890;37;2021126;35;362738;33109;33254
19077;Estivals;77;2549453;244581;47;2235993;30;313460;33110;33255
51591;Vandeuil;100;3311248;205695;67;2903327;33;407921;33112;33256
14196;Crépon;115;3808161;313660;75;3243329;40;564832;33114;33257
68186;Ligsdorf;178;5894404;417392;119;5284251;59;610153;33115;33258
84093;Puget;358;11855519;786354;249;10478863;109;1376656;33116;33259
57067;Bertrange;1285;42559329;1411697;741;30544199;544;12015130;33120;33260
60023;Armancourt;275;9108513;572127;214;8409029;61;699484;33122;33261
01250;Misérieux;772;25573214;1411982;575;23036367;197;2536847;33126;33262
60527;Réez-Fosse-Martin;72;2385195;205845;40;2030586;32;354609;33128;33263
50600;Tonneville;294;9741177;456119;224;8848873;70;892304;33133;33264
60007;Agnetz;1431;47414310;2661631;1072;42917512;359;4496798;33134;33265
64550;Uzos;402;13320271;952116;259;11523898;143;1796373;33135;33266
51425;Passy-Grigny;225;7455552;777020;146;6655349;79;800203;33136;33267
91099;Boutigny-sur-Essonne;1663;55104847;4344538;1171;48896775;492;6208072;33136;33268
28076;La Chapelle-Forainvilliers;90;2982289;190613;63;2639266;27;343023;33137;33269
71074;Chaintré;293;9709635;709071;221;8877958;72;831677;33139;33270
64035;Arbonne;1075;35625296;2717245;653;30636912;422;4988384;33140;33271
21428;Monthelie;91;3015778;298160;59;2653471;32;362307;33140;33272
77281;Mauperthuis;242;8020583;599747;178;7320181;64;700402;33143;33273
55120;Combles-en-Barrois;445;14750168;973091;340;13600185;105;1149983;33146;33274
60142;La Chapelle-en-Serval;1475;48892009;3409492;1130;44877123;345;4014886;33147;33275
77276;Mareuil-lès-Meaux;1096;36331818;2326303;800;32380094;296;3951724;33149;33276
25542;Serre-les-Sapins;769;25495184;1562918;560;22860591;209;2634593;33154;33277
21401;Meloisey;193;6399311;624564;144;5881059;49;518252;33157;33278
60027;Auger-Saint-Vincent;248;8223781;658201;186;7543696;62;680085;33160;33279
59370;Mairieux;400;13264681;887999;285;11905673;115;1359008;33162;33280
27616;La Saussaye;956;31703279;2143464;710;28466068;246;3237211;33162;33281
27347;Huest;366;12137541;772336;273;11085050;93;1052491;33163;33282
21010;Aloxe-Corton;91;3017811;288887;61;2702263;30;315548;33163;33283
25108;Cernay-l'Église;154;5107241;360959;117;4653132;37;454109;33164;33284
89228;Lindry;654;21690925;1071254;450;19174548;204;2516377;33167;33285
76720;Varengeville-sur-Mer;607;20132664;1717085;373;17272731;234;2859933;33167;33286
31029;Aurin;151;5008312;361182;100;4447036;51;561276;33168;33287
77501;Villecerf;387;12836037;914355;277;11494833;110;1341204;33168;33288
31240;Issus;218;7231087;321164;154;6547477;64;683610;33170;33289
62529;Lorgies;732;24282955;1390207;508;21505080;224;2777875;33173;33290
77521;Villiers-sur-Morin;921;30553109;2260545;700;28288903;221;2264206;33174;33291
69034;Caluire-et-Cuire;24094;799375619;66743686;16512;714108229;7582;85267390;33177;33292
76753;Ymare;563;18678900;1015323;447;17272197;116;1406703;33177;33293
08064;Biermes;136;4512665;326265;95;4016901;41;495764;33181;33294
27254;Fontaine-sous-Jouy;433;14369440;1134028;299;12826072;134;1543368;33186;33295
15102;Lavigerie;59;1958069;193229;24;1646775;35;311294;33188;33296
69059;Civrieux-d'Azergues;734;24361988;1475989;538;21958642;196;2403346;33191;33297
77295;Moisenay;662;21977376;1292688;526;20374218;136;1603158;33198;33298
01063;Brion;256;8499456;554104;201;7885850;55;613606;33201;33299
92019;Châtenay-Malabry;16755;556287752;47708742;11592;502513670;5163;53774082;33201;33300
57432;Maizery;81;2689614;103865;59;2419288;22;270326;33205;33301
62905;Zudausques;356;11821228;659104;259;10466154;97;1355074;33206;33302
63302;La Roche-Blanche;1624;53932635;3365678;1179;48577776;445;5354859;33210;33303
54499;Seicheprey;47;1560907;80371;26;1252964;21;307943;33211;33304
41015;Beauvilliers;31;1029555;65951;19;816152;12;213403;33211;33305
59328;Lambersart;14942;496253247;42038887;10127;443867512;4815;52385735;33212;33306
14568;Sainte-Croix-Grand-Tonne;137;4550150;259247;100;4036129;37;514021;33213;33307
67163;Gougenheim;265;8802771;519553;205;8108815;60;693956;33218;33308
25074;Bonnétage;448;14881739;979613;315;13356308;133;1525431;33218;33309
95026;Asnières-sur-Oise;1382;45915082;3170437;1044;41844831;338;4070251;33224;33310
57512;Nouilly;278;9237131;593004;191;8005323;87;1231808;33227;33311
77144;Crèvecoeur-en-Brie;142;4718985;255515;111;4362976;31;356009;33232;33312
76658;Saint-Vincent-Cramesnil;272;9039185;455952;201;8139934;71;899251;33232;33313
84055;Jonquerettes;728;24194573;1837010;520;21593723;208;2600850;33234;33314
31533;Saubens;948;31508199;1907882;701;28417629;247;3090570;33236;33315
45043;Bou;460;15289543;898844;338;13723872;122;1565671;33238;33316
73050;Bourdeau;312;10371668;776379;225;9336814;87;1034854;33243;33317
38067;Chamagnieu;701;23303432;1413685;511;20737666;190;2565766;33243;33318
18039;Bué;185;6150704;453199;125;5452439;60;698265;33247;33319
54571;Ville-en-Vermois;299;9941065;485111;226;8922254;73;1018811;33248;33320
10260;Moussey;272;9043603;479299;190;7974677;82;1068926;33249;33321
57245;Gavisse;263;8745385;151156;119;4652342;144;4093043;33252;33322
24451;Saint-Martial-de-Valette;478;15895679;1656885;242;13272700;236;2622979;33255;33323
74083;Combloux;1169;38875171;2962859;813;34345948;356;4529223;33255;33324
59258;Genech;1092;36315652;2200056;753;32352820;339;3962832;33256;33325
01065;Buellas;853;28370276;1800746;635;25408135;218;2962141;33259;33326
60363;Lierville;115;3824893;339857;76;3429471;39;395422;33260;33327
95051;Beauchamp;4837;160878835;12805646;3487;147264049;1350;13614786;33260;33328
10127;Dommartin-le-Coq;34;1130859;102399;22;988639;12;142220;33261;33329
91666;Villejust;1121;37288035;2462273;866;34549943;255;2738092;33263;33330
28058;Bréchamps;177;5888021;460481;135;5372422;42;515599;33266;33331
14110;Brucourt;70;2328612;213465;36;1962985;34;365627;33266;33332
38223;Maubec;818;27214751;1621116;566;24127473;252;3087278;33270;33333
38102;Chèzeneuve;240;7985057;489183;180;7246155;60;738902;33271;33334
25320;Labergement-Sainte-Marie;615;20463274;1529069;459;18760566;156;1702708;33274;33335
37059;Charentilly;579;19265845;1153889;432;17705995;147;1559850;33274;33336
76611;Saint-Martin-aux-Arbres;154;5124575;331512;109;4530883;45;593692;33276;33337
37206;Saint-Antoine-du-Rocher;750;24957944;1475448;559;22332352;191;2625592;33277;33338
69061;Cogny;554;18438107;1161225;372;16292815;182;2145292;33282;33339
68212;Moernach;308;10251020;702914;200;8714254;108;1536766;33283;33340
34057;Castelnau-le-Lez;9339;310864813;26577825;5952;273661064;3387;37203749;33287;33341
25263;Gellin;119;3961442;267191;88;3563082;31;398360;33289;33342
28193;Havelu;68;2263702;186958;49;2076747;19;186955;33290;33343
45261;Rebréchien;639;21277505;1226518;512;19631624;127;1645881;33298;33344
78325;Jumeauville;300;9989893;657676;227;9156038;73;833855;33300;33345
95456;Noisy-sur-Oise;341;11355320;867880;263;10515656;78;839664;33300;33346
95170;Condécourt;292;9725373;726843;231;9050250;61;675123;33306;33347
01342;Sainte-Croix;251;8359991;471765;180;7352174;71;1007817;33307;33348
76503;Pissy-Pôville;602;20053160;1231394;442;18107654;160;1945506;33311;33349
60226;Ève;220;7329370;724000;145;6322487;75;1006883;33315;33350
42185;Rivas;249;8295908;467551;184;7464272;65;831636;33317;33351
59605;Uxem;623;20757051;1086315;475;18554888;148;2202163;33318;33352
59513;Roucourt;201;6697130;517692;140;6120121;61;577009;33319;33353
51476;Saint-Étienne-au-Temple;321;10695960;613503;250;9662642;71;1033318;33321;33354
51147;La Cheppe;149;4965983;244897;106;4387897;43;578086;33329;33355
57140;Chesny;272;9067623;501030;206;8279514;66;788109;33337;33356
63150;Enval;694;23138631;1491786;502;21068181;192;2070450;33341;33357
29085;Île-Tudy;476;15872065;1308223;291;13852543;185;2019522;33345;33358
91433;Morigny-Champigny;2229;74325329;4932336;1733;68098371;496;6226958;33345;33359
68122;Hartmannswiller;309;10304093;604999;204;8884452;105;1419641;33347;33360
51586;Unchair;86;2867864;264221;66;2658651;20;209213;33347;33361
68381;Wuenheim;422;14073163;987025;302;12583462;120;1489701;33349;33362
91198;D'Huison-Longueville;759;25312752;1669637;590;23252040;169;2060712;33350;33363
91654;Videlles;349;11640048;933305;252;10473072;97;1166976;33353;33364
71292;Mellecey;641;21380671;1461037;464;19309444;177;2071227;33355;33365
77520;Villiers-sous-Grez;426;14209495;1040080;302;12794194;124;1415301;33356;33366
77006;Arbonne-la-Forêt;526;17545530;1322792;354;15726373;172;1819157;33357;33367
57184;Dornot;104;3469284;253920;74;3154274;30;315010;33359;33368
25287;Grandfontaine;713;23784871;1461418;510;21204706;203;2580165;33359;33369
25309;Houtaud;474;15812840;993864;341;14141927;133;1670913;33360;33370
38200;Jarrie;2003;66821753;4489709;1514;60857539;489;5964214;33361;33371
57146;Coin-lès-Cuvry;352;11743162;696096;246;10500834;106;1242328;33361;33372
77492;Verdelot;406;13544899;1068983;228;11585540;178;1959359;33362;33373
80160;Cagny;703;23453521;1624530;459;20974993;244;2478528;33362;33374
31120;Le Castéra;373;12444493;843344;232;10668382;141;1776111;33363;33375
36052;Chouday;78;2602390;215257;59;2416632;19;185758;33364;33376
95331;Lassy;87;2902770;213811;72;2724248;15;178522;33365;33377
72320;Saint-Saturnin;1088;36305096;2316906;783;32677568;305;3627528;33369;33378
77111;Chessy;2230;74413055;5504552;1704;68355881;526;6057174;33369;33379
51323;Linthelles;62;2068980;240495;33;1746081;29;322899;33371;33380
73080;Le Châtel;86;2869970;167901;63;2533711;23;336259;33372;33381
43002;Aiguilhe;907;30270809;2052829;593;26619525;314;3651284;33375;33382
90048;Fontenelle;66;2202739;102397;47;1960358;19;242381;33375;33383
71102;La Charmée;328;10947581;770315;242;9803675;86;1143906;33377;33384
91114;Brunoy;13475;449769900;35643616;9596;408419925;3879;41349975;33378;33385
28220;Luisant;3646;121710274;8493095;2567;108567017;1079;13143257;33382;33386
38215;Luzinay;1049;35017747;2158714;769;31672262;280;3345485;33382;33387
62003;Acheville;304;10148261;687862;225;9162034;79;986227;33382;33388
91376;Marolles-en-Hurepoix;2482;82857473;5576459;1922;76347632;560;6509841;33383;33389
27197;Dampsmesnil;98;3271661;249420;71;2984164;27;287497;33384;33390
74206;Orcier;449;14991901;695049;294;13071135;155;1920766;33390;33391
77453;Sivry-Courtry;551;18397717;1130137;401;16420054;150;1977663;33390;33392
43036;Borne;213;7112353;425924;110;5939269;103;1173084;33391;33393
14316;Grangues;135;4508018;386483;82;3815878;53;692140;33393;33394
39042;Baverans;225;7513657;320430;159;6540810;66;972847;33394;33395
67299;Mollkirch;465;15528649;1001647;335;13846324;130;1682325;33395;33396
38432;Saint-Nicolas-de-Macherin;450;15028261;799675;338;13735794;112;1292467;33396;33397
25328;Larnod;337;11254597;695708;232;9993050;105;1261547;33396;33398
54089;Bouxières-aux-Chênes;713;23811983;1494511;507;21093800;206;2718183;33397;33399
95594;Seugy;560;18705281;1410700;442;17621888;118;1083393;33402;33400
78381;Maulette;388;12960847;949626;283;11771830;105;1189017;33404;33401
67137;Fegersheim;2796;93399410;7408302;1967;83596480;829;9802930;33405;33402
68127;Heidwiller;323;10791872;759547;231;9614693;92;1177179;33411;33403
28417;Villiers-le-Morhier;690;23054949;1665257;516;21200659;174;1854290;33413;33404
44215;Vertou;11518;384903010;24050938;7792;338362382;3726;46540628;33418;33405
67250;Kriegsheim;339;11329182;674147;245;9960386;94;1368796;33419;33406
74297;Versonnex;253;8456036;410412;174;7341494;79;1114542;33423;33407
60669;Verderonne;298;9960236;776752;240;9386439;58;573797;33424;33408
73326;Vimines;967;32320727;1933959;699;28973083;268;3347644;33424;33409
67442;Scharrachbergheim-Irmstett;574;19188499;1229705;417;17060283;157;2128216;33429;33410
76551;Sainneville;380;12703452;670638;289;11445617;91;1257835;33430;33411
68141;Hochstatt;1136;37983172;2605541;804;33754566;332;4228606;33436;33412
31188;Fontenilles;2247;75132937;4012845;1597;67129111;650;8003826;33437;33413
51652;Vouarces;38;1270734;90892;23;1078604;15;192130;33440;33414
13033;Ensuès-la-Redonne;2789;93268830;6588862;1888;82564459;901;10704371;33442;33415
91081;Boissy-le-Sec;344;11504326;846992;251;10448589;93;1055737;33443;33416
77369;Poincy;370;12374019;973804;265;11150654;105;1223365;33443;33417
52125;Chamarandes-Choignes;514;17191379;1256869;365;15126284;149;2065095;33446;33418
67049;Blaesheim;672;22477631;1495865;481;20109753;191;2367878;33449;33419
10360;Saint-Pouange;405;13547672;864213;314;12269789;91;1277883;33451;33420
83034;Carqueiranne;6138;205341487;16072171;3966;180925976;2172;24415511;33454;33421
77058;Bussy-Saint-Georges;12104;404965734;29846651;8801;369127551;3303;35838183;33457;33422
51644;Vincelles;173;5788325;565376;116;5091250;57;697075;33459;33423
62156;Bonningues-lès-Calais;288;9636139;617533;190;8597546;98;1038593;33459;33424
21370;Magny-sur-Tille;396;13250256;645628;297;11342414;99;1907842;33460;33425
74179;Mésigny;345;11543942;402888;247;10055548;98;1488394;33461;33426
77313;Montmachoux;113;3781944;237973;84;3396205;29;385739;33469;33427
14006;Amayé-sur-Orne;463;15496064;944867;338;13787188;125;1708876;33469;33428
62752;Saint-Josse;584;19547645;1331727;374;17111423;210;2436222;33472;33429
78071;Boinville-le-Gaillard;278;9305972;601269;219;8540898;59;765074;33475;33430
90026;Chèvremont;746;24972344;1777984;520;21680966;226;3291378;33475;33431
33099;Carignan-de-Bordeaux;1922;64357278;4386112;1291;57057522;631;7299756;33485;33432
51028;Avenay-Val-d'Or;461;15438662;1414402;312;13386095;149;2052567;33490;33433
25153;Chevroz;59;1975981;101021;35;1731874;24;244107;33491;33434
76391;La Londe;1113;37279897;2206148;819;33702350;294;3577547;33495;33435
67417;Rottelsheim;160;5359313;350212;119;4777653;41;581660;33496;33436
13118;Coudoux;1705;57129226;3557123;1242;51497309;463;5631917;33507;33437
71084;Chânes;293;9818544;700914;229;9141858;64;676686;33510;33438
76594;Saint-Jean-du-Cardonnay;665;22284827;1381963;482;20124852;183;2159975;33511;33439
25381;Miserey-Salines;1150;38538610;2374206;878;35077608;272;3461002;33512;33440
38170;Fontanil-Cornillon;1521;50984283;3709023;1168;46285694;353;4698589;33520;33441
38176;Frontonas;930;31174661;1856291;680;27965354;250;3209307;33521;33442
78344;Lommoye;298;9989607;596990;230;9103886;68;885721;33522;33443
80130;Bovelles;196;6571048;331540;149;5878373;47;692675;33526;33444
77217;Grisy-Suisnes;1207;40466025;2880797;865;36829895;342;3636130;33526;33445
10321;La Rivière-de-Corps;1569;52604988;3400248;1092;46491277;477;6113711;33528;33446
77382;Quincy-Voisins;2524;84630095;5787938;1902;77740636;622;6889459;33530;33447
25347;La Longeville;331;11099022;825509;239;10024209;92;1074813;33532;33448
57602;Rurange-lès-Thionville;1051;35243633;997960;701;27640561;350;7603072;33533;33449
55065;Boureuilles;74;2481786;81844;38;2040774;36;441012;33538;33450
33394;Saint-Émilion;1083;36321487;3743497;651;31638994;432;4682493;33538;33451
91148;Chauffour-lès-Étréchy;70;2347816;119890;56;2152314;14;195502;33540;33452
62319;Éterpigny;103;3455067;154826;75;3088040;28;367027;33544;33453
78558;Saint-Illiers-la-Ville;165;5534818;352800;114;4992580;51;542238;33544;33454
57199;Escherange;265;8889689;162506;76;3302834;189;5586855;33546;33455
01243;Messimy-sur-Saône;589;19759249;1025575;418;17661154;171;2098095;33547;33456
21565;Saint-Philibert;206;6910982;378400;171;6587791;35;323191;33548;33457
54138;Cosnes-et-Romain;1351;45328149;1943126;696;30181816;655;15146333;33552;33458
60475;Ognon;86;2885742;236214;70;2738547;16;147195;33555;33459
78640;Vélizy-Villacoublay;11270;378172228;30372879;8959;351646064;2311;26526164;33556;33460
77154;Dammartin-sur-Tigeaux;459;15402393;877388;351;14130779;108;1271614;33556;33461
95059;Berville;174;5839964;383248;134;5375069;40;464895;33563;33462
02438;Longpont;147;4934412;436329;96;4344411;51;590001;33567;33463
18068;Cogny;32;1074298;139356;16;926830;16;147468;33572;33464
60480;Oroër;272;9131741;592511;207;8320849;65;810892;33573;33465
26197;Montélier;1936;65002406;3932204;1312;57197494;624;7804912;33576;33466
61472;Sévigny;156;5239578;275224;116;4769328;40;470250;33587;33467
74194;Mûres;356;11957153;637422;265;10794595;91;1162558;33588;33468
76615;Saint-Martin-du-Bec;271;9103597;599064;206;8285913;65;817684;33593;33469
54006;Agincourt;207;6954070;409385;139;6044820;68;909250;33595;33470
42038;Chalain-le-Comtal;296;9944743;817891;184;8507279;112;1437464;33597;33471
08410;Semide;111;3729547;241056;70;3171719;41;557828;33600;33472
77530;Voulton;151;5073564;400224;109;4596822;42;476742;33600;33473
14610;Saint-Manvieu-Norrey;857;28795349;1719330;607;25610596;250;3184753;33600;33474
92062;Puteaux;25886;869855771;82694037;18507;798341454;7379;71514317;33603;33475
51203;Cuperly;103;3461295;202955;71;2982438;32;478857;33605;33476
90076;Pérouse;557;18717993;1418231;389;16819245;168;1898748;33605;33477
74061;Chapeiry;385;12939060;671281;284;11414304;101;1524756;33608;33478
74305;Ville-la-Grand;4629;155590981;4774490;2524;109456159;2105;46134822;33612;33479
46047;Calès;90;3025160;253961;50;2622648;40;402512;33613;33480
51566;Thibie;148;4974768;378964;115;4558273;33;416495;33613;33481
77399;Saint-Ange-le-Viel;110;3697530;238241;75;3152113;35;545417;33614;33482
14059;Benerville-sur-Mer;350;11764995;1227353;223;10625960;127;1139035;33614;33483
67343;Oberhausbergen;2786;93658587;7949556;1921;83497502;865;10161085;33618;33484
12241;Sainte-Radegonde;826;27770019;1713160;608;25137835;218;2632184;33620;33485
33031;Bassanne;51;1715001;134967;25;1361017;26;353984;33627;33486
62615;Nielles-lès-Calais;105;3531024;228902;70;3186318;35;344706;33629;33487
77091;Les Chapelles-Bourbon;187;6289263;386190;151;5818390;36;470873;33632;33488
59022;Attiches;1109;37303073;2638119;759;33106796;350;4196277;33637;33489
31381;Montgiscard;1100;37002065;2589457;753;33156581;347;3845484;33638;33490
76583;Saint-Germain-sous-Cailly;136;4574945;204508;100;3984598;36;590347;33639;33491
63126;Le Crest;646;21732601;1433613;469;19652700;177;2079901;33642;33492
60487;Parnes;165;5551270;395757;107;4836162;58;715108;33644;33493
92004;Asnières-sur-Seine;49278;1657920466;159497961;32609;1502829381;16669;155091085;33644;33494
27014;Amfreville-sur-Iton;370;12449875;826919;270;11193455;100;1256420;33648;33495
57523;Ogy;254;8546937;498983;191;7446447;63;1100490;33649;33496
44055;La Baule-Escoublac;10742;361475410;29160628;6949;315144635;3793;46330775;33651;33497
72360;Trangé;616;20730631;1220315;460;18792606;156;1938025;33654;33498
39321;Menétru-le-Vignoble;72;2423274;201736;49;2108564;23;314710;33657;33499
28137;Écrosnes;431;14506358;1090749;320;13332132;111;1174226;33657;33500
27501;Rouvray;122;4106358;318145;84;3620314;38;486044;33659;33501
76434;Mesnil-Raoul;408;13732924;775099;310;12409560;98;1323364;33659;33502
78311;Houilles;17441;587130163;44905544;12992;539905450;4449;47224713;33664;33503
64519;Serres-Castet;1876;63157909;3946807;1325;55947713;551;7210196;33666;33504
27216;Émalleville;242;8147820;482122;177;7035200;65;1112620;33669;33505
54500;Selaincourt;104;3501850;285789;60;2982774;44;519076;33672;33506
51643;Vinay;317;10674356;832818;225;9647034;92;1027322;33673;33507
27611;Saint-Vigor;142;4781860;300054;106;4376457;36;405403;33675;33508
69055;Les Chères;730;24583965;1632544;507;21834030;223;2749935;33677;33509
77067;Cesson;4543;153007221;9473699;3519;141081242;1024;11925979;33680;33510
31256;Labruyère-Dorsa;126;4243854;255257;99;3905876;27;337978;33681;33511
01368;Saint-Julien-sur-Veyle;355;11957263;781129;227;10338286;128;1618977;33682;33512
94042;Joinville-le-Pont;10330;347954594;32436975;7293;317708091;3037;30246503;33684;33513
28278;Nogent-le-Phaye;674;22703532;1694128;465;19812985;209;2890547;33685;33514
67197;Hindisheim;724;24388744;1725163;498;21705981;226;2682763;33686;33515
51439;Pomacle;209;7040883;420611;150;6329662;59;711221;33688;33516
02053;Baulne-en-Brie;159;5357067;774248;89;4559046;70;798021;33692;33517
54106;Bures;31;1044532;73399;18;862025;13;182507;33695;33518
45197;Marigny-les-Usages;579;19509537;1113155;443;17907062;136;1602475;33695;33519
25245;Fontain;490;16511182;1077736;341;14653138;149;1858044;33696;33520
51031;Baconnes;123;4145131;189507;86;3613450;37;531681;33700;33521
77197;Frétoy;66;2224246;150778;50;2017504;16;206742;33701;33522
71004;Allériot;516;17390598;1192949;374;15451984;142;1938614;33703;33523
31356;Montaigut-sur-Save;751;25313999;1529628;537;22475744;214;2838255;33707;33524
78472;Orsonville;156;5258309;367836;120;4839014;36;419295;33707;33525
14396;Maltot;409;13793524;916413;303;12523093;106;1270431;33725;33526
67138;Fessenheim-le-Bas;242;8162496;527271;171;7319935;71;842561;33729;33527
25481;Raynans;149;5025740;299142;111;4599117;38;426623;33730;33528
83065;Gassin;1950;65773267;7104830;1212;58384965;738;7388302;33730;33529
74252;Saint-Sigismond;319;10761006;655796;234;9621826;85;1139180;33734;33530
59411;Mons-en-Pévèle;1117;37682937;2421531;781;33964899;336;3718038;33736;33531
80202;Coisy;141;4757044;326523;103;4355906;38;401138;33738;33532
77161;Dormelles;454;15318079;1185482;315;14043540;139;1274539;33740;33533
51480;Sainte-Gemme;74;2497244;246702;47;2185488;27;311756;33747;33534
51589;Vanault-le-Châtel;91;3071433;300388;52;2685638;39;385795;33752;33535
74240;Saint-Jean-de-Tholome;461;15560563;438531;296;12450333;165;3110230;33754;33536
51578;Trécon;41;1384091;118878;25;1224046;16;160045;33758;33537
77292;Messy;560;18907302;1410089;442;17409157;118;1498145;33763;33538
45126;Donnery;1262;42609422;2276985;1008;39298329;254;3311093;33763;33539
21483;Pichanges;125;4220614;257692;92;3702990;33;517624;33765;33540
32334;Pujaudran;689;23265123;1680680;492;21311886;197;1953237;33767;33541
78230;La Falaise;310;10467984;734488;256;9892812;54;575172;33768;33542
74117;Étercy;342;11549970;664333;247;10190188;95;1359782;33772;33543
91473;Orveau;105;3546167;245457;79;3192999;26;353168;33773;33544
95271;Génicourt;281;9491025;768311;218;8911503;63;579522;33776;33545
77412;Saint-Germain-sur-École;177;5978618;450741;130;5476692;47;501926;33778;33546
77487;Vaux-le-Pénil;5573;188248283;13029893;4132;171625579;1441;16622704;33779;33547
27238;Ferrières-Haut-Clocher;484;16349466;878938;344;14517683;140;1831783;33780;33548
91156;Cheptainville;934;31553422;2024142;753;29242011;181;2311411;33783;33549
74057;Champanges;445;15034108;862602;323;13372764;122;1661344;33785;33550
91293;Guigneville-sur-Essonne;459;15507223;1038490;361;14149286;98;1357937;33785;33551
14244;Eraines;150;5067818;285151;97;4281630;53;786188;33785;33552
91469;Ormoy-la-Rivière;477;16116173;1205787;362;14931289;115;1184884;33787;33553
77007;Argentières;190;6420412;452560;146;5866309;44;554103;33792;33554
38348;Ruy;2235;75524803;4860512;1618;67588688;617;7936115;33792;33555
57693;Vantoux;455;15381626;969631;300;13445682;155;1935944;33806;33556
63203;Malauzat;518;17512057;1126736;390;15884927;128;1627130;33807;33557
64216;Espoey;498;16835948;1313034;312;14623485;186;2212463;33807;33558
38331;Réaumont;493;16668630;1052086;363;15009416;130;1659214;33811;33559
91556;Saint-Hilaire;215;7270413;500697;175;6901916;40;368497;33816;33560
17200;Lagord;4071;137664708;10761775;2691;120712819;1380;16951889;33816;33561
67298;Mittelschaeffolsheim;249;8421179;534572;190;7623281;59;797898;33820;33562
59330;Landas;1151;38927930;3224446;729;33954769;422;4973161;33821;33563
44217;Vigneux-de-Bretagne;2614;88421101;5460388;1837;78558682;777;9862419;33826;33564
25609;Verrières-de-Joux;207;7002923;500626;151;6472229;56;530694;33831;33565
63308;Royat;2861;96789609;8113029;1805;86268181;1056;10521428;33831;33566
78530;Rosay;191;6462412;485829;143;5910050;48;552362;33835;33567
08058;Belval;114;3857206;270279;89;3485088;25;372118;33835;33568
65259;Lansac;80;2706869;136023;54;2451430;26;255439;33836;33569
04152;Pierrevert;2026;68556025;4828990;1379;59991542;647;8564483;33838;33570
57482;Montoy-Flanville;553;18715651;1288260;397;16609637;156;2106014;33844;33571
21481;Perrigny-lès-Dijon;761;25756808;1779820;577;23768452;184;1988356;33846;33572
77181;Ferrières-en-Brie;1106;37434128;2315010;858;34439000;248;2995128;33846;33573
25593;Vaux-les-Prés;193;6532380;495075;143;5848100;50;684280;33847;33574
67361;Olwisheim;255;8631191;503638;178;7530280;77;1100911;33848;33575
21692;Villecomte;124;4197149;287245;88;3807580;36;389569;33848;33576
42270;Saint-Paul-en-Cornillon;726;24575163;1814896;485;22232987;241;2342176;33850;33577
14426;Le Mesnil-sur-Blangy;89;3012877;252034;57;2726582;32;286295;33853;33578
60008;Airion;209;7075987;468072;154;6259775;55;816212;33856;33579
80459;Laleu;48;1625171;81430;34;1440088;14;185083;33858;33580
76596;Saint-Laurent-de-Brèvedent;677;22922164;1352088;519;21050465;158;1871699;33858;33581
06084;Mouans-Sartoux;5694;192790168;15077758;3766;170094187;1928;22695981;33858;33582
54032;Autrey;87;2945913;164976;63;2641037;24;304876;33861;33583
27554;Saint-Just;648;21942758;1686543;468;19837059;180;2105699;33862;33584
38131;Les Côtes-d'Arey;966;32714690;2085609;688;29327935;278;3386755;33866;33585
25234;Ferrières-le-Lac;86;2912893;211513;65;2666563;21;246330;33871;33586
31579;Villariès;394;13347838;1000883;268;11798175;126;1549663;33878;33587
25160;Les Combes;362;12263838;842103;259;11012805;103;1251033;33878;33588
57203;Évrange;100;3388000;22729;21;977873;79;2410127;33880;33589
60505;Pontarmé;409;13857335;923258;331;13033802;78;823533;33881;33590
59634;Wallon-Cappel;401;13586835;833641;268;11930823;133;1656012;33882;33591
93015;Coubron;2444;82811333;5399181;1891;77225986;553;5585347;33884;33592
95211;Ennery;1173;39752233;2798618;879;35975525;294;3776708;33889;33593
57194;Entrange;612;20743668;476238;300;12701708;312;8041960;33895;33594
27032;Avrilly;216;7321390;430823;165;6665233;51;656157;33895;33595
77165;Les Écrennes;303;10270758;700730;238;9565681;65;705077;33897;33596
95120;Butry-sur-Oise;1084;36751817;2609072;805;33469577;279;3282240;33904;33597
67131;Eschau;2540;86117602;6277454;1846;77652892;694;8464710;33905;33598
57076;Beyren-lès-Sierck;218;7391254;98797;90;3734003;128;3657251;33905;33599
77066;Cerneux;178;6035297;534682;103;5334991;75;700306;33906;33600
41223;Saint-Lubin-en-Vergonnois;380;12884763;558869;283;11715884;97;1168879;33907;33601
63306;La Roche-Noire;322;10918624;661946;240;9929551;82;989073;33909;33602
44071;Haute-Goulaine;2549;86435516;5000645;1759;75965307;790;10470209;33910;33603
67438;Schaeffersheim;398;13496220;825181;288;12068053;110;1428167;33910;33604
84049;Gigondas;320;10852349;1200523;183;9542348;137;1310001;33914;33605
27324;Hébécourt;282;9563692;601930;185;8392439;97;1171253;33914;33606
74218;Publier;3477;117951983;7890404;2369;102588413;1108;15363570;33923;33607
80379;Glisy;300;10177053;604523;232;9395128;68;781925;33924;33608
74078;Clermont;198;6717472;164593;127;5429749;71;1287723;33927;33609
64439;Ousse;742;25176926;1385164;560;22919454;182;2257472;33931;33610
62869;Wailly;522;17713762;1157120;365;15672804;157;2040958;33934;33611
91477;Palaiseau;16430;557560097;45260196;11885;513781136;4545;43778961;33935;33612
95430;Montsoult;1796;60949472;4006925;1339;55412147;457;5537325;33936;33613
02459;Marcy;86;2918539;207079;58;2501264;28;417275;33937;33614
27621;Serez;72;2443625;206389;50;2192109;22;251516;33939;33615
69296;Solaize;1482;50299582;3307296;1114;45658306;368;4641276;33940;33616
91519;Richarville;214;7263270;572539;150;6595862;64;667408;33941;33617
90011;Bermont;175;5940137;356826;126;5127605;49;812532;33944;33618
02687;Saint-Pierre-Aigle;164;5566815;357379;113;4961826;51;604989;33944;33619
77235;Jaignes;162;5499361;366476;127;5026276;35;473085;33947;33620
71032;Berzé-la-Ville;290;9845851;586774;209;8795032;81;1050819;33951;33621
01260;Le Montellier;116;3938497;256234;80;3327512;36;610985;33953;33622
06148;Tourrettes-sur-Loup;2310;78442789;6508071;1442;68854015;868;9588774;33958;33623
31519;Saint-Vincent;75;2546995;161885;46;2213409;29;333586;33960;33624
38558;Villette-de-Vienne;807;27407631;1645646;598;24629157;209;2778474;33962;33625
78104;Breuil-Bois-Robert;377;12804423;978606;280;11938939;97;865484;33964;33626
54025;Art-sur-Meurthe;581;19734436;1397126;414;17871677;167;1862759;33966;33627
91463;Oncy-sur-École;494;16780309;1308574;349;15042455;145;1737854;33968;33628
60646;Troissereux;586;19910173;1415958;400;17662638;186;2247535;33976;33629
27612;Saint-Vincent-des-Bois;150;5096614;367112;112;4566006;38;530608;33977;33630
78444;Neauphlette;401;13626209;827850;298;12307912;103;1318297;33981;33631
31198;Le Fréchet;65;2209007;217140;38;1931111;27;277896;33985;33632
68228;Munwiller;226;7680606;446949;168;6871682;58;808924;33985;33633
67039;Bilwisheim;199;6763247;459248;147;6189561;52;573686;33986;33634
91098;Boutervilliers;183;6219469;422728;140;5674007;43;545462;33986;33635
29005;Baye;571;19407202;1418481;370;17149633;201;2257569;33988;33636
71299;Milly-Lamartine;166;5642342;464429;119;5029072;47;613270;33990;33637
27211;Écardenville-sur-Eure;304;10333288;678640;213;9375490;91;957798;33991;33638
62358;Fresnoy-en-Gohelle;112;3807007;209401;87;3554898;25;252109;33991;33639
49308;Saint-Melaine-sur-Aubance;973;33073430;1748166;698;29272268;275;3801162;33991;33640
50032;La Barre-de-Semilly;494;16791686;1148068;362;15288779;132;1502907;33991;33641
19274;Ussac;2108;71654523;4970144;1496;64436502;612;7218021;33992;33642
14008;Amblie;148;5030787;366446;101;4507357;47;523430;33992;33643
76100;Blainville-Crevon;546;18560507;913729;399;16688547;147;1871960;33994;33644
67172;Griesheim-près-Molsheim;1035;35187008;2305749;753;31243284;282;3943724;33997;33645
51391;Muizon;1091;37094727;2285573;774;33293992;317;3800735;34001;33646
51628;Villeneuve-Saint-Vistre-et-Villevotte;71;2414286;210460;50;2145183;21;269103;34004;33647
69136;Montagny;1333;45327676;3068950;988;41245622;345;4082054;34004;33648
41142;Molineuf;425;14452032;987158;316;12982647;109;1469385;34005;33649
57028;Argancy;655;22273286;1211808;428;18353218;227;3920068;34005;33650
01075;Chaleins;570;19383103;897246;394;17216340;176;2166763;34005;33651
73154;Mercury;1570;53389913;3769010;1164;48879137;406;4510776;34006;33652
62535;La Madelaine-sous-Montreuil;89;3026916;256041;53;2658755;36;368161;34010;33653
12288;Valady;757;25748084;1993750;493;22764106;264;2983978;34013;33654
78147;Chaufour-lès-Bonnières;213;7245315;451890;156;6508992;57;736323;34016;33655
08353;Rancennes;374;12721845;740235;259;11348531;115;1373314;34016;33656
51648;Vitry-la-Ville;164;5578809;488254;113;4924742;51;654067;34017;33657
33273;Martignas-sur-Jalle;3554;120909383;7391351;2648;109339561;906;11569822;34021;33658
77350;Ozoir-la-Ferrière;10528;358256222;26156940;7414;324879997;3114;33376225;34029;33659
38206;Laval;496;16878945;900424;360;15240530;136;1638415;34030;33660
74146;Larringes;621;21133803;1405092;444;18908121;177;2225682;34032;33661
27132;Caugé;391;13306759;838837;309;12351195;82;955564;34033;33662
31075;Bonrepos-sur-Aussonnelle;409;13920562;779562;298;12585124;111;1335438;34036;33663
21462;Norges-la-Ville;429;14601283;836631;287;12973776;142;1627507;34036;33664
80015;Aizecourt-le-Haut;41;1395688;179661;24;1203050;17;192638;34041;33665
51568;Thil;156;5310446;358170;118;4940200;38;370246;34041;33666
51019;Aubérive;109;3710650;235159;79;3289601;30;421049;34043;33667
90024;Chavanatte;77;2621351;270234;51;2270956;26;350395;34044;33668
62085;Basseux;73;2485228;165311;52;2227560;21;257668;34044;33669
68332;Tagolsheim;374;12733053;787331;263;11256174;111;1476879;34046;33670
77073;Chalautre-la-Petite;288;9807568;741588;203;8848499;85;959069;34054;33671
28024;Barjouville;801;27277586;1779385;619;24807758;182;2469828;34054;33672
54168;Dommartin-sous-Amance;142;4835902;415183;107;4495286;35;340616;34056;33673
33245;Lignan-de-Bordeaux;388;13213627;1103225;253;11699240;135;1514387;34056;33674
78506;Prunay-en-Yvelines;440;14985318;1120607;321;13483089;119;1502229;34058;33675
51614;Verzy;566;19279044;1615825;402;17381168;164;1897876;34062;33676
10317;Les Riceys;776;26433682;3186826;454;23253152;322;3180530;34064;33677
74059;La Chapelle-Rambaud;108;3679008;18887;47;2237397;61;1441611;34065;33678
76419;Mauny;94;3202329;295339;67;2929472;27;272857;34067;33679
38408;Saint-Just-Chaleyssin;1195;40715320;2679278;836;36082028;359;4633292;34071;33680
67034;Berstett;1188;40479091;2909050;875;36610337;313;3868754;34073;33681
08346;Prix-lès-Mézières;732;24949559;1728107;526;22325537;206;2624022;34084;33682
34290;Saint-Vincent-de-Barbeyrargues;351;11963737;815918;244;10842758;107;1120979;34085;33683
50437;Roncey;462;15747161;1917063;190;13006939;272;2740222;34085;33684
77358;Penchard;516;17588864;1006950;392;16377132;124;1211732;34087;33685
71235;Hurigny;929;31668967;2084804;678;28423533;251;3245434;34089;33686
89083;Charbuy;877;29897669;2279695;646;27337535;231;2560134;34091;33687
59588;Téteghem;3424;116738737;8332048;2235;103271521;1189;13467216;34094;33688
74166;Marin;868;29597736;1607684;597;26080907;271;3516829;34099;33689
73288;Sonnaz;825;28141433;1874213;621;25622503;204;2518930;34111;33690
14519;Préaux-Bocage;57;1944585;69914;36;1558315;21;386270;34116;33691
92032;Fontenay-aux-Roses;12710;433610567;38472865;9234;397996434;3476;35614133;34116;33692
71124;Chenôves;122;4162160;305328;73;3603572;49;558588;34116;33693
60273;Giraumont;263;8972635;559698;204;8331621;59;641014;34116;33694
38352;Saint-Alban-de-Roche;974;33232680;2365899;685;29342869;289;3889811;34120;33695
73227;Saint-Bon-Tarentaise;1200;40945937;3897426;839;36749647;361;4196290;34122;33696
37243;Savonnières;1505;51358791;2990970;1102;46502964;403;4855827;34125;33697
01238;Massieux;1125;38396862;2237034;849;34665798;276;3731064;34131;33698
67554;Wolxheim;483;16491902;1263167;336;14713226;147;1778676;34145;33699
95352;Luzarches;2357;80481551;6156648;1743;73475731;614;7005820;34146;33700
50321;Le Mesnil-Rouxelin;251;8572824;508122;182;7714118;69;858706;34155;33701
78070;Boinville-en-Mantois;172;5874770;515528;136;5454086;36;420684;34156;33702
91617;Tigery;1395;47653655;2839400;1069;43153419;326;4500236;34160;33703
91017;Angervilliers;783;26748244;1781290;585;24248129;198;2500115;34161;33704
2B353;Ville-di-Pietrabugno;2095;71574161;7488475;1360;64075432;735;7498729;34164;33705
28275;Néron;305;10420509;608977;234;9505984;71;914525;34166;33706
17360;Sainte-Marie-de-Ré;1958;66898279;5330074;1287;58315191;671;8583088;34167;33707
73218;Ruffieux;440;15033529;1386536;269;12967402;171;2066127;34167;33708
59304;Herrin;192;6561301;327406;142;5967247;50;594054;34173;33709
60337;Lachelle;307;10491726;665692;235;9659816;72;831910;34175;33710
51186;Courjeonnet;32;1093683;102685;20;902505;12;191178;34178;33711
62609;Neuville-Saint-Vaast;778;26594238;2024269;526;23476768;252;3117470;34183;33712
69094;Grézieu-la-Varenne;2696;92158379;6612815;1907;81932594;789;10225785;34183;33713
13042;Gémenos;3561;121732849;10390866;2348;108251106;1213;13481743;34185;33714
79334;Usseau;450;15384711;518343;240;13061099;210;2323612;34188;33715
27529;Saint-Cyr-la-Campagne;212;7248066;554350;160;6562980;52;685086;34189;33716
21667;Véronnes;187;6393896;541630;125;5684424;62;709472;34192;33717
62546;Maninghen-Henne;159;5436565;331239;113;4927753;46;508812;34192;33718
68384;Zillisheim;1383;47293268;3143387;974;42320525;409;4972743;34196;33719
42214;Saint-Cyr-les-Vignes;444;15183855;926131;283;13149076;161;2034779;34198;33720
79304;Sansais;394;13474309;617224;270;12062848;124;1411461;34199;33721
14640;Saint-Pair;117;4001448;334620;90;3662385;27;339063;34200;33722
59222;Faumont;1002;34272004;1998436;689;30588814;313;3683190;34204;33723
57475;Mondorff;221;7559168;215189;78;3508462;143;4050706;34204;33724
21179;Clénay;404;13818619;853069;327;12898570;77;920049;34205;33725
95028;Attainville;813;27809828;1805320;636;25909900;177;1899928;34206;33726
95039;Auvers-sur-Oise;3659;125165815;9381699;2734;115150135;925;10015680;34208;33727
91330;Lardy;2781;95137181;6533247;2194;88312903;587;6824278;34210;33728
95625;Us;666;22784395;1529636;505;20995702;161;1788693;34211;33729
10161;Fresnay;24;821106;77823;12;707985;12;113121;34213;33730
76303;Gommerville;326;11157752;737033;233;9849257;93;1308495;34226;33731
35039;Brécé;881;30154114;2090173;620;26779233;261;3374881;34227;33732
01410;Sonthonnax-la-Montagne;161;5510655;346036;121;4945222;40;565433;34228;33733
38472;Sarcenas;101;3457067;247729;73;3039427;28;417640;34228;33734
33122;Cestas;8852;302992391;21117175;6525;275749901;2327;27242490;34229;33735
91195;Dannemois;455;15574083;1134406;349;14421719;106;1152364;34229;33736
38199;Jardin;1106;37859108;2459554;783;34108045;323;3751063;34231;33737
79085;Chérigné;83;2841182;60344;43;2409200;40;431982;34231;33738
25042;Le Barboux;106;3628683;253854;74;3280331;32;348352;34233;33739
68371;Willer;180;6162289;531325;116;5507973;64;654316;34235;33740
25514;Saint-Antoine;157;5374940;340725;116;4727437;41;647503;34235;33741
95078;Boissy-l'Aillerie;897;30709192;1988210;683;28324309;214;2384883;34235;33742
14269;Fierville-les-Parcs;100;3423753;270679;75;3087758;25;335995;34238;33743
59470;Prémesques;1020;34922550;2040275;713;30907117;307;4015433;34238;33744
14134;Canteloup;95;3252784;162421;72;3003777;23;249007;34240;33745
68015;Baldersheim;1313;44956927;3194108;996;40413081;317;4543846;34240;33746
69135;Monsols;480;16436236;1817641;240;13960151;240;2476085;34242;33747
69242;Taponas;413;14142555;405416;268;12279566;145;1862989;34243;33748
45300;Sandillon;1864;63830146;3963476;1417;58036172;447;5793974;34244;33749
77527;Voinsles;275;9417671;719317;200;8573198;75;844473;34246;33750
68124;Hausgauen;221;7568515;540932;152;6577458;69;991057;34247;33751
95151;Chauvry;146;5001088;355451;110;4579208;36;421880;34254;33752
73228;Saint-Cassin;382;13085232;741209;255;11569366;127;1515866;34255;33753
14575;Saint-Étienne-la-Thillaye;232;7948424;596481;148;6965104;84;983320;34260;33754
26011;Aouste-sur-Sye;1332;45639982;4095165;696;38712440;636;6927542;34264;33755
57062;Berg-sur-Moselle;194;6647942;191506;87;3888724;107;2759218;34268;33756
51063;Binson-et-Orquigny;100;3427448;364481;69;3225778;31;201670;34274;33757
39262;Gredisans;69;2364966;190592;43;2095765;26;269201;34275;33758
62208;Canettemont;32;1096869;112172;21;971365;11;125504;34277;33759
13082;Rognes;2533;86830435;7517776;1555;75229857;978;11600578;34280;33760
28163;Fresnay-le-Gilmert;104;3565139;276479;74;3151301;30;413838;34280;33761
39367;Morbier;1260;43194156;2873609;910;38831015;350;4363141;34281;33762
91159;Chevannes;799;27393471;1908738;649;25630819;150;1762652;34285;33763
73281;Saint-Sulpice;370;12685646;710415;276;11362125;94;1323521;34286;33764
78090;Bouafle;1109;38036538;2883205;816;34626644;293;3409894;34298;33765
26342;Solérieux;159;5453407;428223;109;4853382;50;600025;34298;33766
29101;Landéda;1949;66847685;4684396;1211;58206886;738;8640799;34298;33767
38061;La Buisse;1434;49185647;3180079;1058;44918922;376;4266725;34300;33768
45204;Mézières-lez-Cléry;380;13035080;803672;294;12011274;86;1023806;34303;33769
57467;Mey;147;5043262;260019;104;4355336;43;687926;34308;33770
67362;Orschwiller;311;10670208;791637;234;9732354;77;937854;34309;33771
39567;Villeneuve-sous-Pymont;145;4975303;368118;106;4486045;39;489258;34312;33772
21450;Nantoux;91;3123331;225392;68;2868770;23;254561;34322;33773
57649;Servigny-lès-Sainte-Barbe;225;7722622;429677;167;6816049;58;906573;34323;33774
10027;Balignicourt;44;1510210;158545;28;1345310;16;164900;34323;33775
31117;Castelmaurou;1961;67318379;4610714;1369;60173653;592;7144726;34329;33776
57511;Norroy-le-Veneur;560;19225903;1600908;359;16514093;201;2711810;34332;33777
14186;Coulombs;175;6008986;297594;134;5507517;41;501469;34337;33778
76418;Maulévrier-Sainte-Gertrude;478;16413259;797804;308;14230303;170;2182956;34337;33779
33454;Saint-Morillon;769;26407029;1509159;519;23174200;250;3232829;34339;33780
63455;Veyre-Monton;1865;64051983;4383544;1370;58301507;495;5750476;34344;33781
06046;Colomars;1746;59968075;4369791;1183;53937923;563;6030152;34346;33782
51565;Thaas;54;1854724;179987;33;1561758;21;292966;34347;33783
31053;Beaupuy;564;19371749;1198263;414;17617068;150;1754681;34347;33784
91100;Bouville;323;11096107;799767;251;10253713;72;842394;34353;33785
95447;Neuilly-en-Vexin;114;3916611;308545;88;3554256;26;362355;34356;33786
76031;Auberville-la-Campagne;282;9691243;510017;196;8527109;86;1164134;34366;33787
77195;Fouju;289;9934205;714684;216;9117018;73;817187;34374;33788
51302;Les Istres-et-Bury;51;1753153;128895;34;1455376;17;297777;34376;33789
38383;Saint-Étienne-de-Crossey;1287;44242572;2643984;948;39974410;339;4268162;34377;33790
37281;Vouvray;1662;57137233;4136624;1092;51007396;570;6129837;34379;33791
39163;Condes;58;1994123;234142;36;1748007;22;246116;34381;33792
52349;Neuilly-sur-Suize;163;5604339;407413;119;5052845;44;551494;34382;33793
50296;Maupertus-sur-Mer;127;4366600;272825;100;4065602;27;300998;34383;33794
25376;Mérey-Vieilley;48;1650380;115770;37;1506484;11;143896;34383;33795
95176;Cormeilles-en-Parisis;12059;414670786;31232012;8927;380210831;3132;34459955;34387;33796
67102;Dossenheim-Kochersberg;109;3748259;246778;72;3344729;37;403530;34388;33797
74261;Saxel;207;7118898;184625;114;5511094;93;1607804;34391;33798
69020;Belmont-d'Azergues;316;10867637;633810;224;9962510;92;905127;34391;33799
02724;Sommelans;28;962962;81423;17;846823;11;116139;34392;33800
01157;Fareins;1079;37111092;2719949;744;33023183;335;4087909;34394;33801
74053;Cervens;569;19573665;622311;325;15318495;244;4255170;34400;33802
10419;Villemoyenne;383;13176286;1229569;231;11214562;152;1961724;34403;33803
05092;Neffes;361;12419704;827789;248;11035595;113;1384109;34404;33804
28201;Jouy;1016;34954528;1975766;743;31547965;273;3406563;34404;33805
77348;Ormesson;125;4300764;277206;94;3868619;31;432145;34406;33806
31392;Mourvilles-Basses;35;1204227;56384;20;1053493;15;150734;34406;33807
01385;Saint-Rémy;495;17034625;1071567;373;15282393;122;1752232;34413;33808
67227;Itterswiller;124;4267411;247711;70;3459692;54;807719;34415;33809
59029;Auchy-lez-Orchies;721;24816407;1632275;482;21764010;239;3052397;34419;33810
74112;Épagny;2211;76102882;3933314;1648;65872507;563;10230375;34420;33811
68049;Bouxwiller;233;8020727;628057;137;6912018;96;1108709;34424;33812
77232;Isles-lès-Villenoy;413;14217008;998873;325;13174170;88;1042838;34424;33813
33061;Bonnetan;416;14325699;1028351;292;12895376;124;1430323;34437;33814
74304;Ville-en-Sallaz;382;13155435;384251;234;9891454;148;3263981;34438;33815
91587;Saulx-les-Chartreux;2728;93953534;7259092;2111;87141793;617;6811741;34440;33816
68354;Walbach;463;15946994;1030326;343;14296972;120;1650022;34443;33817
27192;Crosville-la-Vieille;269;9265320;578781;197;8328951;72;936369;34444;33818
77226;Héricy;1360;46843523;3509354;982;42147004;378;4696519;34444;33819
08498;Warnécourt;185;6372956;414022;146;5941775;39;431181;34448;33820
28173;Gasville-Oisème;645;22221418;1540942;458;19676075;187;2545343;34452;33821
28423;Yermenonville;292;10061974;712794;232;9275524;60;786450;34459;33822
37152;Mettray;1038;35777186;2335667;734;32136953;304;3640233;34467;33823
74250;Saint-Pierre-en-Faucigny;3105;107037342;4792350;2071;88637347;1034;18399995;34473;33824
45282;Saint-Hilaire-Saint-Mesmin;1494;51505754;3305272;1108;46882683;386;4623071;34475;33825
21263;Fénay;797;27480025;1855415;613;25082601;184;2397424;34479;33826
71583;Vinzelles;372;12828386;991263;267;11262093;105;1566293;34485;33827
60074;Blaincourt-lès-Précy;597;20587983;1444025;452;18799601;145;1788382;34486;33828
72065;La Chapelle-Saint-Aubin;1073;37004480;2148366;809;33201099;264;3803381;34487;33829
78564;Saint-Martin-de-Bréthencourt;335;11553607;829085;257;10673629;78;879978;34488;33830
37203;Rochecorbon;1687;58192128;4380869;1144;51480530;543;6711598;34494;33831
14260;Fauguernon;120;4139398;262977;95;3873492;25;265906;34495;33832
38270;La Murette;932;32152182;2303666;672;28912590;260;3239592;34498;33833
32312;Pessan;386;13319143;654071;238;11666371;148;1652772;34506;33834
59168;Cysoing;2439;84164431;5271731;1612;74683558;827;9480873;34508;33835
35149;Lassy;656;22637847;905219;470;20201129;186;2436718;34509;33836
78517;Rambouillet;14244;491551875;36091227;10326;446170676;3918;45381199;34509;33837
27412;Montaure;497;17151814;1286903;374;15698386;123;1453428;34511;33838
34340;Villetelle;708;24443006;1699599;423;20848782;285;3594224;34524;33839
68320;Spechbach-le-Haut;306;10564440;555932;231;9557162;75;1007278;34524;33840
91648;Vert-le-Grand;1137;39267506;2956625;898;36161767;239;3105739;34536;33841
69144;Nuelles;315;10879761;645648;227;9771598;88;1108163;34539;33842
76541;Roumare;651;22485520;1494316;487;20710355;164;1775165;34540;33843
31021;Aspret-Sarrat;64;2210683;203589;44;2070216;20;140467;34542;33844
91022;Arrancourt;69;2383790;186709;51;2237716;18;146074;34548;33845
78107;Bréval;951;32856771;2096761;691;29710888;260;3145883;34550;33846
28052;Bouglainval;392;13544345;1059930;297;12510838;95;1033507;34552;33847
73301;Trévignin;373;12888171;945583;251;11385988;122;1502183;34553;33848
76650;Saint-Sauveur-d'Émalleville;507;17520137;1088356;378;15682033;129;1838104;34556;33849
60429;Morangles;197;6808173;463522;137;6204288;60;603885;34559;33850
01160;Ferney-Voltaire;4530;156568414;7959278;2112;110742855;2418;45825559;34563;33851
77003;Amponville;188;6498106;507968;140;5906762;48;591344;34564;33852
54525;Tiercelet;309;10680739;234398;115;5038549;194;5642190;34565;33853
68095;Fortschwihr;559;19322975;1187223;396;17508965;163;1814010;34567;33854
51525;Sarry;1027;35500633;2193036;770;32132207;257;3368426;34567;33855
80690;Rumigny;279;9644500;754008;201;8769967;78;874533;34568;33856
95535;Sagy;557;19257888;1302002;418;17561548;139;1696340;34574;33857
77237;Jossigny;330;11410591;949856;225;10300858;105;1109733;34578;33858
51612;Vertus;1374;47510636;4889476;836;41557095;538;5953541;34578;33859
80291;Estrées-sur-Noye;146;5049238;394703;103;4666944;43;382294;34584;33860
25255;Fournet-Blancheroche;159;5498898;359802;117;4927829;42;571069;34584;33861
01361;Saint-Jean-de-Niost;714;24695226;1770216;524;22362160;190;2333066;34587;33862
91079;Boissy-la-Rivière;297;10273961;717723;225;9538589;72;735372;34592;33863
68169;Koestlach;269;9305740;764967;197;8170206;72;1135534;34594;33864
32038;Beaupuy;78;2698483;150547;61;2545605;17;152878;34596;33865
45175;Jouy-le-Potier;717;24806562;1887178;526;22576627;191;2229935;34598;33866
21185;Combertault;235;8131272;415957;184;7390305;51;740967;34601;33867
60341;Lagny-le-Sec;952;32945115;2080848;753;30298428;199;2646687;34606;33868
68176;Largitzen;151;5226320;326611;113;4741770;38;484550;34611;33869
73183;Myans;541;18725687;1258032;381;16224827;160;2500860;34613;33870
68157;Jebsheim;597;20664745;895503;411;18288728;186;2376017;34614;33871
91634;Vaugrigneuse;659;22813968;1637337;486;20360657;173;2453311;34619;33872
51563;Talus-Saint-Prix;52;1800696;176299;31;1515102;21;285594;34629;33873
95259;Gadancourt;47;1627580;164343;35;1487269;12;140311;34629;33874
21279;Fontaines-les-Sèches;24;831277;83360;12;722246;12;109031;34637;33875
33422;Saint-Jean-d'Illac;3267;113158969;7126880;2406;102084483;861;11074486;34637;33876
21021;Arc-sur-Tille;1203;41670193;2508817;910;37673969;293;3996224;34639;33877
28056;Boutigny-Prouais;877;30382069;2154967;635;27709213;242;2672856;34643;33878
95149;Chaumontel;1704;59032618;4187103;1336;55135276;368;3897342;34644;33879
01225;Lurcy;196;6790148;591935;148;6123309;48;666839;34644;33880
51252;Fleury-la-Rivière;271;9389540;955545;180;8425361;91;964179;34648;33881
25380;Métabief;778;26962270;2547746;623;25453297;155;1508973;34656;33882
62369;Gavrelle;271;9391865;737144;170;8032318;101;1359547;34656;33883
77234;Jablines;302;10466662;740383;249;9891493;53;575169;34658;33884
39304;Le Louverot;138;4783162;288233;104;4263384;34;519778;34661;33885
71057;Bray;78;2703869;298599;42;2222635;36;481234;34665;33886
31512;Saint-Pierre-de-Lages;333;11543656;647491;239;10365174;94;1178482;34666;33887
10440;Voigny;114;3952485;533982;77;3556379;37;396106;34671;33888
14665;Sallenelles;163;5651504;493246;96;4911034;67;740470;34672;33889
62075;Baincthun;638;22120864;1210689;418;19521237;220;2599627;34672;33890
25050;Le Bélieu;181;6275885;509754;130;5688870;51;587015;34673;33891
54296;Laneuvelotte;214;7420405;618912;157;6746709;57;673696;34675;33892
59257;Fromelles;431;14949153;1110945;292;13354117;139;1595036;34685;33893
91629;Valpuiseaux;324;11238704;956633;239;10157029;85;1081675;34687;33894
45274;Saint-Denis-en-Val;3703;128447976;8256783;2716;115562678;987;12885298;34688;33895
38435;Saint-Pancrasse;211;7319763;440463;154;6647216;57;672547;34691;33896
42135;Marclopt;221;7666744;528402;154;6869919;67;796825;34691;33897
33213;La Brède;2048;71053444;5419428;1412;63275723;636;7777721;34694;33898
91579;Saint-Vrain;1579;54785804;4036572;1205;50291426;374;4494378;34697;33899
54070;Bey-sur-Seille;70;2428783;190991;51;2204389;19;224394;34697;33900
31169;Escalquens;3120;108256687;7297089;2271;98114694;849;10141993;34698;33901
74067;Chavanod;1157;40145772;2222592;823;35978331;334;4167441;34698;33902
67382;Quatzenheim;403;13983613;845862;298;12445623;105;1537990;34699;33903
69048;Chassagny;576;19993908;1099347;433;18113504;143;1880404;34712;33904
37237;Saint-Roch;558;19370123;1169278;425;17658551;133;1711572;34713;33905
76361;Heuqueville;313;10866350;675761;229;9716257;84;1150093;34717;33906
54141;Coyviller;77;2673462;170349;54;2472805;23;200657;34720;33907
78567;Saint-Martin-la-Garenne;511;17742633;1503519;378;16361408;133;1381225;34721;33908
27200;Dardez;83;2883070;249810;64;2621129;19;261941;34736;33909
31478;Saint-Félix-Lauragais;742;25775845;1288296;372;22105767;370;3670078;34738;33910
60461;Nivillers;100;3475353;270645;76;3173399;24;301954;34754;33911
95002;Ableiges;485;16856276;1175484;369;15374865;116;1481411;34755;33912
60534;Rethondes;354;12304966;923493;254;11108016;100;1196950;34760;33913
44209;Treillières;3619;125797293;7114158;2625;112531466;994;13265827;34760;33914
31285;Lavalette;344;11958263;834648;240;10689933;104;1268330;34762;33915
33236;Lège-Cap-Ferret;5443;189214864;17855003;3319;166114670;2124;23100194;34763;33916
51321;Lhéry;44;1529712;163783;25;1374222;19;155490;34766;33917
01052;Bouligneux;150;5215033;374936;124;4808385;26;406648;34767;33918
70563;Villers-le-Sec;273;9495137;507359;199;8644331;74;850806;34781;33919
57454;Mécleuves;558;19407960;1164386;434;17651889;124;1756071;34781;33920
78324;Jouy-Mauvoisin;257;8939022;620985;196;8122659;61;816363;34782;33921
76580;Saint-Georges-sur-Fontaine;416;14471370;861346;292;13118525;124;1352845;34787;33922
31338;Menville;306;10645086;783571;221;9655896;85;989190;34788;33923
76448;Montmain;614;21363711;1166292;466;19561549;148;1802162;34794;33924
74310;Viuz-la-Chiésaz;648;22547838;1503241;491;20622551;157;1925287;34796;33925
01248;Mionnay;959;33369564;2050417;724;30346406;235;3023158;34796;33926
73155;Méry;736;25611706;1640921;550;23006808;186;2604898;34799;33927
28372;Senantes;292;10161599;631594;224;9298690;68;862909;34800;33928
39336;Molain;57;1983607;164569;36;1748455;21;235152;34800;33929
94047;Mandres-les-Roses;2331;81121396;6128849;1666;73778417;665;7342979;34801;33930
74226;Saint-André-de-Boëge;300;10441032;237153;191;8087280;109;2353752;34803;33931
73051;Le Bourget-du-Lac;2115;73615745;5551687;1534;66873542;581;6742203;34806;33932
68007;Andolsheim;1089;37906194;2433078;808;34110231;281;3795963;34808;33933
69089;Francheville;6884;239647042;16634720;4943;216461821;1941;23185221;34812;33934
14685;Thaon;690;24021938;1695232;519;21870302;171;2151636;34814;33935
54037;Azelot;191;6649738;368511;160;6340315;31;309423;34815;33936
08484;Ville-sur-Retourne;44;1532098;100856;29;1343018;15;189080;34820;33937
62059;Autingues;138;4805387;391430;84;4126278;54;679109;34822;33938
02824;Vorges;195;6790363;586094;128;5990778;67;799585;34822;33939
78486;Le Perray-en-Yvelines;3493;121644489;8513864;2713;112546644;780;9097845;34825;33940
28087;Châtaincourt;128;4457932;457848;81;3857471;47;600461;34828;33941
91441;Nainville-les-Roches;259;9020485;731628;198;8390327;61;630158;34828;33942
95459;Nucourt;345;12015794;711066;249;10738720;96;1277074;34828;33943
25035;Auxon-Dessus;527;18356450;1155425;412;16908390;115;1448060;34832;33944
45232;Olivet;10413;362725917;27604659;7612;330395831;2801;32330086;34834;33945
21688;Villars-Fontaine;64;2229384;141511;50;2052916;14;176468;34834;33946
01349;Saint-Éloi;219;7629277;582609;162;6969894;57;659383;34837;33947
31277;Lasserre;498;17349016;952322;354;15750144;144;1598872;34837;33948
10269;Nozay;74;2578102;210188;50;2246222;24;331880;34839;33949
13113;Venelles;4506;156989531;11521645;3207;140611021;1299;16378510;34840;33950
54289;Laître-sous-Amance;189;6585649;365704;142;5853836;47;731813;34845;33951
28073;Champseru;157;5471709;530228;121;5126851;36;344858;34852;33952
33328;Pomerol;398;13873635;1788111;244;12147187;154;1726448;34858;33953
94069;Saint-Maurice;7897;275282464;27558227;5727;253331232;2170;21951232;34859;33954
83152;Rayol-Canadel-sur-Mer;480;16733366;1494954;302;14557222;178;2176144;34861;33955
67452;Schnersheim;663;23116573;1518134;486;20916646;177;2199927;34867;33956
14466;Norolles;133;4637533;339668;101;4259272;32;378261;34869;33957
77426;Saint-Méry;189;6592181;532483;141;6050591;48;541590;34879;33958
74181;Metz-Tessy;1436;50087831;2798063;1040;44183324;396;5904507;34880;33959
92020;Châtillon;19266;672111288;59664575;14592;623798140;4674;48313148;34886;33960
68219;Mortzwiller;155;5407476;290274;115;4940243;40;467233;34887;33961
06159;Villefranche-sur-Mer;3356;117081982;13795346;2089;103845616;1267;13236366;34887;33962
08388;Saint-Marceau;193;6734174;609522;133;5986110;60;748064;34892;33963
38519;Valencin;1247;43511092;2592088;926;39517022;321;3994070;34893;33964
28009;Ardelu;36;1256335;118576;23;1101217;13;155118;34898;33965
77128;Couilly-Pont-aux-Dames;1094;38180459;2892369;774;34220571;320;3959888;34900;33966
76184;Colmesnil-Manneville;53;1849779;97747;40;1651319;13;198460;34901;33967
77114;Chevry-Cossigny;1908;66592775;4802123;1454;61078664;454;5514111;34902;33968
25442;Oye-et-Pallet;354;12356937;869046;257;11256437;97;1100500;34907;33969
54147;Crion;52;1815523;140135;35;1619243;17;196280;34914;33970
68092;Fislis;223;7786366;614212;158;7013768;65;772598;34916;33971
91204;Écharcon;403;14073445;1001537;326;12979568;77;1093877;34922;33972
59042;Bachy;722;25218291;1645507;502;22249409;220;2968882;34928;33973
59083;Bissezeele;101;3527816;222614;67;3076988;34;450828;34929;33974
74262;Scientrier;553;19319043;536971;345;14534558;208;4784485;34935;33975
27519;Sainte-Barbe-sur-Gaillon;133;4646466;377192;96;4177678;37;468788;34936;33976
31506;Saint-Orens-de-Gameville;6074;212282904;13961387;4271;191226903;1803;21056001;34949;33977
62851;Vieille-Chapelle;350;12232457;517849;243;10841246;107;1391211;34950;33978
76285;Fresne-le-Plan;263;9192036;496699;189;8296538;74;895498;34951;33979
51488;Saint-Imoges;148;5172793;302646;111;4644376;37;528417;34951;33980
27094;Bosquentin;68;2377075;243053;42;2091233;26;285842;34957;33981
70218;Esmoulins;69;2412108;112004;47;1756436;22;655672;34958;33982
77328;Nanteau-sur-Essonne;236;8250907;604673;155;7140081;81;1110826;34961;33983
62290;Écurie;195;6817603;474145;130;6034506;65;783097;34962;33984
49106;Corné;1374;48047036;2508889;923;42633897;451;5413139;34969;33985
27136;Chaignes;142;4965628;436499;109;4596871;33;368757;34969;33986
51490;Saint-Jean-sur-Moivre;89;3112340;216229;62;2754703;27;357637;34970;33987
42275;Saint-Priest-en-Jarez;3282;114785625;9670394;2172;101109622;1110;13676003;34974;33988
68184;Liebsdorf;155;5421315;353143;111;4833533;44;587782;34976;33989
14709;Tracy-sur-Mer;180;6296958;664107;117;5532885;63;764073;34983;33990
60631;Thiers-sur-Thève;582;20360370;1624374;443;18615856;139;1744514;34983;33991
54459;Richardménil;1273;44534585;3152920;981;40850310;292;3684275;34984;33992
74189;Mont-Saxonnex;887;31033420;1912987;623;26894647;264;4138773;34987;33993
21442;Morey-Saint-Denis;385;13470458;1262403;267;12233028;118;1237430;34988;33994
44026;Carquefou;8723;305207158;19126154;6273;275128097;2450;30079061;34989;33995
63084;Chanonat;856;29950733;2227186;639;27576279;217;2374454;34989;33996
39348;Montaigu;259;9062385;576003;178;8101688;81;960697;34990;33997
89346;Saint-Georges-sur-Baulche;1904;66622889;5794279;1358;59582600;546;7040289;34991;33998
02563;Noyales;90;3149235;234352;52;2820793;38;328442;34992;33999
51312;Juvigny;461;16132940;959398;372;15054068;89;1078872;34996;34000
38248;Montaud;241;8434958;582813;176;7649165;65;785793;35000;34001
35150;Lécousse;1573;55059197;3065498;1048;47856012;525;7203185;35003;34002
25256;Frambouhans;386;13512003;968123;291;12532441;95;979562;35005;34003
57218;Fleury;510;17857139;1028318;361;15341916;149;2515223;35014;34004
71221;Givry;2010;70382515;5732224;1359;63003808;651;7378707;35016;34005
31194;Francarville;84;2941597;227641;55;2608610;29;332987;35019;34006
77219;Guérard;1169;40972390;3099557;912;37674948;257;3297442;35049;34007
38140;Crolles;3972;139234743;9270453;2904;125286409;1068;13948334;35054;34008
57557;Puttelange-lès-Thionville;372;13040865;61013;111;4872407;261;8168458;35056;34009
38350;Sainte-Agnès;261;9149987;661537;184;8226307;77;923680;35057;34010
50376;Nicorps;211;7397225;784842;140;6539370;71;857855;35058;34011
71390;Saint-Berain-sous-Sanvignes;534;18721026;713040;321;16305983;213;2415043;35058;34012
01062;Bressolles;371;13006703;769999;259;11475777;112;1530926;35058;34013
95254;Frémécourt;271;9503516;696474;211;8710321;60;793195;35068;34014
41134;Menars;329;11538121;940916;236;10386527;93;1151594;35070;34015
59188;Écuélin;58;2034504;173630;37;1808367;21;226137;35078;34016
70093;Breuches;434;15225009;1760917;232;13019489;202;2205520;35081;34017
64179;Castetner;76;2666198;207944;44;2240011;32;426187;35082;34018
80185;Champien;153;5368177;456588;90;4799788;63;568389;35086;34019
01285;Parcieux;525;18421105;1099918;378;16661776;147;1759329;35088;34020
60249;Foulangues;91;3193224;173704;67;2918959;24;274265;35090;34021
78062;Beynes;3845;134930329;9089320;3025;125090785;820;9839544;35092;34022
77400;Saint-Augustin;892;31302847;2360475;649;28485766;243;2817081;35093;34023
76275;Fontenay;520;18248761;1200716;420;16990799;100;1257962;35094;34024
68355;Waldighofen;798;28016737;2158819;584;25177211;214;2839526;35109;34025
77466;Tigeaux;199;6986855;604347;149;6484740;50;502115;35110;34026
69154;Pollionnay;1021;35852589;2879357;696;31827032;325;4025557;35115;34027
74022;Aviernoz;387;13589832;713916;272;11705856;115;1883976;35116;34028
16271;Puymoyen;1307;45898889;3381883;959;41802790;348;4096099;35118;34029
69244;Tassin-la-Demi-Lune;11421;401099092;34801610;8263;364021597;3158;37077495;35119;34030
78647;Vert;437;15347360;1214576;318;13894523;119;1452837;35120;34031
38433;Saint-Nizier-du-Moucherotte;539;18929916;1196937;392;17196203;147;1733713;35120;34032
77177;Favières;608;21356360;1673490;462;19393974;146;1962386;35126;34033
02809;Villers-Agron-Aiguizy;49;1721258;166285;29;1540559;20;180699;35128;34034
94075;Villecresnes;4983;175061529;13759385;3721;161618919;1262;13442610;35132;34035
51102;Cauroy-lès-Hermonville;213;7483686;484618;152;6691933;61;791753;35135;34036
77389;La Rochette;1756;61701294;5737748;1230;56440834;526;5260460;35137;34037
91106;Breux-Jouy;650;22843084;1438954;474;20875492;176;1967592;35143;34038
80429;Hénencourt;91;3198060;103958;50;2798320;41;399740;35144;34039
59129;Cappelle-en-Pévèle;1014;35640812;2194577;718;31950281;296;3690531;35149;34040
30351;Villeneuve-lès-Avignon;7138;250913529;22777624;4645;223359320;2493;27554209;35152;34041
95628;Valmondois;680;23903258;1984708;518;22156675;162;1746583;35152;34042
51204;Damery;776;27278737;2590177;558;24791234;218;2487503;35153;34043
02822;Vivières;207;7278524;587542;128;6308241;79;970283;35162;34044
80624;Pierregot;118;4149857;242226;88;3756685;30;393172;35168;34045
51374;Mondement-Montgivroux;24;844124;86221;13;739179;11;104945;35172;34046
21595;Savolles;69;2427457;190623;48;2123385;21;304072;35181;34047
14227;Douville-en-Auge;103;3623688;187020;64;3182787;39;440901;35181;34048
54197;Fléville-devant-Nancy;1214;42717956;3180342;927;39298599;287;3419357;35188;34049
68143;Holtzwihr;657;23119302;1574787;483;20863133;174;2256169;35189;34050
95529;Ronquerolles;421;14814862;1166877;324;13671985;97;1142877;35190;34051
53054;Changé;2630;92549749;5428361;1941;83393919;689;9155830;35190;34052
42043;Chamboeuf;716;25198059;1524847;552;23169615;164;2028444;35193;34053
74259;Le Sappey;195;6865082;127373;98;4633167;97;2231915;35206;34054
57601;Rozérieulles;702;24720722;1748405;492;21870454;210;2850268;35215;34055
28172;Gas;366;12888663;843894;293;11946220;73;942443;35215;34056
31389;Montrabé;1945;68510865;4691535;1481;62737843;464;5773022;35224;34057
91408;Moigny-sur-École;665;23430327;1819889;494;21570188;171;1860139;35234;34058
31184;Flourens;960;33826969;2454130;680;30457352;280;3369617;35236;34059
78536;Sailly;183;6448413;484237;143;6010114;40;438299;35237;34060
21037;Auxey-Duresses;175;6167016;539870;131;5619569;44;547447;35240;34061
27506;Saint-Amand-des-Hautes-Terres;149;5250776;379879;106;4729699;43;521077;35240;34062
62007;Acq;326;11488343;703646;222;10253259;104;1235084;35240;34063
64038;Arcangues;1720;60613909;4874741;1136;53054694;584;7559215;35241;34064
42093;Farnay;603;21250856;1395872;442;19059850;161;2191006;35242;34065
56106;Larmor-Baden;571;20125331;1452489;365;17036945;206;3088386;35246;34066
57385;Laquenexy;489;17236004;891688;363;15043225;126;2192779;35247;34067
81218;Puygouzon;1602;56469888;4257946;1123;50729705;479;5740183;35250;34068
44151;Saint-André-des-Eaux;2684;94655905;6326408;1926;85025963;758;9629942;35267;34069
77477;Ury;445;15694581;1249322;306;14102118;139;1592463;35269;34070
26007;Ambonil;57;2010685;178945;38;1751112;19;259573;35275;34071
31057;Belberaud;604;21313742;1238198;415;18898200;189;2415542;35288;34072
05037;Châteauvieux;253;8927873;659318;175;8098881;78;828992;35288;34073
60261;Fresnoy-le-Luat;232;8187997;535190;177;7635165;55;552832;35293;34074
51587;Vadenay;116;4095057;271692;79;3654839;37;440218;35302;34075
74106;Draillant;356;12569075;421310;220;10065242;136;2503833;35306;34076
29011;Bohars;1710;60393096;3913393;1106;53633351;604;6759745;35318;34077
51046;Beine-Nauroy;461;16282137;991915;346;14578548;115;1703589;35319;34078
68243;Oberlarg;85;3002584;223966;56;2627305;29;375279;35325;34079
95313;L'Isle-Adam;6546;231238031;20825520;4684;209927281;1862;21310750;35325;34080
95353;Maffliers;778;27483067;1924555;620;25787069;158;1695998;35325;34081
68012;Aspach-le-Haut;726;25648836;1419089;526;22951988;200;2696848;35329;34082
74163;Margencel;1002;35400954;1685055;671;29773232;331;5627722;35330;34083
94071;Sucy-en-Brie;13409;473822388;38914355;9677;432109801;3732;41712587;35336;34084
69272;Communay;1975;69791689;4680334;1464;63363798;511;6427891;35338;34085
34270;Saint-Jean-de-Védas;4673;165155432;13150954;3122;147102770;1551;18052662;35342;34086
76591;Saint-Jacques-sur-Darnétal;1345;47537240;3260171;967;42854891;378;4682349;35344;34087
74019;Argonay;1338;47290090;3318396;971;41653383;367;5636707;35344;34088
67368;Ottrott;847;29941250;2340288;596;26741114;251;3200136;35350;34089
69219;Saint-Laurent-d'Agny;1036;36622950;2328476;760;33141547;276;3481403;35350;34090
25286;Grand'Combe-des-Bois;61;2156775;122018;40;1879370;21;277405;35357;34091
80643;Prouzel;255;9016924;847437;180;8188598;75;828326;35360;34092
57249;Glatigny;127;4490870;249590;91;3928591;36;562279;35361;34093
26139;Génissieux;1022;36141684;2648407;680;32060430;342;4081254;35364;34094
14254;Éterville;639;22597815;1252385;494;20590763;145;2007052;35364;34095
02094;Blesmes;206;7285404;557022;134;6439315;72;846089;35366;34096
60216;Erquinvillers;85;3006215;413616;65;2793658;20;212557;35367;34097
02343;Germaine;37;1308874;106363;26;1180575;11;128299;35375;34098
76464;La Neuville-Chant-d'Oisel;992;35099498;2172872;764;32281675;228;2817823;35383;34099
25534;Sarrageois;83;2937382;192833;62;2726512;21;210870;35390;34100
54202;Fontenoy-sur-Moselle;158;5591883;292415;119;5007622;39;584261;35392;34101
34309;Teyran;2359;83496139;6058331;1666;74720288;693;8775851;35395;34102
28036;Berchères-sur-Vesgre;417;14759640;1213016;296;13368042;121;1391598;35395;34103
80239;Devise;34;1203488;120729;18;1070620;16;132868;35397;34104
59145;Chemy;343;12141761;801060;255;11121533;88;1020228;35399;34105
91086;Bondoufle;4444;157327365;11019407;3473;145238378;971;12088987;35402;34106
74120;Évires;668;23650200;752143;417;18703597;251;4946603;35404;34107
38487;Seyssuel;965;34167031;2279515;707;31318253;258;2848778;35406;34108
01322;Reyrieux;2088;73931971;4992933;1476;65928683;612;8003288;35408;34109
65340;Orleix;1047;37072224;1368601;624;32152544;423;4919680;35408;34110
73310;Verel-Pragondran;230;8144335;483030;184;7562286;46;582049;35410;34111
25525;Saint-Point-Lac;150;5311639;391010;114;4939482;36;372157;35411;34112
31501;Saint-Marcel-Paulel;208;7367976;612714;139;6545549;69;822427;35423;34113
78484;Perdreauville;290;10273180;650801;225;9509739;65;763441;35425;34114
25013;Allondans;137;4853502;270794;89;4396535;48;456967;35427;34115
77306;Montereau-sur-le-Jard;268;9494902;673884;214;8789966;54;704936;35429;34116
51594;Vassimont-et-Chapelaine;36;1275565;99852;23;1025646;13;249919;35432;34117
01423;Toussieux;377;13362674;712585;286;12220218;91;1142456;35445;34118
67236;Kienheim;288;10208191;660562;218;9350515;70;857676;35445;34119
06065;La Gaude;3537;125373438;10076169;2464;112835255;1073;12538183;35446;34120
10211;Macey;434;15384687;1129410;333;13960857;101;1423830;35449;34121
73059;Brison-Saint-Innocent;1130;40061988;2847195;787;35847798;343;4214190;35453;34122
28118;Croisilles;227;8048168;507294;175;7418426;52;629742;35454;34123
92060;Le Plessis-Robinson;15438;547395320;47187197;11910;509345049;3528;38050271;35458;34124
28195;Houx;364;12908565;598824;281;11952627;83;955938;35463;34125
42097;La Fouillouse;2338;82915104;6004014;1611;73911670;727;9003434;35464;34126
88320;Nayemont-les-Fosses;447;15859661;1077240;300;13984541;147;1875120;35480;34127
78077;La Boissière-École;382;13557489;1354145;293;12589529;89;967960;35491;34128
31148;Clermont-le-Fort;259;9192236;674356;183;8406358;76;785878;35491;34129
90012;Bessoncourt;509;18067386;1251619;381;16492369;128;1575017;35496;34130
76267;La Folletière;34;1207067;113002;21;1036229;13;170838;35502;34131
37117;Hommes;476;16898947;559394;233;14256796;243;2642151;35502;34132
45200;Ménestreau-en-Villette;752;26703041;2212079;524;23730347;228;2972694;35509;34133
65223;Horgues;609;21628198;1690964;434;19457530;175;2170668;35514;34134
95348;Longuesse;269;9555195;687828;214;9029266;55;525929;35521;34135
68087;Feldbach;223;7922011;532352;163;7181009;60;741002;35525;34136
59085;Blécourt;171;6076562;334460;96;5170551;75;906011;35535;34137
28269;Morancez;821;29175400;1871128;619;26719774;202;2455626;35536;34138
38415;Saint-Marcel-Bel-Accueil;671;23854896;1566814;487;21333599;184;2521297;35551;34139
76167;Cauville-sur-Mer;657;23357332;1504718;507;21642126;150;1715206;35551;34140
34177;Murles;140;4977429;491316;102;4641275;38;336154;35553;34141
74077;Clarafond-Arcine;457;16250603;436420;266;12183783;191;4066820;35559;34142
33118;Cénac;923;32829438;2175768;662;29284885;261;3544553;35568;34143
57408;Lixing-lès-Rouhling;489;17396823;682556;313;15147209;176;2249614;35576;34144
10209;Lusigny-sur-Barse;920;32730781;2346983;576;28977807;344;3752974;35577;34145
59250;Fournes-en-Weppes;1055;37541280;2645832;742;33770609;313;3770671;35584;34146
67363;Osthoffen;422;15016597;887610;312;13657386;110;1359211;35584;34147
62589;Mont-Saint-Éloi;522;18575934;1735969;372;16850373;150;1725561;35586;34148
51049;Bergères-lès-Vertus;299;10640458;1026277;207;9594217;92;1046241;35587;34149
91347;Longpont-sur-Orge;3432;122146104;10123394;2543;113291981;889;8854123;35590;34150
68206;Michelbach;168;5979780;420432;123;5313777;45;666003;35594;34151
39228;Foncine-le-Haut;525;18698578;1686987;331;16326284;194;2372294;35616;34152
51384;Morangis;148;5271916;350794;112;4785586;36;486330;35621;34153
62445;Hesdigneul-lès-Béthune;455;16210030;1116450;239;13825717;216;2384313;35626;34154
83027;La Cadière-d'Azur;3013;107353741;9278756;1936;95397699;1077;11956042;35630;34155
77186;Fontainebleau;8652;308344214;30887052;5630;276239545;3022;32104669;35638;34156
67001;Achenheim;1083;38599714;2730251;800;35034242;283;3565472;35641;34157
57104;Boust;516;18391091;483158;214;9359411;302;9031680;35642;34158
95491;Le Plessis-Bouchard;4043;144105201;10521543;3164;134200933;879;9904268;35643;34159
50616;Le Val-Saint-Père;986;35149966;2353926;666;30745049;320;4404917;35649;34160
65331;Odos;1760;62744684;5137241;1198;55978327;562;6766357;35650;34161
78618;Tilly;254;9056276;702016;195;8366320;59;689956;35655;34162
78382;Maurecourt;2186;77941610;5614676;1608;71244558;578;6697052;35655;34163
74015;Arbusigny;484;17259832;378256;281;12445999;203;4813833;35661;34164
69208;Saint-Germain-sur-l'Arbresle;649;23148569;1459099;495;21149931;154;1998638;35668;34165
14131;Canapville;125;4459218;439036;79;3996207;46;463011;35674;34166
74140;Habère-Poche;653;23297129;740609;405;18234868;248;5062261;35677;34167
01166;Frans;983;35074654;2276252;732;31957523;251;3117131;35681;34168
68309;Sierentz;1854;66161153;5821065;1311;59271805;543;6889348;35686;34169
91038;Auvers-Saint-Georges;597;21305259;1415959;461;19476202;136;1829057;35687;34170
02496;Monnes;44;1570607;145905;26;1259140;18;311467;35696;34171
90042;Évette-Salbert;1094;39053641;2854658;822;35941935;272;3111706;35698;34172
39217;L'Étoile;297;10603567;641552;210;9632921;87;970646;35702;34173
14492;Pennedepie;150;5355352;295677;89;4638990;61;716362;35702;34174
91577;Saintry-sur-Seine;2625;93724555;7288415;2036;86826376;589;6898179;35705;34175
57574;Basse-Rentgen;182;6500002;64360;74;3102614;108;3397388;35714;34176
25043;Bart;1061;37903256;2407260;691;33345400;370;4557856;35724;34177
59658;Wicres;186;6644745;445321;140;5971248;46;673497;35724;34178
06085;Mougins;10938;390794258;37124349;7299;351358636;3639;39435622;35728;34179
76619;Saint-Martin-le-Gaillard;150;5359298;415132;95;4709363;55;649935;35729;34180
40178;Mazerolles;327;11684237;739285;250;10841996;77;842241;35732;34181
13009;La Barben;367;13113596;949136;261;11810278;106;1303318;35732;34182
02621;Presles-et-Thierny;219;7828554;668209;151;6993756;68;834798;35747;34183
57521;OEting;1333;47652216;3778415;905;41563945;428;6088271;35748;34184
91560;Saint-Jean-de-Beauregard;156;5578450;508406;124;5228820;32;349630;35759;34185
68259;Raedersdorf;262;9370283;807551;193;8684036;69;686247;35764;34186
73243;Saint-Jean-d'Arvey;768;27471862;1809509;585;25127080;183;2344782;35771;34187
76404;Manéglise;559;20000190;1052379;416;17917436;143;2082754;35779;34188
77434;Saint-Sauveur-lès-Bray;208;7444521;632311;132;6520512;76;924009;35791;34189
77268;Magny-le-Hongre;3409;122045869;9133829;2602;112802809;807;9243060;35801;34190
41153;Montrouveau;82;2935712;563810;39;2440848;43;494864;35801;34191
67350;Oberschaeffolsheim;1110;39741340;2894273;833;35987421;277;3753919;35803;34192
78513;La Queue-les-Yvelines;1112;39816175;3059144;767;35609152;345;4207023;35806;34193
69040;Champagne-au-Mont-d'Or;2928;104839922;10352264;2012;93843045;916;10996877;35806;34194
71222;Gourdon;468;16757478;1291752;312;14872169;156;1885309;35807;34195
02132;Bucy-lès-Cerny;97;3473724;298076;61;3118438;36;355286;35812;34196
76287;Fresquiennes;498;17834717;1297621;359;16040368;139;1794349;35813;34197
68303;Schwoben;127;4548809;318838;90;4129113;37;419696;35817;34198
39059;Bois-d'Amont;937;33563460;2748338;696;30720931;241;2842529;35820;34199
01043;Beynost;2220;79532415;5793768;1641;72361431;579;7170984;35825;34200
95504;Presles;1963;70345138;5208594;1505;65449459;458;4895679;35836;34201
72328;Sargé-lès-le-Mans;1727;61888401;3949313;1270;56291388;457;5597013;35836;34202
69148;Orliénas;1139;40826882;3181076;856;37386556;283;3440326;35844;34203
68033;Bettendorf;255;9140514;818053;170;8033129;85;1107385;35845;34204
51320;Leuvrigny;171;6129582;692342;102;5364535;69;765047;35846;34205
76106;Bois-d'Ennebourg;261;9356570;666232;197;8523828;64;832742;35849;34206
39102;Chancia;120;4302544;244774;85;3543973;35;758571;35855;34207
91363;Marcoussis;4056;145435296;11077763;2997;133350659;1059;12084637;35857;34208
77056;Burcy;88;3155539;324134;59;2811139;29;344400;35858;34209
25049;Belfays;54;1936382;114914;42;1775990;12;160392;35859;34210
01088;Charnoz-sur-Ain;403;14452322;969007;306;13154634;97;1297688;35862;34211
90096;Thiancourt;130;4662182;389306;102;4334085;28;328097;35863;34212
91661;Villebon-sur-Yvette;5285;189581756;14741357;4237;177975450;1048;11606306;35872;34213
51308;Jonchery-sur-Vesle;952;34152925;2428481;671;30779953;281;3372972;35875;34214
76187;Contremoulins;99;3551942;317754;70;3179974;29;371968;35878;34215
44035;La Chapelle-sur-Erdre;8679;311415396;18905576;6278;278464283;2401;32951113;35881;34216
06152;Valbonne;6172;221464085;18483075;4163;199091913;2009;22372172;35882;34217
27440;Notre-Dame-de-l'Isle;348;12487170;1035804;260;11512338;88;974832;35883;34218
60420;Montjavoult;246;8827525;902671;169;7973453;77;854072;35884;34219
51178;Coupetz;39;1399496;131463;24;1214152;15;185344;35885;34220
74172;Maxilly-sur-Léman;721;25873332;1951854;495;23213523;226;2659809;35885;34221
51560;Suizy-le-Franc;54;1937963;186170;37;1721922;17;216041;35888;34222
91457;La Norville;2087;74901822;5766875;1625;69449222;462;5452600;35890;34223
81041;Broze;59;2117714;245857;28;1824970;31;292744;35893;34224
80627;Plachy-Buyon;441;15829719;1092702;335;14530838;106;1298881;35895;34225
78465;Orgerus;1214;43584834;3233869;927;40126966;287;3457868;35902;34226
10160;Fravaux;28;1005359;136540;17;902823;11;102536;35906;34227
33349;Quinsac;1063;38168228;3107637;711;34048726;352;4119502;35906;34228
13015;Bouc-Bel-Air;7399;265698931;20262930;5179;239834904;2220;25864027;35910;34229
68148;Hundsbach;151;5424132;330243;106;4701175;45;722957;35921;34230
25285;Grand'Combe-Châteleu;729;26193765;1887422;549;23718184;180;2475581;35931;34231
78502;Le Port-Marly;2716;97600707;8522232;2012;90225973;704;7374734;35935;34232
60452;Neuville-Bosc;251;9020165;686070;189;8280300;62;739865;35937;34233
42087;Écotay-l'Olme;600;21564195;1412748;438;19365709;162;2198486;35940;34234
14391;Maisons;191;6865447;276749;117;6010092;74;855355;35945;34235
45317;Tavers;700;25163140;1928574;505;22626142;195;2536998;35947;34236
68240;Oberdorf;293;10533836;840935;200;9369866;93;1163970;35952;34237
35334;Thorigné-Fouillard;3596;129293394;8482670;2702;118714892;894;10578502;35955;34238
68129;Heimsbrunn;714;25672519;1800653;514;23013121;200;2659398;35956;34239
68347;Vieux-Ferrette;313;11255191;826788;213;9792107;100;1463084;35959;34240
74118;Étrembières;1021;36739275;1406244;480;23902167;541;12837108;35984;34241
51227;Écury-sur-Coole;220;7916528;527430;163;7068997;57;847531;35984;34242
74257;Sallenôves;271;9752007;296072;196;8306695;75;1445312;35985;34243
08287;Ménil-Lépinois;71;2554980;171415;50;2195323;21;359657;35986;34244
88178;Les Forges;1031;37103445;2725699;740;33627519;291;3475926;35988;34245
71051;Bouzeron;79;2844013;486882;43;2432063;36;411950;36000;34246
14322;Guéron;127;4572237;377716;84;4090372;43;481865;36002;34247
94053;Noiseau;2343;84355191;6047379;1882;79061944;461;5293247;36003;34248
90004;Argiésans;192;6915262;644123;146;6374432;46;540830;36017;34249
01318;Rancé;295;10628271;599360;223;9713824;72;914447;36028;34250
51076;Boursault;237;8538870;854895;172;7694924;65;843946;36029;34251
14706;Tourville-en-Auge;115;4143372;255637;84;3858198;31;285174;36029;34252
10106;Courceroy;74;2666594;239988;50;2380431;24;286163;36035;34253
80264;Éclusier-Vaux;50;1801962;99976;23;1561740;27;240222;36039;34254
91130;Chalo-Saint-Mars;614;22128585;1816978;443;19589643;171;2538942;36040;34255
78609;Tessancourt-sur-Aubette;467;16831086;1279204;364;15683226;103;1147860;36041;34256
14274;Fontaine-Étoupefour;955;34423219;1959420;716;30613477;239;3809742;36045;34257
91685;Villiers-sur-Orge;2005;72302457;5409851;1596;67440166;409;4862291;36061;34258
28235;Marchezais;138;4976654;306148;110;4531251;28;445403;36063;34259
45193;Marcilly-en-Villette;1032;37221277;2381949;723;33734935;309;3486342;36067;34260
91689;Wissous;3708;133742428;10411998;2886;124097238;822;9645190;36069;34261
95256;Frépillon;1372;49504182;3500410;1071;45820188;301;3683994;36082;34262
60293;Hadancourt-le-Haut-Clocher;179;6458998;524096;134;5966580;45;492418;36084;34263
92075;Vanves;15191;548289508;52120780;11516;509687655;3675;38601853;36093;34264
25240;Les Fins;1577;56929239;4594098;1156;51689251;421;5239988;36100;34265
77047;Bouleurs;677;24443937;1884634;488;22425883;189;2018054;36106;34266
78588;Saulx-Marchais;425;15350108;1138969;344;14475011;81;875097;36118;34267
10295;Polisot;168;6070627;603444;123;5526537;45;544090;36135;34268
06038;Châteauneuf-Grasse;1755;63426233;5859791;1117;55805438;638;7620795;36140;34269
02568;Oigny-en-Valois;81;2927392;262873;53;2559425;28;367967;36141;34270
90083;Recouvrance;48;1734870;120983;36;1536349;12;198521;36143;34271
78642;Verneuil-sur-Seine;7866;284321923;23252626;5942;262208787;1924;22113136;36146;34272
38542;Veyssilieu;148;5350801;309808;110;4852008;38;498793;36154;34273
71240;Jalogny;187;6764265;226250;109;5911131;78;853134;36173;34274
33033;Baurech;443;16027968;1419452;273;13727116;170;2300852;36181;34275
18255;Le Subdray;407;14727828;848826;323;13591951;84;1135877;36186;34276
51509;Saint-Pierre;137;4957721;324214;102;4357560;35;600161;36188;34277
13111;Vauvenargues;535;19361282;1440776;348;17384256;187;1977026;36189;34278
51153;Chouilly;556;20124798;2235130;401;18388957;155;1735841;36196;34279
06121;Saint-Jean-Cap-Ferrat;834;30188972;3600069;534;27180150;300;3008822;36198;34280
51599;Vaudemange;144;5213758;393365;97;4511762;47;701996;36207;34281
77352;Ozouer-le-Voulgis;898;32519106;2166440;668;29923897;230;2595209;36213;34282
35051;Cesson-Sévigné;8341;302074371;23958565;6057;275079447;2284;26994924;36216;34283
91332;Leudeville;669;24233056;1621285;543;22544060;126;1688996;36223;34284
78537;Saint-Arnoult-en-Yvelines;3056;110707285;8630700;2392;103075116;664;7632169;36226;34285
67374;Pfettisheim;426;15433225;1153166;338;14130803;88;1302422;36228;34286
76078;Bennetot;76;2754009;229905;50;2434197;26;319812;36237;34287
78416;Montalet-le-Bois;175;6341726;549387;136;5755657;39;586069;36238;34288
78033;Aulnay-sur-Mauldre;575;20841893;1656061;429;19302727;146;1539166;36247;34289
95303;Le Heaulme;115;4168635;353931;93;3986532;22;182103;36249;34290
51431;Pierry;678;24584588;2742118;498;22509410;180;2075178;36260;34291
62211;Capelle-Fermont;79;2864721;243408;57;2572761;22;291960;36262;34292
91243;Fontenay-lès-Briis;942;34159146;2517923;765;32167228;177;1991918;36262;34293
27589;Saint-Pierre-de-Bailleul;477;17298839;1491205;343;15873911;134;1424928;36266;34294
59056;Beaucamps-Ligny;413;14978513;1001339;278;13309342;135;1669171;36268;34295
60326;Jonquières;313;11354932;907804;231;10512253;82;842679;36278;34296
76367;Houppeville;1236;44840121;3069751;934;41168083;302;3672038;36278;34297
60614;Serans;117;4244657;378234;83;3882758;34;361899;36279;34298
02317;Fluquières;105;3809727;312922;64;3300289;41;509438;36283;34299
28347;Saint-Lubin-de-la-Haye;452;16405003;1394098;325;14653513;127;1751490;36294;34300
31358;Montastruc-la-Conseillère;1579;57311494;3850296;1101;52071552;478;5239942;36296;34301
01105;Civrieux;643;23339677;1518513;470;21142542;173;2197135;36298;34302
40139;Laglorieuse;290;10526544;653701;201;9470190;89;1056354;36298;34303
68075;Durmenach;474;17206450;1234638;302;15364332;172;1842118;36301;34304
94055;Ormesson-sur-Marne;5157;187202434;14911629;3844;172407750;1313;14794684;36301;34305
68198;Magstatt-le-Haut;139;5046472;395374;94;4547556;45;498916;36306;34306
59602;Tressin;694;25198694;1836871;483;22901342;211;2297352;36309;34307
38516;La Tronche;3354;121816669;12101484;2284;110565068;1070;11251601;36320;34308
91525;Roinville;617;22410723;1617325;457;20115906;160;2294817;36322;34309
77040;Boissise-le-Roi;1878;68241080;5129580;1416;62976988;462;5264092;36337;34310
51448;Prouilly;311;11303538;1056768;227;10366703;84;936835;36346;34311
10126;Dolancourt;77;2798821;389767;43;2368201;34;430620;36348;34312
78265;Garancières;1189;43225241;3403127;911;40306278;278;2918963;36354;34313
60546;Rosières;48;1745347;208093;28;1557509;20;187838;36361;34314
68312;Sondersdorf;181;6581614;616207;117;5748089;64;833525;36363;34315
95510;Puiseux-Pontoise;185;6727360;583151;130;6096752;55;630608;36364;34316
74043;Bons-en-Chablais;2636;95857751;2705458;1571;71146151;1065;24711600;36365;34317
91671;Villeneuve-sur-Auvers;298;10836801;802900;242;10305140;56;531661;36365;34318
76313;Gouy;361;13128243;757911;270;11941359;91;1186884;36366;34319
51276;Gourgançon;84;3054944;299538;52;2664075;32;390869;36368;34320
55395;Osches;27;981948;105491;16;854912;11;127036;36368;34321
25454;Pirey;1006;36589531;2879516;749;32980743;257;3608788;36371;34322
57554;Pournoy-la-Grasse;262;9529416;594454;195;8546292;67;983124;36372;34323
95554;Saint-Gervais;471;17132090;1404725;346;15664183;125;1467907;36374;34324
51103;La Celle-sous-Chantemerle;82;2983117;266494;56;2694835;26;288282;36379;34325
91244;Fontenay-le-Vicomte;585;21285815;1572464;461;19917047;124;1368768;36386;34326
31445;Quint-Fonsegrives;2644;96226097;6947158;1932;87332559;712;8893538;36394;34327
68161;Katzenthal;278;10121163;742928;207;9304071;71;817092;36407;34328
33330;Pompignac;1415;51517522;3166445;1027;46832289;388;4685233;36408;34329
68133;Henflingen;103;3750073;257485;75;3412187;28;337886;36408;34330
64220;Estos;273;9940838;646776;188;8754400;85;1186438;36413;34331
28245;Meslay-le-Grenet;147;5353086;432021;118;5056615;29;296471;36416;34332
77359;Perthes;1080;39348217;3251499;816;36406408;264;2941809;36434;34333
39470;Les Rousses;1936;70562437;5800741;1431;64563596;505;5998841;36448;34334
02561;Nouvion-le-Vineux;83;3025425;340496;58;2774356;25;251069;36451;34335
40320;Uchacq-et-Parentis;295;10754364;819278;202;9649207;93;1105157;36455;34336
77442;Samoreau;1166;42512678;3202055;876;38930038;290;3582640;36460;34337
51367;Le Mesnil-sur-Oger;619;22570778;2472768;421;20370228;198;2200550;36463;34338
76513;Quevillon;278;10139563;735627;197;9188443;81;951120;36473;34339
39244;Frontenay;89;3246590;123908;47;2774710;42;471880;36479;34340
91581;Saint-Yon;467;17037838;1403838;380;16154357;87;883481;36484;34341
68248;Oltingue;387;14122342;1286890;268;12841677;119;1280665;36492;34342
59197;Ennevelin;1024;37368524;2387496;728;33808481;296;3560043;36493;34343
45341;Villeneuve-sur-Conie;98;3576341;332838;70;3131762;28;444579;36493;34344
78403;Mézy-sur-Seine;1050;38317986;3024615;776;34812906;274;3505080;36493;34345
69237;Saint-Sorlin;283;10329443;634484;199;9035997;84;1293446;36500;34346
39146;Chilly-le-Vignoble;314;11463707;647260;211;10234435;103;1229272;36509;34347
74064;Châtillon-sur-Cluses;635;23183959;1578460;464;20608990;171;2574969;36510;34348
51631;Villers-aux-Noeuds;89;3249826;243002;69;2970082;20;279744;36515;34349
57600;Roussy-le-Village;562;20526471;191484;209;9257993;353;11268478;36524;34350
83119;Saint-Tropez;3468;126670742;17364126;2175;113789479;1293;12881263;36526;34351
74071;Chessenaz;86;3141756;95140;53;2279857;33;861899;36532;34352
31366;Montbrun-Lauragais;284;10375968;776206;200;9487251;84;888717;36535;34353
67344;Oberhoffen-lès-Wissembourg;150;5480564;336471;110;4778348;40;702216;36537;34354
67181;Handschuheim;152;5555885;591357;105;5043187;47;512698;36552;34355
63141;Durtol;1087;39732085;3086354;749;35537563;338;4194522;36552;34356
78317;Jambville;385;14072950;975909;308;13182133;77;890817;36553;34357
77125;Condé-Sainte-Libiaire;750;27415505;2115944;559;25410766;191;2004739;36554;34358
34314;Le Triadou;197;7202609;457267;129;6501609;68;701000;36561;34359
78015;Andrésy;6600;241333225;20241616;5147;225611937;1453;15721288;36566;34360
35210;Pacé;5138;187979511;12761271;3695;169862196;1443;18117315;36586;34361
01354;Saint-Genis-Pouilly;4156;152057669;6453896;1996;108004348;2160;44053321;36588;34362
78113;Brueil-en-Vexin;349;12769828;935748;278;12028711;71;741117;36590;34363
57200;Les Étangs;202;7391587;554632;145;6638641;57;752946;36592;34364
95042;Baillet-en-France;996;36450851;2505857;818;33937884;178;2512967;36597;34365
74005;Allinges;2128;77880453;3855995;1454;65303781;674;12576672;36598;34366
23016;Banize;85;3111649;101502;35;2701618;50;410031;36608;34367
74137;Groisy;1644;60184217;2873447;1149;51542242;495;8641975;36608;34368
77041;Boissy-aux-Cailles;162;5930784;484310;127;5540777;35;390007;36610;34369
31439;Préserville;339;12410728;890570;248;11334198;91;1076530;36610;34370
16151;Genté;460;16840724;1086394;299;15144232;161;1696492;36610;34371
74050;Burdignin;317;11605509;304249;196;8957906;121;2647603;36610;34372
78423;Montigny-le-Bretonneux;17299;633356853;50835656;13796;593502162;3503;39854691;36612;34373
71339;Ozolles;230;8421079;289096;110;7057447;120;1363632;36613;34374
68365;Wettolsheim;907;33217897;2930900;650;30091811;257;3126086;36624;34375
14509;Plumetot;120;4395316;309187;93;4067237;27;328079;36628;34376
27588;Saint-Pierre-d'Autils;520;19047504;1562574;365;17318732;155;1728772;36630;34377
77175;Évry-Grégy-sur-Yerre;1218;44618426;3217415;946;42043073;272;2575353;36633;34378
51093;Brugny-Vaudancourt;235;8613206;745157;179;8034729;56;578477;36652;34379
69277;Genas;6131;224815349;15772294;4624;205667668;1507;19147681;36669;34380
78188;Cravent;193;7077396;584987;134;6485157;59;592239;36670;34381
38529;Vaulnaveys-le-Haut;1948;71439501;5270232;1479;66218639;469;5220862;36673;34382
25451;Petite-Chaux;87;3190575;316575;63;2922051;24;268524;36673;34383
77308;Montgé-en-Goële;351;12876532;883437;283;12018489;68;858043;36685;34384
21412;Meursault;833;30573830;3140438;549;27227609;284;3346221;36703;34385
63263;Orcines;1802;66142537;5336606;1324;60726140;478;5416397;36705;34386
59096;Bourghelles;746;27383238;1925287;514;24384296;232;2998942;36707;34387
76728;La Vaupalière;466;17105613;929846;354;15697263;112;1408350;36707;34388
51251;Flavigny;100;3671188;360949;74;3387622;26;283566;36712;34389
86163;Montamisé;1633;59969950;4469773;1213;55145916;420;4824034;36724;34390
38252;Montchaboud;183;6720829;562802;155;6370137;28;350692;36726;34391
39441;Prémanon;591;21707117;1581569;456;19920691;135;1786426;36729;34392
27111;Bretagnolles;108;3966820;419413;73;3582543;35;384277;36730;34393
27473;Port-Mort;476;17483556;1386852;338;15903507;138;1580049;36730;34394
51267;Germigny;100;3673411;365319;77;3390241;23;283170;36734;34395
37208;Saint-Avertin;7783;285937915;22087246;5600;259455466;2183;26482449;36739;34396
38294;Panossas;299;10985742;858221;213;9919260;86;1066482;36742;34397
68056;Brunstatt;3264;119994168;10500549;2261;107932513;1003;12061655;36763;34398
33420;Saint-Hippolyte;90;3308696;364909;56;3017525;34;291171;36763;34399
31192;Fourquevaux;382;14044449;1121785;286;13062660;96;981789;36766;34400
25318;Jougne;881;32393110;2864929;694;30277463;187;2115647;36769;34401
95422;Montgeroult;198;7281005;572715;157;6824354;41;456651;36773;34402
74235;Saint-Germain-sur-Rhône;205;7539129;201926;130;5434672;75;2104457;36776;34403
95181;Courcelles-sur-Viosne;159;5848234;531461;123;5475426;36;372808;36781;34404
95563;Saint-Leu-la-Forêt;7998;294237761;25787026;5819;269985092;2179;24252669;36789;34405
94065;Rungis;3040;111843699;9532490;2420;105230701;620;6612998;36791;34406
74311;Viuz-en-Sallaz;2176;80065330;3187943;1394;63160087;782;16905243;36795;34407
27652;Tourneville;161;5924851;408986;131;5590162;30;334689;36800;34408
78237;Flins-Neuve-Église;69;2539256;237689;51;2337902;18;201354;36801;34409
91482;Pecqueuse;307;11298031;756018;249;10334644;58;963387;36801;34410
63212;Marsat;632;23261275;1779887;461;20954601;171;2306674;36806;34411
68363;Werentzhouse;308;11336318;934241;224;10247303;84;1089015;36806;34412
74076;Choisy;786;28930852;1098329;540;24278190;246;4652662;36808;34413
21227;Darois;217;7988599;556536;153;7134029;64;854570;36814;34414
21391;Marsannay-le-Bois;356;13105821;760047;271;11793286;85;1312535;36814;34415
77087;La Chapelle-Iger;88;3239896;312713;66;3011982;22;227914;36817;34416
77528;Voisenon;500;18409158;1526177;395;17306358;105;1102800;36818;34417
60047;Baron;403;14843466;1371679;296;13664725;107;1178741;36832;34418
68254;Petit-Landau;376;13851061;948234;278;12305328;98;1545733;36838;34419
51555;Soudé;86;3168524;288034;51;2726049;35;442475;36843;34420
77484;Vaucourtois;99;3648953;209778;74;3302422;25;346531;36858;34421
91494;Le Plessis-Pâté;1821;67139742;4667600;1510;63396861;311;3742881;36870;34422
57533;Pange;444;16376580;1062391;341;14935728;103;1440852;36884;34423
60016;Ansacq;133;4905745;373572;99;4531491;34;374254;36885;34424
78597;Soindres;312;11509426;1097733;233;10687974;79;821452;36889;34425
51177;Coulommes-la-Montagne;108;3985077;289769;85;3736751;23;248326;36899;34426
74007;Amancy;1151;42492479;2063840;797;36209693;354;6282786;36918;34427
10199;Loches-sur-Ource;206;7606546;1033982;127;6820346;79;786200;36925;34428
77013;Aulnoy;201;7422135;735321;147;6656791;54;765344;36926;34429
77005;Annet-sur-Marne;1619;59787607;4667821;1224;54505187;395;5282420;36929;34430
02257;Dallon;211;7792380;703187;155;7166005;56;626375;36931;34431
33409;Saint-Genis-du-Bois;56;2068173;309019;32;1871126;24;197047;36932;34432
31088;Brax;1238;45723742;3234327;902;41718324;336;4005418;36934;34433
79128;François;481;17765733;1226334;353;16236199;128;1529534;36935;34434
95316;Jagny-sous-Bois;139;5136163;473735;110;4796485;29;339678;36951;34435
69052;Chazay-d'Azergues;1962;72502814;4834291;1483;65905619;479;6597195;36954;34436
69105;Lacenas;450;16629785;1198658;319;15056132;131;1573653;36955;34437
78460;Oinville-sur-Montcient;575;21252041;1652940;431;19331817;144;1920224;36960;34438
69271;Chassieu;4840;178940231;13570235;3573;163071574;1267;15868657;36971;34439
74062;Charvonnex;570;21079208;1150812;406;18516140;164;2563068;36981;34440
57204;Failly;264;9763513;726275;194;8699012;70;1064501;36983;34441
67268;Lipsheim;1292;47784805;3104446;969;43563791;323;4221014;36985;34442
51375;Montbré;139;5142601;424363;115;4915927;24;226674;36997;34443
77075;Chalifert;650;24049533;2249040;484;22286800;166;1762733;36999;34444
63425;Tallende;754;27903555;1506946;515;25286690;239;2616865;37007;34445
31044;Balma;7371;272812022;22152320;5255;248711618;2116;24100404;37012;34446
68025;Bendorf;118;4369003;380215;84;4034776;34;334227;37025;34447
80229;Crouy-Saint-Pierre;176;6516518;584525;123;5891287;53;625231;37026;34448
51451;Queudes;45;1666793;152998;32;1505915;13;160878;37040;34449
54265;Houdemont;1153;42710347;3328757;879;39522129;274;3188218;37043;34450
22179;Fréhel;1004;37191424;1723451;530;31746300;474;5445124;37043;34451
95445;Nerville-la-Forêt;330;12224987;1097133;236;11346474;94;878513;37045;34452
69265;Ville-sur-Jarnioux;389;14411338;1475482;287;13397677;102;1013661;37047;34453
39371;La Mouille;174;6446784;405407;121;5666533;53;780251;37050;34454
77496;Vieux-Champagne;92;3408795;223499;77;3171998;15;236797;37052;34455
54574;Villers-la-Chèvre;280;10375036;542746;164;7485804;116;2889232;37054;34456
68285;Rorschwihr;200;7414122;779941;152;6745035;48;669087;37071;34457
26138;La Garde-Adhémar;605;22428048;1695554;404;20080980;201;2347068;37071;34458
03077;Chirat-l'Église;81;3002930;57340;27;2524580;54;478350;37073;34459
70215;Errevet;126;4673010;346789;98;4265758;28;407252;37087;34460
35315;Saint-Sulpice-la-Forêt;610;22623906;1358920;466;20648731;144;1975175;37088;34461
74197;Nangy;847;31417608;1039611;499;21771347;348;9646261;37093;34462
27203;Douains;251;9311582;587293;172;8358557;79;953025;37098;34463
25316;Issans;129;4786058;332227;95;4394549;34;391509;37101;34464
51422;Pargny-lès-Reims;189;7013686;579075;141;6407425;48;606261;37109;34465
91458;Nozay;2182;80976465;5742810;1756;76088171;426;4888294;37111;34466
38436;Saint-Paul-de-Varces;1039;38562441;2493169;790;35175401;249;3387040;37115;34467
78261;Gaillon-sur-Montcient;342;12697525;996763;273;11762204;69;935321;37127;34468
92023;Clamart;28730;1066727379;101627210;20505;982927854;8225;83799525;37129;34469
69127;Marcy-l'Étoile;1500;55700395;3686103;1092;48994953;408;6705442;37134;34470
51613;Verzenay;570;21168629;1955177;369;18999850;201;2168779;37138;34471
28300;Poinville;66;2452504;245327;40;2059478;26;393026;37159;34472
77529;Voulangis;762;28325937;2393474;585;26137394;177;2188543;37173;34473
69253;Tupin-et-Semons;294;10929340;711873;216;9992055;78;937285;37175;34474
74177;Menthonnex-en-Bornes;393;14611674;364096;237;11106535;156;3505139;37180;34475
77104;Châtres;313;11637528;882888;235;10691778;78;945750;37181;34476
57449;Marsilly;233;8665080;433764;177;7933054;56;732026;37189;34477
95592;Seraincourt;674;25067797;2322924;494;23045113;180;2022684;37193;34478
01418;Thil;477;17744896;1144000;357;16139119;120;1605777;37201;34479
10154;Fontenay-de-Bossery;44;1636933;175674;30;1456637;14;180296;37203;34480
27081;Boncourt;82;3050775;188132;56;2682366;26;368409;37205;34481
77132;Coupvray;1315;48931690;3816238;1076;46181687;239;2750003;37210;34482
33234;Latresne;1791;66649264;5988655;1193;59312363;598;7336901;37213;34483
80260;Drucat;433;16114013;1254711;307;14501979;126;1612034;37215;34484
54557;Velaine-en-Haye;803;29892194;2109588;623;27779069;180;2113125;37226;34485
28069;Champagne;120;4467311;275449;90;4161476;30;305835;37228;34486
65104;Boulin;133;4951575;325033;93;4524168;40;427407;37230;34487
78356;Magny-les-Hameaux;4383;163194245;12888552;3297;150145665;1086;13048580;37233;34488
59154;Coudekerque-Village;586;21819651;1688839;421;19799768;165;2019883;37235;34489
78220;Les Essarts-le-Roi;3322;123702601;10263046;2528;114977786;794;8724815;37237;34490
54186;Eulmont;490;18249922;1601649;363;16910491;127;1339431;37245;34491
59600;Tourmignies;343;12776094;801305;253;11793922;90;982172;37248;34492
51456;Remicourt;36;1341448;49998;21;1156390;15;185058;37262;34493
14060;Bénouville;1034;38529905;2882680;766;35270511;268;3259394;37263;34494
91546;Saint-Cyr-sous-Dourdan;538;20048371;1687598;415;18482426;123;1565945;37265;34495
90016;Bourg-sous-Châtelet;53;1975467;142967;42;1814011;11;161456;37273;34496
27525;Sainte-Colombe-près-Vernon;130;4845857;277421;107;4563049;23;282808;37276;34497
76475;Franqueville-Saint-Pierre;2829;105459575;7436619;2122;96755381;707;8704194;37278;34498
95365;Mareil-en-France;340;12675288;1040890;277;11747732;63;927556;37280;34499
31557;Tournefeuille;13381;499006197;40589248;9752;457745742;3629;41260455;37292;34500
34082;Combaillaux;769;28677690;2452610;549;25774120;220;2903570;37292;34501
64399;Montardon;1006;37518478;2462215;756;33883181;250;3635297;37295;34502
74018;Arenthon;802;29912446;1003596;517;23160389;285;6752057;37297;34503
78569;Sainte-Mesme;445;16598281;1648839;318;15182505;127;1415776;37300;34504
91111;Briis-sous-Forges;1541;57491051;4234700;1161;53074394;380;4416657;37308;34505
56107;Larmor-Plage;4990;186165821;15679194;3435;167319018;1555;18846803;37308;34506
86157;Mignaloux-Beauvoir;2028;75684291;5628102;1498;69154460;530;6529831;37320;34507
68245;Obermorschwiller;205;7654824;601102;143;6894885;62;759939;37341;34508
80725;Salouël;1572;58700527;4959355;1148;53954446;424;4746081;37341;34509
86019;Beaumont;992;37050619;1533875;587;32498166;405;4552453;37349;34510
51605;Venteuil;303;11317951;1302657;199;10317566;104;1000385;37353;34511
95690;Wy-dit-Joli-Village;185;6911027;610053;152;6415052;33;495975;37357;34512
91544;Saint-Cyr-la-Rivière;260;9713143;606216;188;8958350;72;754793;37358;34513
38334;Revel;656;24509106;1652796;509;22622316;147;1886790;37361;34514
21219;Curtil-Vergy;54;2017522;105466;41;1860111;13;157411;37362;34515
02652;Rogny;55;2055230;272954;28;1771263;27;283967;37368;34516
27401;Le Mesnil-Fuguet;92;3438105;240838;73;3209118;19;228987;37371;34517
51081;Branscourt;120;4484582;334915;88;4156962;32;327620;37372;34518
51411;Oger;320;11960204;1218773;249;11187282;71;772922;37376;34519
28355;Saint-Ouen-Marchefroy;163;6092373;526381;121;5597178;42;495195;37377;34520
06137;Spéracèdes;712;26626966;2540528;453;23733174;259;2893792;37397;34521
60609;Savignies;357;13353433;916316;252;12222920;105;1130513;37405;34522
46016;Baladou;215;8043884;233989;114;6980728;101;1063156;37413;34523
78624;Triel-sur-Seine;6135;229570732;19160542;4621;212777894;1514;16792838;37420;34524
31429;Pompertuzat;944;35325775;2475432;729;32609842;215;2715933;37421;34525
74173;Megève;2334;87353566;7495401;1456;76640919;878;10712647;37427;34526
78601;Sonchamp;813;30430240;2588198;617;28062324;196;2367916;37430;34527
51291;Hermonville;683;25567034;1727492;511;23327430;172;2239604;37433;34528
95543;Saint-Cyr-en-Arthies;120;4492160;408706;90;4089265;30;402895;37435;34529
21469;Orgeux;221;8273773;623093;172;7549055;49;724718;37438;34530
59034;Avelin;1251;46839342;3495617;917;42483858;334;4355484;37442;34531
59215;Estreux;469;17565894;1443466;332;16138234;137;1427660;37454;34532
77146;Croissy-Beaubourg;1030;38580209;3051979;828;36464247;202;2115962;37457;34533
27285;Giverny;298;11164119;1218324;205;10076684;93;1087435;37463;34534
51041;Baudement;60;2247974;103228;39;2008255;21;239719;37466;34535
38486;Seyssins;3593;134622602;10800704;2669;122551859;924;12070743;37468;34536
42311;La Tour-en-Jarez;727;27241871;2415109;489;24527950;238;2713921;37472;34537
95287;Grisy-les-Plâtres;335;12556274;892660;241;11520896;94;1035378;37481;34538
74242;Saint-Jorioz;3209;120285108;9700922;2279;107981121;930;12303987;37484;34539
38066;Châlons;86;3223788;255596;56;2791401;30;432387;37486;34540
13021;Carry-le-Rouet;3883;145560837;13640716;2723;132180374;1160;13380463;37487;34541
77312;Montigny-sur-Loing;1553;58230866;5420773;1141;53553746;412;4677120;37496;34542
78643;Vernouillet;4552;170715206;15256753;3057;155065370;1495;15649836;37503;34543
51450;Puisieulx;191;7164626;485348;156;6767658;35;396968;37511;34544
95023;Arronville;335;12566487;1070428;254;11590226;81;976261;37512;34545
61280;Monceaux-au-Perche;45;1688130;220299;28;1461326;17;226804;37514;34546
39032;Avignon-lès-Saint-Claude;187;7016644;433132;148;6316139;39;700505;37522;34547
47208;Pompogne;90;3377405;120293;38;2862264;52;515141;37527;34548
95450;Neuville-sur-Oise;983;36892404;3310958;673;33603692;310;3288712;37530;34549
95169;Commeny;194;7281434;604576;144;6761873;50;519561;37533;34550
60045;Barbery;287;10774336;1070000;207;9851351;80;922985;37541;34551
51048;Belval-sous-Châtillon;83;3116482;289325;58;2869680;25;246802;37548;34552
70148;Chemilly;51;1915093;136119;40;1785601;11;129492;37551;34553
74303;Villaz;1520;57081117;3655326;1177;51616671;343;5464446;37553;34554
06006;Aspremont;1132;42522126;3984543;829;39152812;303;3369314;37564;34555
69246;Theizé;571;21449818;2007545;383;19154934;188;2294884;37565;34556
69205;Saint-Genis-les-Ollières;2322;87245653;6239579;1774;80274984;548;6970669;37573;34557
91338;Limours;3381;127039256;10071426;2640;118112935;741;8926321;37574;34558
10102;Colombé-la-Fosse;107;4020540;437210;68;3505240;39;515300;37575;34559
95584;Santeuil;320;12025382;810253;264;11370975;56;654407;37579;34560
57767;Stuckange;464;17438760;626124;284;13345565;180;4093195;37584;34561
51331;Louvois;176;6614995;713056;131;6087524;45;527471;37585;34562
67326;Niederhausbergen;761;28603332;2433669;603;26527254;158;2076078;37587;34563
31551;Tarabel;189;7105086;404076;131;6524482;58;580604;37593;34564
78681;Villiers-le-Mahieu;338;12710499;1024576;266;11835680;72;874819;37605;34565
69122;Lucenay;846;31818895;2277014;606;28677168;240;3141727;37611;34566
57212;Féy;311;11699086;858839;237;10749485;74;949601;37618;34567
02669;Saint-Agnan;58;2182153;240128;37;1941115;21;241038;37623;34568
59023;Aubencheul-au-Bac;260;9783401;488143;147;8556953;113;1226448;37628;34569
76273;Fontaine-sous-Préaux;245;9219610;655847;195;8515341;50;704269;37631;34570
71099;Charbonnières;167;6285162;447804;122;5678518;45;606644;37636;34571
31409;Péchabou;1008;37940496;2670964;801;35549028;207;2391468;37639;34572
25321;Villers-le-Lac;2584;97264595;8941085;1969;90334252;615;6930343;37641;34573
94018;Charenton-le-Pont;17132;644997692;67346186;12681;600412943;4451;44584749;37649;34574
80159;Cachy;126;4744188;210876;89;4206245;37;537943;37652;34575
92009;Bois-Colombes;15719;591905900;60502343;11317;548221331;4402;43684569;37655;34576
21712;Volnay;151;5687270;565103;108;5129700;43;557570;37664;34577
59378;Marcq-en-Baroeul;21224;799518153;73025218;14421;720960168;6803;78557985;37670;34578
36050;Chezelles;258;9722490;454438;164;8630983;94;1091507;37684;34579
80261;Dury;731;27547851;2923686;430;25918112;301;1629739;37685;34580
71459;Saint-Martin-sous-Montaigu;196;7386725;515472;136;6642900;60;743825;37687;34581
67375;Pfulgriesheim;611;23029573;1992750;461;21055927;150;1973646;37692;34582
51173;Cormoyeux;63;2375215;255849;46;2201701;17;173514;37702;34583
67026;Bellefosse;69;2602875;331573;41;2327324;28;275551;37723;34584
91386;Mennecy;6630;250180811;19953970;4992;230955676;1638;19225135;37735;34585
57579;Rhodes;68;2566328;99285;51;2398142;17;168186;37740;34586
18016;Aubinges;184;6945050;675194;115;5977522;69;967528;37745;34587
51200;Cuis;224;8456543;865787;170;7895583;54;560960;37752;34588
59201;Erquinghem-le-Sec;253;9551754;681295;176;8537695;77;1014059;37754;34589
14525;Putot-en-Bessin;194;7326221;493547;138;6697981;56;628240;37764;34590
57616;Saint-Julien-lès-Metz;1646;62173635;5098121;1078;55754001;568;6419634;37773;34591
77196;Fresnes-sur-Marne;331;12503387;1107311;254;11731038;77;772349;37775;34592
21270;Flavignerot;94;3550982;271526;68;3290240;26;260742;37776;34593
45249;Paucourt;450;17003231;1333538;356;15784584;94;1218647;37785;34594
68333;Tagsdorf;144;5441898;351915;97;4751693;47;690205;37791;34595
77069;Chailly-en-Bière;1124;42481321;4962715;802;38598423;322;3882898;37795;34596
42033;Le Cergne;361;13646334;560420;232;12136920;129;1509414;37801;34597
95328;Labbeville;333;12591216;1021262;255;11828500;78;762716;37811;34598
74065;Chaumont;218;8243602;197627;138;6114794;80;2128808;37815;34599
25361;Malbuisson;426;16111650;1270090;333;15027746;93;1083904;37821;34600
74122;Faucigny;272;10289530;275632;183;7940037;89;2349493;37829;34601
31402;Odars;373;14111106;1096701;278;13080577;95;1030529;37831;34602
74090;Cornier;636;24062029;988926;425;19845668;211;4216361;37833;34603
78385;Ménerville;92;3482912;244024;76;3300285;16;182627;37858;34604
51101;Caurel;312;11812011;1035212;230;10902522;82;909489;37859;34605
39421;Le Pin;133;5035340;354227;94;4476315;39;559025;37860;34606
68080;Emlingen;135;5111257;377299;102;4755273;33;355984;37861;34607
01347;Saint-Didier-de-Formans;863;32675513;2108561;654;29944824;209;2730689;37863;34608
69212;Saint-Jean-des-Vignes;186;7045594;510222;140;6441549;46;604045;37880;34609
51287;Hautvillers;415;15722439;1448137;291;14228911;124;1493528;37885;34610
74157;Lyaud;761;28832676;1419338;574;25454586;187;3378090;37888;34611
68237;Niedermorschwihr;311;11784126;1145459;224;10689547;87;1094579;37891;34612
77463;Thomery;1741;65969362;5307010;1327;60971807;414;4997555;37892;34613
78407;Mittainville;289;10951828;903837;220;10126008;69;825820;37896;34614
77427;Saint-Mesmes;268;10156039;890051;208;9498696;60;657343;37896;34615
63272;Pérignat-lès-Sarliève;1353;51279772;4052359;1018;47184296;335;4095476;37901;34616
77248;Lesches;327;12396790;992094;257;11435346;70;961444;37911;34617
91593;Sermaise;824;31249068;2283672;652;28853414;172;2395654;37924;34618
38373;Saint-Cassien;576;21846312;1346958;401;19618813;175;2227499;37928;34619
77103;Châtillon-la-Borde;112;4249420;354426;84;3947027;28;302393;37941;34620
28253;Mignières;394;14950204;985488;314;13989516;80;960688;37945;34621
60144;Chavençon;84;3188433;301445;65;3046589;19;141844;37958;34622
28285;Oinville-sous-Auneau;168;6380621;535626;124;5936338;44;444283;37980;34623
06026;Cabris;834;31676638;3395807;536;28165971;298;3510667;37982;34624
67253;Kuttolsheim;337;12800147;1050990;256;11864817;81;935330;37983;34625
25293;Granges-Narboz;475;18043639;1216163;380;16755779;95;1287860;37987;34626
74165;Marigny-Saint-Marcel;330;12536394;960216;221;11011451;109;1524943;37989;34627
59437;Noyelles-lès-Seclin;431;16373535;1417799;311;14811243;120;1562292;37990;34628
95309;Hodent;114;4331056;322088;80;3955896;34;375160;37992;34629
25301;Guyans-Vennes;399;15162661;790321;252;13434589;147;1728072;38002;34630
77062;Carnetin;239;9082745;733971;180;8415330;59;667415;38003;34631
31484;Saint-Geniès-Bellevue;1048;39833840;2880482;790;36785889;258;3047951;38009;34632
38133;Coublevie;2148;81661731;5739111;1583;74388816;565;7272915;38018;34633
76429;Le Mesnil-Esnard;3903;148399419;11516544;2862;135679199;1041;12720220;38022;34634
18147;Ménétréol-sur-Sauldre;128;4867454;298790;69;4186493;59;680961;38027;34635
80174;Le Cardonnois;40;1521094;139672;27;1384714;13;136380;38027;34636
67109;Durningen;300;11411672;809014;218;10251633;82;1160039;38039;34637
51511;Saint-Quentin-le-Verger;68;2586734;268722;43;2316958;25;269776;38040;34638
88071;Bouzemont;30;1141304;167951;17;1003708;13;137596;38043;34639
59100;Bousignies;136;5175927;423513;94;4727486;42;448441;38058;34640
59427;La Neuville;335;12753924;845624;232;11655929;103;1097995;38071;34641
14242;Épron;676;25737390;1955372;497;23654279;179;2083111;38073;34642
78283;Grandchamp;140;5331966;473189;107;5025217;33;306749;38085;34643
25207;Dung;317;12075745;679758;234;10721454;83;1354291;38094;34644
57356;Kanfen;497;18934029;215871;183;9169753;314;9764276;38097;34645
59146;Chéreng;1477;56269123;3981323;1105;51168237;372;5100886;38097;34646
34077;Clapiers;2643;100734669;7026824;1830;90380536;813;10354133;38114;34647
69168;Rochetaillée-sur-Saône;715;27253625;2381051;491;24805279;224;2448346;38117;34648
77526;Vincy-Manoeuvre;114;4345508;375635;72;3756924;42;588584;38118;34649
68093;Flaxlanden;728;27750973;1861434;519;24968339;209;2782634;38119;34650
69298;Toussieu;1210;46125924;3177778;865;42139466;345;3986458;38121;34651
31480;Sainte-Foy-d'Aigrefeuille;926;35302573;2231688;715;32607210;211;2695363;38124;34652
76318;Grand-Camp;303;11551494;698238;225;10477888;78;1073606;38124;34653
21504;Prâlon;47;1792355;130167;30;1599005;17;193350;38135;34654
51534;Serzy-et-Prin;93;3546632;316806;66;3225313;27;321319;38136;34655
77039;Boissise-la-Bertrand;580;22119325;2075948;377;19631227;203;2488098;38137;34656
94058;Le Perreux-sur-Marne;18610;709852908;67059569;13944;660076671;4666;49776237;38144;34657
51301;Isse;58;2212680;220099;41;1972826;17;239854;38150;34658
06059;Èze;1491;56901260;5757580;1049;52305941;442;4595319;38163;34659
06044;La Colle-sur-Loup;4220;161067300;15707700;2890;147038046;1330;14029254;38168;34660
71426;Sainte-Hélène;238;9084834;373382;126;7724497;112;1360337;38172;34661
78209;Émancé;427;16302346;1299114;340;15220649;87;1081697;38179;34662
78674;Villepreux;4753;181473206;14611128;3696;169306310;1057;12166896;38181;34663
90103;Vétrigne;293;11188479;836928;226;10163726;67;1024753;38186;34664
91667;Villemoisson-sur-Orge;3620;138263705;11620451;2827;128983261;793;9280444;38194;34665
14288;Le Fresne-Camilly;388;14819970;927710;282;13652720;106;1167250;38196;34666
59150;Cobrieux;245;9365919;666944;171;8502527;74;863392;38228;34667
27121;Bus-Saint-Rémy;168;6423827;773950;117;5761061;51;662766;38237;34668
38230;Meyrié;496;18966688;1512070;378;17496535;118;1470153;38239;34669
77386;Recloses;361;13804522;1145646;268;12855506;93;949016;38240;34670
92026;Courbevoie;49474;1892326632;194664163;37356;1773471649;12118;118854983;38249;34671
10039;Bergères;69;2639405;356004;41;2344020;28;295385;38252;34672
69281;Marennes;795;30415044;2278665;588;27815504;207;2599540;38258;34673
51247;Fèrebrianges;96;3673674;414772;60;3313622;36;360052;38267;34674
51390;Moussy;387;14811497;1608790;284;13720933;103;1090564;38273;34675
60612;Senlis;8682;332381961;28452481;5774;300659374;2908;31722587;38284;34676
91318;Janville-sur-Juine;958;36677868;2774553;737;34176192;221;2501676;38286;34677
57447;Marly;5078;194436304;17064783;3481;174387416;1597;20048888;38290;34678
28301;Poisvilliers;197;7543252;420256;154;7034666;43;508586;38291;34679
54364;Méréville;646;24736727;1696941;527;23358555;119;1378172;38292;34680
57694;Vany;164;6282371;365679;118;5373424;46;908947;38307;34681
62630;Noyelle-Vion;130;4981114;308429;77;4326165;53;654949;38316;34682
34266;Saint-Jean-de-Cuculles;216;8277020;661766;154;7560127;62;716893;38320;34683
74302;Les Villards-sur-Thônes;581;22264375;926652;377;19496929;204;2767446;38321;34684
04128;Montfuron;110;4216030;113039;54;3599683;56;616347;38328;34685
51633;Villers-Franqueux;153;5865807;594894;113;5470818;40;394989;38339;34686
77009;Arville;77;2952141;379177;56;2708034;21;244107;38339;34687
42294;Saint-Vincent-de-Boisset;429;16450122;1021242;313;14719352;116;1730770;38345;34688
94056;Périgny;1205;46206492;3817377;962;43587740;243;2618752;38346;34689
78615;Thiverval-Grignon;391;14993388;1515229;297;13916314;94;1077074;38346;34690
28352;Saint-Martin-de-Nigelles;741;28418427;2034592;583;26744622;158;1673805;38351;34691
14660;Saint-Vaast-en-Auge;45;1726052;153058;22;1491840;23;234212;38357;34692
51261;Fresne-lès-Reims;209;8021623;589327;165;7491036;44;530587;38381;34693
25213;Les Écorces;307;11783753;932026;239;10897119;68;886634;38384;34694
91292;Guibeville;297;11402983;743974;240;10618184;57;784799;38394;34695
78470;Orphin;439;16855861;1297811;348;15717557;91;1138304;38396;34696
14086;Bonneville-sur-Touques;215;8260159;890524;149;7527987;66;732172;38419;34697
02161;La Chapelle-Monthodon;101;3880360;360990;72;3559353;29;321007;38419;34698
62037;Anzin-Saint-Aubin;1408;54110823;4531223;1064;50058961;344;4051862;38431;34699
57634;Saulny;700;26902139;2040338;526;24623596;174;2278543;38432;34700
51518;Saint-Thierry;314;12071399;1099242;216;11212971;98;858428;38444;34701
21278;Fontaine-lès-Dijon;5010;192614038;17280122;3702;176326441;1308;16287597;38446;34702
38214;Lumbin;954;36703101;2398284;722;33680264;232;3022837;38473;34703
69086;Fleurieux-sur-l'Arbresle;1089;41908995;2562709;836;38701663;253;3207332;38484;34704
95341;Livilliers;198;7620820;688387;166;7293754;32;327066;38489;34705
51115;Champfleury;267;10276687;804913;204;9465930;63;810757;38489;34706
74158;Machilly;517;19900261;541442;307;14373004;210;5527257;38492;34707
67428;Saint-Nabor;257;9893742;525427;192;9102015;65;791727;38497;34708
95253;Frémainville;230;8863440;601941;167;8166274;63;697166;38537;34709
77001;Achères-la-Forêt;620;23898862;2121162;447;21996327;173;1902535;38547;34710
76069;Belbeuf;994;38321696;3072507;774;35845742;220;2475954;38553;34711
25295;Les Grangettes;146;5629000;544092;109;5200769;37;428231;38555;34712
73160;Montagnole;426;16425514;1370896;318;14989305;108;1436209;38558;34713
69193;Saint-Cyr-sur-le-Rhône;576;22210679;1612003;443;20675089;133;1535590;38560;34714
37109;Fondettes;5012;193265455;15336881;3625;174969493;1387;18295962;38561;34715
77533;Vulaines-sur-Seine;1269;48960615;3829788;945;44850349;324;4110266;38582;34716
62857;Villers-Châtel;54;2085559;122587;43;1902560;11;182999;38621;34717
01254;Montagnat;809;31245023;2113224;630;28732650;179;2512373;38622;34718
78605;Tacoignières;480;18542865;1398351;366;17080299;114;1462566;38631;34719
21297;Gilly-lès-Cîteaux;327;12633218;1264535;249;11656047;78;977171;38634;34720
78171;Condé-sur-Vesgre;545;21058151;1583772;403;19447092;142;1611059;38639;34721
67119;Eckwersheim;693;26782057;2378433;504;24250613;189;2531444;38647;34722
76481;Octeville-sur-Mer;2720;105169420;6771667;2010;95833045;710;9336375;38665;34723
59128;Capinghem;800;30943401;2343270;585;27800067;215;3143334;38679;34724
91186;Courson-Monteloup;282;10907917;846948;228;10285218;54;622699;38681;34725
74109;Éloise;421;16290489;502710;275;12573764;146;3716725;38695;34726
25425;Noël-Cerneux;182;7042520;518658;144;6613067;38;429453;38695;34727
83080;Mons;512;19814294;2344803;278;17260549;234;2553745;38700;34728
60422;Montlognon;104;4025317;382872;69;3595465;35;429852;38705;34729
45272;Saint-Cyr-en-Val;1554;60148631;4458716;1223;55673679;331;4474952;38706;34730
68158;Jettingen;257;9950019;872224;192;9165780;65;784239;38716;34731
51418;Ormes;222;8595384;625240;178;7980593;44;614791;38718;34732
51636;Villers-Marmery;281;10880528;1022666;200;9981367;81;899161;38721;34733
14356;Lasson;267;10339226;739283;198;9515200;69;824026;38724;34734
51005;Allemant;91;3524627;440636;51;2978769;40;545858;38732;34735
38062;La Buissière;367;14215578;689195;232;12645847;135;1569731;38735;34736
78557;Saint-Hilarion;447;17318525;1623044;333;16013566;114;1304959;38744;34737
01173;Gex;5721;221657794;13566418;3426;174868339;2295;46789455;38745;34738
69112;Lentilly;2575;99768063;7679412;1875;90614650;700;9153413;38745;34739
51275;Glannes;90;3487199;131530;63;3161299;27;325900;38747;34740
51338;Mailly-Champagne;374;14491439;1500686;259;13276407;115;1215032;38747;34741
40304;Soorts-Hossegor;2669;103467414;9174338;1706;92428778;963;11038636;38766;34742
51168;Coolus;103;3995399;335565;81;3626757;22;368642;38790;34743
85212;Sainte-Florence;594;23044115;855500;374;20258457;220;2785658;38795;34744
59458;Péronne-en-Mélantois;418;16220470;1498581;311;14761305;107;1459165;38805;34745
91508;Puiselet-le-Marais;139;5393929;428130;110;4749507;29;644422;38805;34746
91044;Ballainvilliers;1788;69387400;5685986;1433;65085200;355;4302200;38807;34747
77179;Féricy;286;11102060;899445;217;10316955;69;785105;38818;34748
68194;Lutter;151;5862014;526911;114;5342042;37;519972;38821;34749
74048;Brenthonne;472;18328158;530291;303;14014698;169;4313460;38831;34750
80225;Creuse;96;3727968;241963;75;3440606;21;287362;38833;34751
77096;Chartrettes;1347;52309161;4321129;1044;48474344;303;3834817;38834;34752
91249;Forges-les-Bains;1825;70871826;5680348;1440;66399517;385;4472309;38834;34753
78020;Arnouville-lès-Mantes;448;17408559;1504507;346;16187511;102;1221048;38858;34754
60238;Fleurines;945;36723158;3017412;722;34202698;223;2520460;38860;34755
59609;Vendeville;843;32761070;2051575;637;30116328;206;2644742;38862;34756
79034;Bessines;824;32027174;2597487;613;29340600;211;2686574;38868;34757
78246;Fontenay-Saint-Père;495;19242421;1727699;380;17939759;115;1302662;38874;34758
28158;Fontenay-sur-Eure;426;16563050;1456353;332;15442610;94;1120440;38880;34759
74314;Vulbens;584;22711714;628316;330;15900353;254;6811361;38890;34760
68385;Zimmerbach;453;17623044;1523632;341;16017635;112;1605409;38903;34761
67228;Neugartheim-Ittlenheim;350;13621123;944258;259;12421297;91;1199826;38917;34762
68324;Steinbrunn-le-Haut;290;11294782;933559;214;10426139;76;868643;38948;34763
51512;Saint-Quentin-sur-Coole;36;1402115;129727;25;1221081;11;181034;38948;34764
92040;Issy-les-Moulineaux;36807;1433655771;149332054;28171;1348248300;8636;85407471;38951;34765
78108;Les Bréviaires;670;26097966;2268927;470;23884414;200;2213552;38952;34766
51459;Réveillon;55;2143593;368442;33;1893933;22;249660;38974;34767
69255;Vaugneray;2555;99616629;9380510;1727;89522255;828;10094374;38989;34768
95660;Villaines-sous-Bois;319;12446837;1012211;258;11867901;61;578936;39018;34769
59106;Bouvines;353;13777478;942398;243;12492080;110;1285398;39030;34770
34066;Cazevieille;97;3786832;294116;64;3437566;33;349266;39040;34771
51465;Romery;98;3825872;414129;69;3428704;29;397168;39040;34772
42031;Caloire;156;6090661;470457;112;5476832;44;613829;39043;34773
69270;Chaponnay;1926;75206588;5415443;1446;69055619;480;6150969;39048;34774
68325;Steinsoultz;381;14877748;1199965;289;13620046;92;1257702;39049;34775
10381;Torvilliers;432;16871273;1399815;330;15529668;102;1341605;39054;34776
68380;Wolschwiller;239;9336200;861758;183;8751337;56;584863;39064;34777
41200;Sainte-Anne;173;6758587;346376;126;6195733;47;562854;39067;34778
51414;Olizy;81;3164688;366599;57;2915525;24;249163;39070;34779
27481;Pullay;189;7385761;686112;133;6675989;56;709772;39078;34780
68150;Husseren-les-Châteaux;234;9146146;575510;179;8410647;55;735499;39086;34781
51429;Pévy;117;4574257;383084;85;4210795;32;363462;39096;34782
13060;Meyreuil;2886;112840022;9697461;1918;102167184;968;10672838;39099;34783
69028;Brindas;2736;106983689;8004058;2052;98152149;684;8831540;39102;34784
51645;Vindey;74;2893820;377647;49;2605491;25;288329;39106;34785
14030;Authie;700;27376685;2037813;518;25152738;182;2223947;39110;34786
16304;Saint-Brice;558;21824764;2027640;411;20138252;147;1686512;39112;34787
06018;Biot;5030;196792547;19287181;3494;179535474;1536;17257073;39124;34788
31035;Auzeville-Tolosane;1485;58101910;4777292;1057;52595390;428;5506520;39126;34789
17391;Saint-Rogatien;987;38638068;1995099;703;35034852;284;3603216;39147;34790
91275;Gometz-le-Châtel;1293;50632353;4258450;1014;47463830;279;3168523;39159;34791
95446;Nesles-la-Vallée;1011;39597971;3682799;759;36941230;252;2656741;39167;34792
13012;Beaurecueil;338;13240901;1503081;193;11390761;145;1850140;39174;34793
72342;Souvigné-sur-Même;97;3800470;419960;74;3486453;23;314017;39180;34794
51558;Soulières;66;2586252;239276;47;2379920;19;206332;39186;34795
74105;Douvaine;2735;107187912;2822539;1476;75023963;1259;32163949;39191;34796
21003;Ahuy;627;24573477;2106978;489;22827543;138;1745934;39192;34797
67548;Wiwersheim;407;15953292;1217126;329;14897843;78;1055449;39197;34798
91662;Villeconin;352;13804504;1141212;279;12978731;73;825773;39217;34799
14355;Lantheuil;321;12593736;1123850;225;11546324;96;1047412;39233;34800
06112;Le Rouret;1933;75857935;6541210;1329;68672108;604;7185827;39244;34801
74156;Lully;320;12560240;307776;178;8371647;142;4188593;39251;34802
01275;Neyron;1287;50534786;4200677;949;46110685;338;4424101;39266;34803
77198;Fromont;113;4439336;366700;77;3974123;36;465213;39286;34804
45102;Conflans-sur-Loing;196;7700785;582402;141;6995199;55;705586;39290;34805
57093;Blies-Guersviller;328;12887939;784454;216;11570769;112;1317170;39292;34806
78307;Hermeray;497;19530145;1548831;371;17840081;126;1690064;39296;34807
68187;Linsdorf;163;6405399;544516;122;5776796;41;628603;39297;34808
67256;Lampertheim;1556;61152674;5138445;1190;56334880;366;4817794;39301;34809
51611;Vert-Toulon;158;6211510;730545;109;5645996;49;565514;39313;34810
91378;Mauchamps;137;5387837;388556;114;5066047;23;321790;39327;34811
71371;La Roche-Vineuse;836;32887870;3270416;579;29772826;257;3115044;39340;34812
62278;Drouvin-le-Marais;245;9644600;679410;161;8505595;84;1139005;39366;34813
51201;Cuisles;68;2677583;317728;48;2506265;20;171318;39376;34814
57415;Lorry-lès-Metz;814;32055147;2147528;609;28982875;205;3072272;39380;34815
68323;Steinbrunn-le-Bas;356;14020329;1239266;266;12871615;90;1148714;39383;34816
63070;Ceyrat;3088;121619619;10692874;2258;112610229;830;9009390;39385;34817
31161;Deyme;447;17605957;1351617;329;16198073;118;1407884;39387;34818
18174;Osmoy;101;3978723;462258;66;3605546;35;373177;39393;34819
29023;Carantec;1958;77136096;6269441;1222;68130642;736;9005454;39395;34820
01109;Collonges;911;35890699;965857;507;25202987;404;10687712;39397;34821
69125;Marcilly-d'Azergues;458;18047241;1561143;352;16801892;106;1245349;39404;34822
31417;Pibrac;4101;161620430;12288143;2998;147852339;1103;13768091;39410;34823
78516;Raizeux;428;16870118;1480209;341;15759788;87;1110330;39416;34824
51503;Saint-Martin-l'Heureux;41;1616207;181331;25;1453309;16;162898;39420;34825
74011;Annecy-le-Vieux;11539;454928518;35099507;8202;404612828;3337;50315690;39425;34826
27133;Caumont;513;20229525;1764896;377;18670497;136;1559028;39434;34827
74102;Dingy-Saint-Clair;648;25554557;1714570;496;23140020;152;2414537;39436;34828
57607;Sainte-Barbe;343;13529210;1212439;247;12361552;96;1167658;39444;34829
67495;Truchtersheim;1482;58461628;4635560;1104;53513635;378;4947993;39448;34830
51634;Villers-le-Château;124;4891638;362797;96;4403070;28;488568;39449;34831
18036;Brinay;290;11440456;681491;191;10294666;99;1145790;39450;34832
78364;Marcq;368;14519689;1204131;293;13586327;75;933362;39456;34833
74051;Cercier;280;11051374;257014;168;8527933;112;2523441;39469;34834
76616;Saint-Martin-du-Manoir;706;27871265;1946478;577;26086122;129;1785143;39478;34835
10262;Neuville-sur-Seine;210;8293249;1032851;133;7468156;77;825093;39492;34836
51188;Courmas;99;3909827;388426;79;3733196;20;176631;39493;34837
31163;Drémil-Lafage;1210;47796235;3349660;920;44008391;290;3787844;39501;34838
69190;Sainte-Consorce;935;36953762;2750510;713;33930924;222;3022838;39523;34839
14701;Tourgéville;567;22410849;2312352;384;20436006;183;1974843;39525;34840
92002;Antony;32310;1277128157;121836054;24263;1190253722;8047;86874435;39527;34841
46107;Floressas;94;3717352;127523;38;3142956;56;574396;39546;34842
31052;Beaumont-sur-Lèze;821;32467664;1603850;512;29298810;309;3168854;39546;34843
59559;Sebourg;963;38088453;3053081;644;34143188;319;3945265;39552;34844
95678;Villiers-Adam;433;17129266;1706447;340;16161509;93;967757;39560;34845
77031;Bernay-Vilbert;429;16973106;1172181;318;15685044;111;1288062;39564;34846
74263;Sciez;2807;111057891;4364166;1642;82246653;1165;28811238;39565;34847
78380;Maule;2985;118155745;10580057;2159;108914708;826;9241037;39583;34848
95493;Le Plessis-Luzarches;81;3206354;383079;54;2960485;27;245869;39585;34849
74121;Excenevex;544;21541213;784420;314;16447872;230;5093341;39598;34850
78236;Flexanville;293;11604069;825958;218;10537451;75;1066618;39604;34851
76451;Mont-Saint-Aignan;9393;372009701;36785765;6411;339541835;2982;32467866;39605;34852
27651;Tournedos-sur-Seine;60;2376481;221282;42;2142413;18;234068;39608;34853
77450;Servon;1546;61266398;4812009;1218;57306199;328;3960199;39629;34854
68021;Bartenheim;2011;79729772;7105710;1527;72924004;484;6805768;39647;34855
78499;Ponthévrard;264;10472142;692302;215;9761594;49;710548;39667;34856
06150;La Turbie;1724;68395350;6472262;1284;63781952;440;4613398;39672;34857
74126;Fessy;378;15002826;508681;255;12173994;123;2828832;39690;34858
25307;Les Hôpitaux-Neufs;467;18537636;1817384;382;17624708;85;912928;39695;34859
62107;Bénifontaine;173;6868007;539149;121;6377831;52;490176;39699;34860
92035;La Garenne-Colombes;15646;621154501;63699915;12091;584109931;3555;37044570;39701;34861
94015;Bry-sur-Marne;8711;345832553;33642128;6539;322092956;2172;23739597;39701;34862
60494;Plailly;879;34900336;2807055;680;32700567;199;2199769;39705;34863
14197;Cresserons;569;22594416;1377220;412;20766813;157;1827603;39709;34864
56003;Arradon;2914;115715546;9137445;2021;103402602;893;12312944;39710;34865
25403;Montlebon;982;39007191;3067726;759;36151199;223;2855992;39722;34866
51072;Bouilly;89;3535320;271233;71;3325455;18;209865;39723;34867
74130;Franclens;224;8898947;269288;135;6844987;89;2053960;39727;34868
73177;Montvernier;120;4767720;452492;85;4425366;35;342354;39731;34869
78269;Gazeran;621;24674600;1994950;474;23005659;147;1668941;39734;34870
74198;Nâves-Parmelan;463;18399476;1102949;355;16825323;108;1574153;39740;34871
51086;Breuil;156;6199513;539530;115;5659310;41;540203;39740;34872
10111;Courteron;71;2821816;359045;45;2527921;26;293895;39744;34873
59088;Bois-Grenier;710;28221054;2043360;538;25821091;172;2399963;39748;34874
14577;Saint-Gabriel-Brécy;136;5406940;314404;95;4736038;41;670902;39757;34875
57007;Adaincourt;58;2306146;264159;28;1869305;30;436841;39761;34876
94080;Vincennes;29158;1159552038;126200167;22055;1088004809;7103;71547229;39768;34877
57546;Plesnois;348;13841022;906149;247;12341947;101;1499075;39773;34878
21480;Pernand-Vergelesses;145;5767988;577251;100;5177358;45;590630;39779;34879
70345;Miellin;38;1512249;161277;20;1280597;18;231652;39796;34880
51146;Cheniers;52;2069406;151426;35;1842580;17;226826;39796;34881
74217;Pringy;2152;85657643;5106102;1625;76075092;527;9582551;39804;34882
95658;Vigny;521;20745782;1900575;392;19108011;129;1637771;39819;34883
69133;Millery;1834;73100524;5508852;1393;66892381;441;6208143;39859;34884
59124;Camphin-en-Pévèle;1005;40057836;3517741;699;35896035;306;4161801;39859;34885
57588;Rodemack;468;18655508;220766;171;8321523;297;10333985;39862;34886
62806;Tardinghen;83;3309011;287380;50;2907344;33;401667;39868;34887
49035;Bouchemaine;3253;129711941;9543175;2385;117803902;868;11908039;39875;34888
60482;Orry-la-Ville;1784;71145882;5961479;1411;66541326;373;4604556;39880;34889
69047;Charnay;541;21578224;2368516;358;19375426;183;2202798;39886;34890
95257;La Frette-sur-Seine;2424;96705181;8996604;1911;90899281;513;5805900;39895;34891
21265;Fixin;393;15685593;1232097;300;14512629;93;1172964;39912;34892
67505;La Vancelle;208;8302711;728352;153;7552155;55;750556;39917;34893
21111;Brognon;140;5588959;519118;103;5141707;37;447252;39921;34894
51266;Germaine;244;9744554;780021;197;9137586;47;606968;39937;34895
51479;Saint-Euphraise-et-Clairizet;110;4393940;342306;78;3983543;32;410397;39945;34896
54305;Lay-Saint-Christophe;1320;52731290;4878116;894;48039039;426;4692251;39948;34897
68165;Kiffis;139;5553231;570892;101;5071573;38;481658;39951;34898
74315;Yvoire;461;18419139;775695;272;14284918;189;4134221;39955;34899
95040;Avernes;397;15866077;1599075;311;15000028;86;866049;39965;34900
68163;Kembs;2444;97679246;8620704;1879;89391858;565;8287388;39967;34901
93033;Gournay-sur-Marne;3454;138047016;11743956;2703;129598351;751;8448665;39967;34902
95102;Bréançon;183;7314031;631841;145;6863913;38;450118;39967;34903
76108;Bois-Guillaume - Bihorel;11372;454535918;43320983;8142;416128381;3230;38407537;39970;34904
54583;Villey-le-Sec;194;7754422;514989;146;7024418;48;730004;39971;34905
51378;Monthelon;188;7516274;847918;140;6940137;48;576137;39980;34906
21209;Couternon;821;32846001;2387079;652;30921685;169;1924316;40007;34907
78087;Bonnelles;992;39688463;3454338;774;37045761;218;2642702;40009;34908
51435;Pocancy;89;3561121;395473;65;3286154;24;274967;40013;34909
38111;Claix;3940;157697496;12853157;2941;145038520;999;12658976;40025;34910
02151;Cerny-lès-Bucy;70;2802274;322528;49;2520752;21;281522;40032;34911
68326;Sternenberg;78;3122565;255243;49;2804329;29;318236;40033;34912
02595;Passy-sur-Marne;85;3403274;485547;57;3169675;28;233599;40039;34913
78124;Carrières-sur-Seine;7599;304328367;28710349;5635;283033681;1964;21294686;40048;34914
14170;Colomby-sur-Thaon;195;7809951;623920;147;7114852;48;695099;40051;34915
51118;Champigny;611;24474380;1665377;486;22960239;125;1514141;40056;34916
31352;Mondouzil;112;4488072;278815;82;4009526;30;478546;40072;34917
21261;Fauverney;342;13706128;997489;238;12434892;104;1271236;40076;34918
21192;Corcelles-les-Monts;349;13989644;1293776;285;13119288;64;870356;40085;34919
51281;Grauves;334;13391626;1124551;246;12379496;88;1012130;40095;34920
73300;Tresserve;1739;69730768;7426576;1191;63253453;548;6477315;40098;34921
78262;Galluis;553;22179739;2002480;427;20500149;126;1679590;40108;34922
91041;Avrainville;429;17207945;1403156;337;16106099;92;1101846;40112;34923
74096;Cruseilles;2217;88936629;4478305;1296;67904180;921;21032449;40116;34924
57142;Chieulles;190;7623856;404240;146;7009024;44;614832;40126;34925
57438;Malroy;218;8748687;828013;142;7384984;76;1363703;40132;34926
31541;Seilh;1596;64128879;6460335;1223;59751546;373;4377333;40181;34927
77188;Fontaine-le-Port;535;21509022;1865193;408;20138484;127;1370538;40204;34928
74220;Reignier-Ésery;3752;150853094;4821321;2224;112377356;1528;38475738;40206;34929
34255;Saint-Gély-du-Fesc;4726;190032756;15137722;3355;173131313;1371;16901443;40210;34930
60591;Saint-Paul;780;31372586;2649626;563;28743598;217;2628988;40221;34931
50532;Saint-Pair-sur-Mer;2335;93931425;5925163;1443;82752056;892;11179369;40228;34932
69202;Sainte-Foy-lès-Lyon;11734;472103460;41727450;8306;433226960;3428;38876500;40234;34933
60213;Ermenonville;501;20170599;1893642;341;18133405;160;2037194;40261;34934
77485;Le Vaudoué;396;15944112;1551077;302;14906318;94;1037794;40263;34935
74219;Quintal;595;23964064;1727137;431;21616691;164;2347373;40276;34936
54330;Lupcourt;214;8619550;791044;172;8133862;42;485688;40278;34937
28314;Les Ressuintes;84;3383701;359705;51;2713438;33;670263;40282;34938
10296;Polisy;89;3585214;444114;52;3145792;37;439422;40283;34939
59025;Aubers;757;30497361;2522398;548;27602035;209;2895326;40287;34940
74253;Saint-Sixt;421;16964765;614124;279;14153909;142;2810856;40296;34941
62742;Saint-Aubin;135;5442145;566124;100;5004679;35;437466;40312;34942
78048;Bazainville;679;27374760;2257051;554;25772916;125;1601844;40316;34943
74024;Ayse;1095;44149525;3060186;807;39333767;288;4815758;40319;34944
70168;Conflans-sur-Lanterne;370;14926400;1901035;193;13001979;177;1924421;40342;34945
62235;Condette;1362;54949555;4888627;892;49579566;470;5369989;40345;34946
21408;Messigny-et-Vantoux;727;29334770;2304803;546;26857703;181;2477067;40350;34947
78464;Orcemont;418;16875546;1391716;337;15870771;81;1004775;40372;34948
51318;Lavannes;274;11063577;785837;202;10145420;72;918157;40378;34949
51403;Nogent-l'Abbesse;272;10986916;1008719;206;10024972;66;961944;40393;34950
77004;Andrezel;168;6788164;576090;126;6376615;42;411549;40406;34951
14068;Biéville-Beuville;1293;52300564;4012385;934;47166603;359;5133961;40449;34952
01158;Farges;403;16313235;404475;222;11643155;181;4670080;40479;34953
10055;Bourguignons;136;5509822;500034;91;4349352;45;1160470;40513;34954
60552;Rouville;118;4781124;343454;87;4256718;31;524406;40518;34955
60543;Rocquemont;49;1986308;143540;37;1713864;12;272444;40537;34956
31074;Bonrepos-Riquet;138;5595008;500742;102;5234060;36;360948;40544;34957
74152;Lovagny;581;23579171;1324487;431;20842678;150;2736493;40584;34958
74087;Contamine-sur-Arve;849;34464891;1132490;527;25733747;322;8731144;40595;34959
92073;Suresnes;25147;1020834764;114244894;18194;949462607;6953;71372157;40595;34960
69140;Morancé;928;37675238;2983015;700;34627107;228;3048131;40598;34961
51273;Givry-lès-Loisy;37;1502734;165029;25;1373728;12;129006;40614;34962
57642;Scy-Chazelles;1524;61897063;5233570;1026;55450847;498;6446216;40615;34963
56008;Baden;2320;94240204;6427980;1531;84936262;789;9303942;40621;34964
90039;Essert;1635;66415369;4054226;1141;60414576;494;6000793;40621;34965
21027;Asnières-lès-Dijon;550;22346215;1746558;435;21085835;115;1260380;40629;34966
71037;Bissy-sur-Fley;48;1951425;164609;30;1751829;18;199596;40655;34967
21657;Varois-et-Chaignot;940;38224777;2947402;777;36196394;163;2028383;40665;34968
42297;Salvizinet;287;11675127;1058037;183;10465607;104;1209520;40680;34969
51562;Taissy;1124;45726965;3601483;850;42251247;274;3475718;40682;34970
91578;Saint-Sulpice-de-Favières;176;7160534;786234;117;6666242;59;494292;40685;34971
62338;Fleurbaix;1283;52208729;3939213;934;47608367;349;4600362;40693;34972
68353;Wahlbach;222;9035510;777866;164;8369522;58;665988;40700;34973
74195;Musièges;193;7862976;291039;117;6432133;76;1430843;40741;34974
74275;Talloires;1035;42166864;4465216;772;38944078;263;3222786;40741;34975
31151;Corronsac;331;13488516;1012774;258;12523956;73;964560;40751;34976
13022;Cassis;4833;196950299;26420985;3127;179065751;1706;17884548;40751;34977
75056;Paris;1412849;57576455027;7673435794;932909;53521301119;479940;4055153908;40752;34978
51580;Trépail;230;9373215;1141412;162;8558518;68;814697;40753;34979
01237;Martignat;784;31964515;1725027;513;28613609;271;3350906;40771;34980
27471;Porte-Joie;59;2405609;224074;38;2134250;21;271359;40773;34981
60282;Gouvieux;4743;193407868;18650739;3459;179207805;1284;14200063;40778;34982
95480;Parmain;2762;112637836;9780589;2109;104714404;653;7923432;40781;34983
78031;Auffreville-Brasseuil;341;13911925;1208518;272;13263181;69;648744;40797;34984
34099;Ferrières-les-Verreries;31;1264781;136357;18;1107021;13;157760;40799;34985
93062;Le Raincy;7920;323172217;34555687;5776;299510667;2144;23661550;40805;34986
88279;Madecourt;33;1346678;147618;21;1207837;12;138841;40808;34987
78475;Osmoy;196;8002050;781207;148;7380194;48;621856;40827;34988
35204;Nouvoitou;1374;56127186;2621427;940;51060404;434;5066782;40849;34989
95369;Margency;1485;60661618;5340284;1208;57149137;277;3512481;40850;34990
78481;Le Pecq;8765;358080460;35355760;6590;333680974;2175;24399486;40853;34991
78505;Prunay-le-Temple;182;7435401;631098;137;6860948;45;574453;40854;34992
64100;Bassussarry;1247;50952788;4137535;873;45875018;374;5077770;40860;34993
74066;Chavannaz;91;3718376;63465;52;2706394;39;1011982;40861;34994
68350;Voegtlinshoffen;262;10709088;846948;197;9676190;65;1032898;40874;34995
91471;Orsay;8428;344536953;32245098;6449;325697774;1979;18839179;40880;34996
91312;Igny;5149;210513965;19089743;4049;197646511;1100;12867454;40884;34997
95428;Montmorency;11786;481944486;47907473;8295;444297625;3491;37646861;40891;34998
91553;Saint-Germain-lès-Corbeil;3605;147428802;12706481;2846;137532086;759;9896716;40896;34999
74244;Saint-Laurent;374;15298838;479680;250;12430533;124;2868305;40906;35000
21016;Arceau;376;15382360;1406887;300;14461443;76;920917;40911;35001
51319;Lenharrée;48;1963901;151055;30;1630187;18;333714;40915;35002
74243;Saint-Julien-en-Genevois;6406;262106652;9564250;3340;175715533;3066;86391119;40916;35003
44009;Basse-Goulaine;3884;158926179;10256333;2854;144779427;1030;14146752;40918;35004
74229;Saint-Cergues;1596;65321907;2005793;928;47939360;668;17382547;40929;35005
92022;Chaville;10815;442652680;43560703;8245;415582572;2570;27070108;40930;35006
42092;L'Étrat;1421;58164444;5675458;1017;52367243;404;5797201;40932;35007
40037;Benquet;799;32715783;1788465;521;29241860;278;3473923;40946;35008
28303;Poupry;54;2213390;219610;42;2030146;12;183244;40989;35009
57031;Ars-Laquenexy;392;16078047;1163485;307;14538167;85;1539880;41015;35010
67485;Stutzheim-Offenheim;692;28384643;2299154;549;26301794;143;2082849;41018;35011
31036;Auzielle;649;26634316;2200723;520;25183846;129;1450470;41039;35012
69126;Marcy;315;12930430;999531;228;11702290;87;1228140;41049;35013
50081;Bréville-sur-Mer;427;17528149;1615420;282;15644304;145;1883845;41050;35014
74185;Monnetier-Mornex;1129;46347689;1546701;633;33157710;496;13189979;41052;35015
77065;Cély;586;24059340;2316182;459;22695306;127;1364034;41057;35016
10364;Saint-Usage;55;2258131;345714;36;2003319;19;254812;41057;35017
31388;Montpitol;181;7434244;566573;128;6925531;53;508713;41073;35018
10011;Arrentières;122;5011528;696535;83;4555684;39;455844;41078;35019
74021;Arthaz-Pont-Notre-Dame;692;28442241;1107700;440;22650776;252;5791465;41102;35020
13032;Éguilles;4128;169758615;16440877;2905;155167848;1223;14590767;41124;35021
10097;Chervey;101;4155321;541215;62;3737514;39;417807;41142;35022
13025;Châteauneuf-le-Rouge;1122;46167177;3718836;797;42012789;325;4154388;41147;35023
21512;Puligny-Montrachet;226;9299588;1200019;154;8571590;72;727998;41149;35024
68132;Helfrantzkirch;384;15808155;1448781;284;14469729;100;1338426;41167;35025
83101;Ramatuelle;1477;60817545;7720617;900;54648934;577;6168611;41176;35026
71400;Saint-Clément-sur-Guye;78;3212570;128212;51;2972133;27;240437;41187;35027
72310;Saint-Pavace;861;35468636;2448196;701;33502677;160;1965959;41195;35028
49167;Juigné-sur-Loire;1310;53967899;4647321;908;48978413;402;4989486;41197;35029
76377;Isneauville;1284;52901970;4172985;981;48760256;303;4141714;41201;35030
51052;Berru;235;9688500;890902;180;8995394;55;693106;41228;35031
68382;Zaessingue;168;6927214;483973;121;6348384;47;578830;41233;35032
51303;Jâlons;282;11632818;681804;178;10344285;104;1288533;41251;35033
51163;Congy;133;5488489;700359;87;4907251;46;581238;41267;35034
25062;Le Bizot;146;6029740;538070;115;5747217;31;282523;41300;35035
57396;Lessy;414;17100611;1637147;309;15607986;105;1492625;41306;35036
77252;Limoges-Fourches;197;8138172;641156;151;7440667;46;697505;41311;35037
51079;Bouzy;461;19056231;2131035;349;17717632;112;1338599;41337;35038
95379;Maudétour-en-Vexin;96;3969147;363766;68;3589675;28;379472;41345;35039
38027;Barraux;886;36635053;2519213;609;33247826;277;3387227;41349;35040
51641;Villevenard;118;4879162;659225;81;4555194;37;323968;41349;35041
38466;Saint-Vincent-de-Mercuze;707;29244047;2080759;527;26931590;180;2312457;41364;35042
25565;Touillon-et-Loutelet;97;4016473;280700;79;3829952;18;186521;41407;35043
51438;Poix;45;1864245;234984;28;1632931;17;231314;41428;35044
60172;Coye-la-Forêt;2074;85925961;8425347;1599;80379609;475;5546352;41430;35045
31273;Lapeyrouse-Fossat;1300;53869906;4013563;973;49683043;327;4186863;41438;35046
74307;Villy-le-Pelloux;454;18818228;1006802;325;16253978;129;2564250;41450;35047
68349;Village-Neuf;2059;85362887;8029862;1519;77962160;540;7400727;41458;35048
28135;Droue-sur-Drouette;603;25003187;2407609;467;23259699;136;1743488;41465;35049
25133;Châtillon-le-Duc;935;38776628;3151012;744;36252805;191;2523823;41472;35050
27674;Vaux-sur-Eure;152;6308794;696738;105;5728399;47;580395;41505;35051
14305;Gonneville-sur-Mer;331;13746196;1310713;225;12315607;106;1430589;41529;35052
12257;Causse-et-Diège;444;18439377;689052;224;16100812;220;2338565;41530;35053
81200;Palleville;239;9937641;298629;134;8883651;105;1053990;41580;35054
38328;Quaix-en-Chartreuse;433;18007858;1414605;340;16653294;93;1354564;41589;35055
69106;Lachassagne;471;19589765;1590230;369;18175676;102;1414089;41592;35056
34118;Guzargues;242;10065267;721445;177;8929519;65;1135748;41592;35057
57659;Spicheren;1738;72349694;5181867;1062;64381607;676;7968087;41628;35058
14014;Anguerny;347;14456424;1209606;281;13614790;66;841634;41661;35059
94068;Saint-Maur-des-Fossés;42908;1788058578;191456437;31830;1670461007;11078;117597571;41672;35060
74168;Marlioz;353;14713961;381582;213;11213537;140;3500424;41683;35061
80020;Allonville;362;15091272;1067231;271;13976600;91;1114672;41689;35062
74108;Duingt;467;19473733;1825978;330;17882598;137;1591135;41700;35063
59523;Sainghin-en-Mélantois;1359;56672055;5338462;967;51684519;392;4987536;41701;35064
68096;Franken;170;7094625;659442;126;6598064;44;496561;41733;35065
74184;Minzier;433;18072662;326732;246;11817779;187;6254883;41738;35066
59522;Sailly-lez-Lannoy;809;33773853;2559837;604;31331668;205;2442185;41748;35067
74200;Neuvecelle;1404;58626398;5404376;991;52796240;413;5830158;41757;35068
69250;La Tour-de-Salvagny;1919;80144980;6940591;1471;74281285;448;5863695;41764;35069
27031;Aviron;545;22763110;1638245;439;21574463;106;1188647;41767;35070
02146;Celles-lès-Condé;45;1880548;223388;28;1639479;17;241069;41790;35071
59596;Tilloy-lez-Marchiennes;221;9236663;479406;161;8345898;60;890765;41795;35072
62604;Neufchâtel-Hardelot;2099;87739528;8724353;1257;78009630;842;9729898;41801;35073
31089;Bretx;255;10659493;794151;184;9654491;71;1005002;41802;35074
77206;Giremoutiers;66;2759806;319174;49;2620746;17;139060;41815;35075
51056;Bethon;152;6356505;864313;100;5808783;52;547722;41819;35076
51305;Janvry;73;3054342;370032;54;2872314;19;182028;41840;35077
31003;Aigrefeuille;482;20169130;1323118;397;18944875;85;1224255;41845;35078
51196;Cramant;476;19927124;2065577;361;18395717;115;1531407;41864;35079
33065;Bouliac;1530;64098514;5131392;1131;58277444;399;5821070;41894;35080
78084;Boissy-sans-Avoir;276;11566232;1059668;215;10818329;61;747903;41907;35081
10355;Saint-Nicolas-la-Chapelle;41;1718608;203138;27;1566875;14;151733;41917;35082
38533;Venon;364;15260219;1178228;298;14314674;66;945545;41924;35083
74211;Pers-Jussy;1358;56932661;1744781;875;44780987;483;12151674;41924;35084
14566;Saint-Contest;1212;50837987;4688965;916;46826437;296;4011550;41946;35085
74193;La Muraz;520;21813271;545654;303;15830666;217;5982605;41949;35086
77185;Fleury-en-Bière;337;14136791;1487572;252;13323520;85;813271;41949;35087
95014;Andilly;1277;53591412;5428567;901;49228633;376;4362779;41967;35088
76517;Quincampoix;1385;58129397;4593385;1064;54044217;321;4085180;41971;35089
69293;Sathonay-Village;1012;42474904;3184569;803;39403980;209;3070924;41971;35090
91679;Villiers-le-Bâcle;613;25742892;2239512;517;24818193;96;924699;41995;35091
95298;Haravilliers;247;10372830;728033;188;9509494;59;863336;41995;35092
25395;Montfaucon;750;31500363;2750343;579;29480502;171;2019861;42000;35093
60208;Énencourt-Léage;72;3024955;154631;51;2777068;21;247887;42013;35094
69073;Dareizé;211;8864803;546542;149;8103227;62;761576;42013;35095
78420;Montfort-l'Amaury;1657;69619236;7639068;1146;63593259;511;6025977;42015;35096
01424;Tramoyes;746;31343558;2382519;589;29364945;157;1978613;42015;35097
74267;Sévrier;2245;94363046;9342586;1640;86295025;605;8068021;42033;35098
59570;Socx;470;19768177;1617115;328;17736804;142;2031373;42060;35099
38068;Champagnier;611;25705054;2119092;480;23860831;131;1844223;42070;35100
67519;La Wantzenau;2920;122881399;11740474;2213;114379484;707;8501915;42083;35101
15143;Nieudan;61;2567181;305551;31;2240911;30;326270;42085;35102
68197;Magstatt-le-Bas;217;9133130;780735;169;8484793;48;648337;42088;35103
67173;Griesheim-sur-Souffel;566;23822784;2016792;449;22030892;117;1791892;42090;35104
10048;Bligny;95;3999316;476207;59;3478328;36;520988;42098;35105
68221;Muespach;452;19036455;1799752;342;17724398;110;1312057;42116;35106
74003;Alex;489;20596341;1172141;357;18634583;132;1961758;42119;35107
25308;Les Hôpitaux-Vieux;190;8004305;627397;147;7439499;43;564806;42128;35108
60674;Vieux-Moulin;316;13318100;1277199;235;12317149;81;1000951;42146;35109
77048;Bourron-Marlotte;1497;63106115;6230757;1013;57578121;484;5527994;42155;35110
73208;Pugny-Chatenod;506;21350302;2106856;352;19081793;154;2268509;42194;35111
06128;Saint-Paul-de-Vence;2023;85421841;10208315;1301;78363679;722;7058162;42225;35112
74040;Bonne;1490;62915852;2303459;955;47889902;535;15025950;42225;35113
13019;Cabriès;4864;205387910;18482941;3517;188245452;1347;17142458;42226;35114
76039;Les Authieux-sur-le-Port-Saint-Ouen;559;23622516;1808937;437;22041371;122;1581145;42259;35115
78608;Le Tertre-Saint-Denis;55;2324808;242748;36;2148400;19;176408;42269;35116
33376;Saint-Aubin-de-Médoc;2934;124047356;10104985;2289;115766570;645;8280786;42279;35117
38229;Meylan;9720;411035239;38992242;7272;380268300;2448;30766939;42288;35118
77203;Germigny-l'Évêque;713;30157041;2597624;556;28256294;157;1900747;42296;35119
64152;Buros;885;37435767;2917806;633;33979186;252;3456581;42300;35120
14495;Périers-sur-le-Dan;260;10998085;930213;200;10137500;60;860585;42300;35121
28216;Louvilliers-en-Drouais;103;4357394;370408;76;3977669;27;379725;42305;35122
27079;Boissy-Lamberville;175;7403341;226993;109;6696320;66;707021;42305;35123
38422;Saint-Martin-d'Uriage;2750;116422318;9805870;2084;107073872;666;9348446;42335;35124
60428;Le Mont-Saint-Adrien;318;13468030;1189892;241;12603319;77;864711;42352;35125
78245;Fontenay-Mauvoisin;190;8051472;656008;149;7448992;41;602480;42376;35126
66113;Montbolo;80;3390358;176235;42;2995684;38;394674;42379;35127
59421;Mouvaux;6977;295757530;26092730;4803;267947691;2174;27809839;42390;35128
31511;Saint-Pierre;124;5256933;444628;80;4753607;44;503326;42395;35129
78677;Villette;248;10520005;913540;200;10052446;48;467559;42419;35130
51569;Thillois;133;5648745;419323;103;5195765;30;452980;42472;35131
33426;Saint-Laurent-des-Combes;168;7135946;873780;105;6583792;63;552154;42476;35132
74086;Contamine-Sarzin;267;11345644;256587;172;8861666;95;2483978;42493;35133
78565;Saint-Martin-des-Champs;145;6161516;498756;113;5727878;32;433638;42493;35134
78372;Marly-le-Roi;9032;383866887;37910509;7186;362338287;1846;21528600;42501;35135
91035;Authon-la-Plaine;180;7654633;784911;131;7135909;49;518724;42526;35136
78013;Andelu;203;8639075;652708;166;8232703;37;406372;42557;35137
95074;Boisemont;383;16299567;1551146;290;15399183;93;900384;42558;35138
38258;Mont-Saint-Martin;43;1830656;152336;32;1717949;11;112707;42573;35139
10032;Baroville;175;7452156;890347;136;7097578;39;354578;42584;35140
21591;Savigny-le-Sec;390;16608057;1321968;313;15553293;77;1054764;42585;35141
44201;Sucé-sur-Erdre;3080;131179490;11568787;2251;120414152;829;10765338;42591;35142
95213;Épiais-Rhus;337;14353890;1424676;266;13528696;71;825194;42593;35143
74020;Armoy;599;25514314;1680909;453;23102893;146;2411421;42595;35144
38059;Brié-et-Angonnes;1247;53132764;4496873;977;49943357;270;3189407;42608;35145
08293;Moiry;94;4005574;125718;39;3438913;55;566661;42612;35146
76567;Sainte-Beuve-en-Rivière;97;4134699;170906;57;3662064;40;472635;42626;35147
78321;Jouars-Pontchartrain;2649;112960046;10216805;2061;105742069;588;7217977;42643;35148
69233;Saint-Romain-au-Mont-d'Or;553;23581555;2262346;407;21956737;146;1624818;42643;35149
78163;Civry-la-Forêt;169;7211237;472755;125;6720157;44;491080;42670;35150
10438;Vitry-le-Croisé;143;6102861;882554;85;5523884;58;578977;42677;35151
21315;Hauteville-lès-Dijon;556;23730370;1962350;420;21622593;136;2107777;42681;35152
68055;Bruebach;503;21475412;1791992;385;19405231;118;2070181;42695;35153
80156;Bussy-lès-Daours;182;7774221;502879;139;7285666;43;488555;42716;35154
92048;Meudon;24895;1063828504;117183020;18418;992245152;6477;71583352;42733;35155
74101;Dingy-en-Vuache;287;12270684;210400;158;8693120;129;3577564;42755;35156
51007;Ambonnay;472;20188806;1821575;322;18406431;150;1782375;42773;35157
34014;Assas;763;32637416;3407979;546;29825114;217;2812302;42775;35158
78616;Thoiry;568;24297052;2243951;454;22832018;114;1465034;42777;35159
95489;Piscop;358;15315395;1473303;262;14151006;96;1164389;42780;35160
51294;Hourges;43;1840001;230121;30;1691730;13;148271;42791;35161
78227;Évecquemont;393;16817003;1524723;309;15866443;84;950560;42791;35162
38057;Bresson;359;15363649;1325742;293;14437279;66;926370;42796;35163
14542;Rosel;286;12240133;873650;224;11465534;62;774599;42798;35164
02481;Mesnil-Saint-Laurent;225;9631196;953910;176;9102105;49;529091;42805;35165
78285;Gressey;261;11174907;1155424;199;10315097;62;859810;42816;35166
78397;Le Mesnil-Saint-Denis;3259;139584802;12211683;2662;132247223;597;7337579;42831;35167
78683;Villiers-Saint-Frédéric;1304;55868152;4989486;1048;52433449;256;3434703;42844;35168
78638;Vaux-sur-Seine;2474;106000578;8205014;1773;98456362;701;7544216;42846;35169
84109;Saint-Hippolyte-le-Graveyron;92;3941885;377485;55;3525164;37;416721;42847;35170
95061;Béthemont-la-Forêt;210;8999001;847591;156;8239206;54;759795;42852;35171
21059;Bellefond;384;16455687;1534896;319;15640468;65;815219;42853;35172
51564;Tauxières-Mutry;130;5571500;590040;102;5220892;28;350608;42858;35173
72257;Rouillon;1051;45047257;2754894;769;41144108;282;3903149;42861;35174
42206;Saint-Bonnet-les-Oules;733;31423836;2653452;562;29126734;171;2297102;42870;35175
67151;Gambsheim;2483;106461136;5231701;1687;97357388;796;9103748;42876;35176
21616;Tailly;90;3859984;328862;71;3608690;19;251294;42889;35177
95656;Vienne-en-Arthies;220;9435925;812745;161;8744788;59;691137;42891;35178
68263;Ranspach-le-Bas;356;15271970;1471357;294;14414687;62;857283;42899;35179
60525;Raray;70;3004244;400391;51;2870904;19;133340;42918;35180
77394;Rubelles;953;40924384;3899446;730;38108047;223;2816337;42943;35181
76270;Fontaine-la-Mallet;1340;57548574;4815497;1048;53734326;292;3814248;42947;35182
50107;Catz;70;3007442;736082;33;2609327;37;398115;42963;35183
76123;Bosc-Guérard-Saint-Adrien;396;17032231;1263208;297;15908026;99;1124205;43011;35184
21541;Saint-Aubin;136;5851976;812333;97;5502087;39;349889;43029;35185
92014;Bourg-la-Reine;10625;457215701;50536237;8143;430058600;2482;27157101;43032;35186
69268;Vourles;1544;66441688;5620578;1163;60798282;381;5643406;43032;35187
14123;Cairon;752;32363994;2991093;592;30179931;160;2184063;43037;35188
74260;Savigny;361;15539429;485433;206;10401045;155;5138384;43046;35189
06089;Opio;1135;48857227;5097786;790;44593214;345;4264013;43046;35190
02191;Chivy-lès-Étouvelles;263;11324799;592922;165;10274075;98;1050724;43060;35191
77037;Bois-le-Roi;2908;125240558;11253948;2229;117357634;679;7882924;43068;35192
95308;Hérouville;282;12157357;952606;224;11416065;58;741292;43111;35193
77275;Les Marêts;65;2803092;119812;35;2494935;30;308157;43124;35194
74074;Chevrier;198;8543549;277787;111;5971358;87;2572191;43149;35195
01339;Saint-Bernard;693;29932305;2464557;511;27508704;182;2423601;43192;35196
64269;Idron;2098;90696166;7460187;1564;83288240;534;7407926;43230;35197
69049;Chasselay;1325;57327352;5053971;965;52574371;360;4752981;43266;35198
91630;Le Val-Saint-Germain;714;30891899;2609318;583;29167229;131;1724670;43266;35199
91568;Saint-Maurice-Montcouronne;767;33189376;3051389;617;31452972;150;1736404;43272;35200
95258;Frouville;193;8354571;787639;150;7891867;43;462704;43288;35201
28403;Ver-lès-Chartres;401;17359079;1034415;315;16217395;86;1141684;43289;35202
21347;Levernois;155;6713565;599377;122;6411602;33;301963;43313;35203
51584;Trois-Puits;86;3726246;396817;65;3494462;21;231784;43328;35204
44194;Sautron;3473;150500199;11551203;2611;139066116;862;11434083;43334;35205
14202;Cricqueboeuf;119;5158547;449125;78;4626538;41;532009;43349;35206
51309;Jonquery;44;1908214;215010;31;1707156;13;201058;43369;35207
59364;Louvil;406;17615122;1539895;315;16601793;91;1013329;43387;35208
13109;Le Tholonet;1293;56112874;6446672;926;52059769;367;4053105;43397;35209
72331;Sceaux-sur-Huisne;283;12293659;422448;173;10984758;110;1308901;43440;35210
89175;Fontenay-près-Chablis;73;3172824;452122;54;2972524;19;200300;43463;35211
10022;Avirey-Lingey;121;5260314;805298;82;4765834;39;494480;43474;35212
51471;Sacy;197;8567132;863414;155;8099727;42;467405;43488;35213
2A228;Pietrosella;718;31231695;3512390;451;28548275;267;2683420;43498;35214
68222;Muespach-le-Haut;506;22022657;1961080;400;20535254;106;1487403;43523;35215
59195;Englos;255;11099458;1132838;191;10129629;64;969829;43527;35216
13114;Ventabren;2603;113391054;10092049;1954;105159211;649;8231843;43562;35217
10242;Meurville;98;4269591;571789;62;3885301;36;384290;43567;35218
71169;Davayé;330;14388678;1065901;256;13465968;74;922710;43602;35219
01288;Péron;1050;45796652;1373682;580;31971525;470;13825127;43616;35220
95210;Enghien-les-Bains;6455;281592354;33915433;4733;263250778;1722;18341576;43624;35221
60170;Courteuil;350;15276252;1685619;257;14147657;93;1128595;43646;35222
95627;Vallangoujard;318;13884854;1410595;241;12893895;77;990959;43663;35223
27343;Houlbec-Cocherel;626;27339921;2122423;485;25538334;141;1801587;43674;35224
10025;Bagneux-la-Fosse;104;4542677;539528;67;4069132;37;473545;43680;35225
77372;Pomponne;1889;82533579;10064534;1424;77568837;465;4964742;43692;35226
01360;Saint-Jean-de-Gonville;717;31330921;1395449;398;22558391;319;8772530;43697;35227
69081;Écully;8554;373820105;38723823;6079;343527775;2475;30292330;43701;35228
78418;Montesson;7540;329516723;30588378;5905;310718491;1635;18798232;43702;35229
91619;Torfou;127;5551346;466118;97;5058737;30;492609;43711;35230
21716;Vougeot;103;4508576;580293;72;4099686;31;408890;43773;35231
69043;Chaponost;3988;174586187;15829310;2972;162000657;1016;12585530;43778;35232
01308;Pougny;359;15718917;429649;191;9659760;168;6059157;43785;35233
67260;Laubach;151;6618442;310310;114;6208603;37;409839;43831;35234
68072;Dietwiller;654;28685843;2577877;500;26701664;154;1984179;43862;35235
74288;Valleiry;1732;75999786;1670316;941;48993216;791;27006570;43880;35236
78072;Boinvilliers;139;6100033;682214;108;5597554;31;502479;43885;35237
69087;Fontaines-Saint-Martin;1410;61893522;5789255;976;56691144;434;5202378;43896;35238
60695;Vineuil-Saint-Firmin;784;34436709;3838531;561;31599844;223;2836865;43924;35239
77249;Lésigny;3594;157951504;13854764;2847;148703475;747;9248029;43949;35240
69046;Charly;2142;94173666;7670973;1645;87154256;497;7019410;43965;35241
25405;Montperreux;382;16812294;1242644;275;15406125;107;1406169;44011;35242
51249;Festigny;230;10125854;1297871;173;9337778;57;788076;44025;35243
78442;Neauphle-le-Château;1556;68520986;6335212;1237;64565813;319;3955173;44037;35244
02637;Remaucourt;175;7709733;820867;114;6910319;61;799414;44056;35245
18274;Verdigny;159;7005162;877989;107;6354062;52;651100;44058;35246
94052;Nogent-sur-Marne;18267;804907257;89284748;13945;759963463;4322;44943794;44063;35247
51119;Champillon;266;11722845;1175773;210;10926796;56;796049;44071;35248
91122;Bures-sur-Yvette;4587;202157952;19289112;3664;191586053;923;10571899;44072;35249
51457;Reuil;146;6435477;771718;102;6007918;44;427559;44079;35250
59371;Le Maisnil;284;12525603;1033620;218;11535467;66;990136;44104;35251
62836;Vaudricourt;447;19721426;2120797;332;18242319;115;1479107;44120;35252
74171;Massongy;737;32545183;782642;414;23406150;323;9139033;44159;35253
45057;Labrosse;47;2075782;270457;34;1941399;13;134383;44166;35254
51105;Cernay-lès-Reims;645;28486940;2502540;491;26578105;154;1908835;44166;35255
50204;Glatigny;90;3975341;132307;40;3411811;50;563530;44170;35256
14041;Barneville-la-Bertran;76;3356955;412568;52;3070033;24;286922;44170;35257
27321;La Haye-le-Comte;68;3004196;293139;52;2844186;16;160010;44179;35258
74296;Vers;340;15021517;312305;200;10528936;140;4492581;44181;35259
68042;Blotzheim;2246;99231555;9796369;1730;92111034;516;7120521;44181;35260
78194;Dannemarie;121;5346409;556183;93;4989540;28;356869;44185;35261
68286;Rosenau;1147;50686661;5002887;909;46518986;238;4167675;44191;35262
77381;Quiers;306;13524774;1475992;238;12667113;68;857661;44199;35263
74116;Etaux;860;38026732;1596009;616;32795974;244;5230758;44217;35264
78329;Lainville-en-Vexin;404;17865581;1616108;325;16979056;79;886525;44222;35265
51142;Chavot-Courcourt;192;8491034;865540;149;7891795;43;599239;44224;35266
51333;Ludes;336;14868630;1772879;244;13580217;92;1288413;44252;35267
74144;Jonzier-Épagny;354;15671043;383633;198;11116424;156;4554619;44268;35268
86014;Availles-en-Châtellerault;852;37723648;1696096;552;33878136;300;3845512;44277;35269
77124;Conches-sur-Gondoire;873;38677398;3418770;657;36337006;216;2340392;44304;35270
91600;Soisy-sur-Seine;3675;162839666;15746038;2868;152362723;807;10476943;44310;35271
38471;Le Sappey-en-Chartreuse;544;24110422;2315075;401;22481939;143;1628483;44321;35272
74298;Vétraz-Monthoux;3891;172755356;8171686;2313;131989244;1578;40766112;44399;35273
68084;Eschentzwiller;726;32239177;3091443;576;30170257;150;2068920;44407;35274
51376;Montgenost;75;3330823;310556;48;2944749;27;386074;44411;35275
92044;Levallois-Perret;35916;1595911953;193663907;27081;1506044177;8835;89867776;44435;35276
51069;Bligny;56;2488560;157037;39;2306873;17;181687;44439;35277
91411;Les Molières;927;41201553;3727392;748;39418200;179;1783353;44446;35278
74209;Peillonnex;681;30277933;1108505;452;23938431;229;6339502;44461;35279
78053;Béhoust;232;10315069;932108;182;9315078;50;999991;44462;35280
68327;Stetten;154;6849712;565178;120;6499372;34;350340;44479;35281
38249;Montbonnot-Saint-Martin;2386;106236735;9736067;1876;99248233;510;6988502;44525;35282
60033;Avilly-Saint-Léonard;460;20485732;1901337;369;19316365;91;1169367;44534;35283
51231;L'Épine;308;13718530;1146181;237;12881577;71;836953;44541;35284
54461;Romain;34;1514445;57873;23;1388854;11;125591;44543;35285
78366;Mareil-le-Guyon;189;8425219;893762;149;7837913;40;587306;44578;35286
68054;Brinckheim;182;8115035;801348;136;7641861;46;473174;44588;35287
78562;Saint-Léger-en-Yvelines;706;31486973;3459784;536;29226582;170;2260391;44599;35288
30204;Potelières;201;8965615;1245094;100;8020014;101;945601;44605;35289
95282;Gouzangrez;79;3527608;288772;60;2929390;19;598218;44653;35290
51120;Champlat-et-Boujacourt;69;3081155;212603;45;2784850;24;296305;44654;35291
31259;Lacroix-Falgarde;1041;46497361;3993700;801;43712359;240;2785002;44666;35292
78349;Longvilliers;262;11702964;1277857;213;11203297;49;499667;44668;35293
72386;Yvré-l'Évêque;2194;98030740;9909559;1518;89465224;676;8565516;44681;35294
80424;Hébécourt;220;9838418;850006;174;9106436;46;731982;44720;35295
01419;Thoiry;2569;114964538;4909717;1425;83081536;1144;31883002;44751;35296
51482;Saint-Germain-la-Ville;339;15183365;730871;191;13363512;148;1819853;44789;35297
68160;Kappelen;276;12365384;1128020;214;11517194;62;848190;44802;35298
10029;Balnot-sur-Laignes;82;3676076;469059;61;3493566;21;182510;44830;35299
01435;Versonnex;926;41523278;2003344;559;31989790;367;9533488;44842;35300
51152;Chigny-les-Roses;286;12827710;1503541;215;11997125;71;830585;44852;35301
84121;Sannes;92;4126708;117599;48;3636186;44;490522;44856;35302
67188;Heiligenberg;348;15614714;1850816;236;14378368;112;1236346;44870;35303
64329;Lée;569;25533612;2213989;441;23713742;128;1819870;44875;35304
68301;Schlierbach;566;25408816;2293844;436;23614381;130;1794435;44892;35305
35278;Saint-Grégoire;4360;195765384;19095683;3339;183013050;1021;12752334;44900;35306
14125;Cambes-en-Plaine;665;29860120;2716676;502;27881108;163;1979012;44902;35307
80696;Sains-en-Amiénois;574;25787714;2362175;432;23903432;142;1884282;44926;35308
51461;Rilly-la-Montagne;527;23698656;2573301;391;22166436;136;1532220;44969;35309
51256;Fontaine-sur-Ay;157;7063635;472174;121;6662836;36;400799;44991;35310
01281;Ornex;1852;83393045;4245313;994;62027345;858;21365700;45029;35311
31355;Mons;683;30767213;2542366;543;29053883;140;1713330;45047;35312
51582;Trigny;271;12209660;1295915;208;11408232;63;801428;45054;35313
78231;Favrieux;75;3379781;357799;60;3237470;15;142311;45064;35314
69117;Lissieu;1455;65657566;5846878;1119;61008592;336;4648974;45125;35315
01436;Vesancy;257;11601839;750857;181;10208992;76;1392847;45143;35316
68319;Spechbach-le-Bas;345;15582577;866684;250;14569543;95;1013034;45167;35317
91180;Courances;185;8356691;669991;138;7830095;47;526596;45171;35318
76446;Montigny;570;25749369;2221585;465;24522578;105;1226791;45174;35319
67097;Dingsheim;624;28201539;2548285;496;26592671;128;1608868;45195;35320
25148;La Chenalotte;212;9582771;857143;180;9241396;32;341375;45202;35321
51036;Barbonne-Fayel;284;12840414;1400475;196;11836345;88;1004069;45213;35322
01399;Ségny;801;36229806;1704462;472;28340288;329;7889518;45231;35323
51629;Villers-Allerand;447;20224047;2348404;303;18196735;144;2027312;45244;35324
68238;Niffer;451;20420951;1838987;360;19056800;91;1364151;45279;35325
14238;Englesqueville-en-Auge;71;3216852;227903;53;3004629;18;212223;45308;35326
60022;Apremont;377;17092221;1577252;285;15564385;92;1527836;45337;35327
01103;Chevry;638;28945135;1478486;390;21937612;248;7007523;45369;35328
77180;Férolles-Attilly;550;24953808;2504035;446;23726971;104;1226837;45371;35329
77447;Seine-Port;982;44602583;4310948;755;41614296;227;2988287;45420;35330
74162;Marcellaz;406;18455723;524661;256;13564845;150;4890878;45457;35331
76354;Hénouville;616;28012743;1987565;462;25966080;154;2046663;45475;35332
06060;Falicon;1015;46171446;4962093;741;43260193;274;2911253;45489;35333
10248;Montgueux;217;9874236;1235334;170;9238487;47;635749;45503;35334
91274;Gometz-la-Ville;643;29276022;2733285;534;28058845;109;1217177;45530;35335
68362;Wentzwiller;365;16622504;1791360;277;15459157;88;1163347;45541;35336
95574;Saint-Prix;3560;162180691;17786355;2674;151778870;886;10401821;45556;35337
51468;Rosnay;138;6288920;503961;109;5895117;29;393803;45572;35338
68034;Bettlach;157;7154978;731923;125;6682791;32;472187;45573;35339
21294;Gerland;196;8945220;446902;149;8314045;47;631175;45639;35340
74306;Villy-le-Bouveret;242;11047388;253734;158;8944978;84;2102410;45650;35341
67296;Mittelhausbergen;1014;46342412;5287837;812;43323804;202;3018608;45703;35342
51058;Bezannes;657;30035595;2751143;502;27918785;155;2116810;45716;35343
78146;Chatou;15871;725693416;78963901;12417;686978220;3454;38715196;45724;35344
78160;Chevreuse;2964;135578917;14850804;2256;126989058;708;8589859;45742;35345
78096;Bourdonné;283;12945090;1486859;219;12326488;64;618602;45742;35346
68357;Waltenheim;268;12265864;1221065;208;11368101;60;897763;45768;35347
38039;Bernin;1397;63946353;5058696;1120;59997779;277;3948574;45774;35348
69156;Pommiers;1095;50123631;3918254;817;46351368;278;3772263;45775;35349
68027;Berentzwiller;158;7234734;683452;116;6624453;42;610281;45789;35350
78550;Saint-Germain-de-la-Grange;865;39612682;3368839;727;37460141;138;2152541;45795;35351
09314;Tourtrol;123;5633875;564321;66;4913727;57;720148;45804;35352
78128;Cernay-la-Ville;788;36098633;3352596;647;34402663;141;1695970;45810;35353
21133;Chambolle-Musigny;183;8385933;1394442;127;7590246;56;795687;45825;35354
57147;Coin-sur-Seille;149;6833208;931661;107;6195389;42;637819;45860;35355
68135;Hésingue;1325;60783920;6317785;1059;56406623;266;4377297;45875;35356
51532;Sermiers;262;12022352;1192038;210;11395607;52;626745;45887;35357
59611;Verlinghem;1119;51362158;5094415;793;46722402;326;4639756;45900;35358
39145;Chille;162;7437655;808940;121;6662062;41;775593;45911;35359
68170;Koetzingue;270;12397355;1052428;206;11502550;64;894805;45916;35360
74150;Loisin;692;31782728;876472;408;23071736;284;8710992;45929;35361
78334;Lévis-Saint-Nom;844;38771056;3895134;684;36610413;160;2160643;45937;35362
74094;Cranves-Sales;3058;140485479;5570521;1944;108848591;1114;31636888;45940;35363
71302;Montagny-lès-Buxy;120;5513091;303278;88;5179412;32;333679;45942;35364
74128;Fillinges;1571;72305794;2402402;1017;55927986;554;16377808;46025;35365
76614;Saint-Martin-de-Boscherville;715;32920028;2993327;550;30363449;165;2556579;46042;35366
69033;Cailloux-sur-Fontaines;1147;52810186;4427507;879;49389482;268;3420704;46042;35367
41294;Villiers-sur-Loir;636;29288548;3044451;405;26470696;231;2817852;46051;35368
69085;Fleurieu-sur-Saône;692;31873050;2597522;518;29874245;174;1998805;46059;35369
74245;Saint-Martin-Bellevue;1223;56353295;3803147;926;49672279;297;6681016;46078;35370
57545;Plappeville;1083;49938559;4592428;804;46317866;279;3620693;46111;35371
74088;Copponex;445;20538795;419480;266;14992822;179;5545973;46155;35372
68264;Ranspach-le-Haut;300;13852929;1423263;230;12693954;70;1158975;46176;35373
69071;Curis-au-Mont-d'Or;518;23929773;2372525;416;22681326;102;1248447;46196;35374
69284;Montanay;1283;59271493;4476037;1011;55149902;272;4121591;46198;35375
69072;Dardilly;4059;187638137;17609638;3027;175802057;1032;11836080;46228;35376
51112;Chamery;207;9576994;1108408;144;9036533;63;540461;46266;35377
60536;Rhuis;64;2961649;299177;52;2805913;12;155736;46276;35378
31025;Aureville;367;16986798;1324029;288;15715830;79;1270968;46286;35379
41251;Souvigny-en-Sologne;283;13126217;744973;168;11884751;115;1241466;46382;35380
91534;Saclay;1690;78412962;7020992;1370;74559818;320;3853144;46398;35381
78140;Chapet;573;26598529;2499929;469;25311370;104;1287159;46420;35382
78646;Versailles;45312;2104027072;234119500;34337;1973534236;10975;130492836;46434;35383
32265;Monclar-sur-Losse;60;2787291;216097;29;2524332;31;262959;46455;35384
60432;Mortefontaine;420;19513296;1913816;326;18349655;94;1163641;46460;35385
51145;Chenay;135;6272526;716982;95;5950170;40;322356;46463;35386
77435;Saint-Sauveur-sur-École;558;25952474;2588501;452;24510546;106;1441928;46510;35387
01078;Challex;644;29955157;844870;362;20451728;282;9503429;46514;35388
51365;Les Mesneux;409;19033213;1786435;313;17878189;96;1155024;46536;35389
74309;Viry;1773;82612317;2129554;958;56032933;815;26579384;46595;35390
18219;Saint-Laurent;227;10585334;1346175;146;9501494;81;1083840;46631;35391
51657;Vrigny;105;4898787;622454;75;4624450;30;274337;46655;35392
68208;Michelbach-le-Haut;296;13810742;1373599;229;12976599;67;834143;46658;35393
31448;Rebigue;219;10220908;861055;173;9583706;46;637202;46671;35394
14015;Anisy;338;15785079;1159252;266;14889489;72;895590;46701;35395
28358;Saint-Prest;1038;48486235;4084206;802;45882736;236;2603499;46711;35396
78120;Bullion;899;41995608;4378373;741;40229637;158;1765971;46714;35397
95610;Théméricourt;138;6449112;614258;110;6088539;28;360573;46733;35398
62079;Bancourt;50;2337033;408915;29;2125934;21;211099;46741;35399
78686;Viroflay;8219;384436231;39098696;6539;362631896;1680;21804335;46774;35400
76552;Sainte-Adresse;4171;195153943;20769089;3158;181404322;1013;13749621;46788;35401
78263;Gambais;1177;55082752;5793023;949;52457192;228;2625560;46799;35402
77225;La Haute-Maison;154;7207770;692306;109;6663953;45;543817;46804;35403
74216;Présilly;367;17179496;564565;216;12398652;151;4780844;46811;35404
64178;Castetnau-Camblong;220;10308721;1325937;124;9182742;96;1125979;46858;35405
90054;Grosmagny;290;13601333;1659950;196;12566862;94;1034471;46901;35406
28349;Saint-Lucien;137;6426336;744389;105;6000082;32;426254;46908;35407
06105;Roquefort-les-Pins;3295;154594028;15596074;2350;143110490;945;11483538;46918;35408
50471;Saint-Georges-de-la-Rivière;146;6855734;265710;80;6046462;66;809272;46957;35409
68035;Biederthal;148;6953837;751016;115;6440087;33;513750;46985;35410
31243;Juzes;51;2396703;278443;21;2135970;30;260733;46994;35411
57129;Charly-Oradour;297;13977317;1009485;214;12834800;83;1142517;47062;35412
31489;Saint-Jean-Lherm;163;7674454;863907;120;7185377;43;489077;47083;35413
78034;Auteuil;426;20057800;2431496;342;19078542;84;979258;47084;35414
51592;Vandières;174;8194825;1135940;130;7738219;44;456606;47097;35415
62826;Le Touquet-Paris-Plage;3520;165836720;17177165;2242;151307386;1278;14529334;47113;35416
77038;Boissettes;224;10553758;923251;160;9596492;64;957266;47115;35417
78417;Montchauvet;152;7171930;746151;117;6787520;35;384410;47184;35418
78368;Mareil-sur-Mauldre;805;37999350;3596992;683;36487752;122;1511598;47204;35419
14645;Saint-Pierre-Azif;83;3918229;434208;53;3500546;30;417683;47208;35420
59487;Radinghem-en-Weppes;647;30610506;3111774;508;28909773;139;1700733;47311;35421
77441;Samois-sur-Seine;1125;53229722;6093957;814;49417647;311;3812075;47315;35422
60569;Saint-Crépin-aux-Bois;119;5631004;619685;90;5282807;29;348197;47319;35423
74100;Desingy;387;18318332;1724323;231;15390399;156;2927933;47334;35424
74098;Cuvat;497;23533442;1225919;376;21021558;121;2511884;47351;35425
78158;Le Chesnay;15491;734173289;81873030;12367;696229285;3124;37944004;47394;35426
78497;Poigny-la-Forêt;519;24601401;2656353;371;22343782;148;2257619;47402;35427
94048;Marolles-en-Brie;2296;108843394;10501474;1863;103126987;433;5716407;47406;35428
01014;Arbent;1714;81269192;4832470;1030;72437029;684;8832163;47415;35429
77209;Gouvernes;600;28451220;3159179;466;27120709;134;1330511;47419;35430
78300;Hargeville;203;9639745;790292;159;9077407;44;562338;47486;35431
31462;Rouffiac-Tolosan;1002;47588865;4291546;695;43908938;307;3679927;47494;35432
92012;Boulogne-Billancourt;67211;3196760135;409826983;50233;3024876850;16978;171883285;47563;35433
68120;Hagenthal-le-Bas;616;29315074;3307403;488;27291658;128;2023416;47589;35434
78049;Bazemont;749;35652600;3777813;610;33745540;139;1907060;47600;35435
60689;Villers-sur-Coudun;670;31895640;2956606;537;30030898;133;1864742;47605;35436
01135;Crozet;900;42855746;1973955;506;31895004;394;10960742;47617;35437
34169;Montferrier-sur-Lez;1919;91426789;10299736;1319;84799425;600;6627364;47643;35438
92072;Sèvres;12256;583960079;68415794;9282;552170354;2974;31789725;47647;35439
78415;Montainville;287;13679893;1537534;212;12378314;75;1301579;47665;35440
74036;Bluffy;178;8485642;652678;141;7571601;37;914041;47672;35441
95295;Guiry-en-Vexin;91;4338421;357761;74;4082077;17;256344;47675;35442
38188;Herbeys;692;33011739;2715589;547;31030598;145;1981141;47705;35443
92063;Rueil-Malmaison;41349;1974199449;227166746;32161;1873191874;9188;101007575;47745;35444
02303;Fayet;349;16668870;1513688;248;15096106;101;1572764;47762;35445
68207;Michelbach-le-Bas;390;18655274;1974605;315;17489457;75;1165817;47834;35446
10427;Ville-sur-Arce;143;6845148;1121205;97;6283699;46;561449;47868;35447
60579;Saint-Jean-aux-Bois;182;8718729;1062188;126;7945347;56;773382;47905;35448
34138;Lieuran-Cabrières;155;7436644;303053;70;6587964;85;848680;47978;35449
60346;Lamorlaye;4978;238913632;28682756;3760;224464280;1218;14449352;47994;35450
78030;Auffargis;979;46993712;4830626;808;44996282;171;1997430;48002;35451
68094;Folgensbourg;419;20139785;2185943;336;19115640;83;1024145;48066;35452
68121;Hagenthal-le-Haut;298;14332119;1280819;242;13519013;56;813106;48094;35453
74069;Chênex;315;15155909;279403;191;10491937;124;4663972;48114;35454
21107;Bretigny;432;20788870;1680522;338;19736886;94;1051984;48122;35455
59196;Ennetières-en-Weppes;629;30314701;3063814;466;27942915;163;2371786;48195;35456
77425;Saint-Martin-en-Bière;383;18467801;2123888;292;17278336;91;1189465;48219;35457
02765;Vaucelles-et-Beffecourt;129;6228658;724540;89;5757936;40;470722;48284;35458
67354;Odratzheim;222;10724060;1462898;156;10036141;66;687919;48307;35459
60100;Brasseuse;60;2898531;423390;42;2751019;18;147512;48309;35460
91631;Varennes-Jarcy;1112;53748763;5416617;873;51104920;239;2643843;48335;35461
68061;Buschwiller;542;26211465;3076628;416;24374934;126;1836531;48361;35462
21255;Étaules;125;6047323;655515;106;5838850;19;208473;48379;35463
68013;Attenschwiller;473;22901049;2323276;363;21121323;110;1779726;48417;35464
27605;Saint-Sylvestre-de-Cormeilles;121;5863072;674436;62;5242283;59;620789;48455;35465
94070;Santeny;1736;84195648;8576115;1322;79290825;414;4904823;48500;35466
74228;Saint-Blaise;163;7916535;161737;98;5848838;65;2067697;48568;35467
34247;Saint-Clément-de-Rivière;2329;113187622;11142576;1739;105563318;590;7624304;48599;35468
77339;Noisy-sur-École;993;48338082;5149021;757;45039134;236;3298948;48679;35469
51310;Jouy-lès-Reims;102;4965756;552192;75;4646668;27;319088;48684;35470
78551;Saint-Germain-en-Laye;21334;1040539482;129986842;15885;978268036;5449;62271446;48774;35471
91319;Janvry;317;15461389;1509989;246;14628735;71;832654;48774;35472
45100;Combleux;248;12097951;1282687;206;11467211;42;630740;48782;35473
22023;Bulat-Pestivien;250;12196276;456450;106;10705406;144;1490870;48785;35474
77214;Gressy;428;20880263;2319310;358;19958091;70;922172;48786;35475
78655;Vieille-Église-en-Yvelines;365;17819491;1957097;300;16891135;65;928356;48821;35476
78185;Courgent;202;9870188;1019452;156;8998926;46;871262;48862;35477
78117;Buc;2713;132815827;13941927;2277;127443272;436;5372555;48955;35478
61308;Neuvy-au-Houlme;125;6121243;271563;73;5459530;52;661713;48970;35479
68168;Knoeringue;173;8472140;845975;137;7903967;36;568173;48972;35480
80307;Feuillères;86;4212075;590439;49;3812588;37;399487;48978;35481
14758;Villons-les-Buissons;306;15016755;1427180;258;14454122;48;562633;49074;35482
69076;Dommartin;1185;58153722;5389776;908;54120449;277;4033273;49075;35483
38431;Saint-Nazaire-les-Eymes;1372;67387728;5537432;1113;63519128;259;3868600;49116;35484
68341;Uffheim;488;23997352;2195563;366;22196397;122;1800955;49175;35485
31353;Monès;35;1722687;343534;21;1562584;14;160103;49220;35486
21150;Chassagne-Montrachet;200;9869333;1530040;134;9053142;66;816191;49347;35487
91635;Vauhallan;998;49250227;5159018;784;46303085;214;2947142;49349;35488
36027;Brives;154;7605837;1052630;93;6914456;61;691381;49389;35489
74013;Anthy-sur-Léman;1074;53043557;4803566;743;45220854;331;7822703;49389;35490
27190;Croisy-sur-Eure;119;5879010;653430;86;5406913;33;472097;49403;35491
62279;Duisans;601;29693185;3078994;444;27313742;157;2379443;49406;35492
68265;Rantzwiller;371;18338055;1779256;289;16741151;82;1596904;49429;35493
59356;Lompret;1078;53356433;5065993;792;49550140;286;3806293;49496;35494
27545;Saint-Germain-de-Pasquier;65;3217567;375817;51;3089578;14;127989;49501;35495
51622;Ville-Dommange;215;10658465;1277985;163;10061836;52;596629;49574;35496
68386;Zimmersheim;566;28121833;2899769;449;26531387;117;1590446;49685;35497
51362;Merfy;301;14958013;1566871;234;14116301;67;841712;49694;35498
01071;Cessy;1997;99287378;6032105;1295;81624026;702;17663352;49718;35499
10068;Buxeuil;75;3733286;537319;56;3542662;19;190624;49777;35500
78384;Médan;685;34134372;3709533;535;31683287;150;2451085;49831;35501
10070;Celles-sur-Ource;272;13554650;2111670;191;12347699;81;1206951;49833;35502
78092;Bougival;4476;223208971;26571394;3562;212551087;914;10657884;49868;35503
91272;Gif-sur-Yvette;10088;504035140;53352071;8219;481451465;1869;22583675;49964;35504
78404;Millemont;124;6197152;787426;96;5857945;28;339207;49977;35505
78302;La Hauteville;99;4950768;594603;73;4651842;26;298926;50008;35506
78006;Adainville;411;20589863;2980782;301;19364333;110;1225530;50097;35507
54126;Chenicourt;105;5268947;949001;64;4685522;41;583425;50180;35508
31284;Lauzerville;597;29977226;2219893;479;27969417;118;2007809;50213;35509
78688;Voisins-le-Bretonneux;5259;264306811;26544396;4388;253196404;871;11110407;50258;35510
27124;Cailly-sur-Eure;135;6788346;902498;94;6365677;41;422669;50284;35511
77059;Bussy-Saint-Martin;349;17549994;1789068;275;16724066;74;825928;50287;35512
94067;Saint-Mandé;11952;602681794;79388799;9108;571868552;2844;30813242;50425;35513
71182;Dracy-le-Fort;668;33786552;3667847;500;31635198;168;2151354;50579;35514
76444;Mont-de-l'If;50;2530059;264507;28;2213796;22;316263;50601;35515
74070;Chens-sur-Léman;926;46858114;1017407;495;30602475;431;16255639;50603;35516
78126;La Celle-Saint-Cloud;10651;539138596;60927523;8082;507660964;2569;31477632;50619;35517
01401;Sergy;891;45107293;1872982;492;32349001;399;12758292;50625;35518
14407;Mathieu;967;49007488;4631855;734;46369576;233;2637912;50680;35519
77518;Villiers-en-Bière;115;5829784;1005325;90;5580296;25;249488;50694;35520
49216;Montreuil-sur-Loir;255;12927414;814454;171;11991099;84;936315;50696;35521
77221;Guermantes;580;29491029;3173378;461;28181640;119;1309389;50847;35522
68103;Geispitzen;224;11410794;1147198;175;10679511;49;731283;50941;35523
68183;Liebenswiller;99;5044135;492647;82;4844731;17;199404;50951;35524
78443;Neauphle-le-Vieux;426;21707352;2681636;352;20888714;74;818638;50956;35525
78358;Maisons-Laffitte;12503;637139983;74478718;9952;606813286;2551;30326697;50959;35526
51181;Courcelles-Sapicourt;150;7657853;910198;118;7234725;32;423128;51052;35527
77034;Blandy;368;18825714;2456791;274;17833046;94;992668;51157;35528
91093;Boullay-les-Troux;291;14897527;1463854;246;14378183;45;519344;51194;35529
91538;Saint-Aubin;364;18651343;2047400;320;18149089;44;502254;51240;35530
78125;La Celle-les-Bordes;438;22513270;2158018;365;21730248;73;783022;51400;35531
74153;Lucinges;776;39899231;1997837;487;30720058;289;9179173;51417;35532
60640;Tourly;89;4583784;604432;68;4316559;21;267225;51503;35533
10134;Échemines;43;2214887;168455;28;1493450;15;721437;51509;35534
60682;Villers-Saint-Frambourg;284;14631793;1647329;224;14016350;60;615443;51520;35535
01397;Sauverny;477;24594562;1692542;303;20019153;174;4575409;51561;35536
78524;Rocquencourt;1792;92433784;11593518;1461;88096499;331;4337285;51581;35537
01313;Prévessin-Moëns;3249;168194607;8913763;1845;131065552;1404;37129055;51768;35538
78389;Méré;841;43563126;4184509;666;40837441;175;2725685;51799;35539
77049;Boutigny;406;21071732;2397752;313;19931572;93;1140160;51901;35540
78653;Vicq;140;7281230;665258;102;6243748;38;1037482;52009;35541
74082;Collonges-sous-Salève;1987;103387812;2913349;1072;70050016;915;33337796;52032;35542
74009;Andilly;370;19254348;450258;232;14328301;138;4926047;52039;35543
21714;Vosne-Romanée;208;10832819;1535875;147;10171918;61;660901;52081;35544
60087;Borest;156;8142779;1026941;117;7776147;39;366632;52197;35545
57701;Vaux;417;21803302;1798640;287;20064096;130;1739206;52286;35546
21223;Daix;720;37694390;3949968;564;35488141;156;2206249;52353;35547
91064;Bièvres;2252;117925627;14432447;1788;111852337;464;6073290;52365;35548
59217;Eth;150;7855120;651676;116;7407046;34;448074;52367;35549
74052;Cernex;439;23003955;518982;285;18458035;154;4545920;52401;35550
51225;Écueil;166;8708927;1140146;132;8237199;34;471728;52463;35551
95426;Montlignon;1250;65670864;7149263;966;62130096;284;3540768;52537;35552
74044;Bossey;400;21066590;567786;221;13693382;179;7373208;52666;35553
78010;Les Alluets-le-Roi;559;29443854;3333563;457;28072468;102;1371386;52672;35554
78322;Jouy-en-Josas;3412;179730939;20018136;2764;171212625;648;8518314;52676;35555
57596;Rosbruck;442;23318042;937104;217;21155520;225;2162522;52756;35556
01261;Monthieux;297;15679883;894113;214;14624342;83;1055541;52794;35557
58113;Fertrève;65;3434214;152659;27;3118257;38;315957;52834;35558
68232;Neuwiller;283;15038530;1647201;222;13761323;61;1277207;53140;35559
13006;Aureille;870;46252997;2669517;514;42581945;356;3671052;53164;35560
78143;Châteaufort;651;34631704;3691918;544;33056432;107;1575272;53198;35561
78193;Dampierre-en-Yvelines;555;29658114;3613637;427;27878612;128;1779502;53438;35562
78620;Toussus-le-Noble;449;23998351;2402547;378;23117486;71;880865;53448;35563
10390;Urville;79;4229771;603807;58;3951538;21;278233;53541;35564
60060;Belle-Église;309;16547801;952331;208;15460274;101;1087527;53553;35565
78575;Saint-Rémy-lès-Chevreuse;3898;209149940;20551308;3044;197080909;854;12069031;53656;35566
91645;Verrières-le-Buisson;8065;432777681;51885305;6241;410912512;1824;21865169;53661;35567
38397;Saint-Ismier;3271;175526111;18704898;2542;165716394;729;9809717;53661;35568
71126;Chevagny-les-Chevrières;277;14893761;1677861;221;14154008;56;739753;53768;35569
68182;Leymen;602;32423477;4006987;455;30033999;147;2389478;53860;35570
78522;Rochefort-en-Yvelines;467;25215052;2619231;389;24402495;78;812557;53994;35571
78396;Le Mesnil-le-Roi;3189;172329219;19571070;2403;162439965;786;9889254;54039;35572
68126;Hégenheim;1669;90242481;11279970;1304;84410033;365;5832448;54070;35573
95580;Saint-Witz;1121;60719427;6570077;939;58248851;182;2470576;54165;35574
74145;Juvigny;301;16314930;743198;190;12755412;111;3559518;54202;35575
69044;Charbonnières-les-Bains;2493;135137263;15225205;1967;127987903;526;7149360;54207;35576
91435;Morsang-sur-Seine;285;15454670;1418722;223;14743003;62;711667;54227;35577
25557;Tallenay;207;11245922;896881;174;10818728;33;427194;54328;35578
01180;Grilly;380;20659346;1577216;247;17303310;133;3356036;54367;35579
69116;Limonest;1687;91777582;13121263;1227;85371503;460;6406079;54403;35580
51623;Ville-en-Selve;133;7259032;762659;118;6877902;15;381130;54579;35581
92071;Sceaux;10024;547730839;68589658;7917;521476938;2107;26253901;54642;35582
78162;Choisel;265;14504443;1839553;209;13904146;56;600297;54734;35583
57352;Jussy;230;12628598;1321960;171;11749143;59;879455;54907;35584
31227;Goyrans;419;23026552;2180942;329;22134737;90;891815;54956;35585
74031;Beaumont;1074;59055125;1634299;663;43598636;411;15456489;54986;35586
31437;Pouze;49;2694621;304762;37;2527051;12;167570;54992;35587
78431;Morainvilliers;1067;58957136;6714384;825;56128762;242;2828374;55255;35588
59090;Bondues;4680;259504241;25344240;3374;241700435;1306;17803806;55450;35589
59208;Escobecques;136;7547840;837818;108;7103204;28;444636;55499;35590
21689;Villars-et-Villenotte;82;4554141;818510;53;4260446;29;293695;55538;35591
80702;Saint-Fuscien;463;25725582;2958647;367;24530739;96;1194843;55563;35592
74180;Messery;971;54068110;1837148;568;39237588;403;14830522;55683;35593
95304;Hédouville;141;7871891;1043559;111;7505750;30;366141;55829;35594
74124;Feigères;708;39553425;1336357;442;29367055;266;10186370;55866;35595
59398;Mérignies;1173;65649402;7022547;921;61459282;252;4190120;55967;35596
78133;Chambourcy;2898;164054809;23145876;2248;155437392;650;8617417;56610;35597
60560;Rully;355;20102985;2410939;258;18959239;97;1143746;56628;35598
78576;Saint-Rémy-l'Honoré;692;39217878;5228212;566;37611007;126;1606871;56673;35599
31418;Pin-Balma;441;25062305;2765101;298;23020197;143;2042108;56831;35600
74201;Neydens;727;41326262;1046755;437;31449528;290;9876734;56845;35601
01143;Divonne-les-Bains;4392;249682913;22398283;2938;213319447;1454;36363466;56849;35602
74293;Veigy-Foncenex;1578;89742237;1828698;818;58040410;760;31701827;56871;35603
31411;Pechbusque;400;22752807;2537793;332;21876670;68;876137;56882;35604
51282;Gueux;795;45375356;5449338;629;42953990;166;2421366;57076;35605
34265;Saint-Jean-de-Cornies;285;16394544;792727;197;15270211;88;1124333;57525;35606
69153;Poleymieux-au-Mont-d'Or;482;27791934;2843592;391;26449219;91;1342715;57660;35607
74176;Menthon-Saint-Bernard;1031;59476965;6529364;777;53509554;254;5967411;57689;35608
78590;Senlisse;278;16045021;1916965;225;15163647;53;881374;57716;35609
74199;Nernier;190;10993627;465033;103;7838825;87;3154802;57861;35610
27025;Autheuil-Authouillet;465;27103084;3959069;319;25522559;146;1580525;58286;35611
74025;Ballaison;658;38388670;1563344;383;29457349;275;8931321;58341;35612
74016;Archamps;1190;69481024;1722296;670;47611084;520;21869940;58387;35613
92033;Garches;9552;559192934;74977225;7598;533579322;1954;25613612;58542;35614
86256;Savigny-Lévescault;533;31309763;4316509;398;29718681;135;1591082;58743;35615
16237;Mouton;135;7940421;263240;68;7186699;67;753722;58818;35616
38126;Corenc;1927;113701105;13039171;1489;107050210;438;6650895;59004;35617
57624;Sainte-Ruffine;283;16717315;2511845;214;15575289;69;1142026;59072;35618
60241;Fontaine-Chaalis;174;10309793;1698282;136;9908575;38;401218;59252;35619
78548;Saint-Forget;245;14525334;2042365;219;14280657;26;244677;59287;35620
02449;Macogny;33;1965879;267580;20;1750649;13;215230;59572;35621
78561;Saint-Lambert;203;12164101;1566074;167;11769918;36;394183;59922;35622
51637;Villers-sous-Châtillon;111;6688383;1156709;79;6316032;32;372351;60256;35623
78455;Noisy-le-Roi;3627;220466193;26622279;3033;212230015;594;8236178;60785;35624
51342;Mancy;135;8209619;648410;108;7878792;27;330827;60812;35625
60415;Montépilloy;77;4708176;590294;59;4562666;18;145510;61145;35626
78406;Milon-la-Chapelle;169;10339567;1468187;117;9803261;52;536306;61181;35627
38404;Saint-Jean-le-Vieux;122;7474421;936188;99;7183181;23;291240;61266;35628
10379;Torcy-le-Grand;243;14899431;2073146;155;13806966;88;1092465;61315;35629
90086;Romagny-sous-Rougemont;111;6814738;549925;74;6326907;37;487831;61394;35630
71115;Châtel-Moron;42;2579954;354486;24;2336809;18;243145;61427;35631
62658;Pittefaux;53;3266785;467664;40;3086549;13;180236;61637;35632
51109;Châlons-sur-Vesle;90;5549779;606460;73;5349406;17;200373;61664;35633
25482;Recologne;331;20439310;2957235;227;19249570;104;1189740;61750;35634
60028;Aumont-en-Halatte;267;16488443;2140205;209;15952148;58;536295;61754;35635
31340;Mervilla;110;6814029;662325;95;6583302;15;230727;61946;35636
91225;Étiolles;1526;94628844;10500529;1267;91241382;259;3387462;62011;35637
59275;Gruson;534;33154380;3422376;433;31695098;101;1459282;62087;35638
37047;Cerelles;540;33527154;1537566;406;31674728;134;1852426;62087;35639
10264;Noé-les-Mallets;71;4419913;815000;54;4246047;17;173866;62252;35640
77022;Barbizon;798;50135232;6819951;574;47254599;224;2880633;62826;35641
78466;Orgeval;2652;166977514;20202733;2115;159860543;537;7116971;62963;35642
45006;Ardon;508;32048337;3522432;418;30741865;90;1306472;63087;35643
78281;Goussonville;289;18251830;1574105;215;17386175;74;865655;63155;35644
21218;Curtil-Saint-Seine;57;3628331;404211;39;3464290;18;164041;63655;35645
78043;Bailly;1809;115254758;13604349;1552;111850172;257;3404586;63712;35646
60138;Chamant;462;29460826;5053181;347;27886835;115;1573991;63768;35647
76617;Saint-Martin-du-Vivier;795;50835276;6007747;673;49087280;122;1747996;63944;35648
13090;Saint-Antonin-sur-Bayon;80;5152603;503583;56;4850281;24;302322;64408;35649
78350;Louveciennes;3611;232731027;32333624;2838;222940846;773;9790181;64451;35650
14731;Vauville;121;7856611;1982746;76;7361683;45;494928;64931;35651
51127;La Chapelle-Lasson;52;3400183;312779;33;3140629;19;259554;65388;35652
78189;Crespières;770;50436497;7416722;613;48480696;157;1955801;65502;35653
13095;Saint-Marc-Jaumegarde;516;33875756;4133212;377;31713940;139;2161816;65651;35654
01153;Échenevex;722;47427931;2691212;474;39177873;248;8250058;65690;35655
50460;Sainte-Croix-Hague;357;23490097;999829;235;21804557;122;1685540;65799;35656
31578;Vigoulet-Auzil;444;29298829;3353083;365;28155162;79;1143667;65988;35657
92064;Saint-Cloud;15090;999189573;139065304;11989;960500667;3101;38688906;66215;35658
92077;Ville-d'Avray;5736;382103143;52057009;4595;366822873;1141;15280270;66615;35659
59554;Sars-et-Rosières;242;16175609;2271481;160;15035575;82;1140034;66841;35660
78196;Davron;152;10192897;1327549;125;9509753;27;683144;67059;35661
71562;Vaudebarrier;118;7938288;276721;77;7377296;41;560992;67274;35662
38045;Biviers;1163;78298916;10550049;954;75176365;209;3122551;67325;35663
78036;Autouillet;226;15287872;2211364;177;14713477;49;574395;67645;35664
10155;Fontette;106;7179494;1294136;78;6861403;28;318091;67731;35665
78623;Le Tremblay-sur-Mauldre;443;30025964;2176860;342;28868175;101;1157789;67779;35666
78367;Mareil-Marly;1507;102707727;12236608;1234;98911216;273;3796511;68154;35667
76097;Biville-la-Rivière;58;4032134;136386;38;3828838;20;203296;69520;35668
78152;Chavenay;800;56174424;7492331;685;54403675;115;1770749;70218;35669
69191;Saint-Cyr-au-Mont-d'Or;2726;192310068;27602993;2011;183384085;715;8925983;70547;35670
78190;Croissy-sur-Seine;4824;341427800;46983891;3932;328847133;892;12580667;70777;35671
69063;Collonges-au-Mont-d'Or;1959;139305998;14544516;1507;133367879;452;5938119;71111;35672
68147;Hunawihr;322;22966167;1386704;217;21541274;105;1424893;71324;35673
14425;Le Mesnil-Simon;87;6475813;311943;52;6155837;35;319976;74435;35674
78672;Villennes-sur-Seine;2502;186766874;27481374;2033;180601559;469;6165315;74647;35675
78050;Bazoches-sur-Guyonne;268;20089231;2458483;221;19281534;47;807697;74960;35676
54165;Dommartemont;325;24433330;3341372;258;23493409;67;939921;75179;35677
74299;Veyrier-du-Lac;1277;96157679;11479746;964;89784392;313;6373287;75300;35678
78224;L'Étang-la-Ville;2196;170100417;22713588;1841;164537236;355;5563181;77459;35679
31575;Vieille-Toulouse;550;43008783;5630516;454;41673952;96;1334831;78198;35680
92076;Vaucresson;4303;336986885;47464932;3506;326014582;797;10972303;78314;35681
78007;Aigremont;460;36067463;5350309;380;34931973;80;1135490;78408;35682
30286;Saint-Maximin;412;32618977;2942273;240;31149572;172;1469405;79172;35683
78251;Fourqueux;1780;141313829;19772185;1483;136270402;297;5043427;79390;35684
69194;Saint-Didier-au-Mont-d'Or;3055;248045699;33031376;2425;239295601;630;8750098;81193;35685
78650;Le Vésinet;8088;661143012;104398022;6413;637224149;1675;23918863;81744;35686
78233;Feucherolles;1282;105239115;16895204;1064;101689764;218;3549351;82090;35687
78164;Clairefontaine-en-Yvelines;422;36304918;7502849;307;35025223;115;1279695;86031;35688
78398;Les Mesnuls;435;37460720;3812054;303;35893621;132;1567099;86117;35689
64520;Serres-Morlaàs;345;30236952;4118950;260;28947814;85;1289138;87643;35690
03168;Meaulne;470;42713252;8043222;214;39989544;256;2723708;90879;35691
78343;Les Loges-en-Josas;657;60546242;9630282;551;58826562;106;1719680;92156;35692
14178;Corbon;32;3002633;357769;21;2888735;11;113898;93832;35693
78571;Saint-Nom-la-Bretèche;2278;213962808;34866447;1914;207533796;364;6429012;93926;35694
78305;Herbeville;131;12611035;3215422;101;12320676;30;290359;96267;35695
92051;Neuilly-sur-Seine;33704;3256133223;553615440;26214;3161146953;7490;94986270;96610;35696
92047;Marnes-la-Coquette;751;74018331;13222268;601;71806383;150;2211948;98560;35697
78278;Goupillières;236;24026322;1954659;195;23511520;41;514802;101806;35698
78289;Grosrouvre;454;54129388;10811721;354;52756840;100;1372548;119228;35699
10103;Colombé-le-Sec;79;10100178;653226;62;9937017;17;163161;127850;35700
